subject,interval,date_time,light,vo2,vco2,rer,heat,xyt,xt,xa,xf,yt,ya,yf,z,drink,feed
1001,1,2020-03-16 10:53:00,1,4009.0,3090.0,0.771,19.218,8,8,1,7,0,0,0,0,0.01,0.02
1001,2,2020-03-16 10:56:00,1,3959.0,3019.0,0.763,18.94,20,13,11,2,7,5,2,0,0.01,0.01
1001,3,2020-03-16 10:59:00,1,3960.0,2977.0,0.752,18.9,136,96,66,30,40,32,8,8,0.02,0.02
1001,4,2020-03-16 11:02:00,1,3959.0,3057.0,0.772,18.984,25,25,10,15,0,0,0,0,0.06,0.0
1001,5,2020-03-16 11:05:00,1,3951.0,2981.0,0.755,18.869,13,11,7,4,2,0,2,0,0.01,0.01
1001,6,2020-03-16 11:08:00,1,3821.0,2930.0,0.767,18.298,32,19,15,4,13,11,2,3,0.01,0.0
1001,7,2020-03-16 11:11:00,1,3760.0,2918.0,0.776,18.045,67,43,31,12,24,14,10,1,0.01,0.0
1001,8,2020-03-16 11:14:00,1,3750.0,2906.0,0.775,17.993,117,73,41,32,44,35,9,3,0.0,0.0
1001,9,2020-03-16 11:17:00,1,3831.0,2944.0,0.769,18.355,4,3,1,2,1,1,0,0,0.06,0.0
1001,10,2020-03-16 11:20:00,1,3767.0,2848.0,0.756,17.994,56,31,22,9,25,19,6,2,0.0,0.0
1001,11,2020-03-16 11:23:00,1,3758.0,2902.0,0.772,18.018,16,14,8,6,2,1,1,0,0.01,0.0
1001,12,2020-03-16 11:26:00,1,3762.0,2861.0,0.761,17.991,58,26,19,7,32,27,5,0,0.01,0.0
1001,13,2020-03-16 11:29:00,1,3764.0,2856.0,0.759,17.992,25,25,11,14,0,0,0,0,0.01,0.0
1001,14,2020-03-16 11:32:00,1,3686.0,2824.0,0.766,17.648,74,66,43,23,8,4,4,0,0.0,0.0
1001,15,2020-03-16 11:35:00,1,3751.0,2939.0,0.784,18.032,188,134,91,43,54,34,20,2,0.01,0.0
1001,16,2020-03-16 11:38:00,1,3754.0,2904.0,0.774,18.006,166,105,71,34,61,44,17,2,0.01,0.0
1001,17,2020-03-16 11:41:00,1,3966.0,2985.0,0.753,18.93,44,44,24,20,0,0,0,0,0.0,0.0
1001,18,2020-03-16 11:44:00,1,3982.0,2978.0,0.748,18.987,101,77,62,15,24,20,4,0,0.01,0.0
1001,19,2020-03-16 11:47:00,1,3972.0,2995.0,0.754,18.965,13,13,5,8,0,0,0,0,0.07,0.0
1001,20,2020-03-16 11:50:00,1,3891.0,2944.0,0.757,18.589,2,2,0,2,0,0,0,0,0.0,0.0
1001,21,2020-03-16 11:53:00,1,3742.0,2900.0,0.775,17.954,15,15,4,11,0,0,0,0,0.0,0.0
1001,22,2020-03-16 11:56:00,1,3764.0,2868.0,0.762,18.006,6,6,4,2,0,0,0,0,0.0,0.0
1001,23,2020-03-16 11:59:00,1,3758.0,2843.0,0.756,17.956,59,54,33,21,5,2,3,0,0.01,0.0
1001,24,2020-03-16 12:02:00,1,3745.0,2914.0,0.778,17.98,49,44,27,17,5,3,2,0,0.0,0.0
1001,25,2020-03-16 12:05:00,1,3749.0,2898.0,0.773,17.979,36,34,9,25,2,1,1,0,0.01,0.0
1001,26,2020-03-16 12:08:00,1,3771.0,2878.0,0.763,18.044,29,27,18,9,2,0,2,0,0.04,0.0
1001,27,2020-03-16 12:11:00,1,3765.0,2887.0,0.767,18.03,5,5,2,3,0,0,0,0,0.0,0.0
1001,28,2020-03-16 12:14:00,1,3614.0,2817.0,0.779,17.357,5,5,4,1,0,0,0,0,0.0,0.0
1001,29,2020-03-16 12:17:00,1,3632.0,2743.0,0.755,17.349,24,24,13,11,0,0,0,0,0.01,0.0
1001,30,2020-03-16 12:20:00,1,3558.0,2708.0,0.761,17.017,16,16,7,9,0,0,0,0,0.01,0.0
1001,31,2020-03-16 12:23:00,1,3503.0,2626.0,0.75,16.708,16,16,10,6,0,0,0,0,0.0,0.0
1001,32,2020-03-16 12:26:00,1,3512.0,2692.0,0.767,16.817,26,26,4,22,0,0,0,0,0.01,0.0
1001,33,2020-03-16 12:29:00,1,3508.0,2613.0,0.745,16.715,32,31,11,20,1,0,1,0,0.0,0.0
1001,34,2020-03-16 12:32:00,1,3490.0,2685.0,0.769,16.723,64,54,42,12,10,4,6,3,0.02,0.0
1001,35,2020-03-16 12:35:00,1,3505.0,2657.0,0.758,16.752,1,1,0,1,0,0,0,0,0.03,0.01
1001,36,2020-03-16 12:38:00,1,3374.0,2578.0,0.764,16.15,10,10,5,5,0,0,0,0,0.0,0.0
1001,37,2020-03-16 12:41:00,1,3294.0,2546.0,0.773,15.798,67,55,37,18,12,8,4,0,0.01,0.0
1001,38,2020-03-16 12:44:00,1,3361.0,2597.0,0.773,16.118,17,17,7,10,0,0,0,0,0.0,0.0
1001,39,2020-03-16 12:47:00,1,3280.0,2536.0,0.773,15.732,67,62,47,15,5,3,2,0,0.01,0.0
1001,40,2020-03-16 12:50:00,1,3492.0,2643.0,0.757,16.686,151,111,75,36,40,20,20,5,0.0,0.0
1001,41,2020-03-16 12:53:00,1,3623.0,2854.0,0.788,17.434,273,167,135,32,106,78,28,17,0.0,0.0
1001,42,2020-03-16 12:56:00,1,3756.0,2904.0,0.773,18.016,93,56,39,17,37,28,9,0,0.0,0.0
1001,43,2020-03-16 12:59:00,1,3615.0,2815.0,0.779,17.362,9,8,2,6,1,1,0,0,0.01,0.0
1001,44,2020-03-16 13:02:00,1,3495.0,2634.0,0.754,16.689,7,7,4,3,0,0,0,0,0.0,0.0
1001,45,2020-03-16 13:05:00,1,3290.0,2537.0,0.771,15.77,2,2,2,0,0,0,0,0,0.01,0.0
1001,46,2020-03-16 13:08:00,1,3232.0,2445.0,0.756,15.443,5,5,1,4,0,0,0,0,0.0,0.0
1001,47,2020-03-16 13:11:00,1,3166.0,2420.0,0.764,15.153,3,3,2,1,0,0,0,0,0.01,0.0
1001,48,2020-03-16 13:14:00,1,3195.0,2387.0,0.747,15.234,25,23,13,10,2,1,1,0,0.0,0.0
1001,49,2020-03-16 13:17:00,1,3029.0,2356.0,0.778,14.542,29,21,14,7,8,5,3,0,0.0,0.0
1001,50,2020-03-16 13:20:00,1,2971.0,2227.0,0.75,14.17,11,11,5,6,0,0,0,0,0.0,0.0
1001,51,2020-03-16 13:23:00,1,2913.0,2219.0,0.762,13.935,1,1,1,0,0,0,0,0,0.01,0.0
1001,52,2020-03-16 13:26:00,1,2771.0,2075.0,0.749,13.214,0,0,0,0,0,0,0,0,0.0,0.0
1001,53,2020-03-16 13:29:00,1,2711.0,2043.0,0.754,12.943,0,0,0,0,0,0,0,0,0.01,0.0
1001,54,2020-03-16 13:32:00,1,2710.0,2001.0,0.739,12.893,4,4,3,1,0,0,0,0,0.0,0.0
1001,55,2020-03-16 13:35:00,1,2494.0,1901.0,0.762,11.933,12,12,1,11,0,0,0,0,0.01,0.0
1001,56,2020-03-16 13:38:00,1,2505.0,1872.0,0.747,11.944,2,2,0,2,0,0,0,0,0.0,0.0
1001,57,2020-03-16 13:41:00,1,2515.0,1877.0,0.746,11.988,1,1,0,1,0,0,0,0,0.01,0.0
1001,58,2020-03-16 13:44:00,1,2500.0,1896.0,0.759,11.95,39,39,2,37,0,0,0,0,0.01,0.0
1001,59,2020-03-16 13:47:00,1,2502.0,1911.0,0.764,11.975,16,16,1,15,0,0,0,0,0.0,0.0
1001,60,2020-03-16 13:50:00,1,2445.0,1832.0,0.749,11.6625,15,15,1,14,0,0,0,0,0.0,0.0
1001,61,2020-03-16 13:53:00,1,2388.0,1753.0,0.734,11.35,0,0,0,0,0,0,0,0,0.03,0.0
1001,62,2020-03-16 13:56:00,1,2392.0,1784.0,0.746,11.4,6,6,0,6,0,0,0,0,0.0,0.0
1001,63,2020-03-16 13:59:00,1,2376.0,1782.0,0.75,11.336,1,1,0,1,0,0,0,0,0.0,0.0
1001,64,2020-03-16 14:02:00,1,2330.0,1715.0,0.736,11.079,12,12,1,11,0,0,0,0,0.01,0.0
1001,65,2020-03-16 14:05:00,1,2317.0,1713.0,0.739,11.027,24,22,16,6,2,0,2,2,0.02,0.0
1001,66,2020-03-16 14:08:00,1,2372.0,1762.0,0.743,11.297,13,13,0,13,0,0,0,0,0.0,0.0
1001,67,2020-03-16 14:11:00,1,2389.0,1737.0,0.727,11.337,2,2,0,2,0,0,0,0,0.0,0.0
1001,68,2020-03-16 14:14:00,1,2402.0,1724.0,0.718,11.374,7,5,1,4,2,0,2,0,0.0,0.0
1001,69,2020-03-16 14:17:00,1,2383.0,1743.0,0.732,11.32,3,3,0,3,0,0,0,0,0.0,0.0
1001,70,2020-03-16 14:20:00,1,2246.0,1677.0,0.747,10.708,35,35,0,35,0,0,0,0,0.01,0.0
1001,71,2020-03-16 14:23:00,1,2170.0,1662.0,0.766,10.392,0,0,0,0,0,0,0,0,0.0,0.0
1001,72,2020-03-16 14:26:00,1,2187.0,1632.0,0.746,10.423,0,0,0,0,0,0,0,0,0.0,0.0
1001,73,2020-03-16 14:29:00,1,2058.0,1527.0,0.742,9.799,4,4,1,3,0,0,0,0,0.0,0.0
1001,74,2020-03-16 14:32:00,1,2309.0,1725.0,0.747,11.009,3,3,0,3,0,0,0,0,0.0,0.0
1001,75,2020-03-16 14:35:00,1,2243.0,1691.0,0.754,10.71,0,0,0,0,0,0,0,0,0.01,0.0
1001,76,2020-03-16 14:38:00,1,2406.0,1747.0,0.726,11.413,0,0,0,0,0,0,0,0,0.0,0.0
1001,77,2020-03-16 14:41:00,1,2195.0,1628.0,0.742,10.449,2,1,0,1,1,0,1,0,0.0,0.0
1001,78,2020-03-16 14:44:00,1,2174.0,1675.0,0.771,10.42,8,7,6,1,1,0,1,2,0.01,0.0
1001,79,2020-03-16 14:47:00,1,2379.0,1790.0,0.752,11.356,11,10,6,4,1,0,1,0,0.01,0.0
1001,80,2020-03-16 14:50:00,1,2168.0,1689.0,0.779,10.413,0,0,0,0,0,0,0,0,0.0,0.0
1001,81,2020-03-16 14:53:00,1,2246.0,1672.0,0.745,10.7,4,4,1,3,0,0,0,0,0.0,0.0
1001,82,2020-03-16 14:56:00,1,2176.0,1670.0,0.767,10.421,0,0,0,0,0,0,0,0,0.0,0.0
1001,83,2020-03-16 14:59:00,1,2040.0,1568.0,0.768,9.776,8,7,4,3,1,0,1,1,0.0,0.0
1001,84,2020-03-16 15:02:00,1,2166.0,1691.0,0.78,10.407,27,27,0,27,0,0,0,0,0.01,0.0
1001,85,2020-03-16 15:05:00,1,2173.0,1668.0,0.768,10.407,5,3,1,2,2,0,2,0,0.0,0.0
1001,86,2020-03-16 15:08:00,1,2168.0,1657.0,0.764,10.376,14,14,0,14,0,0,0,0,0.01,0.0
1001,87,2020-03-16 15:11:00,1,2185.0,1619.0,0.741,10.403,20,20,0,20,0,0,0,0,0.0,0.0
1001,88,2020-03-16 15:14:00,1,2184.0,1582.0,0.724,10.357,0,0,0,0,0,0,0,0,0.0,0.0
1001,89,2020-03-16 15:17:00,1,2113.0,1587.0,0.751,10.083,31,31,1,30,0,0,0,0,0.0,0.0
1001,90,2020-03-16 15:20:00,1,2194.0,1632.0,0.744,10.45,24,23,0,23,1,0,1,0,0.01,0.0
1001,91,2020-03-16 15:23:00,1,2182.0,1644.0,0.754,10.417,38,38,0,38,0,0,0,0,0.0,0.0
1001,92,2020-03-16 15:26:00,1,2182.0,1617.0,0.741,10.389,8,8,2,6,0,0,0,0,0.0,0.0
1001,93,2020-03-16 15:29:00,1,2389.0,1792.0,0.75,11.395,26,25,8,17,1,0,1,0,0.01,0.0
1001,94,2020-03-16 15:32:00,1,2484.0,1959.0,0.789,11.955,35,34,7,27,1,0,1,0,0.0,0.0
1001,95,2020-03-16 15:35:00,1,2501.0,1946.0,0.778,12.008,64,58,16,42,6,0,6,2,0.0,0.0
1001,96,2020-03-16 15:38:00,1,2910.0,2249.0,0.773,13.956,178,129,90,39,49,31,18,6,0.0,0.0
1001,97,2020-03-16 15:41:00,1,2957.0,2322.0,0.785,14.224,227,150,112,38,77,56,21,13,0.01,0.0
1001,98,2020-03-16 15:44:00,1,3297.0,2511.0,0.761,15.771,293,186,147,39,107,81,26,5,0.01,0.0
1001,99,2020-03-16 15:47:00,1,3174.0,2387.0,0.752,15.149,68,52,21,31,16,5,11,0,0.0,0.0
1001,100,2020-03-16 15:50:00,1,3168.0,2401.0,0.758,15.142,57,30,5,25,27,2,25,0,0.0,0.0
1001,101,2020-03-16 15:53:00,1,3285.0,2475.0,0.753,15.683,65,43,7,36,22,0,22,1,0.0,0.0
1001,102,2020-03-16 15:56:00,1,3310.0,2525.0,0.763,15.839,37,31,21,10,6,1,5,0,0.0,0.0
1001,103,2020-03-16 15:59:00,1,3015.0,2343.0,0.777,14.472,22,19,13,6,3,1,2,0,0.02,0.0
1001,104,2020-03-16 16:02:00,1,2838.0,2143.0,0.755,13.556,1,1,0,1,0,0,0,0,0.0,0.0
1001,105,2020-03-16 16:05:00,1,2504.0,1916.0,0.765,11.986,0,0,0,0,0,0,0,0,0.0,0.0
1001,106,2020-03-16 16:08:00,1,2442.0,1839.0,0.753,11.658,0,0,0,0,0,0,0,0,0.0,0.0
1001,107,2020-03-16 16:11:00,1,2394.0,1788.0,0.747,11.414,2,2,1,1,0,0,0,0,0.0,0.0
1001,108,2020-03-16 16:14:00,1,2368.0,1779.0,0.752,11.299,4,2,0,2,2,0,2,0,0.0,0.0
1001,109,2020-03-16 16:17:00,1,2406.0,1716.0,0.713,11.379,3,2,0,2,1,0,1,0,0.01,0.0
1001,110,2020-03-16 16:20:00,1,2372.0,1834.0,0.773,11.375,1,0,0,0,1,0,1,0,0.0,0.0
1001,111,2020-03-16 16:23:00,1,2390.0,1743.0,0.729,11.346,7,7,1,6,0,0,0,0,0.0,0.0
1001,112,2020-03-16 16:26:00,1,2394.0,1745.0,0.729,11.363,8,7,2,5,1,0,1,0,0.0,0.0
1001,113,2020-03-16 16:29:00,1,2366.0,1841.0,0.778,11.362,11,9,2,7,2,0,2,0,0.0,0.0
1001,114,2020-03-16 16:32:00,1,2391.0,1751.0,0.732,11.361,0,0,0,0,0,0,0,0,0.01,0.0
1001,115,2020-03-16 16:35:00,1,2235.0,1705.0,0.763,10.696,12,3,3,0,9,2,7,0,0.01,0.0
1001,116,2020-03-16 16:38:00,1,2387.0,1739.0,0.729,11.329,33,16,10,6,17,1,16,0,0.0,0.0
1001,117,2020-03-16 16:41:00,1,2373.0,1825.0,0.769,11.372,16,16,7,9,0,0,0,0,0.0,0.0
1001,118,2020-03-16 16:44:00,1,2392.0,1730.0,0.723,11.339,5,5,0,5,0,0,0,0,0.0,0.0
1001,119,2020-03-16 16:47:00,1,2247.0,1677.0,0.746,10.708,4,4,0,4,0,0,0,0,0.0,0.0
1001,120,2020-03-16 16:50:00,1,2397.5,1718.5,0.7185,11.3485,3,3,1,2,0,0,0,0,0.03,0.0
1001,121,2020-03-16 16:53:00,1,2548.0,1760.0,0.691,11.989,1,0,0,0,1,1,0,0,0.0,0.0
1001,122,2020-03-16 16:56:00,1,2549.0,1748.0,0.686,11.98,4,4,0,4,0,0,0,0,0.0,0.0
1001,123,2020-03-16 16:59:00,1,2541.0,1761.0,0.693,11.961,1,1,0,1,0,0,0,0,0.0,0.0
1001,124,2020-03-16 17:02:00,1,2405.0,1714.0,0.713,11.373,31,31,2,29,0,0,0,0,0.0,0.0
1001,125,2020-03-16 17:05:00,1,2394.0,1705.0,0.712,11.32,11,11,4,7,0,0,0,0,0.01,0.0
1001,126,2020-03-16 17:08:00,1,2408.0,1735.0,0.72,11.41,25,23,9,14,2,0,2,2,0.01,0.0
1001,127,2020-03-16 17:11:00,1,2392.0,1710.0,0.715,11.317,0,0,0,0,0,0,0,0,0.0,0.0
1001,128,2020-03-16 17:14:00,1,2462.0,1733.0,0.704,11.62,0,0,0,0,0,0,0,0,0.0,0.0
1001,129,2020-03-16 17:17:00,1,2318.0,1669.0,0.72,10.98,19,18,2,16,1,0,1,0,0.0,0.0
1001,130,2020-03-16 17:20:00,1,2398.0,1736.0,0.724,11.369,8,7,1,6,1,0,1,0,0.01,0.0
1001,131,2020-03-16 17:23:00,1,2339.0,1700.0,0.727,11.099,8,8,1,7,0,0,0,0,0.0,0.0
1001,132,2020-03-16 17:26:00,1,2333.0,1697.0,0.727,11.071,9,9,0,9,0,0,0,0,0.0,0.0
1001,133,2020-03-16 17:29:00,1,2409.0,1720.0,0.714,11.395,5,5,0,5,0,0,0,0,0.0,0.0
1001,134,2020-03-16 17:32:00,1,2323.0,1698.0,0.731,11.032,158,112,75,37,46,27,19,9,0.0,0.0
1001,135,2020-03-16 17:35:00,1,2716.0,2010.0,0.74,12.928,82,52,2,50,30,0,30,0,0.0,0.0
1001,136,2020-03-16 17:38:00,1,2850.0,2090.0,0.733,13.545,52,34,7,27,18,2,16,0,0.01,0.0
1001,137,2020-03-16 17:41:00,1,2977.0,2218.0,0.745,14.185,131,88,61,27,43,20,23,3,0.0,0.0
1001,138,2020-03-16 17:44:00,1,2987.0,2181.0,0.73,14.183,13,8,1,7,5,0,5,0,0.01,0.0
1001,139,2020-03-16 17:47:00,1,2965.0,2260.0,0.762,14.186,88,56,19,37,32,2,30,0,0.0,0.0
1001,140,2020-03-16 17:50:00,1,2978.0,2235.0,0.75,14.209,85,66,10,56,19,0,19,0,0.0,0.0
1001,141,2020-03-16 17:53:00,1,3040.0,2268.0,0.746,14.489,62,37,5,32,25,0,25,0,0.0,0.0
1001,142,2020-03-16 17:56:00,1,3120.0,2288.0,0.733,14.826,54,42,18,24,12,0,12,0,0.01,0.0
1001,143,2020-03-16 17:59:00,1,2981.0,2230.0,0.748,14.214,4,4,0,4,0,0,0,0,0.0,0.0
1001,144,2020-03-16 18:02:00,0,2639.0,1959.0,0.742,12.568,0,0,0,0,0,0,0,0,0.0,0.0
1001,145,2020-03-16 18:05:00,0,2528.0,1860.0,0.736,12.021,4,4,1,3,0,0,0,0,0.0,0.0
1001,146,2020-03-16 18:08:00,0,2531.0,1763.0,0.697,11.925,2,2,1,1,0,0,0,0,0.01,0.0
1001,147,2020-03-16 18:11:00,0,2539.0,1779.0,0.701,11.975,5,5,1,4,0,0,0,0,0.0,0.0
1001,148,2020-03-16 18:14:00,0,2555.0,1752.0,0.686,12.005,0,0,0,0,0,0,0,0,0.0,0.0
1001,149,2020-03-16 18:17:00,0,2396.0,1717.0,0.717,11.342,9,8,4,4,1,0,1,0,0.0,0.0
1001,150,2020-03-16 18:20:00,0,2529.0,1778.0,0.703,11.934,80,68,32,36,12,2,10,0,0.0,0.0
1001,151,2020-03-16 18:23:00,0,2978.0,2235.0,0.75,14.208,464,270,219,51,194,156,38,30,0.01,0.0
1001,152,2020-03-16 18:26:00,0,3247.0,2417.0,0.744,15.471,183,121,66,55,62,35,27,13,0.0,0.0
1001,153,2020-03-16 18:29:00,0,3322.0,2409.0,0.725,15.755,67,59,22,37,8,2,6,2,0.0,0.0
1001,154,2020-03-16 18:32:00,0,3459.0,2547.0,0.736,16.448,74,50,15,35,24,8,16,7,0.01,0.0
1001,155,2020-03-16 18:35:00,0,3462.0,2560.0,0.739,16.477,118,84,49,35,34,6,28,2,0.0,0.0
1001,156,2020-03-16 18:38:00,0,3448.0,2561.0,0.743,16.422,169,118,72,46,51,10,41,20,0.01,0.0
1001,157,2020-03-16 18:41:00,0,3650.0,2712.0,0.743,17.382,234,127,79,48,107,60,47,13,0.0,0.0
1001,158,2020-03-16 18:44:00,0,3622.0,2685.0,0.741,17.245,92,70,34,36,22,4,18,5,0.01,0.0
1001,159,2020-03-16 18:47:00,0,3639.0,2754.0,0.757,17.388,324,194,136,58,130,84,46,10,0.0,0.0
1001,160,2020-03-16 18:50:00,0,3748.0,2817.0,0.752,17.888,698,391,314,77,307,245,62,13,0.0,0.0
1001,161,2020-03-16 18:53:00,0,3623.0,2709.0,0.748,17.274,324,191,140,51,133,95,38,8,0.0,0.0
1001,162,2020-03-16 18:56:00,0,3585.0,2626.0,0.733,17.034,21,21,3,18,0,0,0,2,0.0,0.0
1001,163,2020-03-16 18:59:00,0,3117.0,2318.0,0.744,14.847,18,16,8,8,2,0,2,0,0.0,0.0
1001,164,2020-03-16 19:02:00,0,2975.0,2161.0,0.726,14.113,87,51,35,16,36,30,6,3,0.01,0.0
1001,165,2020-03-16 19:05:00,0,2845.0,2065.0,0.726,13.498,34,32,26,6,2,1,1,7,0.0,0.0
1001,166,2020-03-16 19:08:00,0,2735.0,1988.0,0.727,12.978,1,1,1,0,0,0,0,0,0.0,0.0
1001,167,2020-03-16 19:11:00,0,2645.0,1943.0,0.735,12.572,12,7,5,2,5,3,2,0,0.0,0.0
1001,168,2020-03-16 19:14:00,0,2654.0,1955.0,0.737,12.621,7,7,0,7,0,0,0,0,0.0,0.0
1001,169,2020-03-16 19:17:00,0,2662.0,1918.0,0.721,12.61,1,1,0,1,0,0,0,0,0.01,0.0
1001,170,2020-03-16 19:20:00,0,2516.0,1804.0,0.717,11.911,87,45,26,19,42,31,11,3,0.0,0.0
1001,171,2020-03-16 19:23:00,0,2844.0,2104.0,0.74,13.535,192,107,68,39,85,43,42,6,0.0,0.0
1001,172,2020-03-16 19:26:00,0,3135.0,2265.0,0.723,14.858,128,99,47,52,29,3,26,22,0.0,0.0
1001,173,2020-03-16 19:29:00,0,3322.0,2474.0,0.745,15.83,243,185,110,75,58,32,26,12,0.0,0.0
1001,174,2020-03-16 19:32:00,0,3381.0,2510.0,0.742,16.101,201,123,78,45,78,42,36,7,0.01,0.0
1001,175,2020-03-16 19:35:00,0,3431.0,2578.0,0.751,16.372,464,232,178,54,232,174,58,7,0.0,0.0
1001,176,2020-03-16 19:38:00,0,3290.0,2482.0,0.755,15.711,664,313,247,66,351,264,87,23,0.0,0.0
1001,177,2020-03-16 19:41:00,0,3509.0,2592.0,0.739,16.697,282,135,97,38,147,99,48,7,0.0,0.0
1001,178,2020-03-16 19:44:00,0,3466.0,2540.0,0.733,16.469,44,34,7,27,10,1,9,3,0.0,0.0
1001,179,2020-03-16 19:47:00,0,3459.0,2496.0,0.722,16.392,59,27,11,16,32,7,25,0,0.01,0.0
1001,180,2020-03-16 19:50:00,0,3457.0,2497.0,0.7225,16.3855,99,50,19,31,49,5,44,9,0.0,0.0
1001,181,2020-03-16 19:53:00,0,3455.0,2498.0,0.723,16.379,105,64,19,45,41,3,38,0,0.0,0.0
1001,182,2020-03-16 19:56:00,0,3448.0,2514.0,0.729,16.368,218,133,83,50,85,54,31,18,0.0,0.0
1001,183,2020-03-16 19:59:00,0,3443.0,2607.0,0.757,16.453,481,238,187,51,243,185,58,15,0.0,0.0
1001,184,2020-03-16 20:02:00,0,3450.0,2556.0,0.741,16.423,381,232,170,62,149,103,46,17,0.0,0.0
1001,185,2020-03-16 20:05:00,0,3431.0,2526.0,0.736,16.315,80,40,26,14,40,30,10,2,0.02,0.0
1001,186,2020-03-16 20:08:00,0,3186.0,2342.0,0.735,15.148,213,119,84,35,94,62,32,4,0.0,0.0
1001,187,2020-03-16 20:11:00,0,3113.0,2302.0,0.739,14.813,352,218,162,56,134,84,50,28,0.0,0.0
1001,188,2020-03-16 20:14:00,0,3335.0,2406.0,0.721,15.805,274,139,98,41,135,92,43,14,0.0,0.0
1001,189,2020-03-16 20:17:00,0,3339.0,2418.0,0.724,15.831,363,193,145,48,170,129,41,20,0.0,0.0
1001,190,2020-03-16 20:20:00,0,3107.0,2291.0,0.737,14.78,251,163,134,29,88,71,17,3,0.0,0.0
1001,191,2020-03-16 20:23:00,0,3120.0,2284.0,0.732,14.82,62,39,9,30,23,1,22,1,0.0,0.0
1001,192,2020-03-16 20:26:00,0,3115.0,2236.0,0.718,14.749,87,61,38,23,26,11,15,0,0.0,0.0
1001,193,2020-03-16 20:29:00,0,3059.0,2229.0,0.729,14.521,57,34,2,32,23,2,21,2,0.01,0.0
1001,194,2020-03-16 20:32:00,0,3002.0,2140.0,0.713,14.197,8,7,0,7,1,0,1,0,0.01,0.0
1001,195,2020-03-16 20:35:00,0,2806.0,1977.0,0.704,13.246,0,0,0,0,0,0,0,0,0.0,0.0
1001,196,2020-03-16 20:38:00,0,2595.0,1855.0,0.715,12.279,4,1,0,1,3,0,3,0,0.0,0.0
1001,197,2020-03-16 20:41:00,0,2530.0,1795.0,0.71,11.955,9,1,0,1,8,0,8,0,0.0,0.0
1001,198,2020-03-16 20:44:00,0,2550.0,1740.0,0.682,11.973,13,3,1,2,10,0,10,0,0.0,0.0
1001,199,2020-03-16 20:47:00,0,2338.0,1670.0,0.714,11.06,72,60,9,51,12,4,8,10,0.0,0.0
1001,200,2020-03-16 20:50:00,0,2648.0,1888.0,0.713,12.522,170,96,63,33,74,48,26,15,0.0,0.0
1001,201,2020-03-16 20:53:00,0,2855.0,2089.0,0.732,13.56,143,61,42,19,82,57,25,11,0.01,0.0
1001,202,2020-03-16 20:56:00,0,2718.0,1980.0,0.729,12.901,7,6,0,6,1,0,1,0,0.01,0.0
1001,203,2020-03-16 20:59:00,0,2677.0,1890.0,0.706,12.641,88,62,31,31,26,5,21,10,0.0,0.0
1001,204,2020-03-16 21:02:00,0,2860.0,2036.0,0.712,13.523,81,51,19,32,30,6,24,9,0.0,0.0
1001,205,2020-03-16 21:05:00,0,2852.0,2088.0,0.732,13.55,63,34,11,23,29,1,28,0,0.0,0.0
1001,206,2020-03-16 21:08:00,0,2993.0,2150.0,0.718,14.171,126,90,43,47,36,7,29,14,0.0,0.0
1001,207,2020-03-16 21:11:00,0,2974.0,2241.0,0.753,14.199,524,289,234,55,235,177,58,28,0.01,0.0
1001,208,2020-03-16 21:14:00,0,3099.0,2316.0,0.747,14.777,429,241,193,48,188,137,51,26,0.0,0.0
1001,209,2020-03-16 21:17:00,0,3171.0,2338.0,0.737,15.081,473,264,207,57,209,152,57,21,0.0,0.0
1001,210,2020-03-16 21:20:00,0,3316.0,2414.0,0.728,15.74,684,465,372,93,219,170,49,88,0.0,0.0
1001,211,2020-03-16 21:23:00,0,3454.0,2503.0,0.725,16.38,679,423,345,78,256,192,64,39,0.01,0.0
1001,212,2020-03-16 21:26:00,0,3461.0,2500.0,0.722,16.403,483,281,215,66,202,144,58,57,0.0,0.0
1001,213,2020-03-16 21:29:00,0,3450.0,2555.0,0.741,16.421,622,320,252,68,302,231,71,32,0.0,0.0
1001,214,2020-03-16 21:32:00,0,3326.0,2402.0,0.722,15.766,450,255,180,75,195,141,54,37,0.0,0.0
1001,215,2020-03-16 21:35:00,0,3323.0,2435.0,0.733,15.788,470,256,196,60,214,154,60,26,0.0,0.0
1001,216,2020-03-16 21:38:00,0,3318.0,2387.0,0.719,15.715,188,77,54,23,111,73,38,16,0.0,0.0
1001,217,2020-03-16 21:41:00,0,3128.0,2291.0,0.733,14.86,245,105,53,52,140,92,48,14,0.01,0.0
1001,218,2020-03-16 21:44:00,0,2974.0,2200.0,0.74,14.155,150,87,39,48,63,35,28,6,0.0,0.0
1001,219,2020-03-16 21:47:00,0,2997.0,2137.0,0.713,14.173,59,28,2,26,31,0,31,0,0.0,0.0
1001,220,2020-03-16 21:50:00,0,2991.0,2095.0,0.7,14.103,71,31,6,25,40,5,35,3,0.0,0.0
1001,221,2020-03-16 21:53:00,0,2944.0,2102.0,0.714,13.927,104,60,19,41,44,19,25,8,0.01,0.0
1001,222,2020-03-16 21:56:00,0,2880.0,2044.0,0.71,13.609,31,31,8,23,0,0,0,0,0.0,0.0
1001,223,2020-03-16 21:59:00,0,2669.0,1909.0,0.715,12.63,10,5,0,5,5,0,5,0,0.01,0.0
1001,224,2020-03-16 22:02:00,0,2538.0,1757.0,0.692,11.946,31,16,0,16,15,2,13,0,0.0,0.0
1001,225,2020-03-16 22:05:00,0,2336.0,1639.0,0.702,11.019,23,8,0,8,15,0,15,0,0.0,0.0
1001,226,2020-03-16 22:08:00,0,2192.0,1571.0,0.717,10.376,16,8,0,8,8,0,8,0,0.0,0.0
1001,227,2020-03-16 22:11:00,0,2193.0,1574.0,0.718,10.384,17,15,0,15,2,1,1,0,0.0,0.0
1001,228,2020-03-16 22:14:00,0,2207.0,1553.0,0.704,10.416,8,3,0,3,5,0,5,0,0.0,0.0
1001,229,2020-03-16 22:17:00,0,2200.0,1535.0,0.698,10.369,20,9,0,9,11,0,11,0,0.0,0.0
1001,230,2020-03-16 22:20:00,0,2216.0,1535.0,0.693,10.43,9,4,0,4,5,0,5,0,0.01,0.0
1001,231,2020-03-16 22:23:00,0,2139.0,1490.0,0.697,10.077,13,7,3,4,6,3,3,0,0.0,0.0
1001,232,2020-03-16 22:26:00,0,2204.0,1565.0,0.71,10.417,217,78,48,30,139,82,57,23,0.0,0.0
1001,233,2020-03-16 22:29:00,0,2535.0,1833.0,0.723,12.018,329,149,95,54,180,121,59,31,0.01,0.0
1001,234,2020-03-16 22:32:00,0,2851.0,2050.0,0.719,13.503,302,186,142,44,116,70,46,20,0.0,0.0
1001,235,2020-03-16 22:35:00,0,2914.0,2102.0,0.721,13.81,193,123,68,55,70,22,48,22,0.0,0.0
1001,236,2020-03-16 22:38:00,0,2985.0,2180.0,0.73,14.176,263,136,93,43,127,80,47,19,0.0,0.0
1001,237,2020-03-16 22:41:00,0,3122.0,2295.0,0.735,14.84,372,191,146,45,181,131,50,13,0.01,0.0
1001,238,2020-03-16 22:44:00,0,3109.0,2311.0,0.743,14.809,357,183,138,45,174,130,44,21,0.0,0.0
1001,239,2020-03-16 22:47:00,0,3108.0,2284.0,0.735,14.776,17,11,6,5,6,1,5,0,0.0,0.0
1001,240,2020-03-16 22:50:00,0,2884.0,2098.0,0.727,13.6875,6,5,1,4,1,0,1,0,0.0,0.0
1001,241,2020-03-16 22:53:00,0,2660.0,1912.0,0.719,12.599,3,3,1,2,0,0,0,0,0.0,0.0
1001,242,2020-03-16 22:56:00,0,2528.0,1794.0,0.709,11.947,0,0,0,0,0,0,0,0,0.0,0.0
1001,243,2020-03-16 22:59:00,0,2393.0,1700.0,0.711,11.312,11,10,5,5,1,0,1,0,0.01,0.0
1001,244,2020-03-16 23:02:00,0,2352.0,1631.0,0.693,11.074,12,9,2,7,3,0,3,0,0.0,0.0
1001,245,2020-03-16 23:05:00,0,2199.0,1557.0,0.708,10.39,8,3,2,1,5,0,5,0,0.0,0.0
1001,246,2020-03-16 23:08:00,0,2196.0,1559.0,0.71,10.378,90,39,25,14,51,40,11,2,0.02,0.0
1001,247,2020-03-16 23:11:00,0,2336.0,1663.0,0.712,11.045,401,187,116,71,214,148,66,16,0.0,0.0
1001,248,2020-03-16 23:14:00,0,2659.0,1941.0,0.73,12.625,249,126,81,45,123,66,57,21,0.0,0.0
1001,249,2020-03-16 23:17:00,0,2854.0,2052.0,0.719,13.517,302,128,74,54,174,122,52,27,0.0,0.0
1001,250,2020-03-16 23:20:00,0,3012.0,2136.0,0.709,14.234,285,146,97,49,139,84,55,10,0.0,0.0
1001,251,2020-03-16 23:23:00,0,2984.0,2200.0,0.737,14.194,367,204,155,49,163,125,38,13,0.0,0.0
1001,252,2020-03-16 23:26:00,0,2993.0,2155.0,0.72,14.18,135,106,76,30,29,15,14,29,0.0,0.0
1001,253,2020-03-16 23:29:00,0,2988.0,2147.0,0.719,14.152,278,134,88,46,144,97,47,28,0.0,0.0
1001,254,2020-03-16 23:32:00,0,2928.0,2113.0,0.722,13.875,482,263,205,58,219,157,62,48,0.0,0.0
1001,255,2020-03-16 23:35:00,0,2999.0,2144.0,0.715,14.191,91,44,28,16,47,29,18,4,0.0,0.0
1001,256,2020-03-16 23:38:00,0,2866.0,2017.0,0.704,13.527,108,66,46,20,42,31,11,3,0.0,0.0
1001,257,2020-03-16 23:41:00,0,2659.0,1950.0,0.733,12.635,4,3,3,0,1,0,1,0,0.0,0.0
1001,258,2020-03-16 23:44:00,0,2527.0,1802.0,0.713,11.95,14,11,7,4,3,1,2,0,0.0,0.0
1001,259,2020-03-16 23:47:00,0,2404.0,1700.0,0.707,11.355,0,0,0,0,0,0,0,0,0.01,0.0
1001,260,2020-03-16 23:50:00,0,2193.0,1566.0,0.714,10.377,6,4,2,2,2,2,0,0,0.0,0.0
1001,261,2020-03-16 23:53:00,0,2218.0,1482.0,0.668,10.381,9,5,0,5,4,1,3,0,0.0,0.0
1001,262,2020-03-16 23:56:00,0,2074.0,1426.0,0.688,9.75,1,1,0,1,0,0,0,0,0.0,0.0
1001,263,2020-03-16 23:59:00,0,2094.0,1428.0,0.682,9.831,0,0,0,0,0,0,0,0,0.0,0.0
1001,264,2020-03-17 00:02:00,0,2087.0,1414.0,0.677,9.79,19,11,2,9,8,2,6,0,0.0,0.0
1001,265,2020-03-17 00:05:00,0,2208.0,1524.0,0.69,10.387,219,107,54,53,112,63,49,11,0.01,0.0
1001,266,2020-03-17 00:08:00,0,2517.0,1855.0,0.737,11.972,468,211,144,67,257,179,78,23,0.0,0.0
1001,267,2020-03-17 00:11:00,0,2788.0,2009.0,0.72,13.211,224,85,52,33,139,88,51,22,0.0,0.0
1001,268,2020-03-17 00:14:00,0,2854.0,2115.0,0.741,13.588,514,236,184,52,278,206,72,20,0.0,0.0
1001,269,2020-03-17 00:17:00,0,2991.0,2162.0,0.723,14.181,207,122,88,34,85,43,42,2,0.0,0.0
1001,270,2020-03-17 00:20:00,0,2981.0,2215.0,0.743,14.199,400,224,160,64,176,126,50,24,0.01,0.0
1001,271,2020-03-17 00:23:00,0,3114.0,2285.0,0.734,14.801,527,312,248,64,215,167,48,60,0.0,0.0
1001,272,2020-03-17 00:26:00,0,3122.0,2284.0,0.731,14.83,415,191,130,61,224,158,66,37,0.0,0.0
1001,273,2020-03-17 00:29:00,0,3123.0,2249.0,0.72,14.797,399,214,168,46,185,131,54,48,0.0,0.0
1001,274,2020-03-17 00:32:00,0,3125.0,2289.0,0.732,14.849,523,280,224,56,243,188,55,43,0.0,0.0
1001,275,2020-03-17 00:35:00,0,3137.0,2265.0,0.722,14.868,338,171,132,39,167,113,54,27,0.0,0.0
1001,276,2020-03-17 00:38:00,0,3137.0,2247.0,0.716,14.846,365,183,131,52,182,132,50,18,0.0,0.0
1001,277,2020-03-17 00:41:00,0,3060.0,2204.0,0.72,14.497,534,217,165,52,317,245,72,28,0.01,0.0
1001,278,2020-03-17 00:44:00,0,2986.0,2195.0,0.735,14.197,425,228,172,56,197,138,59,24,0.0,0.0
1001,279,2020-03-17 00:47:00,0,2998.0,2119.0,0.707,14.159,405,157,108,49,248,178,70,17,0.0,0.0
1001,280,2020-03-17 00:50:00,0,2866.0,2063.0,0.72,13.576,445,204,146,58,241,180,61,22,0.01,0.0
1001,281,2020-03-17 00:53:00,0,2884.0,2034.0,0.705,13.615,279,76,41,35,203,143,60,10,0.0,0.0
1001,282,2020-03-17 00:56:00,0,2809.0,1981.0,0.705,13.261,167,37,2,35,130,71,59,4,0.0,0.0
1001,283,2020-03-17 00:59:00,0,2646.0,1955.0,0.739,12.591,345,162,102,60,183,125,58,10,0.0,0.0
1001,284,2020-03-17 01:02:00,0,2652.0,1926.0,0.726,12.583,217,108,72,36,109,62,47,15,0.0,0.0
1001,285,2020-03-17 01:05:00,0,2667.0,1885.0,0.707,12.595,417,226,175,51,191,130,61,11,0.0,0.0
1001,286,2020-03-17 01:08:00,0,2522.0,1850.0,0.733,11.984,309,175,135,40,134,97,37,5,0.01,0.0
1001,287,2020-03-17 01:11:00,0,2605.0,1867.0,0.717,12.333,609,297,233,64,312,240,72,9,0.0,0.0
1001,288,2020-03-17 01:14:00,0,2598.0,1849.0,0.712,12.284,489,307,233,74,182,142,40,22,0.0,0.0
1001,289,2020-03-17 01:17:00,0,2598.0,1859.0,0.716,12.293,322,190,156,34,132,98,34,9,0.0,0.0
1001,290,2020-03-17 01:20:00,0,2691.0,1868.0,0.694,12.67,244,116,65,51,128,99,29,2,0.0,0.0
1001,291,2020-03-17 01:23:00,0,2531.0,1826.0,0.722,11.994,93,55,11,44,38,14,24,0,0.0,0.0
1001,292,2020-03-17 01:26:00,0,2528.0,1837.0,0.727,11.994,113,67,20,47,46,19,27,4,0.0,0.0
1001,293,2020-03-17 01:29:00,0,2520.0,1834.0,0.728,11.958,60,23,7,16,37,12,25,1,0.0,0.0
1001,294,2020-03-17 01:32:00,0,2538.0,1807.0,0.712,12.002,527,262,186,76,265,201,64,16,0.0,0.0
1001,295,2020-03-17 01:35:00,0,2529.0,1802.0,0.712,11.959,49,23,5,18,26,4,22,2,0.0,0.0
1001,296,2020-03-17 01:38:00,0,2329.0,1691.0,0.726,11.051,0,0,0,0,0,0,0,0,0.0,0.0
1001,297,2020-03-17 01:41:00,0,2191.0,1568.0,0.716,10.37,2,0,0,0,2,0,2,0,0.01,0.0
1001,298,2020-03-17 01:44:00,0,2149.0,1470.0,0.684,10.094,1,0,0,0,1,0,1,0,0.0,0.0
1001,299,2020-03-17 01:47:00,0,2011.0,1386.0,0.689,9.457,5,3,2,1,2,0,2,0,0.0,0.0
1001,300,2020-03-17 01:50:00,0,1970.0,1388.5,0.705,9.298,122,68,28,40,54,34,20,6,0.01,0.0
1001,301,2020-03-17 01:53:00,0,1929.0,1391.0,0.721,9.139,280,160,107,53,120,79,41,7,0.0,0.0
1001,302,2020-03-17 01:56:00,0,2062.0,1489.0,0.722,9.772,268,167,112,55,101,66,35,9,0.0,0.0
1001,303,2020-03-17 01:59:00,0,2209.0,1550.0,0.702,10.42,60,33,3,30,27,6,21,1,0.0,0.0
1001,304,2020-03-17 02:02:00,0,2187.0,1617.0,0.739,10.408,102,46,17,29,56,28,28,12,0.0,0.0
1001,305,2020-03-17 02:05:00,0,2346.0,1624.0,0.692,11.043,69,15,5,10,54,13,41,2,0.0,0.0
1001,306,2020-03-17 02:08:00,0,2320.0,1648.0,0.71,10.964,138,61,25,36,77,27,50,0,0.01,0.0
1001,307,2020-03-17 02:11:00,0,2336.0,1664.0,0.712,11.046,11,10,7,3,1,0,1,0,0.0,0.0
1001,308,2020-03-17 02:14:00,0,2208.0,1555.0,0.704,10.421,106,70,54,16,36,25,11,4,0.0,0.0
1001,309,2020-03-17 02:17:00,0,2129.0,1495.0,0.702,10.042,6,6,1,5,0,0,0,0,0.0,0.0
1001,310,2020-03-17 02:20:00,0,2072.0,1417.0,0.684,9.732,9,8,0,8,1,0,1,0,0.0,0.0
1001,311,2020-03-17 02:23:00,0,2020.0,1379.0,0.683,9.487,5,0,0,0,5,0,5,0,0.0,0.0
1001,312,2020-03-17 02:26:00,0,1862.0,1321.0,0.71,8.799,18,2,0,2,16,2,14,0,0.01,0.0
1001,313,2020-03-17 02:29:00,0,1871.0,1301.0,0.695,8.812,21,3,0,3,18,0,18,0,0.0,0.0
1001,314,2020-03-17 02:32:00,0,1888.0,1306.0,0.692,8.884,38,31,0,31,7,0,7,0,0.0,0.0
1001,315,2020-03-17 02:35:00,0,1887.0,1294.0,0.685,8.869,8,3,0,3,5,0,5,0,0.0,0.0
1001,316,2020-03-17 02:38:00,0,1879.0,1276.0,0.679,8.818,7,3,0,3,4,0,4,0,0.0,0.0
1001,317,2020-03-17 02:41:00,0,1876.0,1276.0,0.68,8.804,15,6,1,5,9,0,9,0,0.01,0.0
1001,318,2020-03-17 02:44:00,0,1878.0,1279.0,0.681,8.818,74,28,13,15,46,25,21,0,0.0,0.0
1001,319,2020-03-17 02:47:00,0,2078.0,1448.0,0.697,9.793,9,2,1,1,7,0,7,0,0.0,0.0
1001,320,2020-03-17 02:50:00,0,2061.0,1449.0,0.703,9.725,26,21,0,21,5,2,3,0,0.0,0.0
1001,321,2020-03-17 02:53:00,0,2191.0,1542.0,0.704,10.342,59,24,5,19,35,5,30,30,0.01,0.0
1001,322,2020-03-17 02:56:00,0,2347.0,1648.0,0.702,11.07,96,57,30,27,39,8,31,5,0.0,0.0
1001,323,2020-03-17 02:59:00,0,2462.0,1754.0,0.712,11.641,261,156,97,59,105,64,41,14,0.0,0.0
1001,324,2020-03-17 03:02:00,0,2657.0,1956.0,0.736,12.635,286,149,99,50,137,91,46,25,0.0,0.0
1001,325,2020-03-17 03:05:00,0,2857.0,2036.0,0.713,13.511,418,214,162,52,204,141,63,22,0.0,0.0
1001,326,2020-03-17 03:08:00,0,2936.0,2105.0,0.717,13.901,418,228,166,62,190,139,51,20,0.01,0.0
1001,327,2020-03-17 03:11:00,0,2929.0,2102.0,0.718,13.866,281,129,93,36,152,107,45,23,0.0,0.0
1001,328,2020-03-17 03:14:00,0,3005.0,2110.0,0.702,14.176,317,169,123,46,148,100,48,23,0.0,0.0
1001,329,2020-03-17 03:17:00,0,2851.0,2075.0,0.728,13.529,391,185,141,44,206,151,55,27,0.0,0.0
1001,330,2020-03-17 03:20:00,0,3013.0,2115.0,0.702,14.213,318,182,141,41,136,101,35,30,0.0,0.0
1001,331,2020-03-17 03:23:00,0,2872.0,2083.0,0.725,13.621,175,84,48,36,91,52,39,12,0.01,0.0
1001,332,2020-03-17 03:26:00,0,2815.0,2002.0,0.711,13.308,397,201,157,44,196,144,52,20,0.0,0.0
1001,333,2020-03-17 03:29:00,0,2640.0,1936.0,0.733,12.546,246,122,84,38,124,98,26,5,0.0,0.0
1001,334,2020-03-17 03:32:00,0,2679.0,1898.0,0.709,12.659,218,115,78,37,103,68,35,10,0.0,0.0
1001,335,2020-03-17 03:35:00,0,2651.0,1903.0,0.718,12.554,39,17,0,17,22,6,16,1,0.0,0.0
1001,336,2020-03-17 03:38:00,0,2542.0,1788.0,0.703,11.996,10,1,0,1,9,1,8,0,0.0,0.0
1001,337,2020-03-17 03:41:00,0,2340.0,1659.0,0.709,11.057,9,0,0,0,9,3,6,0,0.01,0.0
1001,338,2020-03-17 03:44:00,0,2192.0,1544.0,0.705,10.346,17,0,0,0,17,1,16,0,0.0,0.0
1001,339,2020-03-17 03:47:00,0,2066.0,1450.0,0.702,9.747,13,0,0,0,13,4,9,0,0.0,0.0
1001,340,2020-03-17 03:50:00,0,1943.0,1359.0,0.699,9.159,25,3,0,3,22,2,20,0,0.0,0.0
1001,341,2020-03-17 03:53:00,0,1873.0,1328.0,0.709,8.851,9,0,0,0,9,3,6,0,0.0,0.0
1001,342,2020-03-17 03:56:00,0,1885.0,1284.0,0.681,8.849,9,0,0,0,9,3,6,0,0.0,0.0
1001,343,2020-03-17 03:59:00,0,1730.0,1251.0,0.723,8.2,9,1,0,1,8,3,5,0,0.01,0.0
1001,344,2020-03-17 04:02:00,0,1806.0,1272.0,0.704,8.523,8,4,0,4,4,1,3,0,0.01,0.0
1001,345,2020-03-17 04:05:00,0,1732.0,1251.0,0.722,8.21,0,0,0,0,0,0,0,0,0.0,0.0
1001,346,2020-03-17 04:08:00,0,1731.0,1216.0,0.703,8.165,0,0,0,0,0,0,0,0,0.0,0.0
1001,347,2020-03-17 04:11:00,0,1741.0,1215.0,0.698,8.206,0,0,0,0,0,0,0,0,0.0,0.0
1001,348,2020-03-17 04:14:00,0,1734.0,1210.0,0.698,8.173,1,1,0,1,0,0,0,0,0.0,0.0
1001,349,2020-03-17 04:17:00,0,1734.0,1192.0,0.688,8.151,60,57,17,40,3,0,3,0,0.0,0.0
1001,350,2020-03-17 04:20:00,0,1739.0,1233.0,0.709,8.218,119,119,77,42,0,0,0,0,0.0,0.0
1001,351,2020-03-17 04:23:00,0,1876.0,1274.0,0.679,8.803,155,78,56,22,77,48,29,7,0.0,0.0
1001,352,2020-03-17 04:26:00,0,2066.0,1461.0,0.707,9.76,157,58,20,38,99,44,55,19,0.0,0.0
1001,353,2020-03-17 04:29:00,0,2327.0,1668.0,0.717,11.016,427,192,147,45,235,181,54,11,0.0,0.0
1001,354,2020-03-17 04:32:00,0,2540.0,1791.0,0.705,11.991,122,60,19,41,62,21,41,11,0.01,0.0
1001,355,2020-03-17 04:35:00,0,2584.0,1868.0,0.723,12.249,197,115,71,44,82,57,25,19,0.0,0.0
1001,356,2020-03-17 04:38:00,0,2655.0,1944.0,0.732,12.614,320,186,130,56,134,94,40,10,0.0,0.0
1001,357,2020-03-17 04:41:00,0,2645.0,1979.0,0.748,12.613,467,232,189,43,235,178,57,17,0.03,0.0
1001,358,2020-03-17 04:44:00,0,2881.0,2008.0,0.697,13.573,328,163,117,46,165,124,41,22,0.0,0.0
1001,359,2020-03-17 04:47:00,0,2723.0,1988.0,0.73,12.931,299,154,106,48,145,101,44,14,0.0,0.0
1001,360,2020-03-17 04:50:00,0,2681.0,1954.5,0.729,12.728,271,151,100,51,120,72,48,17,0.0,0.0
1001,361,2020-03-17 04:53:00,0,2639.0,1921.0,0.728,12.525,176,98,63,35,78,40,38,17,0.0,0.0
1001,362,2020-03-17 04:56:00,0,2514.0,1835.0,0.73,11.936,149,85,54,31,64,35,29,3,0.0,0.0
1001,363,2020-03-17 04:59:00,0,2527.0,1852.0,0.733,12.005,47,18,9,9,29,3,26,0,0.0,0.0
1001,364,2020-03-17 05:02:00,0,2535.0,1809.0,0.714,11.992,151,130,88,42,21,6,15,0,0.0,0.0
1001,365,2020-03-17 05:05:00,0,2532.0,1767.0,0.698,11.932,408,155,103,52,253,194,59,5,0.0,0.0
1001,366,2020-03-17 05:08:00,0,2540.0,1780.0,0.701,11.978,340,189,141,48,151,103,48,4,0.0,0.0
1001,367,2020-03-17 05:11:00,0,2470.0,1740.0,0.705,11.66,477,174,123,51,303,229,74,6,0.0,0.0
1001,368,2020-03-17 05:14:00,0,2401.0,1721.0,0.717,11.366,63,17,11,6,46,27,19,7,0.0,0.0
1001,369,2020-03-17 05:17:00,0,2325.0,1679.0,0.722,11.018,33,0,0,0,33,2,31,1,0.0,0.0
1001,370,2020-03-17 05:20:00,0,2270.0,1603.0,0.706,10.719,4,0,0,0,4,2,2,0,0.0,0.0
1001,371,2020-03-17 05:23:00,0,2223.0,1484.0,0.668,10.4,4,0,0,0,4,0,4,0,0.01,0.0
1001,372,2020-03-17 05:26:00,0,2089.0,1396.0,0.668,9.776,14,9,3,6,5,1,4,0,0.0,0.0
1001,373,2020-03-17 05:29:00,0,1861.0,1335.0,0.717,8.813,1,0,0,0,1,1,0,0,0.01,0.0
1001,374,2020-03-17 05:32:00,0,1891.0,1264.0,0.668,8.851,2,2,1,1,0,0,0,0,0.0,0.0
1001,375,2020-03-17 05:35:00,0,1744.0,1204.0,0.69,8.204,51,28,17,11,23,6,17,5,0.0,0.0
1001,376,2020-03-17 05:38:00,0,1867.0,1334.0,0.715,8.832,229,111,62,49,118,66,52,9,0.0,0.0
1001,377,2020-03-17 05:41:00,0,2202.0,1603.0,0.728,10.453,444,254,193,61,190,136,54,10,0.0,0.0
1001,378,2020-03-17 05:44:00,0,2386.0,1704.0,0.714,11.287,148,82,48,34,66,39,27,22,0.0,0.0
1001,379,2020-03-17 05:47:00,0,2548.0,1773.0,0.696,12.001,234,151,100,51,83,51,32,37,0.02,0.0
1001,380,2020-03-17 05:50:00,0,2515.0,1838.0,0.731,11.946,259,127,106,21,132,86,46,14,0.0,0.0
1001,381,2020-03-17 05:53:00,0,2526.0,1806.0,0.715,11.952,154,69,53,16,85,54,31,6,0.0,0.0
1001,382,2020-03-17 05:56:00,0,2328.0,1680.0,0.722,11.033,6,0,0,0,6,0,6,0,0.0,0.0
1001,383,2020-03-17 05:59:00,0,2197.0,1564.0,0.712,10.387,7,3,1,2,4,0,4,0,0.0,0.0
1001,384,2020-03-17 06:02:00,1,2213.0,1521.0,0.687,10.403,205,102,64,38,103,66,37,14,0.0,0.0
1001,385,2020-03-17 06:05:00,1,2324.0,1698.0,0.73,11.038,228,135,87,48,93,63,30,14,0.0,0.0
1001,386,2020-03-17 06:08:00,1,2463.0,1751.0,0.711,11.642,239,143,99,44,96,63,33,11,0.0,0.0
1001,387,2020-03-17 06:11:00,1,2541.0,1769.0,0.696,11.972,190,117,71,46,73,43,30,0,0.0,0.0
1001,388,2020-03-17 06:14:00,1,2380.0,1713.0,0.72,11.274,291,148,96,52,143,104,39,4,0.0,0.0
1001,389,2020-03-17 06:17:00,1,2332.0,1702.0,0.73,11.072,266,148,106,42,118,83,35,0,0.0,0.0
1001,390,2020-03-17 06:20:00,1,2338.0,1657.0,0.709,11.045,82,28,19,9,54,40,14,0,0.01,0.0
1001,391,2020-03-17 06:23:00,1,2332.0,1668.0,0.715,11.037,37,18,8,10,19,4,15,0,0.0,0.0
1001,392,2020-03-17 06:26:00,1,2335.0,1635.0,0.7,11.011,71,67,15,52,4,1,3,0,0.0,0.0
1001,393,2020-03-17 06:29:00,1,2220.0,1518.0,0.684,10.43,46,46,0,46,0,0,0,0,0.0,0.0
1001,394,2020-03-17 06:32:00,1,2089.0,1407.0,0.674,9.79,33,33,0,33,0,0,0,0,0.0,0.0
1001,395,2020-03-17 06:35:00,1,1868.0,1314.0,0.703,8.815,8,4,2,2,4,0,4,0,0.0,0.0
1001,396,2020-03-17 06:38:00,1,1883.0,1287.0,0.684,8.844,23,11,4,7,12,0,12,0,0.0,0.0
1001,397,2020-03-17 06:41:00,1,1873.0,1324.0,0.707,8.845,2,2,0,2,0,0,0,0,0.0,0.0
1001,398,2020-03-17 06:44:00,1,1873.0,1319.0,0.704,8.84,1,1,0,1,0,0,0,0,0.01,0.0
1001,399,2020-03-17 06:47:00,1,1869.0,1300.0,0.696,8.803,12,7,2,5,5,0,5,0,0.0,0.0
1001,400,2020-03-17 06:50:00,1,1877.0,1301.0,0.693,8.837,33,33,2,31,0,0,0,0,0.0,0.0
1001,401,2020-03-17 06:53:00,1,1737.0,1224.0,0.705,8.201,9,8,3,5,1,1,0,0,0.01,0.0
1001,402,2020-03-17 06:56:00,1,1744.0,1227.0,0.703,8.228,20,19,2,17,1,0,1,0,0.0,0.0
1001,403,2020-03-17 06:59:00,1,1818.0,1259.0,0.693,8.557,14,14,0,14,0,0,0,0,0.0,0.0
1001,404,2020-03-17 07:02:00,1,1734.0,1243.0,0.717,8.207,2,2,0,2,0,0,0,0,0.0,0.0
1001,405,2020-03-17 07:05:00,1,1743.0,1204.0,0.69,8.201,29,29,2,27,0,0,0,0,0.0,0.0
1001,406,2020-03-17 07:08:00,1,1742.0,1201.0,0.689,8.194,18,16,6,10,2,1,1,0,0.0,0.0
1001,407,2020-03-17 07:11:00,1,1752.0,1195.0,0.682,8.226,23,16,7,9,7,4,3,0,0.0,0.0
1001,408,2020-03-17 07:14:00,1,1730.0,1220.0,0.705,8.166,1,0,0,0,1,0,1,0,0.0,0.0
1001,409,2020-03-17 07:17:00,1,1749.0,1203.0,0.688,8.225,3,0,0,0,3,0,3,0,0.0,0.0
1001,410,2020-03-17 07:20:00,1,1755.0,1162.0,0.662,8.203,20,5,0,5,15,5,10,0,0.0,0.0
1001,411,2020-03-17 07:23:00,1,1797.0,1265.0,0.704,8.482,27,5,2,3,22,10,12,0,0.01,0.0
1001,412,2020-03-17 07:26:00,1,2072.0,1464.0,0.706,9.787,82,35,10,25,47,24,23,0,0.01,0.0
1001,413,2020-03-17 07:29:00,1,2063.0,1484.0,0.72,9.772,53,19,11,8,34,11,23,7,0.0,0.0
1001,414,2020-03-17 07:32:00,1,2189.0,1605.0,0.733,10.403,236,104,70,34,132,88,44,5,0.0,0.0
1001,415,2020-03-17 07:35:00,1,2190.0,1619.0,0.739,10.423,218,103,71,32,115,81,34,10,0.0,0.0
1001,416,2020-03-17 07:38:00,1,2192.0,1597.0,0.728,10.404,137,45,33,12,92,41,51,3,0.0,0.0
1001,417,2020-03-17 07:41:00,1,2203.0,1571.0,0.713,10.419,22,4,0,4,18,0,18,0,0.0,0.0
1001,418,2020-03-17 07:44:00,1,2066.0,1453.0,0.703,9.751,1,0,0,0,1,1,0,0,0.0,0.0
1001,419,2020-03-17 07:47:00,1,1858.0,1348.0,0.726,8.812,1,0,0,0,1,0,1,0,0.01,0.0
1001,420,2020-03-17 07:50:00,1,1800.5,1287.5,0.715,8.519,12,5,2,3,7,1,6,0,0.0,0.0
1001,421,2020-03-17 07:53:00,1,1743.0,1227.0,0.704,8.226,10,3,0,3,7,0,7,0,0.0,0.0
1001,422,2020-03-17 07:56:00,1,1747.0,1195.0,0.684,8.205,10,6,2,4,4,0,4,0,0.0,0.0
1001,423,2020-03-17 07:59:00,1,1743.0,1187.0,0.681,8.182,0,0,0,0,0,0,0,0,0.01,0.0
1001,424,2020-03-17 08:02:00,1,1751.0,1178.0,0.673,8.203,5,5,1,4,0,0,0,0,0.0,0.0
1001,425,2020-03-17 08:05:00,1,1751.0,1201.0,0.686,8.23,17,17,1,16,0,0,0,0,0.0,0.0
1001,426,2020-03-17 08:08:00,1,1739.0,1216.0,0.7,8.197,5,5,0,5,0,0,0,0,0.0,0.0
1001,427,2020-03-17 08:11:00,1,1724.0,1232.0,0.715,8.155,2,2,0,2,0,0,0,0,0.0,0.0
1001,428,2020-03-17 08:14:00,1,1728.0,1219.0,0.705,8.16,5,0,0,0,5,0,5,0,0.01,0.0
1001,429,2020-03-17 08:17:00,1,1742.0,1222.0,0.701,8.216,3,1,0,1,2,1,1,0,0.0,0.0
1001,430,2020-03-17 08:20:00,1,1727.0,1225.0,0.709,8.161,8,8,0,8,0,0,0,0,0.0,0.0
1001,431,2020-03-17 08:23:00,1,1744.0,1217.0,0.698,8.218,82,78,35,43,4,1,3,0,0.0,0.0
1001,432,2020-03-17 08:26:00,1,1867.0,1341.0,0.718,8.84,69,54,15,39,15,0,15,0,0.0,0.0
1001,433,2020-03-17 08:29:00,1,1861.0,1364.0,0.733,8.841,99,66,39,27,33,11,22,0,0.0,0.0
1001,434,2020-03-17 08:32:00,1,1860.0,1370.0,0.737,8.845,15,5,4,1,10,1,9,0,0.0,0.0
1001,435,2020-03-17 08:35:00,1,1803.0,1289.0,0.715,8.533,1,0,0,0,1,0,1,0,0.01,0.0
1001,436,2020-03-17 08:38:00,1,1745.0,1206.0,0.691,8.212,4,0,0,0,4,2,2,0,0.0,0.0
1001,437,2020-03-17 08:41:00,1,1677.0,1155.0,0.689,7.886,1,0,0,0,1,1,0,0,0.02,0.0
1001,438,2020-03-17 08:44:00,1,1604.0,1077.0,0.671,7.513,16,0,0,0,16,4,12,0,0.0,0.0
1001,439,2020-03-17 08:47:00,1,1603.0,1135.0,0.708,7.573,2,0,0,0,2,0,2,0,0.0,0.0
1001,440,2020-03-17 08:50:00,1,1751.0,1171.0,0.669,8.195,3,0,0,0,3,0,3,0,0.0,0.0
1001,441,2020-03-17 08:53:00,1,1740.0,1186.0,0.681,8.168,0,0,0,0,0,0,0,0,0.0,0.0
1001,442,2020-03-17 08:56:00,1,1743.0,1221.0,0.7,8.218,0,0,0,0,0,0,0,0,0.0,0.0
1001,443,2020-03-17 08:59:00,1,1730.0,1237.0,0.715,8.186,33,21,13,8,12,5,7,0,0.0,0.0
1001,444,2020-03-17 09:02:00,1,1726.0,1237.0,0.717,8.169,2,2,0,2,0,0,0,0,0.0,0.0
1001,445,2020-03-17 09:05:00,1,1743.0,1198.0,0.687,8.193,34,29,5,24,5,1,4,0,0.0,0.0
1001,446,2020-03-17 09:08:00,1,1750.0,1191.0,0.681,8.214,11,9,4,5,2,0,2,0,0.0,0.0
1001,447,2020-03-17 09:11:00,1,1600.0,1131.0,0.707,7.556,31,29,11,18,2,0,2,0,0.0,0.0
1001,448,2020-03-17 09:14:00,1,1596.0,1143.0,0.716,7.555,16,16,8,8,0,0,0,0,0.0,0.0
1001,449,2020-03-17 09:17:00,1,1604.0,1119.0,0.698,7.558,70,48,24,24,22,10,12,2,0.01,0.0
1001,450,2020-03-17 09:20:00,1,1668.0,1167.0,0.7,7.863,5,0,0,0,5,3,2,0,0.01,0.0
1001,451,2020-03-17 09:23:00,1,1598.0,1152.0,0.721,7.574,4,0,0,0,4,0,4,0,0.0,0.0
1001,452,2020-03-17 09:26:00,1,1669.0,1167.0,0.699,7.869,12,8,4,4,4,2,2,0,0.0,0.0
1001,453,2020-03-17 09:29:00,1,1732.0,1202.0,0.694,8.153,11,0,0,0,11,0,11,0,0.0,0.0
1001,454,2020-03-17 09:32:00,1,1400.0,995.0,0.711,6.62,213,120,113,7,93,77,16,58,0.46,0.0
1001,455,2020-03-17 09:35:00,1,1396.0,1033.0,0.74,6.644,8,6,2,4,2,0,2,0,0.07,0.0
1001,456,2020-03-17 09:38:00,1,1845.0,1394.0,0.756,8.813,44,42,6,36,2,1,1,0,0.0,0.0
1001,457,2020-03-17 09:41:00,1,2060.0,1491.0,0.724,9.77,42,29,9,20,13,3,10,8,0.0,0.0
1001,458,2020-03-17 09:44:00,1,2198.0,1574.0,0.716,10.405,27,8,3,5,19,0,19,0,0.0,0.0
1001,459,2020-03-17 09:47:00,1,2192.0,1625.0,0.741,10.437,106,79,43,36,27,8,19,0,0.0,0.0
1001,460,2020-03-17 09:50:00,1,2334.0,1681.0,0.72,11.057,80,65,29,36,15,2,13,0,0.0,0.0
1001,461,2020-03-17 09:53:00,1,2319.0,1716.0,0.74,11.037,123,87,50,37,36,12,24,0,0.01,0.0
1001,462,2020-03-17 09:56:00,1,2325.0,1660.0,0.714,11.0,4,2,1,1,2,0,2,0,0.02,0.0
1001,463,2020-03-17 09:59:00,1,2209.0,1548.0,0.701,10.416,2,0,0,0,2,0,2,0,0.01,0.0
1001,464,2020-03-17 10:02:00,1,2076.0,1460.0,0.703,9.798,19,8,4,4,11,2,9,0,0.0,0.0
1001,465,2020-03-17 10:05:00,1,2073.0,1470.0,0.709,9.795,1,0,0,0,1,0,1,0,0.0,0.0
1001,466,2020-03-17 10:08:00,1,2069.0,1433.0,0.692,9.739,7,3,1,2,4,0,4,0,0.0,0.0
1001,467,2020-03-17 10:11:00,1,2009.0,1399.0,0.696,9.464,14,8,4,4,6,0,6,0,0.02,0.0
1001,468,2020-03-17 10:14:00,1,2073.0,1419.0,0.684,9.738,0,0,0,0,0,0,0,0,0.0,0.0
1001,469,2020-03-17 10:17:00,1,2002.0,1413.0,0.706,9.45,1,0,0,0,1,0,1,0,0.0,0.0
1001,470,2020-03-17 10:20:00,1,2082.0,1427.0,0.685,9.785,0,0,0,0,0,0,0,0,0.0,0.0
1001,471,2020-03-17 10:23:00,1,2086.0,1439.0,0.69,9.814,1,0,0,0,1,0,1,0,0.0,0.0
1001,472,2020-03-17 10:26:00,1,2083.0,1422.0,0.683,9.781,13,2,2,0,11,2,9,0,0.02,0.0
1001,473,2020-03-17 10:29:00,1,2073.0,1420.0,0.685,9.739,11,4,2,2,7,0,7,0,0.0,0.0
1001,474,2020-03-17 10:32:00,1,1936.0,1383.0,0.714,9.158,21,0,0,0,21,0,21,0,0.01,0.0
1001,475,2020-03-17 10:35:00,1,1855.0,1358.0,0.732,8.814,65,34,17,17,31,6,25,5,0.0,0.0
1001,476,2020-03-17 10:38:00,1,2128.0,1514.0,0.711,10.06,24,18,4,14,6,0,6,1,0.0,0.0
1001,477,2020-03-17 10:41:00,1,2128.0,1527.0,0.717,10.076,183,99,55,44,84,40,44,2,0.0,0.0
1001,478,2020-03-17 10:44:00,1,2169.0,1629.0,0.751,10.351,386,225,169,56,161,112,49,16,0.02,0.0
1001,479,2020-03-17 10:47:00,1,2321.0,1746.0,0.752,11.079,304,202,147,55,102,64,38,5,0.01,0.0
1001,480,2020-03-17 10:50:00,1,2294.5,1684.0,0.7335,10.9065,104,50,29,21,54,43,11,0,0.0,0.0
1001,481,2020-03-17 10:53:00,1,2268.0,1622.0,0.715,10.734,330,184,134,50,146,94,52,4,0.0,0.0
1001,482,2020-03-17 10:56:00,1,2260.0,1636.0,0.724,10.717,134,65,53,12,69,40,29,3,0.0,0.0
1001,483,2020-03-17 10:59:00,1,2334.0,1630.0,0.698,11.0,49,29,10,19,20,8,12,1,0.0,0.0
1001,484,2020-03-17 11:02:00,1,2349.0,1629.0,0.693,11.06,30,4,1,3,26,3,23,0,0.0,0.0
1001,485,2020-03-17 11:05:00,1,2337.0,1649.0,0.706,11.033,132,45,19,26,87,37,50,0,0.0,0.0
1001,486,2020-03-17 11:08:00,1,2343.0,1661.0,0.709,11.071,8,2,1,1,6,4,2,0,0.01,0.0
1001,487,2020-03-17 11:11:00,1,2260.0,1605.0,0.71,10.681,3,0,0,0,3,0,3,0,0.02,0.0
1001,488,2020-03-17 11:14:00,1,2207.0,1509.0,0.684,10.366,9,6,1,5,3,2,1,0,0.03,0.0
1001,489,2020-03-17 11:17:00,1,2076.0,1411.0,0.68,9.741,7,7,0,7,0,0,0,0,0.0,0.0
1001,490,2020-03-17 11:20:00,1,1938.0,1382.0,0.713,9.168,0,0,0,0,0,0,0,0,0.0,0.0
1001,491,2020-03-17 11:23:00,1,1942.0,1370.0,0.705,9.17,0,0,0,0,0,0,0,0,0.03,0.0
1001,492,2020-03-17 11:26:00,1,2010.0,1379.0,0.686,9.447,4,4,1,3,0,0,0,0,0.0,0.0
1001,493,2020-03-17 11:29:00,1,2080.0,1416.0,0.681,9.765,0,0,0,0,0,0,0,0,0.0,0.0
1001,494,2020-03-17 11:32:00,1,1929.0,1382.0,0.717,9.13,3,0,0,0,3,1,2,0,0.0,0.0
1001,495,2020-03-17 11:35:00,1,1929.0,1366.0,0.708,9.113,6,2,0,2,4,0,4,0,0.0,0.0
1001,496,2020-03-17 11:38:00,1,1925.0,1354.0,0.703,9.084,0,0,0,0,0,0,0,0,0.0,0.0
1001,497,2020-03-17 11:41:00,1,1863.0,1360.0,0.73,8.846,3,0,0,0,3,0,3,0,0.0,0.0
1001,498,2020-03-17 11:44:00,1,1936.0,1378.0,0.712,9.153,3,0,0,0,3,0,3,0,0.01,0.0
1001,499,2020-03-17 11:47:00,1,1924.0,1369.0,0.711,9.098,12,0,0,0,12,0,12,0,0.01,0.0
1001,500,2020-03-17 11:50:00,1,1861.0,1342.0,0.721,8.817,0,0,0,0,0,0,0,0,0.0,0.0
1001,501,2020-03-17 11:53:00,1,1868.0,1325.0,0.709,8.827,0,0,0,0,0,0,0,0,0.02,0.0
1001,502,2020-03-17 11:56:00,1,1865.0,1337.0,0.717,8.827,2,0,0,0,2,0,2,0,0.0,0.0
1001,503,2020-03-17 11:59:00,1,1866.0,1343.0,0.72,8.841,88,58,29,29,30,7,23,1,0.01,0.0
1001,504,2020-03-17 12:02:00,1,2001.0,1402.0,0.701,9.439,3,0,0,0,3,0,3,0,0.0,0.0
1001,505,2020-03-17 12:05:00,1,1862.0,1332.0,0.716,8.811,0,0,0,0,0,0,0,0,0.01,0.0
1001,506,2020-03-17 12:08:00,1,1867.0,1291.0,0.692,8.785,0,0,0,0,0,0,0,0,0.02,0.0
1001,507,2020-03-17 12:11:00,1,1885.0,1290.0,0.685,8.855,0,0,0,0,0,0,0,0,0.0,0.0
1001,508,2020-03-17 12:14:00,1,1884.0,1284.0,0.682,8.846,3,0,0,0,3,1,2,0,0.0,0.0
1001,509,2020-03-17 12:17:00,1,1865.0,1302.0,0.698,8.789,5,0,0,0,5,0,5,0,0.01,0.0
1001,510,2020-03-17 12:20:00,1,1867.0,1308.0,0.701,8.806,6,0,0,0,6,0,6,0,0.03,0.0
1001,511,2020-03-17 12:23:00,1,1868.0,1312.0,0.703,8.814,19,0,0,0,19,0,19,0,0.0,0.0
1001,512,2020-03-17 12:26:00,1,1857.0,1327.0,0.715,8.784,10,0,0,0,10,0,10,0,0.01,0.0
1001,513,2020-03-17 12:29:00,1,1873.0,1309.0,0.699,8.83,15,0,0,0,15,0,15,0,0.02,0.0
1001,514,2020-03-17 12:32:00,1,1876.0,1307.0,0.697,8.84,30,10,5,5,20,5,15,0,0.0,0.0
1001,515,2020-03-17 12:35:00,1,1880.0,1290.0,0.686,8.835,7,0,0,0,7,0,7,0,0.0,0.0
1001,516,2020-03-17 12:38:00,1,1875.0,1313.0,0.7,8.84,8,2,2,0,6,0,6,0,0.0,0.0
1001,517,2020-03-17 12:41:00,1,1862.0,1341.0,0.72,8.823,8,0,0,0,8,0,8,0,0.01,0.0
1001,518,2020-03-17 12:44:00,1,1861.0,1364.0,0.733,8.844,9,0,0,0,9,0,9,0,0.0,0.0
1001,519,2020-03-17 12:47:00,1,1872.0,1304.0,0.696,8.82,10,5,0,5,5,0,5,0,0.0,0.0
1001,520,2020-03-17 12:50:00,1,1862.0,1360.0,0.731,8.84,92,42,19,23,50,23,27,0,0.0,0.0
1001,521,2020-03-17 12:53:00,1,2074.0,1453.0,0.701,9.78,85,64,33,31,21,1,20,0,0.0,0.0
1001,522,2020-03-17 12:56:00,1,2056.0,1498.0,0.728,9.76,104,52,18,34,52,18,34,2,0.0,0.0
1001,523,2020-03-17 12:59:00,1,2201.0,1555.0,0.707,10.394,322,143,98,45,179,113,66,14,0.01,0.0
1001,524,2020-03-17 13:02:00,1,2248.0,1627.0,0.724,10.659,165,114,69,45,51,23,28,6,0.0,0.0
1001,525,2020-03-17 13:05:00,1,2314.0,1732.0,0.748,11.035,357,195,148,47,162,118,44,18,0.0,0.0
1001,526,2020-03-17 13:08:00,1,2533.0,1787.0,0.706,11.958,109,104,62,42,5,1,4,3,0.02,0.0
1001,527,2020-03-17 13:11:00,1,2551.0,1782.0,0.698,12.025,160,81,33,48,79,30,49,0,0.0,0.0
1001,528,2020-03-17 13:14:00,1,2399.0,1723.0,0.718,11.359,383,190,138,52,193,140,53,3,0.0,0.0
1001,529,2020-03-17 13:17:00,1,2327.0,1717.0,0.738,11.068,134,80,50,30,54,27,27,0,0.0,0.0
1001,530,2020-03-17 13:20:00,1,2325.0,1667.0,0.717,11.007,78,53,20,33,25,7,18,1,0.0,0.0
1001,531,2020-03-17 13:23:00,1,2314.0,1674.0,0.723,10.973,91,45,1,44,46,13,33,2,0.0,0.0
1001,532,2020-03-17 13:26:00,1,2330.0,1695.0,0.727,11.058,325,139,83,56,186,138,48,8,0.0,0.0
1001,533,2020-03-17 13:29:00,1,2321.0,1692.0,0.729,11.02,118,55,34,21,63,30,33,6,0.0,0.0
1001,534,2020-03-17 13:32:00,1,2328.0,1732.0,0.744,11.091,202,129,83,46,73,34,39,1,0.01,0.0
1001,535,2020-03-17 13:35:00,1,2341.0,1677.0,0.717,11.079,136,67,52,15,69,44,25,0,0.02,0.0
1001,536,2020-03-17 13:38:00,1,2209.0,1553.0,0.703,10.423,6,6,1,5,0,0,0,0,0.0,0.0
1001,537,2020-03-17 13:41:00,1,2075.0,1440.0,0.694,9.769,7,6,0,6,1,0,1,0,0.0,0.0
1001,538,2020-03-17 13:44:00,1,1857.0,1355.0,0.73,8.816,3,3,0,3,0,0,0,0,0.0,0.0
1001,539,2020-03-17 13:47:00,1,1879.0,1310.0,0.697,8.852,13,7,0,7,6,1,5,0,0.0,0.0
1001,540,2020-03-17 13:50:00,1,1844.0,1282.5,0.6955,8.684,3,0,0,0,3,0,3,0,0.0,0.0
1001,541,2020-03-17 13:53:00,1,1809.0,1255.0,0.694,8.516,1,0,0,0,1,0,1,0,0.0,0.0
1001,542,2020-03-17 13:56:00,1,1731.0,1231.0,0.711,8.185,6,2,0,2,4,0,4,0,0.0,0.0
1001,543,2020-03-17 13:59:00,1,1731.0,1252.0,0.723,8.205,3,0,0,0,3,0,3,0,0.0,0.0
1001,544,2020-03-17 14:02:00,1,1728.0,1250.0,0.724,8.192,7,4,0,4,3,0,3,0,0.0,0.0
1001,545,2020-03-17 14:05:00,1,1866.0,1310.0,0.702,8.805,52,29,8,21,23,4,19,0,0.01,0.0
1001,546,2020-03-17 14:08:00,1,1866.0,1332.0,0.714,8.829,2,0,0,0,2,0,2,0,0.0,0.0
1001,547,2020-03-17 14:11:00,1,1869.0,1351.0,0.723,8.858,1,0,0,0,1,0,1,0,0.0,0.0
1001,548,2020-03-17 14:14:00,1,1865.0,1351.0,0.725,8.843,5,0,0,0,5,0,5,0,0.01,0.0
1001,549,2020-03-17 14:17:00,1,1855.0,1330.0,0.717,8.784,27,18,1,17,9,0,9,0,0.01,0.0
1001,550,2020-03-17 14:20:00,1,1856.0,1324.0,0.713,8.781,10,10,0,10,0,0,0,0,0.01,0.0
1001,551,2020-03-17 14:23:00,1,1878.0,1280.0,0.682,8.819,7,6,0,6,1,0,1,0,0.01,0.0
1001,552,2020-03-17 14:26:00,1,1873.0,1285.0,0.686,8.803,8,5,0,5,3,0,3,0,0.03,0.0
1001,553,2020-03-17 14:29:00,1,1875.0,1277.0,0.681,8.803,1,1,0,1,0,0,0,0,0.0,0.0
1001,554,2020-03-17 14:32:00,1,1877.0,1292.0,0.689,8.825,11,11,0,11,0,0,0,0,0.01,0.0
1001,555,2020-03-17 14:35:00,1,1881.0,1298.0,0.69,8.848,2,2,0,2,0,0,0,0,0.01,0.0
1001,556,2020-03-17 14:38:00,1,1882.0,1303.0,0.692,8.859,19,11,5,6,8,1,7,0,0.0,0.0
1001,557,2020-03-17 14:41:00,1,1867.0,1342.0,0.719,8.843,5,0,0,0,5,0,5,0,0.01,0.0
1001,558,2020-03-17 14:44:00,1,1865.0,1329.0,0.713,8.822,12,0,0,0,12,0,12,0,0.0,0.0
1001,559,2020-03-17 14:47:00,1,1861.0,1326.0,0.713,8.8,19,12,7,5,7,0,7,0,0.0,0.0
1001,560,2020-03-17 14:50:00,1,1874.0,1343.0,0.717,8.872,7,2,2,0,5,2,3,0,0.01,0.0
1001,561,2020-03-17 14:53:00,1,1864.0,1285.0,0.689,8.769,1,0,0,0,1,0,1,0,0.02,0.0
1001,562,2020-03-17 14:56:00,1,1887.0,1294.0,0.686,8.868,6,6,2,4,0,0,0,0,0.0,0.0
1001,563,2020-03-17 14:59:00,1,1881.0,1288.0,0.685,8.837,3,3,2,1,0,0,0,0,0.0,0.0
1001,564,2020-03-17 15:02:00,1,1793.0,1281.0,0.714,8.485,6,5,2,3,1,0,1,0,0.0,0.0
1001,565,2020-03-17 15:05:00,1,1808.0,1292.0,0.714,8.553,6,6,2,4,0,0,0,0,0.0,0.0
1001,566,2020-03-17 15:08:00,1,1875.0,1309.0,0.698,8.837,11,10,5,5,1,0,1,0,0.0,0.0
1001,567,2020-03-17 15:11:00,1,1873.0,1310.0,0.7,8.829,23,20,10,10,3,1,2,0,0.0,0.0
1001,568,2020-03-17 15:14:00,1,1868.0,1308.0,0.7,8.806,34,14,9,5,20,9,11,0,0.01,0.0
1001,569,2020-03-17 15:17:00,1,1731.0,1257.0,0.726,8.212,30,16,6,10,14,2,12,0,0.0,0.0
1001,570,2020-03-17 15:20:00,1,1869.0,1319.0,0.706,8.824,19,13,9,4,6,4,2,1,0.0,0.0
1001,571,2020-03-17 15:23:00,1,1870.0,1350.0,0.722,8.863,22,10,4,6,12,2,10,0,0.0,0.0
1001,572,2020-03-17 15:26:00,1,1859.0,1322.0,0.711,8.788,16,16,6,10,0,0,0,0,0.0,0.0
1001,573,2020-03-17 15:29:00,1,1879.0,1293.0,0.688,8.837,19,19,4,15,0,0,0,0,0.0,0.0
1001,574,2020-03-17 15:32:00,1,1874.0,1269.0,0.677,8.79,19,19,3,16,0,0,0,0,0.02,0.0
1001,575,2020-03-17 15:35:00,1,1868.0,1312.0,0.703,8.811,72,63,41,22,9,5,4,0,0.0,0.0
1001,576,2020-03-17 15:38:00,1,1872.0,1323.0,0.707,8.839,0,0,0,0,0,0,0,0,0.04,0.0
1001,577,2020-03-17 15:41:00,1,1865.0,1337.0,0.717,8.83,1,1,0,1,0,0,0,0,0.0,0.0
1001,578,2020-03-17 15:44:00,1,1849.0,1349.0,0.729,8.779,5,0,0,0,5,0,5,0,0.0,0.0
1001,579,2020-03-17 15:47:00,1,1942.0,1375.0,0.708,9.173,0,0,0,0,0,0,0,0,0.0,0.0
1001,580,2020-03-17 15:50:00,1,1857.0,1338.0,0.721,8.797,0,0,0,0,0,0,0,0,0.01,0.0
1001,581,2020-03-17 15:53:00,1,1999.0,1389.0,0.695,9.416,0,0,0,0,0,0,0,0,0.02,0.0
1001,582,2020-03-17 15:56:00,1,1938.0,1390.0,0.717,9.176,2,2,1,1,0,0,0,0,0.0,0.0
1001,583,2020-03-17 15:59:00,1,2006.0,1391.0,0.693,9.446,2,2,0,2,0,0,0,0,0.0,0.0
1001,584,2020-03-17 16:02:00,1,2013.0,1398.0,0.694,9.482,7,4,0,4,3,1,2,0,0.0,0.0
1001,585,2020-03-17 16:05:00,1,1932.0,1376.0,0.712,9.135,6,2,0,2,4,0,4,0,0.0,0.0
1001,586,2020-03-17 16:08:00,1,1869.0,1338.0,0.716,8.844,1,0,0,0,1,0,1,0,0.05,0.0
1001,587,2020-03-17 16:11:00,1,1929.0,1394.0,0.723,9.146,29,25,2,23,4,1,3,0,0.0,0.0
1001,588,2020-03-17 16:14:00,1,2061.0,1478.0,0.717,9.755,62,27,4,23,35,15,20,1,0.0,0.0
1001,589,2020-03-17 16:17:00,1,2062.0,1497.0,0.726,9.781,213,160,108,52,53,28,25,9,0.0,0.0
1001,590,2020-03-17 16:20:00,1,2188.0,1589.0,0.726,10.38,303,162,108,54,141,90,51,6,0.0,0.0
1001,591,2020-03-17 16:23:00,1,2340.0,1668.0,0.713,11.065,251,127,91,36,124,80,44,3,0.0,0.0
1001,592,2020-03-17 16:26:00,1,2325.0,1661.0,0.714,11.0,377,216,170,46,161,114,47,5,0.0,0.0
1001,593,2020-03-17 16:29:00,1,2336.0,1683.0,0.721,11.069,165,84,57,27,81,54,27,8,0.0,0.0
1001,594,2020-03-17 16:32:00,1,2327.0,1653.0,0.71,10.999,41,32,12,20,9,3,6,1,0.0,0.0
1001,595,2020-03-17 16:35:00,1,2331.0,1679.0,0.72,11.043,35,26,0,26,9,2,7,3,0.01,0.0
1001,596,2020-03-17 16:38:00,1,2325.0,1667.0,0.717,11.007,49,22,4,18,27,6,21,1,0.0,0.0
1001,597,2020-03-17 16:41:00,1,2333.0,1698.0,0.727,11.074,27,16,2,14,11,3,8,0,0.0,0.0
1001,598,2020-03-17 16:44:00,1,2206.0,1572.0,0.712,10.434,18,16,0,16,2,0,2,0,0.0,0.0
1001,599,2020-03-17 16:47:00,1,2077.0,1467.0,0.706,9.809,5,1,0,1,4,0,4,0,0.01,0.0
1001,600,2020-03-17 16:50:00,1,1970.0,1410.0,0.716,9.323,4,0,0,0,4,0,4,0,0.0,0.0
1001,601,2020-03-17 16:53:00,1,1863.0,1353.0,0.726,8.837,0,0,0,0,0,0,0,0,0.0,0.0
1001,602,2020-03-17 16:56:00,1,1923.0,1373.0,0.714,9.096,24,11,4,7,13,0,13,0,0.0,0.0
1001,603,2020-03-17 16:59:00,1,1933.0,1375.0,0.712,9.137,82,74,34,40,8,5,3,0,0.0,0.0
1001,604,2020-03-17 17:02:00,1,2064.0,1498.0,0.726,9.791,75,30,1,29,45,8,37,0,0.0,0.0
1001,605,2020-03-17 17:05:00,1,2211.0,1555.0,0.704,10.433,47,37,0,37,10,3,7,0,0.0,0.0
1001,606,2020-03-17 17:08:00,1,2057.0,1498.0,0.728,9.762,5,5,0,5,0,0,0,0,0.0,0.0
1001,607,2020-03-17 17:11:00,1,2076.0,1431.0,0.689,9.765,16,13,3,10,3,2,1,0,0.01,0.0
1001,608,2020-03-17 17:14:00,1,2004.0,1423.0,0.71,9.471,3,0,0,0,3,0,3,0,0.0,0.0
1001,609,2020-03-17 17:17:00,1,1927.0,1397.0,0.725,9.141,4,2,1,1,2,0,2,0,0.0,0.0
1001,610,2020-03-17 17:20:00,1,2076.0,1422.0,0.685,9.753,2,0,0,0,2,0,2,0,0.0,0.0
1001,611,2020-03-17 17:23:00,1,2076.0,1427.0,0.688,9.76,4,0,0,0,4,0,4,0,0.0,0.0
1001,612,2020-03-17 17:26:00,1,2081.0,1424.0,0.684,9.777,0,0,0,0,0,0,0,0,0.0,0.0
1001,613,2020-03-17 17:29:00,1,2076.0,1406.0,0.677,9.738,1,1,0,1,0,0,0,0,0.0,0.0
1001,614,2020-03-17 17:32:00,1,2080.0,1436.0,0.69,9.784,4,0,0,0,4,0,4,0,0.01,0.0
1001,615,2020-03-17 17:35:00,1,2071.0,1447.0,0.699,9.761,2,0,0,0,2,0,2,0,0.0,0.0
1001,616,2020-03-17 17:38:00,1,2077.0,1455.0,0.701,9.795,2,0,0,0,2,0,2,0,0.0,0.0
1001,617,2020-03-17 17:41:00,1,2062.0,1458.0,0.707,9.737,10,1,0,1,9,0,9,0,0.0,0.0
1001,618,2020-03-17 17:44:00,1,2064.0,1430.0,0.693,9.715,1,0,0,0,1,0,1,0,0.0,0.0
1001,619,2020-03-17 17:47:00,1,2068.0,1452.0,0.702,9.757,5,0,0,0,5,0,5,0,0.02,0.0
1001,620,2020-03-17 17:50:00,1,2061.0,1460.0,0.708,9.738,64,40,12,28,24,13,11,1,0.04,0.0
1001,621,2020-03-17 17:53:00,1,2193.0,1581.0,0.721,10.39,74,14,4,10,60,27,33,0,0.0,0.0
1001,622,2020-03-17 17:56:00,1,2324.0,1640.0,0.706,10.972,78,35,2,33,43,10,33,2,0.0,0.0
1001,623,2020-03-17 17:59:00,1,2334.0,1688.0,0.723,11.066,82,55,33,22,27,1,26,13,0.0,0.0
1001,624,2020-03-17 18:02:00,0,2382.0,1762.0,0.74,11.335,349,197,137,60,152,102,50,28,0.0,0.0
1001,625,2020-03-17 18:05:00,0,2790.0,2032.0,0.728,13.243,474,276,226,50,198,142,56,59,0.01,0.0
1001,626,2020-03-17 18:08:00,0,2857.0,2101.0,0.735,13.583,429,262,203,59,167,120,47,48,0.0,0.0
1001,627,2020-03-17 18:11:00,0,2989.0,2133.0,0.714,14.139,443,254,191,63,189,130,59,23,0.0,0.0
1001,628,2020-03-17 18:14:00,0,2870.0,2081.0,0.725,13.613,473,253,193,60,220,164,56,33,0.0,0.0
1001,629,2020-03-17 18:17:00,0,2863.0,2068.0,0.722,13.571,464,256,203,53,208,164,44,17,0.01,0.0
1001,630,2020-03-17 18:20:00,0,2784.0,2005.0,0.72,13.188,110,54,33,21,56,36,20,17,0.0,0.0
1001,631,2020-03-17 18:23:00,0,2803.0,2007.0,0.716,13.269,134,41,19,22,93,39,54,5,0.0,0.0
1001,632,2020-03-17 18:26:00,0,2722.0,1975.0,0.726,12.913,85,44,12,32,41,16,25,0,0.01,0.0
1001,633,2020-03-17 18:29:00,0,2794.0,1998.0,0.715,13.222,64,13,4,9,51,20,31,0,0.0,0.0
1001,634,2020-03-17 18:32:00,0,2716.0,1992.0,0.734,12.907,34,24,14,10,10,4,6,0,0.01,0.0
1001,635,2020-03-17 18:35:00,0,2657.0,1924.0,0.724,12.601,176,78,45,33,98,54,44,6,0.0,0.0
1001,636,2020-03-17 18:38:00,0,2656.0,1954.0,0.736,12.629,170,107,81,26,63,39,24,15,0.0,0.0
1001,637,2020-03-17 18:41:00,0,2531.0,1841.0,0.727,12.012,13,4,3,1,9,1,8,0,0.04,0.0
1001,638,2020-03-17 18:44:00,0,2317.0,1715.0,0.74,11.029,4,3,2,1,1,0,1,0,0.0,0.0
1001,639,2020-03-17 18:47:00,0,2347.0,1647.0,0.702,11.07,9,2,0,2,7,2,5,0,0.0,0.0
1001,640,2020-03-17 18:50:00,0,2209.0,1596.0,0.722,10.471,14,7,0,7,7,0,7,0,0.0,0.0
1001,641,2020-03-17 18:53:00,0,2202.0,1565.0,0.711,10.408,48,27,10,17,21,8,13,0,0.0,0.0
1001,642,2020-03-17 18:56:00,0,2342.0,1643.0,0.702,11.048,112,62,12,50,50,15,35,4,0.0,0.0
1001,643,2020-03-17 18:59:00,0,2533.0,1757.0,0.694,11.924,223,105,52,53,118,57,61,15,0.0,0.0
1001,644,2020-03-17 19:02:00,0,2515.0,1866.0,0.742,11.975,455,259,204,55,196,138,58,27,0.0,0.0
1001,645,2020-03-17 19:05:00,0,2657.0,1942.0,0.731,12.62,440,268,210,58,172,129,43,20,0.0,0.0
1001,646,2020-03-17 19:08:00,0,2650.0,1976.0,0.746,12.631,400,200,161,39,200,144,56,25,0.0,0.0
1001,647,2020-03-17 19:11:00,0,2789.0,1995.0,0.715,13.197,362,222,167,55,140,102,38,34,0.0,0.0
1001,648,2020-03-17 19:14:00,0,2794.0,1995.0,0.714,13.217,370,191,147,44,179,128,51,16,0.0,0.0
1001,649,2020-03-17 19:17:00,0,2794.0,1992.0,0.713,13.216,644,336,277,59,308,247,61,18,0.0,0.0
1001,650,2020-03-17 19:20:00,0,2656.0,1939.0,0.73,12.613,450,207,166,41,243,184,59,26,0.0,0.0
1001,651,2020-03-17 19:23:00,0,2667.0,1939.0,0.727,12.657,387,196,146,50,191,143,48,22,0.0,0.0
1001,652,2020-03-17 19:26:00,0,2668.0,1921.0,0.72,12.638,120,66,28,38,54,19,35,9,0.01,0.0
1001,653,2020-03-17 19:29:00,0,2666.0,1914.0,0.718,12.623,196,112,63,49,84,35,49,0,0.0,0.0
1001,654,2020-03-17 19:32:00,0,2659.0,1911.0,0.719,12.594,93,59,27,32,34,4,30,0,0.0,0.0
1001,655,2020-03-17 19:35:00,0,2720.0,1970.0,0.724,12.897,361,176,138,38,185,130,55,17,0.0,0.0
1001,656,2020-03-17 19:38:00,0,2645.0,1955.0,0.739,12.588,155,83,58,25,72,48,24,9,0.0,0.0
1001,657,2020-03-17 19:41:00,0,2525.0,1837.0,0.728,11.985,1,1,0,1,0,0,0,0,0.0,0.0
1001,658,2020-03-17 19:44:00,0,2474.0,1737.0,0.702,11.672,0,0,0,0,0,0,0,0,0.0,0.0
1001,659,2020-03-17 19:47:00,0,2336.0,1633.0,0.699,11.014,17,9,6,3,8,5,3,0,0.0,0.0
1001,660,2020-03-17 19:50:00,0,2206.5,1544.5,0.7,10.4055,13,8,2,6,5,2,3,0,0.0,0.0
1001,661,2020-03-17 19:53:00,0,2077.0,1456.0,0.701,9.797,37,19,5,14,18,1,17,0,0.0,0.0
1001,662,2020-03-17 19:56:00,0,2008.0,1395.0,0.695,9.458,13,2,0,2,11,0,11,0,0.0,0.0
1001,663,2020-03-17 19:59:00,0,1932.0,1382.0,0.715,9.141,0,0,0,0,0,0,0,0,0.03,0.0
1001,664,2020-03-17 20:02:00,0,1858.0,1343.0,0.723,8.807,215,114,74,40,101,56,45,14,0.02,0.0
1001,665,2020-03-17 20:05:00,0,2198.0,1565.0,0.712,10.393,175,113,63,50,62,29,33,22,0.0,0.0
1001,666,2020-03-17 20:08:00,0,2330.0,1666.0,0.715,11.025,424,194,151,43,230,169,61,20,0.0,0.0
1001,667,2020-03-17 20:11:00,0,2460.0,1755.0,0.713,11.636,332,201,162,39,131,86,45,21,0.0,0.0
1001,668,2020-03-17 20:14:00,0,2527.0,1840.0,0.728,11.996,363,176,132,44,187,142,45,27,0.0,0.0
1001,669,2020-03-17 20:17:00,0,2521.0,1820.0,0.722,11.947,447,228,163,65,219,159,60,16,0.0,0.0
1001,670,2020-03-17 20:20:00,0,2592.0,1859.0,0.717,12.272,365,172,133,39,193,145,48,29,0.0,0.0
1001,671,2020-03-17 20:23:00,0,2660.0,1891.0,0.711,12.576,332,204,153,51,128,90,38,37,0.0,0.0
1001,672,2020-03-17 20:26:00,0,2738.0,1989.0,0.726,12.991,252,163,109,54,89,63,26,28,0.0,0.0
1001,673,2020-03-17 20:29:00,0,2670.0,1919.0,0.719,12.644,126,80,38,42,46,20,26,8,0.0,0.0
1001,674,2020-03-17 20:32:00,0,2730.0,1950.0,0.714,12.917,156,64,26,38,92,39,53,4,0.0,0.0
1001,675,2020-03-17 20:35:00,0,2796.0,2000.0,0.715,13.232,347,181,137,44,166,112,54,16,0.01,0.0
1001,676,2020-03-17 20:38:00,0,2724.0,1984.0,0.729,12.93,302,185,133,52,117,80,37,30,0.0,0.0
1001,677,2020-03-17 20:41:00,0,2878.0,2019.0,0.702,13.575,594,375,301,74,219,164,55,96,0.02,0.0
1001,678,2020-03-17 20:44:00,0,2848.0,2090.0,0.734,13.536,660,416,345,71,244,188,56,98,0.01,0.0
1001,679,2020-03-17 20:47:00,0,3004.0,2176.0,0.724,14.246,657,352,282,70,305,229,76,72,0.0,0.0
1001,680,2020-03-17 20:50:00,0,3007.0,2124.0,0.706,14.201,421,253,198,55,168,125,43,78,0.01,0.0
1001,681,2020-03-17 20:53:00,0,2791.0,1988.0,0.712,13.198,440,225,191,34,215,163,52,60,0.0,0.0
1001,682,2020-03-17 20:56:00,0,2883.0,2027.0,0.703,13.605,578,374,294,80,204,151,53,92,0.0,0.0
1001,683,2020-03-17 20:59:00,0,3005.0,2172.0,0.723,14.247,492,372,286,86,120,78,42,31,0.0,0.0
1001,684,2020-03-17 21:02:00,0,2853.0,2074.0,0.727,13.538,475,291,228,63,184,131,53,35,0.0,0.0
1001,685,2020-03-17 21:05:00,0,2863.0,2041.0,0.713,13.541,275,160,108,52,115,71,44,20,0.0,0.0
1001,686,2020-03-17 21:08:00,0,2661.0,1934.0,0.727,12.627,228,144,80,64,84,54,30,23,0.0,0.0
1001,687,2020-03-17 21:11:00,0,2724.0,1977.0,0.726,12.923,252,122,84,38,130,84,46,8,0.0,0.0
1001,688,2020-03-17 21:14:00,0,2883.0,1993.0,0.691,13.568,157,113,60,53,44,17,27,22,0.03,0.0
1001,689,2020-03-17 21:17:00,0,2714.0,1955.0,0.721,12.857,363,225,167,58,138,86,52,28,0.0,0.0
1001,690,2020-03-17 21:20:00,0,2658.0,1928.0,0.725,12.606,370,181,134,47,189,150,39,25,0.0,0.0
1001,691,2020-03-17 21:23:00,0,2660.0,1930.0,0.725,12.617,402,223,162,61,179,123,56,13,0.0,0.0
1001,692,2020-03-17 21:26:00,0,2671.0,1889.0,0.707,12.615,289,150,109,41,139,97,42,12,0.0,0.0
1001,693,2020-03-17 21:29:00,0,2668.0,1873.0,0.702,12.587,141,48,23,25,93,36,57,39,0.0,0.0
1001,694,2020-03-17 21:32:00,0,2674.0,1903.0,0.712,12.644,220,117,89,28,103,62,41,22,0.0,0.0
1001,695,2020-03-17 21:35:00,0,2673.0,1902.0,0.712,12.64,79,61,26,35,18,12,6,0,0.0,0.0
1001,696,2020-03-17 21:38:00,0,2544.0,1782.0,0.701,11.996,34,34,11,23,0,0,0,0,0.03,0.0
1001,697,2020-03-17 21:41:00,0,2341.0,1638.0,0.7,11.036,0,0,0,0,0,0,0,0,0.0,0.0
1001,698,2020-03-17 21:44:00,0,2215.0,1522.0,0.687,10.412,7,0,0,0,7,1,6,0,0.0,0.0
1001,699,2020-03-17 21:47:00,0,2060.0,1440.0,0.699,9.712,16,2,1,1,14,0,14,0,0.0,0.0
1001,700,2020-03-17 21:50:00,0,1925.0,1385.0,0.719,9.119,7,0,0,0,7,0,7,0,0.0,0.0
1001,701,2020-03-17 21:53:00,0,1858.0,1368.0,0.736,8.837,12,5,0,5,7,0,7,0,0.0,0.0
1001,702,2020-03-17 21:56:00,0,1868.0,1332.0,0.713,8.834,288,141,103,38,147,90,57,8,0.0,0.0
1001,703,2020-03-17 21:59:00,0,2218.0,1539.0,0.694,10.442,288,178,124,54,110,63,47,16,0.0,0.0
1001,704,2020-03-17 22:02:00,0,2322.0,1697.0,0.731,11.03,581,341,270,71,240,176,64,39,0.0,0.0
1001,705,2020-03-17 22:05:00,0,2533.0,1842.0,0.727,12.019,371,236,183,53,135,93,42,54,0.0,0.0
1001,706,2020-03-17 22:08:00,0,2520.0,1818.0,0.722,11.941,123,60,32,28,63,19,44,10,0.0,0.0
1001,707,2020-03-17 22:11:00,0,2590.0,1839.0,0.71,12.239,360,215,156,59,145,89,56,38,0.0,0.0
1001,708,2020-03-17 22:14:00,0,2594.0,1879.0,0.725,12.301,460,294,241,53,166,116,50,46,0.01,0.0
1001,709,2020-03-17 22:17:00,0,2657.0,1943.0,0.731,12.619,621,338,282,56,283,219,64,49,0.0,0.0
1001,710,2020-03-17 22:20:00,0,2651.0,1945.0,0.734,12.598,400,242,192,50,158,107,51,53,0.0,0.0
1001,711,2020-03-17 22:23:00,0,2883.0,2013.0,0.698,13.587,361,150,122,28,211,144,67,30,0.0,0.0
1001,712,2020-03-17 22:26:00,0,2650.0,1949.0,0.735,12.6,567,316,251,65,251,184,67,41,0.02,0.0
1001,713,2020-03-17 22:29:00,0,2793.0,1981.0,0.709,13.2,247,139,87,52,108,67,41,25,0.0,0.0
1001,714,2020-03-17 22:32:00,0,2659.0,1943.0,0.731,12.63,359,217,167,50,142,112,30,55,0.0,0.0
1001,715,2020-03-17 22:35:00,0,2666.0,1949.0,0.731,12.663,402,212,165,47,190,132,58,33,0.0,0.0
1001,716,2020-03-17 22:38:00,0,2681.0,1924.0,0.718,12.693,437,250,197,53,187,143,44,32,0.0,0.0
1001,717,2020-03-17 22:41:00,0,2669.0,1918.0,0.719,12.639,250,164,115,49,86,51,35,21,0.03,0.0
1001,718,2020-03-17 22:44:00,0,2595.0,1859.0,0.716,12.281,285,166,109,57,119,70,49,12,0.0,0.0
1001,719,2020-03-17 22:47:00,0,2539.0,1832.0,0.722,12.033,140,68,32,36,72,27,45,14,0.0,0.0
1001,720,2020-03-17 22:50:00,0,2538.5,1806.5,0.712,12.003,123,64,41,23,59,17,42,11,0.0,0.0
1001,721,2020-03-17 22:53:00,0,2538.0,1781.0,0.702,11.973,6,1,0,1,5,1,4,0,0.0,0.0
1001,722,2020-03-17 22:56:00,0,2323.0,1654.0,0.712,10.984,21,14,0,14,7,0,7,0,0.0,0.0
1001,723,2020-03-17 22:59:00,0,2205.0,1571.0,0.713,10.426,46,22,14,8,24,10,14,0,0.0,0.0
1001,724,2020-03-17 23:02:00,0,2140.0,1463.0,0.683,10.053,10,8,2,6,2,1,1,0,0.0,0.0
1001,725,2020-03-17 23:05:00,0,2085.0,1437.0,0.689,9.805,21,9,3,6,12,4,8,0,0.02,0.0
1001,726,2020-03-17 23:08:00,0,1937.0,1383.0,0.714,9.162,0,0,0,0,0,0,0,0,0.03,0.0
1001,727,2020-03-17 23:11:00,0,1866.0,1317.0,0.706,8.81,4,1,1,0,3,0,3,0,0.0,0.0
1001,728,2020-03-17 23:14:00,0,1802.0,1265.0,0.702,8.5,19,7,7,0,12,0,12,0,0.0,0.0
1001,729,2020-03-17 23:17:00,0,1723.0,1259.0,0.731,8.183,14,6,4,2,8,0,8,0,0.0,0.0
1001,730,2020-03-17 23:20:00,0,1804.0,1262.0,0.699,8.507,21,6,1,5,15,0,15,0,0.0,0.0
1001,731,2020-03-17 23:23:00,0,1727.0,1252.0,0.725,8.193,28,3,0,3,25,0,25,0,0.0,0.0
1001,732,2020-03-17 23:26:00,0,1730.0,1232.0,0.712,8.182,27,15,4,11,12,2,10,4,0.0,0.0
1001,733,2020-03-17 23:29:00,0,1878.0,1290.0,0.687,8.826,165,101,65,36,64,24,40,7,0.01,0.0
1001,734,2020-03-17 23:32:00,0,2076.0,1456.0,0.701,9.793,141,71,25,46,70,27,43,8,0.0,0.0
1001,735,2020-03-17 23:35:00,0,2191.0,1597.0,0.729,10.4,451,260,201,59,191,121,70,29,0.0,0.0
1001,736,2020-03-17 23:38:00,0,2313.0,1725.0,0.746,11.022,356,194,160,34,162,120,42,33,0.0,0.0
1001,737,2020-03-17 23:41:00,0,2661.0,1926.0,0.724,12.617,590,362,298,64,228,170,58,64,0.0,0.0
1001,738,2020-03-17 23:44:00,0,2657.0,1909.0,0.718,12.583,757,451,371,80,306,235,71,112,0.0,0.0
1001,739,2020-03-17 23:47:00,0,2861.0,2050.0,0.717,13.542,589,357,283,74,232,173,59,86,0.0,0.0
1001,740,2020-03-17 23:50:00,0,2860.0,2057.0,0.719,13.547,567,324,249,75,243,177,66,62,0.02,0.0
1001,741,2020-03-17 23:53:00,0,2859.0,2068.0,0.723,13.553,441,249,200,49,192,147,45,76,0.0,0.0
1001,742,2020-03-17 23:56:00,0,2848.0,2061.0,0.724,13.503,546,265,210,55,281,202,79,54,0.0,0.0
1001,743,2020-03-17 23:59:00,0,2873.0,2054.0,0.715,13.596,597,340,285,55,257,182,75,81,0.01,0.0
1001,744,2020-03-18 00:02:00,0,2863.0,2082.0,0.727,13.587,316,140,102,38,176,112,64,19,0.0,0.0
1001,745,2020-03-18 00:05:00,0,2804.0,1982.0,0.707,13.241,304,195,135,60,109,76,33,40,0.0,0.0
1001,746,2020-03-18 00:08:00,0,2797.0,1985.0,0.71,13.218,369,203,166,37,166,111,55,35,0.01,0.0
1001,747,2020-03-18 00:11:00,0,2790.0,1993.0,0.714,13.2,437,223,169,54,214,157,57,36,0.01,0.0
1001,748,2020-03-18 00:14:00,0,2725.0,1962.0,0.72,12.911,354,187,151,36,167,112,55,38,0.0,0.0
1001,749,2020-03-18 00:17:00,0,2665.0,1913.0,0.718,12.618,462,312,245,67,150,103,47,19,0.2,0.0
1001,750,2020-03-18 00:20:00,0,2663.0,1924.0,0.722,12.624,327,201,144,57,126,82,44,62,0.0,0.0
1001,751,2020-03-18 00:23:00,0,2669.0,1971.0,0.738,12.696,546,304,240,64,242,179,63,58,0.08,0.0
1001,752,2020-03-18 00:26:00,0,2659.0,1946.0,0.732,12.629,308,163,122,41,145,80,65,22,0.0,0.0
1001,753,2020-03-18 00:29:00,0,2848.0,2037.0,0.715,13.478,342,189,129,60,153,112,41,25,0.0,0.0
1001,754,2020-03-18 00:32:00,0,2978.0,2189.0,0.735,14.155,581,309,262,47,272,214,58,38,0.02,0.0
1001,755,2020-03-18 00:35:00,0,2988.0,2161.0,0.723,14.165,516,299,233,66,217,162,55,108,0.0,0.0
1001,756,2020-03-18 00:38:00,0,3013.0,2129.0,0.706,14.229,379,186,141,45,193,140,53,62,0.07,0.0
1001,757,2020-03-18 00:41:00,0,2844.0,2039.0,0.717,13.463,489,281,208,73,208,164,44,87,0.0,0.0
1001,758,2020-03-18 00:44:00,0,2799.0,1981.0,0.708,13.221,654,317,260,57,337,259,78,45,0.03,0.0
1001,759,2020-03-18 00:47:00,0,2716.0,1949.0,0.718,12.857,576,234,193,41,342,275,67,41,0.0,0.0
1001,760,2020-03-18 00:50:00,0,2883.0,1966.0,0.682,13.537,203,77,43,34,126,80,46,9,0.0,0.0
1001,761,2020-03-18 00:53:00,0,2670.0,1935.0,0.725,12.663,263,149,116,33,114,68,46,19,0.0,0.0
1001,762,2020-03-18 00:56:00,0,2878.0,1997.0,0.694,13.55,424,195,151,44,229,165,64,46,0.0,0.0
1001,763,2020-03-18 00:59:00,0,2876.0,1997.0,0.695,13.543,413,176,133,43,237,181,56,19,0.0,0.0
1001,764,2020-03-18 01:02:00,0,2872.0,1981.0,0.69,13.512,517,283,233,50,234,171,63,42,0.0,0.0
1001,765,2020-03-18 01:05:00,0,2850.0,2061.0,0.723,13.511,454,278,222,56,176,132,44,71,0.11,0.0
1001,766,2020-03-18 01:08:00,0,2878.0,2024.0,0.703,13.581,284,156,106,50,128,70,58,45,0.0,0.0
1001,767,2020-03-18 01:11:00,0,2872.0,2003.0,0.697,13.534,221,151,85,66,70,24,46,17,0.0,0.0
1001,768,2020-03-18 01:14:00,0,2883.0,1986.0,0.689,13.557,262,139,99,40,123,81,42,30,0.0,0.0
1001,769,2020-03-18 01:17:00,0,2725.0,1960.0,0.719,12.908,163,80,55,25,83,46,37,14,0.0,0.0
1001,770,2020-03-18 01:20:00,0,2525.0,1855.0,0.735,12.003,427,218,176,42,209,158,51,62,0.0,0.0
1001,771,2020-03-18 01:23:00,0,2532.0,1818.0,0.718,11.991,333,148,122,26,185,140,45,19,0.01,0.0
1001,772,2020-03-18 01:26:00,0,2522.0,1845.0,0.731,11.98,422,215,168,47,207,154,53,30,0.0,0.0
1001,773,2020-03-18 01:29:00,0,2662.0,1949.0,0.732,12.648,200,100,60,40,100,72,28,33,0.0,0.0
1001,774,2020-03-18 01:32:00,0,2665.0,1909.0,0.716,12.615,181,83,50,33,98,50,48,34,0.0,0.0
1001,775,2020-03-18 01:35:00,0,2530.0,1836.0,0.726,12.003,572,316,259,57,256,185,71,39,0.01,0.0
1001,776,2020-03-18 01:38:00,0,2532.0,1795.0,0.709,11.963,290,168,125,43,122,76,46,37,0.0,0.0
1001,777,2020-03-18 01:41:00,0,2521.0,1837.0,0.728,11.967,147,104,48,56,43,11,32,13,0.0,0.0
1001,778,2020-03-18 01:44:00,0,2531.0,1833.0,0.724,12.001,100,39,10,29,61,26,35,0,0.0,0.0
1001,779,2020-03-18 01:47:00,0,2544.0,1798.0,0.707,12.015,493,268,190,78,225,165,60,21,0.0,0.0
1001,780,2020-03-18 01:50:00,0,2540.5,1791.5,0.7055,11.9945,684,336,271,65,348,263,85,34,0.0,0.0
1001,781,2020-03-18 01:53:00,0,2537.0,1785.0,0.704,11.974,395,232,174,58,163,114,49,84,0.0,0.0
1001,782,2020-03-18 01:56:00,0,2468.0,1744.0,0.707,11.656,140,106,73,33,34,22,12,22,0.0,0.0
1001,783,2020-03-18 01:59:00,0,2331.0,1684.0,0.722,11.047,12,12,5,7,0,0,0,0,0.0,0.0
1001,784,2020-03-18 02:02:00,0,2200.0,1570.0,0.714,10.407,2,2,1,1,0,0,0,0,0.0,0.0
1001,785,2020-03-18 02:05:00,0,2060.0,1451.0,0.704,9.723,2,2,1,1,0,0,0,0,0.0,0.0
1001,786,2020-03-18 02:08:00,0,2017.0,1371.0,0.679,9.466,0,0,0,0,0,0,0,0,0.0,0.0
1001,787,2020-03-18 02:11:00,0,1877.0,1285.0,0.685,8.82,2,2,0,2,0,0,0,0,0.0,0.0
1001,788,2020-03-18 02:14:00,0,1806.0,1246.0,0.69,8.493,1,1,0,1,0,0,0,0,0.0,0.0
1001,789,2020-03-18 02:17:00,0,1744.0,1188.0,0.681,8.188,0,0,0,0,0,0,0,0,0.0,0.0
1001,790,2020-03-18 02:20:00,0,1679.0,1148.0,0.684,7.886,27,19,8,11,8,4,4,0,0.0,0.0
1001,791,2020-03-18 02:23:00,0,1596.0,1127.0,0.706,7.538,4,4,1,3,0,0,0,0,0.0,0.0
1001,792,2020-03-18 02:26:00,0,1612.0,1110.0,0.689,7.581,4,4,1,3,0,0,0,0,0.0,0.0
1001,793,2020-03-18 02:29:00,0,1602.0,1128.0,0.704,7.562,1,1,0,1,0,0,0,0,0.0,0.0
1001,794,2020-03-18 02:32:00,0,1608.0,1112.0,0.691,7.566,11,7,3,4,4,0,4,0,0.0,0.0
1001,795,2020-03-18 02:35:00,0,1595.0,1134.0,0.711,7.539,0,0,0,0,0,0,0,0,0.0,0.0
1001,796,2020-03-18 02:38:00,0,1606.0,1116.0,0.695,7.564,1,0,0,0,1,0,1,0,0.0,0.0
1001,797,2020-03-18 02:41:00,0,1610.0,1083.0,0.672,7.544,2,0,0,0,2,0,2,0,0.0,0.0
1001,798,2020-03-18 02:44:00,0,1619.0,1085.0,0.67,7.582,0,0,0,0,0,0,0,0,0.0,0.0
1001,799,2020-03-18 02:47:00,0,1621.0,1066.0,0.658,7.569,168,129,82,47,39,24,15,4,0.0,0.0
1001,800,2020-03-18 02:50:00,0,1722.0,1275.0,0.741,8.195,271,158,103,55,113,80,33,40,0.0,0.0
1001,801,2020-03-18 02:53:00,0,2058.0,1489.0,0.723,9.759,167,86,38,48,81,28,53,27,0.0,0.0
1001,802,2020-03-18 02:56:00,0,2335.0,1669.0,0.715,11.05,381,228,177,51,153,105,48,70,0.0,0.0
1001,803,2020-03-18 02:59:00,0,2522.0,1867.0,0.74,12.003,400,253,177,76,147,101,46,81,0.0,0.0
1001,804,2020-03-18 03:02:00,0,2664.0,1932.0,0.725,12.634,338,215,163,52,123,79,44,74,0.0,0.0
1001,805,2020-03-18 03:05:00,0,2792.0,2005.0,0.718,13.219,333,201,143,58,132,87,45,99,0.0,0.0
1001,806,2020-03-18 03:08:00,0,2868.0,2046.0,0.714,13.566,307,207,125,82,100,63,37,94,0.0,0.0
1001,807,2020-03-18 03:11:00,0,2995.0,2107.0,0.704,14.132,377,255,185,70,122,81,41,123,0.0,0.01
1001,808,2020-03-18 03:14:00,0,3121.0,2255.0,0.722,14.795,341,233,150,83,108,67,41,114,0.0,0.0
1001,809,2020-03-18 03:17:00,0,3120.0,2302.0,0.738,14.841,322,195,125,70,127,69,58,123,0.0,0.01
1001,810,2020-03-18 03:20:00,0,3445.0,2511.0,0.729,16.355,501,279,212,67,222,149,73,100,0.0,0.01
1001,811,2020-03-18 03:23:00,0,3302.0,2407.0,0.729,15.674,334,194,123,71,140,97,43,61,0.06,0.04
1001,812,2020-03-18 03:26:00,0,3116.0,2267.0,0.728,14.787,416,232,169,63,184,121,63,94,0.05,0.0
1001,813,2020-03-18 03:29:00,0,3319.0,2452.0,0.739,15.792,335,178,113,65,157,99,58,111,0.06,0.02
1001,814,2020-03-18 03:32:00,0,3447.0,2593.0,0.752,16.451,235,123,70,53,112,54,58,60,0.06,0.04
1001,815,2020-03-18 03:35:00,0,3416.0,2630.0,0.77,16.373,303,185,121,64,118,76,42,76,0.0,0.12
1001,816,2020-03-18 03:38:00,0,3485.0,2670.0,0.766,16.687,279,148,104,44,131,80,51,74,0.05,0.06
1001,817,2020-03-18 03:41:00,0,3214.0,2530.0,0.787,15.464,270,168,107,61,102,59,43,89,0.04,0.03
1001,818,2020-03-18 03:44:00,0,3806.0,3063.0,0.805,18.387,564,317,258,59,247,191,56,71,0.07,0.02
1001,819,2020-03-18 03:47:00,0,3146.0,2512.0,0.798,15.179,202,134,85,49,68,38,30,30,0.22,0.0
1001,820,2020-03-18 03:50:00,0,2296.0,1797.0,0.783,11.036,234,161,96,65,73,42,31,51,0.0,0.0
1001,821,2020-03-18 03:53:00,0,3583.0,2907.0,0.811,17.338,263,166,94,72,97,51,46,91,0.0,0.06
1001,822,2020-03-18 03:56:00,0,3404.0,2728.0,0.801,16.434,462,245,196,49,217,167,50,64,0.3,0.0
1001,823,2020-03-18 03:59:00,0,3594.0,2887.0,0.803,17.359,236,162,113,49,74,44,30,99,0.0,0.04
1001,824,2020-03-18 04:02:00,0,3618.0,2893.0,0.8,17.459,279,150,97,53,129,80,49,73,0.0,0.03
1001,825,2020-03-18 04:05:00,0,3249.0,2716.0,0.836,15.808,275,182,128,54,93,57,36,96,0.0,0.01
1001,826,2020-03-18 04:08:00,0,3575.0,2950.0,0.825,17.352,338,201,140,61,137,90,47,80,0.0,0.07
1001,827,2020-03-18 04:11:00,0,2982.0,2495.0,0.837,14.513,644,343,270,73,301,222,79,51,0.01,0.01
1001,828,2020-03-18 04:14:00,0,2928.0,2460.0,0.84,14.261,790,409,318,91,381,288,93,37,0.0,0.0
1001,829,2020-03-18 04:17:00,0,2748.0,2230.0,0.811,13.296,626,295,226,69,331,252,79,63,0.09,0.0
1001,830,2020-03-18 04:20:00,0,3236.0,2737.0,0.846,15.781,379,207,146,61,172,126,46,55,0.0,0.0
1001,831,2020-03-18 04:23:00,0,3232.0,2698.0,0.835,15.72,236,143,94,49,93,57,36,53,0.0,0.0
1001,832,2020-03-18 04:26:00,0,3403.0,2806.0,0.825,16.513,191,145,86,59,46,18,28,117,0.0,0.0
1001,833,2020-03-18 04:29:00,0,3031.0,2622.0,0.865,14.846,312,183,130,53,129,88,41,46,0.0,0.02
1001,834,2020-03-18 04:32:00,0,3029.0,2625.0,0.867,14.842,491,251,193,58,240,168,72,43,0.04,0.0
1001,835,2020-03-18 04:35:00,0,2536.0,2117.0,0.835,12.335,503,215,153,62,288,197,91,23,0.0,0.0
1001,836,2020-03-18 04:38:00,0,2862.0,2379.0,0.831,13.908,358,188,131,57,170,125,45,26,0.01,0.0
1001,837,2020-03-18 04:41:00,0,3371.0,2827.0,0.839,16.412,220,127,65,62,93,44,49,100,0.0,0.0
1001,838,2020-03-18 04:44:00,0,3037.0,2584.0,0.851,14.825,163,94,49,45,69,34,35,14,0.08,0.02
1001,839,2020-03-18 04:47:00,0,2987.0,2502.0,0.838,14.537,597,350,279,71,247,185,62,67,0.02,0.0
1001,840,2020-03-18 04:50:00,0,2950.0,2464.0,0.8355,14.3495,356,193,141,52,163,106,57,31,0.07,0.0
1001,841,2020-03-18 04:53:00,0,2913.0,2426.0,0.833,14.162,560,287,218,69,273,208,65,52,0.0,0.0
1001,842,2020-03-18 04:56:00,0,2468.0,2013.0,0.816,11.951,761,382,298,84,379,295,84,30,0.0,0.0
1001,843,2020-03-18 04:59:00,0,2994.0,2486.0,0.83,14.549,789,385,315,70,404,316,88,57,0.0,0.0
1001,844,2020-03-18 05:02:00,0,2986.0,2491.0,0.834,14.524,785,395,298,97,390,282,108,39,0.0,0.0
1001,845,2020-03-18 05:05:00,0,3398.0,2797.0,0.823,16.485,571,256,188,68,315,237,78,31,0.0,0.0
1001,846,2020-03-18 05:08:00,0,3194.0,2633.0,0.824,15.499,272,148,111,37,124,76,48,68,0.0,0.0
1001,847,2020-03-18 05:11:00,0,2805.0,2231.0,0.795,13.52,119,68,28,40,51,13,38,26,0.0,0.0
1001,848,2020-03-18 05:14:00,0,3116.0,2627.0,0.843,15.184,235,144,85,59,91,50,41,24,0.0,0.0
1001,849,2020-03-18 05:17:00,0,3051.0,2576.0,0.844,14.874,243,112,62,50,131,72,59,96,0.01,0.0
1001,850,2020-03-18 05:20:00,0,2916.0,2431.0,0.834,14.181,342,158,102,56,184,123,61,83,0.0,0.02
1001,851,2020-03-18 05:23:00,0,3116.0,2594.0,0.832,15.148,205,81,47,34,124,67,57,80,0.0,0.04
1001,852,2020-03-18 05:26:00,0,3389.0,2761.0,0.815,16.41,218,73,42,31,145,90,55,48,0.15,0.07
1001,853,2020-03-18 05:29:00,0,2872.0,2359.0,0.821,13.926,217,125,82,43,92,55,37,60,0.0,0.0
1001,854,2020-03-18 05:32:00,0,3116.0,2639.0,0.847,15.198,506,255,203,52,251,188,63,54,0.09,0.0
1001,855,2020-03-18 05:35:00,0,2943.0,2393.0,0.813,14.243,526,236,164,72,290,214,76,61,0.0,0.0
1001,856,2020-03-18 05:38:00,0,3186.0,2609.0,0.819,15.442,568,271,204,67,297,219,78,46,0.0,0.02
1001,857,2020-03-18 05:41:00,0,2868.0,2323.0,0.81,13.874,618,321,261,60,297,226,71,58,0.0,0.0
1001,858,2020-03-18 05:44:00,0,2912.0,2443.0,0.839,14.178,517,258,187,71,259,188,71,25,0.0,0.0
1001,859,2020-03-18 05:47:00,0,2934.0,2397.0,0.817,14.216,299,143,108,35,156,117,39,13,0.0,0.0
1001,860,2020-03-18 05:50:00,0,3053.0,2550.0,0.835,14.852,442,232,172,60,210,140,70,37,0.0,0.0
1001,861,2020-03-18 05:53:00,0,2871.0,2303.0,0.802,13.863,407,255,190,65,152,92,60,29,0.0,0.0
1001,862,2020-03-18 05:56:00,0,2940.0,2382.0,0.81,14.221,712,376,301,75,336,248,88,31,0.0,0.0
1001,863,2020-03-18 05:59:00,0,2983.0,2456.0,0.823,14.474,740,414,337,77,326,256,70,76,0.0,0.0
1001,864,2020-03-18 06:02:00,1,2985.0,2485.0,0.833,14.511,582,307,238,69,275,207,68,46,0.0,0.0
1001,865,2020-03-18 06:05:00,1,2849.0,2329.0,0.818,13.804,642,326,252,74,316,234,82,50,0.0,0.0
1001,866,2020-03-18 06:08:00,1,3066.0,2541.0,0.829,14.894,536,269,188,81,267,197,70,13,0.0,0.0
1001,867,2020-03-18 06:11:00,1,3129.0,2586.0,0.826,15.192,572,313,234,79,259,180,79,15,0.0,0.0
1001,868,2020-03-18 06:14:00,1,3053.0,2531.0,0.829,14.831,579,312,233,79,267,192,75,37,0.0,0.0
1001,869,2020-03-18 06:17:00,1,2928.0,2395.0,0.818,14.189,285,175,122,53,110,58,52,8,0.0,0.0
1001,870,2020-03-18 06:20:00,1,2812.0,2237.0,0.796,13.555,371,198,154,44,173,118,55,3,0.02,0.0
1001,871,2020-03-18 06:23:00,1,2817.0,2223.0,0.789,13.562,551,257,179,78,294,212,82,0,0.0,0.0
1001,872,2020-03-18 06:26:00,1,2957.0,2297.0,0.777,14.193,530,232,157,75,298,205,93,2,0.0,0.0
1001,873,2020-03-18 06:29:00,1,2872.0,2265.0,0.789,13.822,696,408,337,71,288,212,76,4,0.0,0.0
1001,874,2020-03-18 06:32:00,1,2821.0,2220.0,0.787,13.574,325,217,151,66,108,67,41,1,0.0,0.0
1001,875,2020-03-18 06:35:00,1,2820.0,2164.0,0.767,13.509,76,51,16,35,25,5,20,8,0.0,0.0
1001,876,2020-03-18 06:38:00,1,2842.0,2169.0,0.763,13.598,101,80,44,36,21,1,20,6,0.0,0.0
1001,877,2020-03-18 06:41:00,1,2819.0,2225.0,0.789,13.572,111,71,24,47,40,9,31,0,0.0,0.0
1001,878,2020-03-18 06:44:00,1,2758.0,2190.0,0.794,13.291,187,166,89,77,21,3,18,2,0.0,0.0
1001,879,2020-03-18 06:47:00,1,2755.0,2193.0,0.796,13.284,347,238,170,68,109,70,39,7,0.0,0.0
1001,880,2020-03-18 06:50:00,1,2758.0,2184.0,0.792,13.285,651,379,315,64,272,200,72,55,0.0,0.0
1001,881,2020-03-18 06:53:00,1,2678.0,2165.0,0.808,12.949,366,242,189,53,124,99,25,33,0.0,0.0
1001,882,2020-03-18 06:56:00,1,2632.0,2060.0,0.783,12.65,36,36,0,36,0,0,0,0,0.0,0.0
1001,883,2020-03-18 06:59:00,1,2517.0,1898.0,0.754,12.02,41,41,7,34,0,0,0,0,0.0,0.0
1001,884,2020-03-18 07:02:00,1,2288.0,1785.0,0.78,10.991,37,37,4,33,0,0,0,0,0.0,0.0
1001,885,2020-03-18 07:05:00,1,2167.0,1670.0,0.77,10.387,1,1,0,1,0,0,0,0,0.0,0.0
1001,886,2020-03-18 07:08:00,1,2039.0,1595.0,0.782,9.799,0,0,0,0,0,0,0,0,0.0,0.0
1001,887,2020-03-18 07:11:00,1,2051.0,1567.0,0.764,9.817,17,17,4,13,0,0,0,0,0.0,0.0
1001,888,2020-03-18 07:14:00,1,2048.0,1555.0,0.759,9.791,12,12,3,9,0,0,0,0,0.01,0.0
1001,889,2020-03-18 07:17:00,1,2042.0,1567.0,0.767,9.782,2,2,0,2,0,0,0,0,0.0,0.0
1001,890,2020-03-18 07:20:00,1,2049.0,1553.0,0.758,9.792,7,7,3,4,0,0,0,0,0.0,0.0
1001,891,2020-03-18 07:23:00,1,2048.0,1557.0,0.761,9.793,0,0,0,0,0,0,0,0,0.0,0.0
1001,892,2020-03-18 07:26:00,1,2036.0,1585.0,0.778,9.778,31,22,9,13,9,3,6,0,0.0,0.0
1001,893,2020-03-18 07:29:00,1,1973.0,1512.0,0.766,9.448,4,4,0,4,0,0,0,0,0.0,0.0
1001,894,2020-03-18 07:32:00,1,1832.0,1493.0,0.815,8.872,2,2,0,2,0,0,0,0,0.01,0.0
1001,895,2020-03-18 07:35:00,1,1825.0,1483.0,0.812,8.833,60,56,25,31,4,1,3,0,0.0,0.0
1001,896,2020-03-18 07:38:00,1,1897.0,1529.0,0.806,9.168,39,36,10,26,3,1,2,0,0.0,0.0
1001,897,2020-03-18 07:41:00,1,1904.0,1512.0,0.794,9.177,3,3,0,3,0,0,0,0,0.0,0.0
1001,898,2020-03-18 07:44:00,1,1844.0,1465.0,0.794,8.888,13,13,4,9,0,0,0,0,0.0,0.0
1001,899,2020-03-18 07:47:00,1,1835.0,1428.0,0.778,8.812,28,26,0,26,2,0,2,0,0.0,0.0
1001,900,2020-03-18 07:50:00,1,1838.0,1431.5,0.7785,8.828,0,0,0,0,0,0,0,0,0.0,0.0
1001,901,2020-03-18 07:53:00,1,1841.0,1435.0,0.779,8.844,35,35,6,29,0,0,0,0,0.0,0.0
1001,902,2020-03-18 07:56:00,1,1833.0,1473.0,0.804,8.851,66,66,37,29,0,0,0,9,0.0,0.0
1001,903,2020-03-18 07:59:00,1,2102.0,1660.0,0.79,10.122,371,200,148,52,171,121,50,48,0.0,0.0
1001,904,2020-03-18 08:02:00,1,2474.0,2029.0,0.82,11.996,243,141,100,41,102,68,34,50,0.02,0.0
1001,905,2020-03-18 08:05:00,1,2598.0,2102.0,0.809,12.565,159,105,66,39,54,21,33,33,0.0,0.0
1001,906,2020-03-18 08:08:00,1,2587.0,2194.0,0.848,12.623,221,116,61,55,105,53,52,70,0.18,0.0
1001,907,2020-03-18 08:11:00,1,2917.0,2473.0,0.848,14.229,186,86,48,38,100,53,47,50,0.0,0.05
1001,908,2020-03-18 08:14:00,1,2863.0,2390.0,0.835,13.926,326,164,119,45,162,123,39,44,0.08,0.01
1001,909,2020-03-18 08:17:00,1,2804.0,2271.0,0.81,13.562,599,340,280,60,259,207,52,22,0.0,0.0
1001,910,2020-03-18 08:20:00,1,2467.0,2052.0,0.832,11.993,1,1,0,1,0,0,0,2,0.0,0.01
1001,911,2020-03-18 08:23:00,1,2622.0,2082.0,0.794,12.636,222,143,104,39,79,49,30,13,0.0,0.0
1001,912,2020-03-18 08:26:00,1,3039.0,2562.0,0.843,14.812,475,329,244,85,146,100,46,82,0.0,0.0
1001,913,2020-03-18 08:29:00,1,2920.0,2418.0,0.828,14.181,235,111,65,46,124,68,56,57,0.0,0.0
1001,914,2020-03-18 08:32:00,1,2939.0,2372.0,0.807,14.208,175,99,72,27,76,49,27,16,0.0,0.07
1001,915,2020-03-18 08:35:00,1,3050.0,2548.0,0.835,14.839,137,37,15,22,100,57,43,55,0.01,0.1
1001,916,2020-03-18 08:38:00,1,2915.0,2381.0,0.817,14.122,334,188,136,52,146,110,36,14,0.04,0.0
1001,917,2020-03-18 08:41:00,1,2277.0,1856.0,0.815,11.026,77,74,27,47,3,0,3,0,0.0,0.0
1001,918,2020-03-18 08:44:00,1,2625.0,2135.0,0.813,12.706,96,85,46,39,11,4,7,0,0.0,0.0
1001,919,2020-03-18 08:47:00,1,2596.0,2176.0,0.838,12.639,159,123,64,59,36,13,23,12,0.0,0.0
1001,920,2020-03-18 08:50:00,1,3037.0,2579.0,0.849,14.822,290,183,132,51,107,63,44,41,0.09,0.0
1001,921,2020-03-18 08:53:00,1,3094.0,2704.0,0.874,15.184,230,159,110,49,71,39,32,28,0.0,0.02
1001,922,2020-03-18 08:56:00,1,2280.0,1835.0,0.805,11.014,102,71,38,33,31,2,29,0,0.0,0.0
1001,923,2020-03-18 08:59:00,1,2531.0,2077.0,0.821,12.274,36,20,6,14,16,5,11,0,0.0,0.0
1001,924,2020-03-18 09:02:00,1,2419.0,1942.0,0.803,11.683,9,5,2,3,4,1,3,0,0.0,0.0
1001,925,2020-03-18 09:05:00,1,2726.0,2276.0,0.835,13.26,2,0,0,0,2,0,2,0,0.0,0.0
1001,926,2020-03-18 09:08:00,1,2791.0,2327.0,0.834,13.572,7,0,0,0,7,0,7,0,0.0,0.0
1001,927,2020-03-18 09:11:00,1,2770.0,2401.0,0.867,13.572,0,0,0,0,0,0,0,0,0.0,0.0
1001,928,2020-03-18 09:14:00,1,2908.0,2479.0,0.852,14.201,25,6,3,3,19,2,17,0,0.0,0.0
1001,929,2020-03-18 09:17:00,1,2786.0,2355.0,0.845,13.585,3,0,0,0,3,0,3,0,0.0,0.0
1001,930,2020-03-18 09:20:00,1,2597.0,2199.0,0.846,12.667,3,2,1,1,1,0,1,0,0.0,0.0
1001,931,2020-03-18 09:23:00,1,2467.0,2089.0,0.847,12.032,9,9,2,7,0,0,0,0,0.0,0.0
1001,932,2020-03-18 09:26:00,1,2478.0,2018.0,0.815,11.997,20,20,0,20,0,0,0,0,0.0,0.0
1001,933,2020-03-18 09:29:00,1,2403.0,1979.0,0.824,11.658,23,23,1,22,0,0,0,0,0.0,0.0
1001,934,2020-03-18 09:32:00,1,2257.0,1939.0,0.859,11.042,34,33,19,14,1,0,1,0,0.0,0.0
1001,935,2020-03-18 09:35:00,1,2253.0,1913.0,0.849,10.996,47,38,14,24,9,4,5,0,0.0,0.01
1001,936,2020-03-18 09:38:00,1,2267.0,1922.0,0.847,11.061,14,12,7,5,2,0,2,0,0.0,0.0
1001,937,2020-03-18 09:41:00,1,2263.0,1900.0,0.84,11.019,10,10,0,10,0,0,0,0,0.0,0.0
1001,938,2020-03-18 09:44:00,1,2267.0,1877.0,0.828,11.01,2,2,0,2,0,0,0,0,0.0,0.0
1001,939,2020-03-18 09:47:00,1,2285.0,1881.0,0.823,11.085,0,0,0,0,0,0,0,0,0.0,0.0
1001,940,2020-03-18 09:50:00,1,2291.0,1829.0,0.798,11.052,93,68,37,31,25,3,22,17,0.0,0.0
1001,941,2020-03-18 09:53:00,1,2471.0,2072.0,0.839,12.029,178,139,74,65,39,4,35,10,0.0,0.0
1001,942,2020-03-18 09:56:00,1,2595.0,2202.0,0.848,12.663,262,131,94,37,131,78,53,41,0.11,0.0
1001,943,2020-03-18 09:59:00,1,2928.0,2381.0,0.813,14.174,112,26,8,18,86,43,43,61,0.0,0.07
1001,944,2020-03-18 10:02:00,1,2905.0,2487.0,0.856,14.198,283,139,105,34,144,93,51,14,0.04,0.04
1001,945,2020-03-18 10:05:00,1,2517.0,2150.0,0.854,12.296,591,284,210,74,307,230,77,8,0.0,0.04
1001,946,2020-03-18 10:08:00,1,2474.0,2047.0,0.828,12.013,783,414,339,75,369,280,89,18,0.0,0.0
1001,947,2020-03-18 10:11:00,1,2773.0,2331.0,0.84,13.507,577,348,270,78,229,169,60,21,0.0,0.0
1001,948,2020-03-18 10:14:00,1,2773.0,2392.0,0.863,13.575,326,209,165,44,117,88,29,7,0.0,0.0
1001,949,2020-03-18 10:17:00,1,2765.0,2390.0,0.864,13.54,55,53,27,26,2,1,1,1,0.0,0.0
1001,950,2020-03-18 10:20:00,1,2723.0,2288.0,0.84,13.26,33,31,6,25,2,1,1,0,0.0,0.0
1001,951,2020-03-18 10:23:00,1,2448.0,2098.0,0.857,11.969,8,7,3,4,1,0,1,0,0.0,0.0
1001,952,2020-03-18 10:26:00,1,2340.0,1957.0,0.836,11.388,11,11,1,10,0,0,0,0,0.0,0.0
1001,953,2020-03-18 10:29:00,1,2287.0,1877.0,0.821,11.088,41,41,27,14,0,0,0,0,0.0,0.0
1001,954,2020-03-18 10:32:00,1,2131.0,1817.0,0.853,10.408,17,15,5,10,2,1,1,0,0.0,0.0
1001,955,2020-03-18 10:35:00,1,2214.0,1843.0,0.833,10.762,146,126,69,57,20,3,17,0,0.0,0.0
1001,956,2020-03-18 10:38:00,1,2331.0,1992.0,0.855,11.39,208,189,111,78,19,2,17,22,0.0,0.0
1001,957,2020-03-18 10:41:00,1,2473.0,2078.0,0.84,12.045,123,117,80,37,6,1,5,31,0.01,0.0
1001,958,2020-03-18 10:44:00,1,2327.0,2025.0,0.87,11.412,4,4,2,2,0,0,0,0,0.0,0.0
1001,959,2020-03-18 10:47:00,1,2270.0,1874.0,0.826,11.02,0,0,0,0,0,0,0,0,0.0,0.0
1001,960,2020-03-18 10:50:00,1,2220.0,1794.0,0.808,10.7345,23,3,2,1,20,0,20,0,0.0,0.0
1001,961,2020-03-18 10:53:00,1,2170.0,1714.0,0.79,10.449,27,14,1,13,13,0,13,0,0.0,0.0
1001,962,2020-03-18 10:56:00,1,2091.0,1680.0,0.804,10.097,33,26,12,14,7,0,7,0,0.0,0.0
1001,963,2020-03-18 10:59:00,1,2158.0,1703.0,0.789,10.39,17,17,0,17,0,0,0,0,0.0,0.0
1001,964,2020-03-18 11:02:00,1,2156.0,1749.0,0.811,10.431,14,0,0,0,14,0,14,0,0.0,0.0
1001,965,2020-03-18 11:05:00,1,2147.0,1784.0,0.831,10.436,4,4,1,3,0,0,0,0,0.0,0.0
1001,966,2020-03-18 11:08:00,1,2142.0,1790.0,0.836,10.422,0,0,0,0,0,0,0,0,0.0,0.0
1001,967,2020-03-18 11:11:00,1,2145.0,1774.0,0.827,10.417,5,0,0,0,5,0,5,0,0.0,0.0
1001,968,2020-03-18 11:14:00,1,2153.0,1753.0,0.814,10.425,7,1,0,1,6,0,6,0,0.0,0.0
1001,969,2020-03-18 11:17:00,1,2162.0,1740.0,0.805,10.447,38,0,0,0,38,0,38,0,0.0,0.0
1001,970,2020-03-18 11:20:00,1,2152.0,1698.0,0.789,10.357,41,0,0,0,41,0,41,0,0.02,0.0
1001,971,2020-03-18 11:23:00,1,2162.0,1700.0,0.786,10.4,33,2,0,2,31,0,31,0,0.0,0.0
1001,972,2020-03-18 11:26:00,1,2167.0,1681.0,0.776,10.399,4,4,0,4,0,0,0,0,0.0,0.0
1001,973,2020-03-18 11:29:00,1,2088.0,1671.0,0.8,10.078,14,9,5,4,5,2,3,0,0.0,0.0
1001,974,2020-03-18 11:32:00,1,2179.0,1685.0,0.773,10.451,14,1,1,0,13,0,13,0,0.0,0.0
1001,975,2020-03-18 11:35:00,1,2032.0,1592.0,0.783,9.77,26,3,0,3,23,0,23,0,0.0,0.0
1001,976,2020-03-18 11:38:00,1,2021.0,1639.0,0.811,9.779,18,5,2,3,13,0,13,0,0.0,0.0
1001,977,2020-03-18 11:41:00,1,2016.0,1644.0,0.816,9.764,14,1,0,1,13,0,13,0,0.0,0.0
1001,978,2020-03-18 11:44:00,1,2019.0,1653.0,0.818,9.785,6,3,0,3,3,0,3,0,0.0,0.0
1001,979,2020-03-18 11:47:00,1,2032.0,1584.0,0.78,9.76,10,4,0,4,6,0,6,0,0.0,0.0
1001,980,2020-03-18 11:50:00,1,2048.0,1581.0,0.772,9.822,10,9,3,6,1,0,1,0,0.0,0.0
1001,981,2020-03-18 11:53:00,1,2044.0,1588.0,0.777,9.811,11,10,6,4,1,1,0,1,0.01,0.0
1001,982,2020-03-18 11:56:00,1,2043.0,1547.0,0.757,9.763,71,50,21,29,21,1,20,5,0.0,0.0
1001,983,2020-03-18 11:59:00,1,2214.0,1782.0,0.805,10.695,98,65,20,45,33,6,27,7,0.0,0.0
1001,984,2020-03-18 12:02:00,1,2500.0,1992.0,0.797,12.058,303,197,129,68,106,54,52,49,0.05,0.0
1001,985,2020-03-18 12:05:00,1,2807.0,2246.0,0.8,13.545,139,43,13,30,96,50,46,63,0.0,0.03
1001,986,2020-03-18 12:08:00,1,2933.0,2392.0,0.815,14.206,674,373,313,60,301,224,77,57,0.08,0.05
1001,987,2020-03-18 12:11:00,1,2860.0,2352.0,0.822,13.873,646,383,336,47,263,210,53,47,0.07,0.05
1001,988,2020-03-18 12:14:00,1,2934.0,2388.0,0.814,14.205,291,126,89,37,165,105,60,75,0.0,0.0
1001,989,2020-03-18 12:17:00,1,2905.0,2435.0,0.838,14.144,656,332,275,57,324,247,77,23,0.06,0.11
1001,990,2020-03-18 12:20:00,1,2489.0,1988.0,0.799,12.009,796,437,343,94,359,263,96,7,0.0,0.0
1001,991,2020-03-18 12:23:00,1,2864.0,2310.0,0.807,13.843,773,436,349,87,337,244,93,30,0.0,0.0
1001,992,2020-03-18 12:26:00,1,2912.0,2465.0,0.846,14.204,631,343,262,81,288,213,75,25,0.01,0.0
1001,993,2020-03-18 12:29:00,1,2922.0,2452.0,0.839,14.228,641,316,244,72,325,247,78,31,0.02,0.0
1001,994,2020-03-18 12:32:00,1,2928.0,2402.0,0.82,14.198,26,9,2,7,17,3,14,3,0.0,0.0
1001,995,2020-03-18 12:35:00,1,2936.0,2390.0,0.814,14.213,125,109,75,34,16,4,12,12,0.0,0.0
1001,996,2020-03-18 12:38:00,1,2793.0,2320.0,0.831,13.573,24,22,14,8,2,0,2,4,0.0,0.0
1001,997,2020-03-18 12:41:00,1,2612.0,2132.0,0.816,12.653,3,3,1,2,0,0,0,0,0.01,0.0
1001,998,2020-03-18 12:44:00,1,2489.0,1980.0,0.795,11.999,5,5,0,5,0,0,0,0,0.01,0.0
1001,999,2020-03-18 12:47:00,1,2292.0,1871.0,0.817,11.101,20,20,4,16,0,0,0,0,0.0,0.0
1001,1000,2020-03-18 12:50:00,1,2153.0,1740.0,0.808,10.41,17,11,2,9,6,2,4,0,0.0,0.0
1001,1001,2020-03-18 12:53:00,1,2160.0,1758.0,0.814,10.458,0,0,0,0,0,0,0,0,0.0,0.0
1001,1002,2020-03-18 12:56:00,1,2162.0,1752.0,0.81,10.459,0,0,0,0,0,0,0,0,0.0,0.0
1001,1003,2020-03-18 12:59:00,1,2162.0,1709.0,0.79,10.411,13,6,4,2,7,0,7,0,0.0,0.0
1001,1004,2020-03-18 13:02:00,1,2174.0,1679.0,0.772,10.423,16,15,0,15,1,0,1,0,0.0,0.0
1001,1005,2020-03-18 13:05:00,1,2165.0,1687.0,0.779,10.4,19,14,13,1,5,0,5,0,0.0,0.0
1001,1006,2020-03-18 13:08:00,1,2077.0,1673.0,0.806,10.037,2,2,0,2,0,0,0,0,0.0,0.0
1001,1007,2020-03-18 13:11:00,1,2093.0,1687.0,0.806,10.116,3,3,1,2,0,0,0,0,0.0,0.0
1001,1008,2020-03-18 13:14:00,1,2023.0,1659.0,0.82,9.806,3,3,1,2,0,0,0,0,0.0,0.0
1001,1009,2020-03-18 13:17:00,1,2168.0,1683.0,0.776,10.406,8,8,4,4,0,0,0,0,0.0,0.0
1001,1010,2020-03-18 13:20:00,1,2029.0,1640.0,0.808,9.811,14,14,2,12,0,0,0,0,0.0,0.0
1001,1011,2020-03-18 13:23:00,1,1970.0,1566.0,0.795,9.496,102,85,45,40,17,5,12,1,0.0,0.0
1001,1012,2020-03-18 13:26:00,1,2166.0,1693.0,0.782,10.409,99,93,57,36,6,1,5,31,0.01,0.0
1001,1013,2020-03-18 13:29:00,1,2210.0,1812.0,0.82,10.715,112,93,42,51,19,0,19,6,0.0,0.0
1001,1014,2020-03-18 13:32:00,1,2282.0,1850.0,0.811,11.04,124,89,42,47,35,4,31,17,0.0,0.0
1001,1015,2020-03-18 13:35:00,1,2264.0,1923.0,0.849,11.048,120,117,58,59,3,1,2,12,0.0,0.0
1001,1016,2020-03-18 13:38:00,1,2284.0,1866.0,0.817,11.064,19,18,1,17,1,0,1,0,0.0,0.0
1001,1017,2020-03-18 13:41:00,1,2162.0,1725.0,0.798,10.427,1,0,0,0,1,0,1,0,0.01,0.0
1001,1018,2020-03-18 13:44:00,1,2095.0,1665.0,0.795,10.099,10,5,3,2,5,0,5,0,0.0,0.0
1001,1019,2020-03-18 13:47:00,1,2027.0,1614.0,0.796,9.773,1,1,0,1,0,0,0,0,0.0,0.0
1001,1020,2020-03-18 13:50:00,1,2035.5,1607.0,0.7895,9.7985,23,18,6,12,5,0,5,0,0.0,0.0
1001,1021,2020-03-18 13:53:00,1,2044.0,1600.0,0.783,9.824,11,8,4,4,3,0,3,0,0.0,0.0
1001,1022,2020-03-18 13:56:00,1,2025.0,1581.0,0.781,9.728,9,7,5,2,2,0,2,0,0.0,0.0
1001,1023,2020-03-18 13:59:00,1,2031.0,1629.0,0.802,9.808,0,0,0,0,0,0,0,0,0.0,0.0
1001,1024,2020-03-18 14:02:00,1,2030.0,1636.0,0.806,9.812,16,13,7,6,3,1,2,0,0.0,0.0
1001,1025,2020-03-18 14:05:00,1,2013.0,1657.0,0.823,9.767,28,28,5,23,0,0,0,0,0.0,0.0
1001,1026,2020-03-18 14:08:00,1,2017.0,1601.0,0.794,9.721,0,0,0,0,0,0,0,0,0.0,0.0
1001,1027,2020-03-18 14:11:00,1,2033.0,1623.0,0.799,9.807,52,37,2,35,15,1,14,0,0.0,0.0
1001,1028,2020-03-18 14:14:00,1,2035.0,1602.0,0.787,9.793,0,0,0,0,0,0,0,0,0.0,0.0
1001,1029,2020-03-18 14:17:00,1,2042.0,1607.0,0.787,9.826,8,5,4,1,3,1,2,0,0.0,0.0
1001,1030,2020-03-18 14:20:00,1,2034.0,1612.0,0.793,9.798,54,35,22,13,19,10,9,0,0.0,0.0
1001,1031,2020-03-18 14:23:00,1,2167.0,1690.0,0.78,10.411,5,3,1,2,2,1,1,0,0.0,0.0
1001,1032,2020-03-18 14:26:00,1,2026.0,1650.0,0.814,9.811,10,3,1,2,7,0,7,0,0.0,0.0
1001,1033,2020-03-18 14:29:00,1,2021.0,1597.0,0.79,9.732,13,3,0,3,10,0,10,0,0.0,0.0
1001,1034,2020-03-18 14:32:00,1,1887.0,1541.0,0.817,9.142,17,15,3,12,2,0,2,0,0.0,0.0
1001,1035,2020-03-18 14:35:00,1,1886.0,1554.0,0.824,9.151,0,0,0,0,0,0,0,0,0.01,0.0
1001,1036,2020-03-18 14:38:00,1,1903.0,1542.0,0.811,9.205,40,33,12,21,7,0,7,3,0.01,0.0
1001,1037,2020-03-18 14:41:00,1,1824.0,1530.0,0.839,8.881,3,3,1,2,0,0,0,0,0.01,0.0
1001,1038,2020-03-18 14:44:00,1,1883.0,1545.0,0.82,9.131,13,12,7,5,1,0,1,0,0.0,0.0
1001,1039,2020-03-18 14:47:00,1,1820.0,1525.0,0.838,8.86,80,74,43,31,6,2,4,6,0.0,0.0
1001,1040,2020-03-18 14:50:00,1,2166.0,1715.0,0.792,10.433,109,103,52,51,6,1,5,22,0.01,0.0
1001,1041,2020-03-18 14:53:00,1,2161.0,1734.0,0.803,10.434,133,90,48,42,43,9,34,16,0.0,0.0
1001,1042,2020-03-18 14:56:00,1,2253.0,1941.0,0.862,11.025,210,110,70,40,100,56,44,57,0.06,0.0
1001,1043,2020-03-18 14:59:00,1,2456.0,2061.0,0.839,11.957,128,35,9,26,93,51,42,55,0.0,0.0
1001,1044,2020-03-18 15:02:00,1,2731.0,2292.0,0.839,13.298,246,93,57,36,153,104,49,31,0.0,0.0
1001,1045,2020-03-18 15:05:00,1,2017.0,1694.0,0.84,9.823,75,62,13,49,13,1,12,0,0.0,0.0
1001,1046,2020-03-18 15:08:00,1,1885.0,1563.0,0.83,9.157,581,356,289,67,225,167,58,32,0.05,0.0
1001,1047,2020-03-18 15:11:00,1,2836.0,2414.0,0.851,13.848,462,266,215,51,196,142,54,33,0.09,0.06
1001,1048,2020-03-18 15:14:00,1,2584.0,2157.0,0.835,12.568,741,403,318,85,338,251,87,44,0.01,0.0
1001,1049,2020-03-18 15:17:00,1,2775.0,2367.0,0.853,13.553,917,521,441,80,396,294,102,52,0.0,0.0
1001,1050,2020-03-18 15:20:00,1,2786.0,2353.0,0.845,13.582,848,447,361,86,401,300,101,35,0.01,0.0
1001,1051,2020-03-18 15:23:00,1,2786.0,2313.0,0.83,13.537,491,280,218,62,211,159,52,41,0.0,0.0
1001,1052,2020-03-18 15:26:00,1,2805.0,2278.0,0.812,13.574,703,382,292,90,321,254,67,18,0.0,0.0
1001,1053,2020-03-18 15:29:00,1,2592.0,2170.0,0.837,12.616,471,275,217,58,196,140,56,30,0.01,0.0
1001,1054,2020-03-18 15:32:00,1,2612.0,2127.0,0.814,12.646,197,180,103,77,17,0,17,2,0.0,0.0
1001,1055,2020-03-18 15:35:00,1,2604.0,2121.0,0.815,12.611,51,41,21,20,10,0,10,0,0.01,0.0
1001,1056,2020-03-18 15:38:00,1,2475.0,2039.0,0.824,12.007,0,0,0,0,0,0,0,0,0.0,0.0
1001,1057,2020-03-18 15:41:00,1,2282.0,1879.0,0.823,11.073,35,3,2,1,32,2,30,1,0.0,0.0
1001,1058,2020-03-18 15:44:00,1,2156.0,1741.0,0.807,10.423,12,12,1,11,0,0,0,0,0.02,0.0
1001,1059,2020-03-18 15:47:00,1,2098.0,1645.0,0.784,10.086,15,14,1,13,1,0,1,0,0.0,0.0
1001,1060,2020-03-18 15:50:00,1,2044.0,1574.0,0.77,9.794,1,1,0,1,0,0,0,0,0.0,0.0
1001,1061,2020-03-18 15:53:00,1,2032.0,1535.0,0.755,9.706,11,11,2,9,0,0,0,0,0.0,0.0
1001,1062,2020-03-18 15:56:00,1,2044.0,1583.0,0.775,9.807,0,0,0,0,0,0,0,0,0.0,0.0
1001,1063,2020-03-18 15:59:00,1,2038.0,1585.0,0.778,9.783,6,5,3,2,1,0,1,0,0.0,0.0
1001,1064,2020-03-18 16:02:00,1,2053.0,1555.0,0.757,9.812,0,0,0,0,0,0,0,0,0.0,0.0
1001,1065,2020-03-18 16:05:00,1,1985.0,1523.0,0.767,9.506,9,7,2,5,2,0,2,0,0.0,0.0
1001,1066,2020-03-18 16:08:00,1,1827.0,1471.0,0.805,8.827,17,13,8,5,4,0,4,0,0.0,0.0
1001,1067,2020-03-18 16:11:00,1,1834.0,1460.0,0.796,8.84,0,0,0,0,0,0,0,0,0.0,0.0
1001,1068,2020-03-18 16:14:00,1,1835.0,1461.0,0.796,8.849,9,4,2,2,5,0,5,0,0.0,0.0
1001,1069,2020-03-18 16:17:00,1,1907.0,1503.0,0.788,9.176,12,9,1,8,3,0,3,0,0.0,0.0
1001,1070,2020-03-18 16:20:00,1,1984.0,1503.0,0.757,9.483,39,7,2,5,32,0,32,0,0.0,0.0
1001,1071,2020-03-18 16:23:00,1,2049.0,1528.0,0.745,9.766,2,2,1,1,0,0,0,0,0.0,0.0
1001,1072,2020-03-18 16:26:00,1,1832.0,1466.0,0.8,8.84,79,59,34,25,20,2,18,0,0.0,0.0
1001,1073,2020-03-18 16:29:00,1,2032.0,1570.0,0.773,9.745,12,11,5,6,1,0,1,0,0.0,0.0
1001,1074,2020-03-18 16:32:00,1,2033.0,1574.0,0.774,9.754,1,1,0,1,0,0,0,0,0.0,0.0
1001,1075,2020-03-18 16:35:00,1,2039.0,1557.0,0.764,9.758,8,6,2,4,2,0,2,0,0.0,0.0
1001,1076,2020-03-18 16:38:00,1,2180.0,1655.0,0.759,10.423,205,161,92,69,44,0,44,18,0.01,0.0
1001,1077,2020-03-18 16:41:00,1,2309.0,1774.0,0.768,11.063,137,124,68,56,13,0,13,29,0.0,0.0
1001,1078,2020-03-18 16:44:00,1,2353.0,1899.0,0.807,11.371,225,125,79,46,100,63,37,37,0.0,0.0
1001,1079,2020-03-18 16:47:00,1,2617.0,2098.0,0.802,12.633,121,49,18,31,72,25,47,71,0.0,0.01
1001,1080,2020-03-18 16:50:00,1,2600.5,2151.5,0.8275,12.6275,171,32,2,30,139,85,54,39,0.0,0.11
1001,1081,2020-03-18 16:53:00,1,2584.0,2205.0,0.853,12.622,483,234,187,47,249,191,58,37,0.09,0.02
1001,1082,2020-03-18 16:56:00,1,2772.0,2341.0,0.845,13.515,485,265,217,48,220,160,60,44,0.0,0.0
1001,1083,2020-03-18 16:59:00,1,1956.0,1564.0,0.8,9.438,688,402,334,68,286,210,76,24,0.01,0.0
1001,1084,2020-03-18 17:02:00,1,2790.0,2313.0,0.829,13.552,754,445,391,54,309,247,62,21,0.08,0.01
1001,1085,2020-03-18 17:05:00,1,2287.0,1880.0,0.822,11.093,120,102,48,54,18,11,7,19,0.0,0.01
1001,1086,2020-03-18 17:08:00,1,2471.0,2078.0,0.841,12.038,66,39,1,38,27,0,27,0,0.0,0.0
1001,1087,2020-03-18 17:11:00,1,2262.0,1942.0,0.858,11.062,15,10,0,10,5,0,5,0,0.0,0.0
1001,1088,2020-03-18 17:14:00,1,2325.0,1982.0,0.852,11.355,33,22,10,12,11,0,11,0,0.0,0.0
1001,1089,2020-03-18 17:17:00,1,2442.0,2164.0,0.886,12.016,4,2,1,1,2,0,2,0,0.0,0.0
1001,1090,2020-03-18 17:20:00,1,2387.0,2022.0,0.847,11.642,3,1,0,1,2,0,2,0,0.0,0.0
1001,1091,2020-03-18 17:23:00,1,2264.0,1972.0,0.871,11.103,15,13,1,12,2,0,2,0,0.0,0.0
1001,1092,2020-03-18 17:26:00,1,2253.0,1924.0,0.854,11.006,26,24,2,22,2,0,2,0,0.0,0.0
1001,1093,2020-03-18 17:29:00,1,2129.0,1849.0,0.869,10.435,4,4,0,4,0,0,0,0,0.0,0.0
1001,1094,2020-03-18 17:32:00,1,2116.0,1835.0,0.867,10.37,15,15,2,13,0,0,0,0,0.0,0.0
1001,1095,2020-03-18 17:35:00,1,2158.0,1783.0,0.826,10.477,10,6,2,4,4,0,4,0,0.0,0.0
1001,1096,2020-03-18 17:38:00,1,1996.0,1733.0,0.868,9.784,9,7,3,4,2,0,2,0,0.0,0.0
1001,1097,2020-03-18 17:41:00,1,2137.0,1791.0,0.838,10.402,18,13,3,10,5,0,5,0,0.0,0.0
1001,1098,2020-03-18 17:44:00,1,1999.0,1731.0,0.866,9.791,32,28,15,13,4,0,4,0,0.0,0.0
1001,1099,2020-03-18 17:47:00,1,2067.0,1782.0,0.862,10.117,11,9,1,8,2,0,2,0,0.0,0.0
1001,1100,2020-03-18 17:50:00,1,1988.0,1740.0,0.875,9.758,6,2,1,1,4,0,4,0,0.0,0.0
1001,1101,2020-03-18 17:53:00,1,2076.0,1767.0,0.851,10.135,69,39,23,16,30,11,19,2,0.0,0.0
1001,1102,2020-03-18 17:56:00,1,2126.0,1818.0,0.855,10.391,0,0,0,0,0,0,0,0,0.0,0.0
1001,1103,2020-03-18 17:59:00,1,2119.0,1827.0,0.862,10.37,4,2,1,1,2,0,2,0,0.0,0.0
1001,1104,2020-03-18 18:02:00,0,2121.0,1862.0,0.878,10.418,32,32,1,31,0,0,0,0,0.0,0.0
1001,1105,2020-03-18 18:05:00,0,2119.0,1865.0,0.88,10.414,294,260,168,92,34,9,25,25,0.0,0.0
1001,1106,2020-03-18 18:08:00,0,2443.0,2129.0,0.872,11.984,87,51,24,27,36,13,23,2,0.0,0.0
1001,1107,2020-03-18 18:11:00,0,2557.0,2339.0,0.915,12.664,13,11,0,11,2,1,1,4,0.0,0.0
1001,1108,2020-03-18 18:14:00,0,2766.0,2418.0,0.874,13.575,324,223,162,61,101,70,31,29,0.0,0.0
1001,1109,2020-03-18 18:17:00,0,2889.0,2569.0,0.889,14.228,226,141,96,45,85,53,32,31,0.0,0.0
1001,1110,2020-03-18 18:20:00,0,2992.0,2740.0,0.916,14.821,210,118,77,41,92,55,37,81,0.0,0.0
1001,1111,2020-03-18 18:23:00,0,3082.0,2758.0,0.895,15.196,255,116,67,49,139,78,61,79,0.1,0.12
1001,1112,2020-03-18 18:26:00,0,3155.0,2793.0,0.885,15.523,579,305,246,59,274,213,61,80,0.03,0.0
1001,1113,2020-03-18 18:29:00,0,3033.0,2627.0,0.866,14.858,319,168,125,43,151,102,49,28,0.0,0.0
1001,1114,2020-03-18 18:32:00,0,2763.0,2469.0,0.894,13.619,344,152,121,31,192,127,65,41,0.0,0.0
1001,1115,2020-03-18 18:35:00,0,3079.0,2738.0,0.889,15.163,342,149,91,58,193,119,74,84,0.0,0.07
1001,1116,2020-03-18 18:38:00,0,3202.0,2871.0,0.897,15.796,133,71,48,23,62,27,35,1,0.12,0.02
1001,1117,2020-03-18 18:41:00,0,2244.0,1991.0,0.888,11.044,101,64,36,28,37,6,31,8,0.0,0.01
1001,1118,2020-03-18 18:44:00,0,2702.0,2318.0,0.858,13.214,466,211,158,53,255,190,65,23,0.04,0.0
1001,1119,2020-03-18 18:47:00,0,3011.0,2733.0,0.908,14.89,435,220,164,56,215,154,61,30,0.02,0.0
1001,1120,2020-03-18 18:50:00,0,3195.0,2849.0,0.892,15.743,347,105,69,36,242,172,70,56,0.0,0.02
1001,1121,2020-03-18 18:53:00,0,3520.0,3167.0,0.9,17.374,28,1,1,0,27,15,12,7,0.0,0.29
1001,1122,2020-03-18 18:56:00,0,3270.0,2956.0,0.904,16.158,131,48,35,13,83,64,19,7,0.29,0.0
1001,1123,2020-03-18 18:59:00,0,3063.0,2856.0,0.932,15.232,472,210,165,45,262,195,67,35,0.0,0.0
1001,1124,2020-03-18 19:02:00,0,2606.0,2409.0,0.924,12.935,49,35,14,21,14,4,10,0,0.0,0.0
1001,1125,2020-03-18 19:05:00,0,2305.0,2085.0,0.904,11.391,0,0,0,0,0,0,0,0,0.0,0.0
1001,1126,2020-03-18 19:08:00,0,2058.0,1811.0,0.88,10.114,36,29,12,17,7,2,5,0,0.0,0.01
1001,1127,2020-03-18 19:11:00,0,1989.0,1771.0,0.89,9.798,18,12,2,10,6,1,5,0,0.0,0.0
1001,1128,2020-03-18 19:14:00,0,1995.0,1740.0,0.872,9.788,23,19,6,13,4,0,4,0,0.0,0.0
1001,1129,2020-03-18 19:17:00,0,1867.0,1604.0,0.859,9.131,33,32,2,30,1,1,0,0,0.0,0.0
1001,1130,2020-03-18 19:20:00,0,2008.0,1710.0,0.852,9.804,3,3,0,3,0,0,0,0,0.0,0.0
1001,1131,2020-03-18 19:23:00,0,2884.0,2617.0,0.907,14.262,12,3,0,3,9,0,9,0,0.0,0.0
1001,1132,2020-03-18 19:26:00,0,2841.0,2713.0,0.955,14.197,21,16,9,7,5,0,5,0,0.0,0.0
1001,1133,2020-03-18 19:29:00,0,2889.0,2613.0,0.904,14.277,35,16,12,4,19,14,5,0,0.0,0.0
1001,1134,2020-03-18 19:32:00,0,2743.0,2491.0,0.908,13.565,15,13,6,7,2,0,2,0,0.0,0.0
1001,1135,2020-03-18 19:35:00,0,2668.0,2448.0,0.918,13.223,7,7,3,4,0,0,0,0,0.0,0.0
1001,1136,2020-03-18 19:38:00,0,2532.0,2377.0,0.939,12.608,0,0,0,0,0,0,0,0,0.0,0.0
1001,1137,2020-03-18 19:41:00,0,2495.0,2318.0,0.929,12.396,4,3,2,1,1,1,0,0,0.0,0.0
1001,1138,2020-03-18 19:44:00,0,2406.0,2235.0,0.929,11.955,1,0,0,0,1,0,1,0,0.0,0.0
1001,1139,2020-03-18 19:47:00,0,2437.0,2217.0,0.91,12.058,69,40,12,28,29,1,28,11,0.0,0.0
1001,1140,2020-03-18 19:50:00,0,2515.5,2338.5,0.929,12.501,199,170,103,67,29,11,18,14,0.0,0.0
1001,1141,2020-03-18 19:53:00,0,2594.0,2460.0,0.948,12.944,137,92,52,40,45,23,22,22,0.0,0.0
1001,1142,2020-03-18 19:56:00,0,2730.0,2520.0,0.923,13.547,271,126,101,25,145,102,43,30,0.1,0.0
1001,1143,2020-03-18 19:59:00,0,2854.0,2698.0,0.945,14.233,396,201,153,48,195,145,50,45,0.0,0.01
1001,1144,2020-03-18 20:02:00,0,2728.0,2563.0,0.94,13.588,363,175,131,44,188,136,52,47,0.0,0.0
1001,1145,2020-03-18 20:05:00,0,2611.0,2447.0,0.937,12.996,409,243,183,60,166,108,58,36,0.0,0.0
1001,1146,2020-03-18 20:08:00,0,2969.0,2847.0,0.959,14.849,573,282,227,55,291,206,85,27,0.0,0.0
1001,1147,2020-03-18 20:11:00,0,2871.0,2646.0,0.922,14.24,520,301,248,53,219,163,56,23,0.0,0.0
1001,1148,2020-03-18 20:14:00,0,2970.0,2832.0,0.953,14.837,542,306,262,44,236,178,58,39,0.0,0.01
1001,1149,2020-03-18 20:17:00,0,2736.0,2538.0,0.928,13.59,280,200,131,69,80,51,29,4,0.0,0.0
1001,1150,2020-03-18 20:20:00,0,2991.0,2807.0,0.938,14.894,569,256,197,59,313,239,74,45,0.0,0.0
1001,1151,2020-03-18 20:23:00,0,2872.0,2618.0,0.912,14.214,515,223,174,49,292,212,80,65,0.0,0.0
1001,1152,2020-03-18 20:26:00,0,2989.0,2808.0,0.94,14.887,208,86,49,37,122,68,54,74,0.0,0.05
1001,1153,2020-03-18 20:29:00,0,3035.0,2838.0,0.935,15.101,82,35,5,30,47,24,23,57,0.01,0.08
1001,1154,2020-03-18 20:32:00,0,3226.0,2999.0,0.93,16.029,126,45,21,24,81,53,28,14,0.08,0.04
1001,1155,2020-03-18 20:35:00,0,2221.0,2083.0,0.938,11.058,26,17,2,15,9,1,8,3,0.0,0.0
1001,1156,2020-03-18 20:38:00,0,2129.0,1862.0,0.874,10.451,295,161,119,42,134,89,45,23,0.08,0.0
1001,1157,2020-03-18 20:41:00,0,2232.0,2049.0,0.918,11.061,655,303,243,60,352,266,86,31,0.0,0.01
1001,1158,2020-03-18 20:44:00,0,2485.0,2294.0,0.923,12.33,428,261,193,68,167,105,62,24,0.0,0.0
1001,1159,2020-03-18 20:47:00,0,2516.0,2198.0,0.874,12.347,482,194,142,52,288,216,72,2,0.0,0.0
1001,1160,2020-03-18 20:50:00,0,2820.0,2513.0,0.891,13.894,399,248,179,69,151,102,49,18,0.0,0.0
1001,1161,2020-03-18 20:53:00,0,2735.0,2520.0,0.921,13.567,24,20,0,20,4,0,4,5,0.0,0.0
1001,1162,2020-03-18 20:56:00,0,3201.0,2998.0,0.936,15.932,79,58,20,38,21,1,20,10,0.0,0.0
1001,1163,2020-03-18 20:59:00,0,3109.0,2877.0,0.925,15.435,19,4,1,3,15,0,15,0,0.0,0.0
1001,1164,2020-03-18 21:02:00,0,2857.0,2678.0,0.938,14.221,1,0,0,0,1,0,1,0,0.01,0.01
1001,1165,2020-03-18 21:05:00,0,2774.0,2456.0,0.885,13.649,1,1,0,1,0,0,0,0,0.0,0.0
1001,1166,2020-03-18 21:08:00,0,2561.0,2290.0,0.894,12.624,3,3,0,3,0,0,0,0,0.0,0.0
1001,1167,2020-03-18 21:11:00,0,2430.0,2158.0,0.888,11.962,0,0,0,0,0,0,0,0,0.0,0.0
1001,1168,2020-03-18 21:14:00,0,2291.0,2103.0,0.918,11.354,8,7,2,5,1,1,0,0,0.0,0.0
1001,1169,2020-03-18 21:17:00,0,2299.0,2104.0,0.915,11.386,10,5,3,2,5,2,3,1,0.0,0.0
1001,1170,2020-03-18 21:20:00,0,2225.0,2037.0,0.915,11.022,1,1,0,1,0,0,0,0,0.0,0.0
1001,1171,2020-03-18 21:23:00,0,2173.0,1966.0,0.905,10.74,9,9,0,9,0,0,0,0,0.0,0.0
1001,1172,2020-03-18 21:26:00,0,2234.0,2005.0,0.897,11.022,1,1,0,1,0,0,0,0,0.0,0.0
1001,1173,2020-03-18 21:29:00,0,2243.0,2014.0,0.898,11.068,3,3,0,3,0,0,0,0,0.0,0.0
1001,1174,2020-03-18 21:32:00,0,2247.0,2000.0,0.89,11.068,9,4,2,2,5,0,5,1,0.0,0.0
1001,1175,2020-03-18 21:35:00,0,2175.0,1960.0,0.901,10.74,7,5,1,4,2,1,1,0,0.0,0.0
1001,1176,2020-03-18 21:38:00,0,2109.0,1904.0,0.903,10.419,40,24,10,14,16,3,13,7,0.0,0.0
1001,1177,2020-03-18 21:41:00,0,2241.0,1995.0,0.89,11.036,47,33,10,23,14,0,14,9,0.0,0.0
1001,1178,2020-03-18 21:44:00,0,2433.0,2146.0,0.882,11.962,215,87,44,43,128,64,64,50,0.0,0.0
1001,1179,2020-03-18 21:47:00,0,2545.0,2341.0,0.92,12.62,202,34,13,21,168,97,71,83,0.0,0.0
1001,1180,2020-03-18 21:50:00,0,2852.0,2663.0,0.934,14.186,148,56,33,23,92,62,30,27,0.0,0.04
1001,1181,2020-03-18 21:53:00,0,2433.0,2160.0,0.888,11.975,589,342,291,51,247,191,56,38,0.05,0.01
1001,1182,2020-03-18 21:56:00,0,2237.0,2032.0,0.908,11.064,843,449,378,71,394,307,87,56,0.01,0.01
1001,1183,2020-03-18 21:59:00,0,2810.0,2590.0,0.922,13.941,653,357,293,64,296,221,75,41,0.0,0.0
1001,1184,2020-03-18 22:02:00,0,2612.0,2385.0,0.913,12.932,522,280,217,63,242,175,67,17,0.0,0.0
1001,1185,2020-03-18 22:05:00,0,2873.0,2630.0,0.915,14.229,487,245,193,52,242,183,59,40,0.0,0.0
1001,1186,2020-03-18 22:08:00,0,2864.0,2582.0,0.901,14.143,59,38,13,25,21,8,13,17,0.0,0.0
1001,1187,2020-03-18 22:11:00,0,2874.0,2635.0,0.917,14.24,86,77,30,47,9,1,8,6,0.0,0.0
1001,1188,2020-03-18 22:14:00,0,2893.0,2558.0,0.884,14.23,21,20,6,14,1,0,1,0,0.0,0.0
1001,1189,2020-03-18 22:17:00,0,2614.0,2340.0,0.895,12.892,24,23,5,18,1,0,1,0,0.0,0.0
1001,1190,2020-03-18 22:20:00,0,2426.0,2199.0,0.907,11.993,10,10,1,9,0,0,0,0,0.0,0.0
1001,1191,2020-03-18 22:23:00,0,2381.0,2086.0,0.876,11.689,3,3,1,2,0,0,0,0,0.0,0.0
1001,1192,2020-03-18 22:26:00,0,2260.0,1984.0,0.878,11.1,26,26,7,19,0,0,0,0,0.0,0.0
1001,1193,2020-03-18 22:29:00,0,2241.0,1978.0,0.883,11.019,45,45,0,45,0,0,0,0,0.0,0.0
1001,1194,2020-03-18 22:32:00,0,2253.0,1967.0,0.873,11.054,38,35,3,32,3,0,3,0,0.0,0.0
1001,1195,2020-03-18 22:35:00,0,2267.0,1941.0,0.856,11.08,27,21,10,11,6,3,3,0,0.0,0.0
1001,1196,2020-03-18 22:38:00,0,2252.0,1963.0,0.871,11.047,46,46,7,39,0,0,0,0,0.0,0.0
1001,1197,2020-03-18 22:41:00,0,2200.0,1916.0,0.871,10.788,25,25,10,15,0,0,0,0,0.0,0.0
1001,1198,2020-03-18 22:44:00,0,2266.0,1946.0,0.858,11.084,9,6,2,4,3,0,3,0,0.0,0.0
1001,1199,2020-03-18 22:47:00,0,2263.0,1918.0,0.847,11.038,4,0,0,0,4,0,4,0,0.0,0.0
1001,1200,2020-03-18 22:50:00,0,2192.0,1901.5,0.868,10.7405,5,2,0,2,3,0,3,0,0.0,0.0
1001,1201,2020-03-18 22:53:00,0,2121.0,1885.0,0.889,10.443,9,6,4,2,3,0,3,0,0.0,0.0
1001,1202,2020-03-18 22:56:00,0,2112.0,1851.0,0.876,10.371,80,42,27,15,38,21,17,1,0.0,0.0
1001,1203,2020-03-18 22:59:00,0,2272.0,1924.0,0.846,11.083,53,33,6,27,20,2,18,0,0.0,0.0
1001,1204,2020-03-18 23:02:00,0,2313.0,2035.0,0.88,11.366,50,25,5,20,25,0,25,4,0.01,0.0
1001,1205,2020-03-18 23:05:00,0,2445.0,2168.0,0.887,12.032,68,48,8,40,20,2,18,12,0.0,0.0
1001,1206,2020-03-18 23:08:00,0,2506.0,2211.0,0.882,12.32,335,190,128,62,145,104,41,86,0.0,0.0
1001,1207,2020-03-18 23:11:00,0,2782.0,2396.0,0.861,13.614,206,120,67,53,86,48,38,87,0.0,0.07
1001,1208,2020-03-18 23:14:00,0,2833.0,2476.0,0.874,13.902,199,90,56,34,109,66,43,60,0.01,0.07
1001,1209,2020-03-18 23:17:00,0,2559.0,2281.0,0.891,12.606,397,235,183,52,162,119,43,35,0.0,0.01
1001,1210,2020-03-18 23:20:00,0,2763.0,2402.0,0.869,13.546,649,313,249,64,336,269,67,31,0.09,0.0
1001,1211,2020-03-18 23:23:00,0,2488.0,2199.0,0.884,12.235,803,430,353,77,373,283,90,72,0.0,0.0
1001,1212,2020-03-18 23:26:00,0,2944.0,2665.0,0.905,14.55,473,285,225,60,188,140,48,62,0.0,0.0
1001,1213,2020-03-18 23:29:00,0,2571.0,2269.0,0.883,12.642,146,106,65,41,40,24,16,58,0.0,0.0
1001,1214,2020-03-18 23:32:00,0,2129.0,1825.0,0.857,10.408,50,48,15,33,2,0,2,2,0.0,0.01
1001,1215,2020-03-18 23:35:00,0,2563.0,2263.0,0.883,12.604,14,13,8,5,1,0,1,0,0.0,0.0
1001,1216,2020-03-18 23:38:00,0,2761.0,2479.0,0.898,13.621,8,8,5,3,0,0,0,0,0.0,0.0
1001,1217,2020-03-18 23:41:00,0,2627.0,2342.0,0.891,12.945,18,18,1,17,0,0,0,0,0.0,0.0
1001,1218,2020-03-18 23:44:00,0,2569.0,2267.0,0.882,12.634,53,50,5,45,3,0,3,0,0.0,0.0
1001,1219,2020-03-18 23:47:00,0,2517.0,2230.0,0.886,12.385,8,5,4,1,3,0,3,0,0.0,0.0
1001,1220,2020-03-18 23:50:00,0,2426.0,2164.0,0.892,11.953,1,1,0,1,0,0,0,0,0.0,0.0
1001,1221,2020-03-18 23:53:00,0,2454.0,2109.0,0.86,12.002,0,0,0,0,0,0,0,0,0.0,0.0
1001,1222,2020-03-18 23:56:00,0,2388.0,2060.0,0.863,11.689,1,1,0,1,0,0,0,0,0.0,0.01
1001,1223,2020-03-18 23:59:00,0,2315.0,2036.0,0.88,11.375,2,2,0,2,0,0,0,0,0.0,0.0
1001,1224,2020-03-19 00:02:00,0,2395.0,2066.0,0.863,11.724,86,65,34,31,21,6,15,22,0.0,0.0
1001,1225,2020-03-19 00:05:00,0,2443.0,2115.0,0.866,11.965,143,105,62,43,38,9,29,30,0.0,0.0
1001,1226,2020-03-19 00:08:00,0,2434.0,2174.0,0.893,11.996,162,141,73,68,21,0,21,6,0.0,0.0
1001,1227,2020-03-19 00:11:00,0,2593.0,2252.0,0.868,12.711,89,36,12,24,53,14,39,6,0.0,0.0
1001,1228,2020-03-19 00:14:00,0,2550.0,2258.0,0.885,12.547,56,47,25,22,9,2,7,1,0.0,0.0
1001,1229,2020-03-19 00:17:00,0,2508.0,2226.0,0.888,12.347,0,0,0,0,0,0,0,0,0.0,0.0
1001,1230,2020-03-19 00:20:00,0,2459.0,2094.0,0.851,12.008,0,0,0,0,0,0,0,0,0.0,0.0
1001,1231,2020-03-19 00:23:00,0,2238.0,2007.0,0.897,11.039,5,5,1,4,0,0,0,0,0.0,0.0
1001,1232,2020-03-19 00:26:00,0,2387.0,2053.0,0.86,11.678,1,1,0,1,0,0,0,0,0.0,0.0
1001,1233,2020-03-19 00:29:00,0,2465.0,2067.0,0.838,12.0,13,0,0,0,13,1,12,0,0.0,0.0
1001,1234,2020-03-19 00:32:00,0,2466.0,2080.0,0.844,12.019,232,142,106,36,90,56,34,24,0.0,0.0
1001,1235,2020-03-19 00:35:00,0,2588.0,2216.0,0.856,12.651,312,169,118,51,143,88,55,57,0.0,0.0
1001,1236,2020-03-19 00:38:00,0,2790.0,2336.0,0.837,13.579,132,40,7,33,92,38,54,71,0.0,0.02
1001,1237,2020-03-19 00:41:00,0,2968.0,2568.0,0.865,14.538,227,51,16,35,176,111,65,66,0.0,0.07
1001,1238,2020-03-19 00:44:00,0,3014.0,2672.0,0.887,14.832,343,126,88,38,217,144,73,49,0.09,0.04
1001,1239,2020-03-19 00:47:00,0,2891.0,2513.0,0.869,14.171,525,273,223,50,252,200,52,69,0.01,0.01
1001,1240,2020-03-19 00:50:00,0,2252.0,1958.0,0.869,11.042,310,132,97,35,178,132,46,61,0.0,0.0
1001,1241,2020-03-19 00:53:00,0,3220.0,2803.0,0.87,15.789,250,114,65,49,136,75,61,97,0.0,0.09
1001,1242,2020-03-19 00:56:00,0,3262.0,2941.0,0.902,16.11,180,65,41,24,115,68,47,28,0.13,0.04
1001,1243,2020-03-19 00:59:00,0,2377.0,2100.0,0.883,11.69,76,58,30,28,18,5,13,0,0.0,0.0
1001,1244,2020-03-19 01:02:00,0,2194.0,1915.0,0.873,10.765,12,7,0,7,5,0,5,1,0.0,0.0
1001,1245,2020-03-19 01:05:00,0,2195.0,1885.0,0.859,10.735,1,1,0,1,0,0,0,0,0.01,0.0
1001,1246,2020-03-19 01:08:00,0,2124.0,1844.0,0.868,10.411,1,0,0,0,1,0,1,0,0.0,0.0
1001,1247,2020-03-19 01:11:00,0,2257.0,1888.0,0.837,10.984,4,1,1,0,3,0,3,0,0.0,0.0
1001,1248,2020-03-19 01:14:00,0,2330.0,2020.0,0.867,11.417,3,2,0,2,1,0,1,0,0.0,0.0
1001,1249,2020-03-19 01:17:00,0,2613.0,2381.0,0.911,12.932,14,9,0,9,5,0,5,0,0.0,0.0
1001,1250,2020-03-19 01:20:00,0,2927.0,2720.0,0.929,14.543,4,3,0,3,1,0,1,0,0.0,0.01
1001,1251,2020-03-19 01:23:00,0,2867.0,2634.0,0.919,14.213,3,2,0,2,1,0,1,0,0.0,0.0
1001,1252,2020-03-19 01:26:00,0,2728.0,2524.0,0.925,13.544,2,1,0,1,1,0,1,0,0.0,0.0
1001,1253,2020-03-19 01:29:00,0,2802.0,2560.0,0.914,13.873,97,64,29,35,33,9,24,9,0.0,0.0
1001,1254,2020-03-19 01:32:00,0,2868.0,2645.0,0.922,14.228,41,37,6,31,4,1,3,3,0.0,0.0
1001,1255,2020-03-19 01:35:00,0,2864.0,2675.0,0.934,14.244,151,101,59,42,50,14,36,9,0.0,0.0
1001,1256,2020-03-19 01:38:00,0,2835.0,2695.0,0.95,14.154,129,68,38,30,61,27,34,9,0.0,0.0
1001,1257,2020-03-19 01:41:00,0,2926.0,2747.0,0.939,14.57,577,289,241,48,288,217,71,56,0.04,0.0
1001,1258,2020-03-19 01:44:00,0,2935.0,2756.0,0.939,14.615,321,140,107,33,181,129,52,85,0.01,0.04
1001,1259,2020-03-19 01:47:00,0,3184.0,2937.0,0.923,15.794,182,66,33,33,116,55,61,74,0.0,0.09
1001,1260,2020-03-19 01:50:00,0,2877.0,2638.0,0.9165,14.255,247,121,75,46,126,75,51,48,0.11,0.1
1001,1261,2020-03-19 01:53:00,0,2570.0,2339.0,0.91,12.716,445,210,163,47,235,169,66,24,0.11,0.0
1001,1262,2020-03-19 01:56:00,0,2741.0,2485.0,0.906,13.552,555,296,238,58,259,200,59,34,0.0,0.01
1001,1263,2020-03-19 01:59:00,0,2751.0,2488.0,0.904,13.595,273,110,70,40,163,112,51,63,0.0,0.02
1001,1264,2020-03-19 02:02:00,0,3299.0,3110.0,0.943,16.44,266,133,90,43,133,93,40,64,0.0,0.11
1001,1265,2020-03-19 02:05:00,0,2484.0,2297.0,0.925,12.329,318,179,120,59,139,83,56,7,0.0,0.0
1001,1266,2020-03-19 02:08:00,0,2556.0,2332.0,0.912,12.653,361,155,106,49,206,146,60,21,0.03,0.0
1001,1267,2020-03-19 02:11:00,0,3059.0,2912.0,0.952,15.277,5,3,0,3,2,0,2,0,0.0,0.0
1001,1268,2020-03-19 02:14:00,0,2973.0,2851.0,0.959,14.871,14,11,2,9,3,2,1,0,0.01,0.0
1001,1269,2020-03-19 02:17:00,0,2856.0,2649.0,0.928,14.183,1,0,0,0,1,0,1,0,0.0,0.0
1001,1270,2020-03-19 02:20:00,0,2741.0,2509.0,0.915,13.577,24,24,3,21,0,0,0,0,0.0,0.0
1001,1271,2020-03-19 02:23:00,0,2518.0,2406.0,0.956,12.585,2,1,0,1,1,0,1,0,0.0,0.0
1001,1272,2020-03-19 02:26:00,0,2414.0,2303.0,0.954,12.062,10,9,3,6,1,0,1,0,0.0,0.0
1001,1273,2020-03-19 02:29:00,0,2406.0,2276.0,0.946,12.0,0,0,0,0,0,0,0,0,0.0,0.0
1001,1274,2020-03-19 02:32:00,0,2416.0,2257.0,0.934,12.016,46,34,28,6,12,8,4,0,0.0,0.0
1001,1275,2020-03-19 02:35:00,0,2420.0,2228.0,0.921,12.0,0,0,0,0,0,0,0,0,0.0,0.0
1001,1276,2020-03-19 02:38:00,0,2424.0,2228.0,0.919,12.016,15,14,10,4,1,0,1,0,0.0,0.0
1001,1277,2020-03-19 02:41:00,0,2425.0,2224.0,0.917,12.018,6,2,1,1,4,1,3,0,0.0,0.0
1001,1278,2020-03-19 02:44:00,0,2443.0,2151.0,0.881,12.006,13,0,0,0,13,0,13,0,0.0,0.0
1001,1279,2020-03-19 02:47:00,0,2441.0,2178.0,0.892,12.029,1,0,0,0,1,0,1,0,0.0,0.0
1001,1280,2020-03-19 02:50:00,0,2365.0,2142.0,0.906,11.689,6,5,1,4,1,0,1,0,0.0,0.0
1001,1281,2020-03-19 02:53:00,0,2407.0,2215.0,0.92,11.936,16,8,2,6,8,0,8,0,0.0,0.0
1001,1282,2020-03-19 02:56:00,0,2564.0,2323.0,0.906,12.675,103,66,29,37,37,9,28,3,0.0,0.0
1001,1283,2020-03-19 02:59:00,0,2553.0,2338.0,0.916,12.648,62,38,19,19,24,0,24,0,0.0,0.0
1001,1284,2020-03-19 03:02:00,0,2535.0,2416.0,0.953,12.661,104,50,12,38,54,33,21,9,0.0,0.0
1001,1285,2020-03-19 03:05:00,0,2527.0,2430.0,0.962,12.649,264,112,80,32,152,105,47,34,0.0,0.33
1001,1286,2020-03-19 03:08:00,0,2738.0,2544.0,0.929,13.603,17,6,0,6,11,1,10,0,0.0,0.0
1001,1287,2020-03-19 03:11:00,0,2807.0,2614.0,0.931,13.952,619,328,278,50,291,215,76,40,0.07,0.0
1001,1288,2020-03-19 03:14:00,0,2850.0,2742.0,0.962,14.263,465,213,162,51,252,182,70,42,0.0,0.01
1001,1289,2020-03-19 03:17:00,0,2846.0,2710.0,0.952,14.214,253,128,100,28,125,79,46,15,0.04,0.0
1001,1290,2020-03-19 03:20:00,0,2833.0,2727.0,0.963,14.18,696,319,257,62,377,288,89,108,0.01,0.0
1001,1291,2020-03-19 03:23:00,0,2852.0,2694.0,0.944,14.22,494,211,161,50,283,209,74,44,0.1,0.0
1001,1292,2020-03-19 03:26:00,0,2985.0,2787.0,0.934,14.847,631,320,254,66,311,225,86,34,0.0,0.0
1001,1293,2020-03-19 03:29:00,0,3225.0,3055.0,0.948,16.088,307,153,122,31,154,121,33,45,0.08,0.0
1001,1294,2020-03-19 03:32:00,0,2903.0,2762.0,0.951,14.498,788,374,299,75,414,319,95,50,0.01,0.0
1001,1295,2020-03-19 03:35:00,0,2841.0,2732.0,0.962,14.217,479,281,235,46,198,148,50,23,0.0,0.0
1001,1296,2020-03-19 03:38:00,0,2907.0,2753.0,0.947,14.5,261,137,95,42,124,93,31,9,0.0,0.0
1001,1297,2020-03-19 03:41:00,0,2993.0,2787.0,0.931,14.878,608,276,216,60,332,244,88,15,0.0,0.0
1001,1298,2020-03-19 03:44:00,0,2869.0,2695.0,0.939,14.288,701,387,319,68,314,238,76,95,0.0,0.03
1001,1299,2020-03-19 03:47:00,0,2742.0,2492.0,0.909,13.561,364,248,183,65,116,80,36,32,0.01,0.0
1001,1300,2020-03-19 03:50:00,0,2997.0,2769.0,0.924,14.874,590,339,270,69,251,178,73,20,0.0,0.0
1001,1301,2020-03-19 03:53:00,0,2719.0,2553.0,0.939,13.541,202,83,64,19,119,83,36,59,0.0,0.0
1001,1302,2020-03-19 03:56:00,0,2875.0,2630.0,0.915,14.238,18,14,6,8,4,0,4,4,0.0,0.0
1001,1303,2020-03-19 03:59:00,0,2740.0,2525.0,0.921,13.592,36,36,1,35,0,0,0,0,0.0,0.0
1001,1304,2020-03-19 04:02:00,0,2547.0,2346.0,0.921,12.633,4,4,2,2,0,0,0,0,0.0,0.0
1001,1305,2020-03-19 04:05:00,0,2425.0,2227.0,0.919,12.021,33,29,10,19,4,0,4,0,0.0,0.0
1001,1306,2020-03-19 04:08:00,0,2300.0,2109.0,0.917,11.397,23,22,0,22,1,0,1,0,0.0,0.0
1001,1307,2020-03-19 04:11:00,0,2241.0,2050.0,0.915,11.099,20,4,0,4,16,0,16,0,0.0,0.0
1001,1308,2020-03-19 04:14:00,0,2239.0,2024.0,0.904,11.061,14,6,0,6,8,0,8,0,0.01,0.0
1001,1309,2020-03-19 04:17:00,0,2241.0,2004.0,0.894,11.048,18,14,9,5,4,0,4,0,0.0,0.0
1001,1310,2020-03-19 04:20:00,0,2097.0,1953.0,0.931,10.426,20,19,6,13,1,0,1,0,0.0,0.0
1001,1311,2020-03-19 04:23:00,0,2109.0,1945.0,0.922,10.463,11,11,5,6,0,0,0,0,0.0,0.0
1001,1312,2020-03-19 04:26:00,0,2156.0,1991.0,0.923,10.697,30,30,6,24,0,0,0,0,0.0,0.0
1001,1313,2020-03-19 04:29:00,0,2231.0,2030.0,0.91,11.038,11,8,4,4,3,1,2,0,0.0,0.0
1001,1314,2020-03-19 04:32:00,0,2372.0,2133.0,0.899,11.707,275,168,125,43,107,65,42,28,0.0,0.0
1001,1315,2020-03-19 04:35:00,0,2419.0,2278.0,0.942,12.054,180,76,44,32,104,59,45,20,0.01,0.0
1001,1316,2020-03-19 04:38:00,0,2560.0,2371.0,0.926,12.71,135,85,49,36,50,28,22,66,0.0,0.0
1001,1317,2020-03-19 04:41:00,0,2757.0,2508.0,0.91,13.641,282,194,145,49,88,51,37,79,0.0,0.01
1001,1318,2020-03-19 04:44:00,0,2746.0,2561.0,0.933,13.653,199,84,57,27,115,77,38,20,0.09,0.01
1001,1319,2020-03-19 04:47:00,0,2438.0,2204.0,0.904,12.047,408,211,158,53,197,131,66,19,0.0,0.0
1001,1320,2020-03-19 04:50:00,0,2647.0,2429.0,0.9165,13.118,413,173,118,55,240,162,78,39,0.0,0.0
1001,1321,2020-03-19 04:53:00,0,2856.0,2654.0,0.929,14.189,430,199,138,61,231,160,71,6,0.0,0.0
1001,1322,2020-03-19 04:56:00,0,2736.0,2553.0,0.933,13.605,659,338,266,72,321,246,75,50,0.01,0.0
1001,1323,2020-03-19 04:59:00,0,2883.0,2655.0,0.921,14.297,354,183,112,71,171,121,50,1,0.0,0.0
1001,1324,2020-03-19 05:02:00,0,2858.0,2627.0,0.919,14.169,530,278,193,85,252,180,72,36,0.0,0.0
1001,1325,2020-03-19 05:05:00,0,2795.0,2587.0,0.926,13.878,124,111,64,47,13,4,9,20,0.0,0.0
1001,1326,2020-03-19 05:08:00,0,2737.0,2550.0,0.932,13.605,13,10,1,9,3,0,3,4,0.0,0.0
1001,1327,2020-03-19 05:11:00,0,2543.0,2381.0,0.936,12.655,3,0,0,0,3,0,3,0,0.0,0.0
1001,1328,2020-03-19 05:14:00,0,2435.0,2205.0,0.905,12.035,3,0,0,0,3,0,3,0,0.0,0.0
1001,1329,2020-03-19 05:17:00,0,2229.0,2066.0,0.927,11.068,3,0,0,0,3,0,3,0,0.0,0.0
1001,1330,2020-03-19 05:20:00,0,2170.0,1946.0,0.897,10.705,155,102,73,29,53,28,25,9,0.0,0.0
1001,1331,2020-03-19 05:23:00,0,2442.0,2143.0,0.878,11.995,108,74,49,25,34,10,24,26,0.0,0.0
1001,1332,2020-03-19 05:26:00,0,2423.0,2246.0,0.927,12.034,281,144,98,46,137,93,44,31,0.0,0.0
1001,1333,2020-03-19 05:29:00,0,2562.0,2327.0,0.908,12.671,255,168,122,46,87,52,35,28,0.0,0.0
1001,1334,2020-03-19 05:32:00,0,2546.0,2348.0,0.922,12.63,59,28,22,6,31,21,10,7,0.0,0.0
1001,1335,2020-03-19 05:35:00,0,2442.0,2197.0,0.9,12.052,27,0,0,0,27,0,27,0,0.0,0.0
1001,1336,2020-03-19 05:38:00,0,2304.0,2092.0,0.908,11.394,11,8,7,1,3,0,3,0,0.0,0.0
1001,1337,2020-03-19 05:41:00,0,2245.0,1983.0,0.883,11.04,0,0,0,0,0,0,0,0,0.0,0.0
1001,1338,2020-03-19 05:44:00,0,2133.0,1896.0,0.889,10.505,0,0,0,0,0,0,0,0,0.0,0.0
1001,1339,2020-03-19 05:47:00,0,2125.0,1824.0,0.858,10.393,4,3,0,3,1,0,1,0,0.0,0.0
1001,1340,2020-03-19 05:50:00,0,2058.0,1814.0,0.882,10.116,21,17,7,10,4,2,2,0,0.0,0.0
1001,1341,2020-03-19 05:53:00,0,1986.0,1765.0,0.889,9.777,0,0,0,0,0,0,0,0,0.01,0.0
1001,1342,2020-03-19 05:56:00,0,1990.0,1723.0,0.866,9.746,0,0,0,0,0,0,0,0,0.0,0.0
1001,1343,2020-03-19 05:59:00,0,2002.0,1736.0,0.867,9.811,1,0,0,0,1,0,1,0,0.0,0.0
1001,1344,2020-03-19 06:02:00,1,2003.0,1721.0,0.859,9.798,32,23,16,7,9,2,7,0,0.0,0.0
1001,1345,2020-03-19 06:05:00,1,1997.0,1756.0,0.879,9.813,11,0,0,0,11,0,11,0,0.0,0.0
1001,1346,2020-03-19 06:08:00,1,1994.0,1738.0,0.871,9.781,8,4,0,4,4,0,4,0,0.0,0.0
1001,1347,2020-03-19 06:11:00,1,2011.0,1693.0,0.841,9.799,33,25,16,9,8,2,6,0,0.0,0.0
1001,1348,2020-03-19 06:14:00,1,1995.0,1740.0,0.872,9.785,13,13,6,7,0,0,0,0,0.01,0.0
1001,1349,2020-03-19 06:17:00,1,2011.0,1684.0,0.837,9.789,15,5,2,3,10,1,9,0,0.0,0.0
1001,1350,2020-03-19 06:20:00,1,2013.0,1701.0,0.845,9.815,25,10,5,5,15,0,15,0,0.0,0.0
1001,1351,2020-03-19 06:23:00,1,2016.0,1637.0,0.812,9.756,11,8,4,4,3,0,3,0,0.0,0.0
1001,1352,2020-03-19 06:26:00,1,2021.0,1648.0,0.816,9.789,11,6,2,4,5,0,5,0,0.0,0.0
1001,1353,2020-03-19 06:29:00,1,2144.0,1782.0,0.831,10.42,116,79,49,30,37,10,27,6,0.0,0.0
1001,1354,2020-03-19 06:32:00,1,2267.0,1929.0,0.851,11.068,51,35,16,19,16,1,15,0,0.0,0.0
1001,1355,2020-03-19 06:35:00,1,2395.0,2010.0,0.839,11.662,243,177,127,50,66,41,25,5,0.0,0.0
1001,1356,2020-03-19 06:38:00,1,2469.0,2074.0,0.84,12.024,87,55,24,31,32,3,29,0,0.0,0.0
1001,1357,2020-03-19 06:41:00,1,2465.0,2072.0,0.841,12.008,206,145,112,33,61,32,29,10,0.0,0.0
1001,1358,2020-03-19 06:44:00,1,2451.0,2107.0,0.86,11.99,475,277,206,71,198,141,57,19,0.0,0.0
1001,1359,2020-03-19 06:47:00,1,2452.0,2105.0,0.859,11.991,410,243,175,68,167,109,58,4,0.0,0.0
1001,1360,2020-03-19 06:50:00,1,2575.0,2255.0,0.876,12.644,562,350,293,57,212,142,70,8,0.0,0.0
1001,1361,2020-03-19 06:53:00,1,2452.0,2156.0,0.879,12.049,485,297,231,66,188,133,55,26,0.0,0.0
1001,1362,2020-03-19 06:56:00,1,2448.0,2170.0,0.887,12.048,628,405,327,78,223,143,80,36,0.0,0.0
1001,1363,2020-03-19 06:59:00,1,2447.0,2127.0,0.869,11.996,785,538,462,76,247,179,68,52,0.0,0.0
1001,1364,2020-03-19 07:02:00,1,2459.0,2125.0,0.864,12.043,380,177,141,36,203,138,65,24,0.0,0.0
1001,1365,2020-03-19 07:05:00,1,2448.0,2127.0,0.869,12.0,198,111,72,39,87,53,34,11,0.0,0.0
1001,1366,2020-03-19 07:08:00,1,2440.0,2075.0,0.85,11.911,65,49,24,25,16,9,7,3,0.0,0.0
1001,1367,2020-03-19 07:11:00,1,2479.0,2053.0,0.828,12.039,79,50,18,32,29,3,26,0,0.0,0.0
1001,1368,2020-03-19 07:14:00,1,2464.0,2044.0,0.83,11.971,99,81,41,40,18,4,14,6,0.0,0.0
1001,1369,2020-03-19 07:17:00,1,2397.0,1974.0,0.823,11.628,6,5,2,3,1,1,0,0,0.0,0.0
1001,1370,2020-03-19 07:20:00,1,2278.0,1848.0,0.811,11.021,6,1,0,1,5,0,5,0,0.0,0.0
1001,1371,2020-03-19 07:23:00,1,2160.0,1714.0,0.794,10.409,5,1,0,1,4,0,4,0,0.0,0.0
1001,1372,2020-03-19 07:26:00,1,2030.0,1631.0,0.803,9.803,0,0,0,0,0,0,0,0,0.0,0.0
1001,1373,2020-03-19 07:29:00,1,1893.0,1561.0,0.825,9.185,14,6,2,4,8,0,8,0,0.0,0.0
1001,1374,2020-03-19 07:32:00,1,1885.0,1553.0,0.824,9.147,15,10,2,8,5,0,5,0,0.0,0.0
1001,1375,2020-03-19 07:35:00,1,1888.0,1543.0,0.817,9.148,10,7,4,3,3,0,3,0,0.01,0.0
1001,1376,2020-03-19 07:38:00,1,1825.0,1509.0,0.827,8.861,11,8,5,3,3,0,3,0,0.0,0.0
1001,1377,2020-03-19 07:41:00,1,1898.0,1534.0,0.808,9.179,5,4,3,1,1,0,1,0,0.0,0.0
1001,1378,2020-03-19 07:44:00,1,1831.0,1475.0,0.806,8.848,10,8,2,6,2,0,2,0,0.0,0.0
1001,1379,2020-03-19 07:47:00,1,1830.0,1455.0,0.795,8.823,2,1,0,1,1,0,1,0,0.0,0.0
1001,1380,2020-03-19 07:50:00,1,1830.0,1456.5,0.796,8.824,16,15,10,5,1,0,1,0,0.0,0.0
1001,1381,2020-03-19 07:53:00,1,1830.0,1458.0,0.797,8.825,15,11,6,5,4,0,4,0,0.0,0.0
1001,1382,2020-03-19 07:56:00,1,1818.0,1510.0,0.831,8.836,0,0,0,0,0,0,0,0,0.0,0.0
1001,1383,2020-03-19 07:59:00,1,1811.0,1511.0,0.834,8.81,0,0,0,0,0,0,0,0,0.0,0.0
1001,1384,2020-03-19 08:02:00,1,1898.0,1530.0,0.806,9.172,0,0,0,0,0,0,0,0,0.0,0.0
1001,1385,2020-03-19 08:05:00,1,2039.0,1565.0,0.767,9.767,0,0,0,0,0,0,0,0,0.0,0.0
1001,1386,2020-03-19 08:08:00,1,1973.0,1544.0,0.783,9.485,0,0,0,0,0,0,0,0,0.0,0.0
1001,1387,2020-03-19 08:11:00,1,1966.0,1549.0,0.788,9.462,0,0,0,0,0,0,0,0,0.01,0.0
1001,1388,2020-03-19 08:14:00,1,1891.0,1526.0,0.807,9.142,0,0,0,0,0,0,0,0,0.0,0.0
1001,1389,2020-03-19 08:17:00,1,1902.0,1514.0,0.796,9.172,6,0,0,0,6,0,6,0,0.0,0.0
1001,1390,2020-03-19 08:20:00,1,2042.0,1560.0,0.764,9.772,6,0,0,0,6,0,6,0,0.0,0.0
1001,1391,2020-03-19 08:23:00,1,1906.0,1528.0,0.802,9.202,27,17,9,8,10,0,10,2,0.0,0.0
1001,1392,2020-03-19 08:26:00,1,1967.0,1533.0,0.78,9.447,4,0,0,0,4,0,4,0,0.0,0.0
1001,1393,2020-03-19 08:29:00,1,1894.0,1512.0,0.798,9.138,3,3,1,2,0,0,0,0,0.0,0.0
1001,1394,2020-03-19 08:32:00,1,1961.0,1545.0,0.788,9.437,32,22,13,9,10,3,7,0,0.0,0.0
1001,1395,2020-03-19 08:35:00,1,2087.0,1640.0,0.786,10.04,65,23,2,21,42,14,28,6,0.0,0.0
1001,1396,2020-03-19 08:38:00,1,2156.0,1711.0,0.794,10.389,79,66,32,34,13,4,9,2,0.0,0.0
1001,1397,2020-03-19 08:41:00,1,2144.0,1784.0,0.832,10.421,77,67,31,36,10,1,9,0,0.0,0.0
1001,1398,2020-03-19 08:44:00,1,2277.0,1845.0,0.81,11.014,128,105,61,44,23,0,23,0,0.0,0.0
1001,1399,2020-03-19 08:47:00,1,2145.0,1746.0,0.814,10.384,27,22,17,5,5,0,5,0,0.0,0.0
1001,1400,2020-03-19 08:50:00,1,2034.0,1630.0,0.802,9.819,1,1,0,1,0,0,0,0,0.0,0.0
1001,1401,2020-03-19 08:53:00,1,1816.0,1516.0,0.835,8.834,4,0,0,0,4,0,4,0,0.0,0.0
1001,1402,2020-03-19 08:56:00,1,1833.0,1470.0,0.802,8.849,27,20,12,8,7,0,7,0,0.0,0.0
1001,1403,2020-03-19 08:59:00,1,1824.0,1499.0,0.822,8.846,21,7,4,3,14,2,12,0,0.0,0.0
1001,1404,2020-03-19 09:02:00,1,1820.0,1507.0,0.828,8.841,45,25,9,16,20,0,20,0,0.0,0.0
1001,1405,2020-03-19 09:05:00,1,1975.0,1545.0,0.783,9.491,63,51,20,31,12,1,11,0,0.0,0.0
1001,1406,2020-03-19 09:08:00,1,2041.0,1583.0,0.776,9.796,0,0,0,0,0,0,0,0,0.0,0.0
1001,1407,2020-03-19 09:11:00,1,2047.0,1581.0,0.772,9.817,0,0,0,0,0,0,0,0,0.02,0.0
1001,1408,2020-03-19 09:14:00,1,2047.0,1537.0,0.751,9.766,45,26,6,20,19,6,13,5,0.0,0.0
1001,1409,2020-03-19 09:17:00,1,2154.0,1745.0,0.81,10.421,84,41,15,26,43,11,32,4,0.0,0.0
1001,1410,2020-03-19 09:20:00,1,2347.0,1884.0,0.803,11.335,179,105,76,29,74,32,42,14,0.0,0.0
1001,1411,2020-03-19 09:23:00,1,2478.0,2010.0,0.811,11.99,32,17,7,10,15,3,12,0,0.0,0.0
1001,1412,2020-03-19 09:26:00,1,2414.0,1928.0,0.799,11.647,22,19,3,16,3,0,3,0,0.0,0.0
1001,1413,2020-03-19 09:29:00,1,2286.0,1800.0,0.787,11.0,2,2,1,1,0,0,0,0,0.0,0.0
1001,1414,2020-03-19 09:32:00,1,2163.0,1665.0,0.77,10.365,54,47,21,26,7,1,6,0,0.0,0.0
1001,1415,2020-03-19 09:35:00,1,2025.0,1624.0,0.802,9.777,35,34,10,24,1,0,1,0,0.0,0.0
1001,1416,2020-03-19 09:38:00,1,1966.0,1515.0,0.771,9.423,18,17,10,7,1,1,0,0,0.0,0.0
1001,1417,2020-03-19 09:41:00,1,1825.0,1459.0,0.799,8.808,45,45,11,34,0,0,0,0,0.0,0.0
1001,1418,2020-03-19 09:44:00,1,2035.0,1578.0,0.775,9.767,63,38,14,24,25,4,21,1,0.0,0.0
1001,1419,2020-03-19 09:47:00,1,2162.0,1720.0,0.796,10.423,252,144,100,44,108,71,37,41,0.0,0.0
1001,1420,2020-03-19 09:50:00,1,2492.0,1976.0,0.793,12.007,394,228,172,56,166,117,49,59,0.0,0.0
1001,1421,2020-03-19 09:53:00,1,2606.0,2105.0,0.808,12.598,164,73,32,41,91,39,52,72,0.0,0.01
1001,1422,2020-03-19 09:56:00,1,2826.0,2248.0,0.796,13.624,252,162,118,44,90,46,44,33,0.04,0.02
1001,1423,2020-03-19 09:59:00,1,2279.0,1858.0,0.815,11.037,610,366,305,61,244,172,72,17,0.0,0.01
1001,1424,2020-03-19 10:02:00,1,2494.0,1974.0,0.792,12.012,339,224,170,54,115,77,38,12,0.02,0.01
1001,1425,2020-03-19 10:05:00,1,2617.0,2122.0,0.811,12.659,92,69,38,31,23,12,11,0,0.0,0.0
1001,1426,2020-03-19 10:08:00,1,2603.0,2072.0,0.796,12.551,91,89,33,56,2,0,2,0,0.0,0.0
1001,1427,2020-03-19 10:11:00,1,2537.0,2053.0,0.809,12.268,52,52,24,28,0,0,0,0,0.0,0.0
1001,1428,2020-03-19 10:14:00,1,2473.0,2059.0,0.832,12.023,367,207,149,58,160,105,55,8,0.0,0.0
1001,1429,2020-03-19 10:17:00,1,2461.0,2093.0,0.85,12.014,762,451,377,74,311,230,81,35,0.0,0.0
1001,1430,2020-03-19 10:20:00,1,2463.0,2098.0,0.852,12.026,650,376,311,65,274,207,67,33,0.0,0.0
1001,1431,2020-03-19 10:23:00,1,2477.0,2077.0,0.838,12.06,243,167,132,35,76,52,24,12,0.0,0.0
1001,1432,2020-03-19 10:26:00,1,2269.0,1907.0,0.841,11.049,10,1,0,1,9,0,9,0,0.0,0.0
1001,1433,2020-03-19 10:29:00,1,2154.0,1775.0,0.824,10.453,18,18,0,18,0,0,0,0,0.0,0.0
1001,1434,2020-03-19 10:32:00,1,2014.0,1641.0,0.815,9.752,13,10,0,10,3,0,3,0,0.0,0.0
1001,1435,2020-03-19 10:35:00,1,1962.0,1584.0,0.807,9.486,8,8,2,6,0,0,0,0,0.0,0.0
1001,1436,2020-03-19 10:38:00,1,1820.0,1528.0,0.839,8.864,11,8,2,6,3,0,3,0,0.0,0.0
1001,1437,2020-03-19 10:41:00,1,1823.0,1521.0,0.834,8.867,4,1,1,0,3,0,3,0,0.0,0.0
1001,1438,2020-03-19 10:44:00,1,1814.0,1513.0,0.834,8.823,1,0,0,0,1,0,1,0,0.0,0.0
1001,1439,2020-03-19 10:47:00,1,1822.0,1518.0,0.833,8.86,0,0,0,0,0,0,0,0,0.0,0.0
1001,1440,2020-03-19 10:50:00,1,1827.0,1503.0,0.8225,8.862,6,2,2,0,4,0,4,0,0.0,0.0
1001,1441,2020-03-19 10:53:00,1,1832.0,1488.0,0.812,8.864,5,4,3,1,1,0,1,0,0.0,0.0
1001,1442,2020-03-19 10:56:00,1,1825.0,1510.0,0.827,8.862,14,5,4,1,9,2,7,0,0.0,0.0
1001,1443,2020-03-19 10:59:00,1,1821.0,1501.0,0.825,8.836,27,4,3,1,23,3,20,0,0.0,0.0
1001,1444,2020-03-19 11:02:00,1,2032.0,1614.0,0.794,9.793,3,2,1,1,1,0,1,0,0.0,0.0
1001,1445,2020-03-19 11:05:00,1,2032.0,1596.0,0.785,9.774,8,8,0,8,0,0,0,0,0.0,0.0
1001,1446,2020-03-19 11:08:00,1,2027.0,1583.0,0.781,9.738,5,2,0,2,3,0,3,0,0.0,0.0
1001,1447,2020-03-19 11:11:00,1,2032.0,1597.0,0.786,9.775,11,1,0,1,10,2,8,0,0.0,0.0
1001,1448,2020-03-19 11:14:00,1,2102.0,1634.0,0.777,10.09,1,0,0,0,1,0,1,0,0.0,0.0
1001,1449,2020-03-19 11:17:00,1,2035.0,1603.0,0.788,9.792,5,5,2,3,0,0,0,0,0.0,0.0
1001,1450,2020-03-19 11:20:00,1,2025.0,1583.0,0.782,9.732,0,0,0,0,0,0,0,0,0.0,0.0
1001,1451,2020-03-19 11:23:00,1,2035.0,1584.0,0.778,9.771,28,28,2,26,0,0,0,0,0.0,0.0
1001,1452,2020-03-19 11:26:00,1,2042.0,1584.0,0.776,9.799,19,19,0,19,0,0,0,0,0.0,0.0
1001,1453,2020-03-19 11:29:00,1,2035.0,1594.0,0.783,9.782,20,20,2,18,0,0,0,0,0.0,0.0
1001,1454,2020-03-19 11:32:00,1,2044.0,1577.0,0.771,9.8,29,17,10,7,12,10,2,0,0.0,0.0
1001,1455,2020-03-19 11:35:00,1,2040.0,1544.0,0.757,9.748,37,37,0,37,0,0,0,0,0.0,0.0
1001,1456,2020-03-19 11:38:00,1,1896.0,1498.0,0.79,9.13,170,162,89,73,8,3,5,15,0.0,0.0
1001,1457,2020-03-19 11:41:00,1,2102.0,1654.0,0.787,10.112,114,105,65,40,9,3,6,0,0.0,0.0
1001,1458,2020-03-19 11:44:00,1,2162.0,1739.0,0.805,10.443,132,114,73,41,18,2,16,12,0.0,0.0
1001,1459,2020-03-19 11:47:00,1,2294.0,1847.0,0.805,11.081,69,42,17,25,27,11,16,6,0.0,0.0
1001,1460,2020-03-19 11:50:00,1,2342.0,1948.0,0.832,11.383,261,154,115,39,107,68,39,33,0.0,0.0
1001,1461,2020-03-19 11:53:00,1,2495.0,1977.0,0.792,12.019,155,117,74,43,38,15,23,89,0.01,0.0
1001,1462,2020-03-19 11:56:00,1,2597.0,2156.0,0.83,12.618,239,161,110,51,78,41,37,73,0.01,0.09
1001,1463,2020-03-19 11:59:00,1,2473.0,2034.0,0.822,11.997,762,443,371,72,319,239,80,35,0.03,0.03
1001,1464,2020-03-19 12:02:00,1,2858.0,2360.0,0.826,13.875,389,234,161,73,155,112,43,24,0.0,0.0
1001,1465,2020-03-19 12:05:00,1,2090.0,1650.0,0.789,10.063,717,459,378,81,258,198,60,21,0.09,0.0
1001,1466,2020-03-19 12:08:00,1,2594.0,2164.0,0.834,12.617,474,266,196,70,208,147,61,10,0.0,0.0
1001,1467,2020-03-19 12:11:00,1,2798.0,2292.0,0.819,13.562,742,413,332,81,329,233,96,49,0.0,0.0
1001,1468,2020-03-19 12:14:00,1,2781.0,2339.0,0.841,13.549,259,218,149,69,41,21,20,41,0.0,0.0
1001,1469,2020-03-19 12:17:00,1,2574.0,2270.0,0.882,12.655,46,40,11,29,6,2,4,1,0.0,0.0
1001,1470,2020-03-19 12:20:00,1,2583.0,2246.0,0.87,12.664,33,23,11,12,10,1,9,2,0.0,0.0
1001,1471,2020-03-19 12:23:00,1,2405.0,2033.0,0.846,11.726,22,22,1,21,0,0,0,0,0.0,0.0
1001,1472,2020-03-19 12:26:00,1,2209.0,1879.0,0.851,10.785,35,35,0,35,0,0,0,0,0.0,0.0
1001,1473,2020-03-19 12:29:00,1,2133.0,1769.0,0.829,10.363,1,1,0,1,0,0,0,0,0.0,0.0
1001,1474,2020-03-19 12:32:00,1,2086.0,1730.0,0.829,10.134,14,12,4,8,2,0,2,0,0.0,0.0
1001,1475,2020-03-19 12:35:00,1,2007.0,1688.0,0.841,9.778,20,20,7,13,0,0,0,0,0.0,0.0
1001,1476,2020-03-19 12:38:00,1,2019.0,1678.0,0.831,9.814,0,0,0,0,0,0,0,0,0.0,0.0
1001,1477,2020-03-19 12:41:00,1,2014.0,1663.0,0.825,9.777,0,0,0,0,0,0,0,0,0.0,0.0
1001,1478,2020-03-19 12:44:00,1,2035.0,1648.0,0.81,9.841,16,11,6,5,5,0,5,0,0.0,0.0
1001,1479,2020-03-19 12:47:00,1,2022.0,1647.0,0.814,9.789,2,0,0,0,2,0,2,0,0.0,0.0
1001,1480,2020-03-19 12:50:00,1,1943.0,1621.0,0.834,9.451,0,0,0,0,0,0,0,0,0.0,0.0
1001,1481,2020-03-19 12:53:00,1,2021.0,1655.0,0.819,9.797,21,15,5,10,6,2,4,0,0.0,0.0
1001,1482,2020-03-19 12:56:00,1,2032.0,1644.0,0.809,9.825,5,5,3,2,0,0,0,0,0.0,0.0
1001,1483,2020-03-19 12:59:00,1,2018.0,1657.0,0.821,9.786,3,3,1,2,0,0,0,0,0.0,0.0
1001,1484,2020-03-19 13:02:00,1,2005.0,1657.0,0.826,9.736,12,12,6,6,0,0,0,0,0.0,0.0
1001,1485,2020-03-19 13:05:00,1,2015.0,1684.0,0.836,9.802,2,2,1,1,0,0,0,0,0.0,0.0
1001,1486,2020-03-19 13:08:00,1,2038.0,1640.0,0.805,9.845,0,0,0,0,0,0,0,0,0.0,0.0
1001,1487,2020-03-19 13:11:00,1,1958.0,1557.0,0.795,9.437,2,2,1,1,0,0,0,0,0.0,0.0
1001,1488,2020-03-19 13:14:00,1,2024.0,1609.0,0.795,9.758,35,30,7,23,5,0,5,0,0.0,0.0
1001,1489,2020-03-19 13:17:00,1,2031.0,1645.0,0.81,9.822,42,41,0,41,1,0,1,0,0.0,0.0
1001,1490,2020-03-19 13:20:00,1,2024.0,1644.0,0.812,9.795,17,14,0,14,3,0,3,0,0.0,0.0
1001,1491,2020-03-19 13:23:00,1,2030.0,1621.0,0.798,9.794,14,12,5,7,2,0,2,0,0.0,0.0
1001,1492,2020-03-19 13:26:00,1,2031.0,1601.0,0.788,9.773,27,18,11,7,9,0,9,1,0.0,0.0
1001,1493,2020-03-19 13:29:00,1,2096.0,1681.0,0.802,10.119,131,93,48,45,38,2,36,3,0.0,0.0
1001,1494,2020-03-19 13:32:00,1,2138.0,1800.0,0.842,10.417,74,71,37,34,3,0,3,0,0.0,0.0
1001,1495,2020-03-19 13:35:00,1,2284.0,1898.0,0.831,11.1,111,75,43,32,36,13,23,5,0.0,0.0
1001,1496,2020-03-19 13:38:00,1,2253.0,1968.0,0.873,11.054,103,75,34,41,28,7,21,23,0.0,0.0
1001,1497,2020-03-19 13:41:00,1,2321.0,1993.0,0.859,11.351,18,15,4,11,3,0,3,0,0.0,0.0
1001,1498,2020-03-19 13:44:00,1,2264.0,1941.0,0.857,11.07,145,122,73,49,23,5,18,11,0.0,0.0
1001,1499,2020-03-19 13:47:00,1,2454.0,2057.0,0.838,11.944,161,61,38,23,100,64,36,48,0.0,0.0
1001,1500,2020-03-19 13:50:00,1,2450.0,2060.5,0.841,11.9335,709,363,309,54,346,268,78,26,0.0,0.0
1001,1501,2020-03-19 13:53:00,1,2446.0,2064.0,0.844,11.923,304,172,132,40,132,80,52,67,0.0,0.03
1001,1502,2020-03-19 13:56:00,1,2587.0,2241.0,0.866,12.673,183,57,35,22,126,75,51,46,0.05,0.08
1001,1503,2020-03-19 13:59:00,1,2125.0,1857.0,0.874,10.428,643,396,317,79,247,191,56,43,0.0,0.02
1001,1504,2020-03-19 14:02:00,1,2259.0,1958.0,0.867,11.07,192,118,78,40,74,46,28,20,0.0,0.0
1001,1505,2020-03-19 14:05:00,1,2146.0,1756.0,0.818,10.4,39,26,9,17,13,2,11,0,0.0,0.0
1001,1506,2020-03-19 14:08:00,1,2015.0,1693.0,0.84,9.814,0,0,0,0,0,0,0,0,0.0,0.0
1001,1507,2020-03-19 14:11:00,1,2130.0,1794.0,0.842,10.379,14,13,5,8,1,0,1,0,0.0,0.0
1001,1508,2020-03-19 14:14:00,1,2240.0,2030.0,0.906,11.074,23,17,4,13,6,0,6,0,0.0,0.0
1001,1509,2020-03-19 14:17:00,1,2555.0,2356.0,0.922,12.675,262,130,75,55,132,86,46,31,0.0,0.0
1001,1510,2020-03-19 14:20:00,1,2867.0,2604.0,0.908,14.177,276,166,110,56,110,66,44,56,0.0,0.0
1001,1511,2020-03-19 14:23:00,1,2879.0,2632.0,0.914,14.258,275,176,131,45,99,60,39,39,0.01,0.0
1001,1512,2020-03-19 14:26:00,1,2869.0,2613.0,0.911,14.197,125,92,49,43,33,7,26,6,0.0,0.0
1001,1513,2020-03-19 14:29:00,1,2886.0,2559.0,0.887,14.203,100,77,34,43,23,8,15,13,0.0,0.0
1001,1514,2020-03-19 14:32:00,1,2750.0,2467.0,0.897,13.566,100,85,46,39,15,1,14,0,0.0,0.0
1001,1515,2020-03-19 14:35:00,1,2556.0,2342.0,0.916,12.664,8,7,4,3,1,0,1,0,0.0,0.0
1001,1516,2020-03-19 14:38:00,1,2426.0,2152.0,0.887,11.939,16,16,9,7,0,0,0,0,0.0,0.0
1001,1517,2020-03-19 14:41:00,1,2242.0,2019.0,0.901,11.067,22,22,4,18,0,0,0,0,0.0,0.0
1001,1518,2020-03-19 14:44:00,1,2108.0,1905.0,0.904,10.415,25,25,2,23,0,0,0,0,0.02,0.0
1001,1519,2020-03-19 14:47:00,1,2120.0,1873.0,0.884,10.426,19,19,5,14,0,0,0,0,0.0,0.0
1001,1520,2020-03-19 14:50:00,1,2141.0,1811.0,0.846,10.439,39,39,14,25,0,0,0,0,0.0,0.0
1001,1521,2020-03-19 14:53:00,1,1982.0,1759.0,0.887,9.757,0,0,0,0,0,0,0,0,0.0,0.0
1001,1522,2020-03-19 14:56:00,1,1996.0,1713.0,0.858,9.762,47,47,24,23,0,0,0,0,0.0,0.0
1001,1523,2020-03-19 14:59:00,1,1989.0,1760.0,0.885,9.787,31,31,9,22,0,0,0,0,0.0,0.0
1001,1524,2020-03-19 15:02:00,1,2012.0,1716.0,0.853,9.828,8,7,4,3,1,0,1,0,0.0,0.0
1001,1525,2020-03-19 15:05:00,1,2003.0,1681.0,0.839,9.752,9,9,5,4,0,0,0,0,0.0,0.0
1001,1526,2020-03-19 15:08:00,1,2010.0,1724.0,0.858,9.83,11,9,7,2,2,0,2,0,0.0,0.0
1001,1527,2020-03-19 15:11:00,1,2068.0,1749.0,0.846,10.083,60,56,20,36,4,1,3,0,0.0,0.0
1001,1528,2020-03-19 15:14:00,1,2125.0,1779.0,0.837,10.341,38,38,0,38,0,0,0,0,0.01,0.0
1001,1529,2020-03-19 15:17:00,1,2138.0,1802.0,0.843,10.419,55,55,0,55,0,0,0,0,0.0,0.0
1001,1530,2020-03-19 15:20:00,1,2153.0,1783.0,0.828,10.458,32,32,0,32,0,0,0,0,0.0,0.0
1001,1531,2020-03-19 15:23:00,1,2154.0,1778.0,0.826,10.455,50,50,0,50,0,0,0,0,0.0,0.0
1001,1532,2020-03-19 15:26:00,1,2153.0,1769.0,0.822,10.441,32,32,1,31,0,0,0,0,0.0,0.0
1001,1533,2020-03-19 15:29:00,1,2142.0,1765.0,0.824,10.394,7,7,1,6,0,0,0,0,0.0,0.0
1001,1534,2020-03-19 15:32:00,1,2136.0,1829.0,0.856,10.443,199,103,58,45,96,46,50,23,0.0,0.0
1001,1535,2020-03-19 15:35:00,1,2251.0,1994.0,0.886,11.075,33,11,0,11,22,5,17,14,0.0,0.0
1001,1536,2020-03-19 15:38:00,1,2386.0,2104.0,0.882,11.729,248,152,116,36,96,54,42,12,0.0,0.0
1001,1537,2020-03-19 15:41:00,1,2426.0,2196.0,0.905,11.991,145,14,2,12,131,76,55,54,0.0,0.0
1001,1538,2020-03-19 15:44:00,1,2538.0,2321.0,0.915,12.571,117,20,8,12,97,56,41,56,0.0,0.06
1001,1539,2020-03-19 15:47:00,1,2628.0,2377.0,0.904,12.988,140,70,34,36,70,28,42,82,0.0,0.08
1001,1540,2020-03-19 15:50:00,1,2741.0,2496.0,0.911,13.563,97,23,3,20,74,45,29,30,0.01,0.12
1001,1541,2020-03-19 15:53:00,1,2541.0,2339.0,0.92,12.602,341,176,127,49,165,116,49,11,0.14,0.01
1001,1542,2020-03-19 15:56:00,1,2490.0,2278.0,0.915,12.331,611,308,257,51,303,225,78,19,0.0,0.0
1001,1543,2020-03-19 15:59:00,1,2410.0,2269.0,0.941,12.008,190,134,98,36,56,28,28,11,0.0,0.0
1001,1544,2020-03-19 16:02:00,1,1923.0,1723.0,0.896,9.484,8,7,3,4,1,0,1,0,0.0,0.0
1001,1545,2020-03-19 16:05:00,1,1858.0,1671.0,0.899,9.172,3,2,2,0,1,0,1,0,0.0,0.0
1001,1546,2020-03-19 16:08:00,1,1810.0,1567.0,0.865,8.867,0,0,0,0,0,0,0,0,0.0,0.0
1001,1547,2020-03-19 16:11:00,1,1728.0,1547.0,0.895,8.523,13,0,0,0,13,0,13,0,0.01,0.0
1001,1548,2020-03-19 16:14:00,1,1814.0,1554.0,0.857,8.867,18,12,7,5,6,0,6,0,0.0,0.0
1001,1549,2020-03-19 16:17:00,1,1996.0,1754.0,0.879,9.804,39,27,15,12,12,2,10,0,0.0,0.0
1001,1550,2020-03-19 16:20:00,1,2402.0,2281.0,0.95,11.989,8,6,2,4,2,0,2,0,0.0,0.0
1001,1551,2020-03-19 16:23:00,1,2730.0,2529.0,0.926,13.557,3,1,0,1,2,0,2,0,0.0,0.0
1001,1552,2020-03-19 16:26:00,1,2542.0,2387.0,0.939,12.657,8,4,3,1,4,0,4,0,0.0,0.0
1001,1553,2020-03-19 16:29:00,1,2415.0,2243.0,0.929,11.998,38,29,9,20,9,0,9,1,0.0,0.0
1001,1554,2020-03-19 16:32:00,1,2397.0,2312.0,0.965,12.006,81,44,11,33,37,0,37,4,0.0,0.0
1001,1555,2020-03-19 16:35:00,1,2393.0,2296.0,0.96,11.97,95,66,30,36,29,2,27,1,0.0,0.0
1001,1556,2020-03-19 16:38:00,1,2458.0,2392.0,0.973,12.333,78,51,26,25,27,4,23,10,0.01,0.01
1001,1557,2020-03-19 16:41:00,1,2523.0,2401.0,0.952,12.598,17,15,7,8,2,0,2,2,0.0,0.0
1001,1558,2020-03-19 16:44:00,1,2350.0,2218.0,0.944,11.717,17,10,4,6,7,0,7,0,0.0,0.0
1001,1559,2020-03-19 16:47:00,1,2231.0,2101.0,0.942,11.118,8,5,3,2,3,0,3,0,0.0,0.0
1001,1560,2020-03-19 16:50:00,1,2165.5,2013.5,0.9295,10.763,4,3,1,2,1,0,1,0,0.0,0.0
1001,1561,2020-03-19 16:53:00,1,2100.0,1926.0,0.917,10.408,13,11,3,8,2,0,2,0,0.0,0.0
1001,1562,2020-03-19 16:56:00,1,2172.0,1987.0,0.915,10.757,31,30,0,30,1,0,1,0,0.0,0.0
1001,1563,2020-03-19 16:59:00,1,2237.0,2038.0,0.911,11.072,71,60,0,60,11,0,11,0,0.0,0.0
1001,1564,2020-03-19 17:02:00,1,2230.0,2016.0,0.904,11.02,60,60,0,60,0,0,0,0,0.0,0.0
1001,1565,2020-03-19 17:05:00,1,2229.0,2065.0,0.926,11.07,21,16,5,11,5,2,3,0,0.0,0.0
1001,1566,2020-03-19 17:08:00,1,2234.0,2011.0,0.9,11.028,9,9,2,7,0,0,0,0,0.0,0.0
1001,1567,2020-03-19 17:11:00,1,2235.0,2061.0,0.922,11.086,7,6,4,2,1,0,1,0,0.0,0.0
1001,1568,2020-03-19 17:14:00,1,2250.0,2020.0,0.898,11.101,4,4,2,2,0,0,0,0,0.0,0.0
1001,1569,2020-03-19 17:17:00,1,2165.0,1991.0,0.92,10.733,2,2,0,2,0,0,0,0,0.0,0.0
1001,1570,2020-03-19 17:20:00,1,2254.0,1987.0,0.881,11.082,41,39,22,17,2,0,2,2,0.0,0.0
1001,1571,2020-03-19 17:23:00,1,2302.0,2121.0,0.921,11.419,179,168,103,65,11,0,11,9,0.0,0.0
1001,1572,2020-03-19 17:26:00,1,2420.0,2182.0,0.902,11.95,82,59,29,30,23,0,23,8,0.0,0.0
1001,1573,2020-03-19 17:29:00,1,2411.0,2295.0,0.952,12.04,99,93,61,32,6,0,6,1,0.0,0.0
1001,1574,2020-03-19 17:32:00,1,2548.0,2359.0,0.926,12.651,97,60,32,28,37,1,36,2,0.0,0.0
1001,1575,2020-03-19 17:35:00,1,2537.0,2358.0,0.93,12.607,167,72,38,34,95,48,47,61,0.0,0.02
1001,1576,2020-03-19 17:38:00,1,2868.0,2628.0,0.916,14.208,175,46,16,30,129,74,55,60,0.0,0.11
1001,1577,2020-03-19 17:41:00,1,2984.0,2778.0,0.931,14.832,252,125,84,41,127,78,49,32,0.1,0.04
1001,1578,2020-03-19 17:44:00,1,1910.0,1745.0,0.913,9.458,21,1,0,1,20,0,20,0,0.0,0.0
1001,1579,2020-03-19 17:47:00,1,1724.0,1526.0,0.885,8.48,5,1,0,1,4,0,4,0,0.0,0.0
1001,1580,2020-03-19 17:50:00,1,1796.0,1601.0,0.892,8.847,8,4,1,3,4,0,4,0,0.0,0.0
1001,1581,2020-03-19 17:53:00,1,1978.0,1756.0,0.888,9.739,18,2,0,2,16,0,16,0,0.0,0.0
1001,1582,2020-03-19 17:56:00,1,2480.0,2336.0,0.942,12.357,60,36,22,14,24,2,22,0,0.0,0.0
1001,1583,2020-03-19 17:59:00,1,2727.0,2565.0,0.94,13.585,20,10,1,9,10,0,10,0,0.0,0.0
1001,1584,2020-03-19 18:02:00,0,2731.0,2560.0,0.937,13.596,426,245,176,69,181,129,52,20,0.02,0.0
1001,1585,2020-03-19 18:05:00,0,3169.0,2997.0,0.946,15.803,403,195,141,54,208,135,73,38,0.01,0.0
1001,1586,2020-03-19 18:08:00,0,3172.0,3037.0,0.957,15.861,271,189,143,46,82,42,40,64,0.0,0.0
1001,1587,2020-03-19 18:11:00,0,3028.0,2943.0,0.972,15.188,279,144,99,45,135,88,47,45,0.05,0.0
1001,1588,2020-03-19 18:14:00,0,2951.0,2923.0,0.991,14.862,466,284,227,57,182,138,44,50,0.03,0.02
1001,1589,2020-03-19 18:17:00,0,3029.0,2950.0,0.974,15.2,314,203,141,62,111,66,45,39,0.0,0.07
1001,1590,2020-03-19 18:20:00,0,2465.0,2330.0,0.945,12.294,128,115,64,51,13,0,13,18,0.0,0.0
1001,1591,2020-03-19 18:23:00,0,2983.0,2849.0,0.955,14.905,44,35,13,22,9,0,9,10,0.0,0.0
1001,1592,2020-03-19 18:26:00,0,2964.0,2800.0,0.945,14.78,281,194,140,54,87,58,29,22,0.0,0.0
1001,1593,2020-03-19 18:29:00,0,2842.0,2694.0,0.948,14.179,89,43,18,25,46,17,29,2,0.0,0.01
1001,1594,2020-03-19 18:32:00,0,2661.0,2513.0,0.944,13.267,295,171,125,46,124,82,42,18,0.0,0.0
1001,1595,2020-03-19 18:35:00,0,2878.0,2610.0,0.907,14.228,259,116,83,33,143,99,44,22,0.05,0.0
1001,1596,2020-03-19 18:38:00,0,2748.0,2506.0,0.912,13.599,343,199,151,48,144,98,46,69,0.05,0.0
1001,1597,2020-03-19 18:41:00,0,2977.0,2810.0,0.944,14.839,331,175,127,48,156,103,53,34,0.0,0.0
1001,1598,2020-03-19 18:44:00,0,2433.0,2149.0,0.884,11.964,115,82,46,36,33,3,30,3,0.0,0.0
1001,1599,2020-03-19 18:47:00,0,2128.0,1860.0,0.874,10.443,72,57,20,37,15,0,15,1,0.0,0.0
1001,1600,2020-03-19 18:50:00,0,2622.0,2361.0,0.9,12.943,99,67,31,36,32,0,32,8,0.0,0.0
1001,1601,2020-03-19 18:53:00,0,3026.0,2696.0,0.891,14.909,326,180,128,52,146,107,39,19,0.0,0.0
1001,1602,2020-03-19 18:56:00,0,2757.0,2446.0,0.887,13.573,452,305,229,76,147,95,52,39,0.0,0.0
1001,1603,2020-03-19 18:59:00,0,2895.0,2511.0,0.867,14.188,31,22,14,8,9,1,8,0,0.0,0.0
1001,1604,2020-03-19 19:02:00,0,2571.0,2287.0,0.89,12.66,17,10,1,9,7,0,7,0,0.0,0.0
1001,1605,2020-03-19 19:05:00,0,2585.0,2182.0,0.844,12.599,29,27,0,27,2,0,2,0,0.0,0.0
1001,1606,2020-03-19 19:08:00,0,2467.0,2080.0,0.843,12.024,30,23,11,12,7,0,7,1,0.0,0.0
1001,1607,2020-03-19 19:11:00,0,2265.0,1924.0,0.849,11.054,11,2,0,2,9,0,9,0,0.0,0.0
1001,1608,2020-03-19 19:14:00,0,2124.0,1809.0,0.852,10.371,3,0,0,0,3,0,3,0,0.0,0.0
1001,1609,2020-03-19 19:17:00,0,2143.0,1764.0,0.823,10.399,12,8,3,5,4,0,4,0,0.0,0.0
1001,1610,2020-03-19 19:20:00,0,2156.0,1761.0,0.816,10.446,10,10,2,8,0,0,0,0,0.0,0.0
1001,1611,2020-03-19 19:23:00,0,2086.0,1702.0,0.816,10.104,5,3,1,2,2,0,2,0,0.0,0.0
1001,1612,2020-03-19 19:26:00,0,2019.0,1662.0,0.823,9.793,121,102,63,39,19,0,19,25,0.0,0.0
1001,1613,2020-03-19 19:29:00,0,2280.0,1909.0,0.837,11.096,216,120,59,61,96,53,43,23,0.0,0.0
1001,1614,2020-03-19 19:32:00,0,2604.0,2117.0,0.813,12.602,443,265,220,45,178,137,41,47,0.03,0.0
1001,1615,2020-03-19 19:35:00,0,2672.0,2221.0,0.831,12.986,355,221,175,46,134,85,49,45,0.03,0.0
1001,1616,2020-03-19 19:38:00,0,2803.0,2307.0,0.823,13.599,252,142,82,60,110,72,38,15,0.0,0.0
1001,1617,2020-03-19 19:41:00,0,2608.0,2150.0,0.824,12.655,216,88,66,22,128,85,43,12,0.0,0.0
1001,1618,2020-03-19 19:44:00,0,2671.0,2179.0,0.816,12.935,330,146,86,60,184,129,55,37,0.0,0.0
1001,1619,2020-03-19 19:47:00,0,2544.0,2078.0,0.817,12.325,183,81,59,22,102,64,38,35,0.02,0.0
1001,1620,2020-03-19 19:50:00,0,2422.5,1929.5,0.7955,11.6815,155,110,69,41,45,23,22,26,0.0,0.0
1001,1621,2020-03-19 19:53:00,0,2301.0,1781.0,0.774,11.038,245,143,104,39,102,69,33,9,0.0,0.0
1001,1622,2020-03-19 19:56:00,0,2822.0,2265.0,0.803,13.628,134,56,29,27,78,48,30,3,0.0,0.0
1001,1623,2020-03-19 19:59:00,0,2952.0,2320.0,0.786,14.199,103,67,28,39,36,22,14,0,0.0,0.0
1001,1624,2020-03-19 20:02:00,0,2629.0,2066.0,0.786,12.647,130,105,57,48,25,7,18,27,0.0,0.0
1001,1625,2020-03-19 20:05:00,0,2033.0,1580.0,0.777,9.759,266,137,85,52,129,80,49,8,0.0,0.0
1001,1626,2020-03-19 20:08:00,0,2542.0,2040.0,0.802,12.272,254,148,99,49,106,63,43,11,0.0,0.0
1001,1627,2020-03-19 20:11:00,0,2609.0,2081.0,0.798,12.584,113,82,54,28,31,12,19,13,0.0,0.0
1001,1628,2020-03-19 20:14:00,0,2285.0,1855.0,0.812,11.058,610,401,322,79,209,146,63,43,0.0,0.0
1001,1629,2020-03-19 20:17:00,0,2669.0,2176.0,0.815,12.925,161,115,77,38,46,11,35,9,0.0,0.0
1001,1630,2020-03-19 20:20:00,0,2604.0,2116.0,0.813,12.604,747,452,400,52,295,215,80,45,0.0,0.0
1001,1631,2020-03-19 20:23:00,0,2626.0,2121.0,0.808,12.696,284,161,126,35,123,76,47,13,0.0,0.0
1001,1632,2020-03-19 20:26:00,0,2615.0,2076.0,0.794,12.602,72,4,2,2,68,0,68,19,0.0,0.0
1001,1633,2020-03-19 20:29:00,0,2633.0,2075.0,0.788,12.671,109,86,46,40,23,0,23,3,0.0,0.0
1001,1634,2020-03-19 20:32:00,0,2551.0,2037.0,0.798,12.308,82,57,26,31,25,0,25,8,0.0,0.0
1001,1635,2020-03-19 20:35:00,0,2503.0,1908.0,0.762,11.977,7,3,0,3,4,0,4,0,0.0,0.0
1001,1636,2020-03-19 20:38:00,0,2298.0,1785.0,0.777,11.029,10,1,0,1,9,0,9,0,0.0,0.0
1001,1637,2020-03-19 20:41:00,0,2174.0,1666.0,0.766,10.412,15,12,8,4,3,0,3,0,0.0,0.0
1001,1638,2020-03-19 20:44:00,0,2046.0,1593.0,0.779,9.826,4,4,1,3,0,0,0,0,0.0,0.0
1001,1639,2020-03-19 20:47:00,0,1968.0,1530.0,0.778,9.447,0,0,0,0,0,0,0,0,0.0,0.0
1001,1640,2020-03-19 20:50:00,0,1822.0,1476.0,0.81,8.813,2,2,1,1,0,0,0,0,0.0,0.0
1001,1641,2020-03-19 20:53:00,0,1840.0,1460.0,0.793,8.866,34,34,5,29,0,0,0,0,0.0,0.0
1001,1642,2020-03-19 20:56:00,0,1835.0,1431.0,0.78,8.813,39,33,24,9,6,0,6,0,0.0,0.0
1001,1643,2020-03-19 20:59:00,0,1839.0,1454.0,0.79,8.857,13,11,0,11,2,0,2,0,0.0,0.0
1001,1644,2020-03-19 21:02:00,0,1860.0,1376.0,0.74,8.854,43,35,11,24,8,2,6,0,0.0,0.0
1001,1645,2020-03-19 21:05:00,0,1839.0,1415.0,0.769,8.813,33,33,0,33,0,0,0,0,0.0,0.0
1001,1646,2020-03-19 21:08:00,0,1845.0,1389.0,0.753,8.806,10,10,0,10,0,0,0,0,0.0,0.0
1001,1647,2020-03-19 21:11:00,0,1775.0,1373.0,0.774,8.515,11,10,0,10,1,0,1,0,0.0,0.0
1001,1648,2020-03-19 21:14:00,0,1709.0,1334.0,0.781,8.209,14,8,0,8,6,0,6,0,0.0,0.0
1001,1649,2020-03-19 21:17:00,0,1716.0,1336.0,0.779,8.239,0,0,0,0,0,0,0,0,0.0,0.0
1001,1650,2020-03-19 21:20:00,0,1706.0,1309.0,0.767,8.17,29,27,6,21,2,0,2,0,0.0,0.0
1001,1651,2020-03-19 21:23:00,0,1715.0,1297.0,0.756,8.191,128,97,31,66,31,4,27,3,0.0,0.0
1001,1652,2020-03-19 21:26:00,0,1846.0,1453.0,0.787,8.884,104,76,37,39,28,0,28,11,0.0,0.0
1001,1653,2020-03-19 21:29:00,0,2050.0,1593.0,0.777,9.841,137,78,41,37,59,27,32,10,0.0,0.0
1001,1654,2020-03-19 21:32:00,0,2353.0,1890.0,0.803,11.364,249,142,99,43,107,71,36,10,0.0,0.03
1001,1655,2020-03-19 21:35:00,0,2615.0,2042.0,0.781,12.562,325,175,117,58,150,114,36,23,0.0,0.0
1001,1656,2020-03-19 21:38:00,0,2619.0,2128.0,0.813,12.675,219,106,55,51,113,66,47,8,0.0,0.01
1001,1657,2020-03-19 21:41:00,0,2489.0,1928.0,0.774,11.942,240,139,82,57,101,68,33,6,0.0,0.0
1001,1658,2020-03-19 21:44:00,0,2162.0,1721.0,0.796,10.425,260,133,88,45,127,89,38,29,0.0,0.0
1001,1659,2020-03-19 21:47:00,0,2519.0,1854.0,0.736,11.977,184,97,56,41,87,53,34,19,0.0,0.0
1001,1660,2020-03-19 21:50:00,0,2176.0,1627.0,0.747,10.377,123,106,67,39,17,2,15,6,0.0,0.0
1001,1661,2020-03-19 21:53:00,0,2125.0,1588.0,0.747,10.132,931,458,376,82,473,356,117,45,0.0,0.0
1001,1662,2020-03-19 21:56:00,0,2637.0,2060.0,0.781,12.671,482,259,184,75,223,152,71,6,0.0,0.0
1001,1663,2020-03-19 21:59:00,0,2626.0,2030.0,0.773,12.596,738,416,349,67,322,229,93,38,0.0,0.0
1001,1664,2020-03-19 22:02:00,0,2698.0,2088.0,0.774,12.942,237,135,95,40,102,66,36,26,0.0,0.0
1001,1665,2020-03-19 22:05:00,0,2314.0,1775.0,0.767,11.082,88,79,41,38,9,0,9,29,0.0,0.0
1001,1666,2020-03-19 22:08:00,0,2492.0,1962.0,0.787,11.991,35,30,15,15,5,0,5,0,0.0,0.0
1001,1667,2020-03-19 22:11:00,0,2381.0,1815.0,0.762,11.389,32,32,0,32,0,0,0,0,0.0,0.0
1001,1668,2020-03-19 22:14:00,0,2180.0,1681.0,0.771,10.451,3,3,0,3,0,0,0,0,0.0,0.0
1001,1669,2020-03-19 22:17:00,0,2111.0,1553.0,0.736,10.036,13,11,4,7,2,0,2,0,0.0,0.0
1001,1670,2020-03-19 22:20:00,0,2063.0,1495.0,0.724,9.784,30,28,1,27,2,0,2,0,0.0,0.0
1001,1671,2020-03-19 22:23:00,0,1904.0,1450.0,0.761,9.108,9,6,1,5,3,0,3,0,0.0,0.0
1001,1672,2020-03-19 22:26:00,0,1834.0,1422.0,0.776,8.8,24,19,9,10,5,0,5,0,0.0,0.0
1001,1673,2020-03-19 22:29:00,0,1846.0,1392.0,0.754,8.814,28,28,13,15,0,0,0,0,0.0,0.0
1001,1674,2020-03-19 22:32:00,0,1844.0,1387.0,0.752,8.801,3,3,2,1,0,0,0,0,0.0,0.0
1001,1675,2020-03-19 22:35:00,0,1844.0,1430.0,0.776,8.851,77,71,31,40,6,0,6,6,0.0,0.0
1001,1676,2020-03-19 22:38:00,0,2055.0,1508.0,0.734,9.766,177,166,108,58,11,0,11,35,0.0,0.0
1001,1677,2020-03-19 22:41:00,0,2188.0,1627.0,0.744,10.422,43,41,16,25,2,0,2,43,0.0,0.0
1001,1678,2020-03-19 22:44:00,0,2162.0,1707.0,0.79,10.408,211,100,63,37,111,70,41,23,0.0,0.0
1001,1679,2020-03-19 22:47:00,0,2307.0,1800.0,0.78,11.081,316,165,119,46,151,110,41,56,0.02,0.0
1001,1680,2020-03-19 22:50:00,0,2340.0,1819.0,0.777,11.2325,73,72,33,39,1,1,0,10,0.0,0.0
1001,1681,2020-03-19 22:53:00,0,2373.0,1838.0,0.774,11.384,24,16,6,10,8,1,7,5,0.0,0.0
1001,1682,2020-03-19 22:56:00,0,2245.0,1719.0,0.766,10.749,12,3,1,2,9,0,9,0,0.0,0.0
1001,1683,2020-03-19 22:59:00,0,2188.0,1601.0,0.731,10.395,31,0,0,0,31,0,31,0,0.0,0.0
1001,1684,2020-03-19 23:02:00,0,1981.0,1481.0,0.748,9.444,26,22,13,9,4,0,4,0,0.0,0.0
1001,1685,2020-03-19 23:05:00,0,1989.0,1474.0,0.741,9.47,14,10,0,10,4,0,4,0,0.0,0.0
1001,1686,2020-03-19 23:08:00,0,1908.0,1456.0,0.763,9.128,40,35,2,33,5,0,5,0,0.0,0.0
1001,1687,2020-03-19 23:11:00,0,1911.0,1451.0,0.759,9.134,20,0,0,0,20,0,20,0,0.0,0.0
1001,1688,2020-03-19 23:14:00,0,1841.0,1442.0,0.784,8.849,17,3,1,2,14,0,14,2,0.0,0.0
1001,1689,2020-03-19 23:17:00,0,2036.0,1563.0,0.768,9.752,143,87,67,20,56,25,31,7,0.0,0.0
1001,1690,2020-03-19 23:20:00,0,2179.0,1644.0,0.755,10.405,27,13,4,9,14,0,14,2,0.0,0.0
1001,1691,2020-03-19 23:23:00,0,2045.0,1569.0,0.767,9.793,7,6,0,6,1,0,1,0,0.0,0.0
1001,1692,2020-03-19 23:26:00,0,2055.0,1525.0,0.742,9.785,6,6,0,6,0,0,0,0,0.0,0.0
1001,1693,2020-03-19 23:29:00,0,2055.0,1517.0,0.738,9.777,84,70,37,33,14,4,10,0,0.0,0.0
1001,1694,2020-03-19 23:32:00,0,2193.0,1621.0,0.739,10.436,61,57,17,40,4,0,4,1,0.0,0.0
1001,1695,2020-03-19 23:35:00,0,2300.0,1764.0,0.767,11.015,66,38,8,30,28,0,28,7,0.0,0.0
1001,1696,2020-03-19 23:38:00,0,2434.0,1842.0,0.757,11.629,123,99,44,55,24,0,24,5,0.0,0.0
1001,1697,2020-03-19 23:41:00,0,2576.0,1997.0,0.775,12.361,207,119,92,27,88,41,47,18,0.0,0.0
1001,1698,2020-03-19 23:44:00,0,2621.0,2018.0,0.77,12.56,365,190,153,37,175,117,58,62,0.0,0.0
1001,1699,2020-03-19 23:47:00,0,2626.0,2008.0,0.765,12.57,207,141,94,47,66,38,28,20,0.0,0.0
1001,1700,2020-03-19 23:50:00,0,2626.0,2044.0,0.779,12.609,451,308,234,74,143,108,35,27,0.0,0.0
1001,1701,2020-03-19 23:53:00,0,2286.0,1815.0,0.794,11.015,22,22,0,22,0,0,0,1,0.0,0.0
1001,1702,2020-03-19 23:56:00,0,2514.0,1859.0,0.74,11.963,1,1,0,1,0,0,0,0,0.0,0.0
1001,1703,2020-03-19 23:59:00,0,2306.0,1787.0,0.775,11.066,0,0,0,0,0,0,0,0,0.0,0.0
1001,1704,2020-03-20 00:02:00,0,2255.0,1716.0,0.761,10.785,35,34,8,26,1,0,1,0,0.0,0.0
1001,1705,2020-03-20 00:05:00,0,2175.0,1590.0,0.731,10.331,32,32,8,24,0,0,0,0,0.0,0.0
1001,1706,2020-03-20 00:08:00,0,2126.0,1566.0,0.737,10.113,11,11,2,9,0,0,0,0,0.0,0.0
1001,1707,2020-03-20 00:11:00,0,2066.0,1495.0,0.723,9.797,3,3,0,3,0,0,0,0,0.0,0.0
1001,1708,2020-03-20 00:14:00,0,2051.0,1506.0,0.734,9.748,44,44,5,39,0,0,0,0,0.0,0.0
1001,1709,2020-03-20 00:17:00,0,2055.0,1510.0,0.735,9.769,12,12,2,10,0,0,0,0,0.0,0.0
1001,1710,2020-03-20 00:20:00,0,2054.0,1510.0,0.735,9.763,9,9,5,4,0,0,0,0,0.0,0.0
1001,1711,2020-03-20 00:23:00,0,2062.0,1508.0,0.731,9.796,95,77,48,29,18,12,6,5,0.0,0.0
1001,1712,2020-03-20 00:26:00,0,2187.0,1630.0,0.745,10.42,48,42,26,16,6,2,4,12,0.0,0.0
1001,1713,2020-03-20 00:29:00,0,2318.0,1742.0,0.752,11.06,47,47,13,34,0,0,0,5,0.0,0.0
1001,1714,2020-03-20 00:32:00,0,2371.0,1831.0,0.772,11.371,102,87,51,36,15,0,15,3,0.0,0.0
1001,1715,2020-03-20 00:35:00,0,2497.0,1920.0,0.769,11.964,303,179,135,44,124,89,35,23,0.0,0.0
1001,1716,2020-03-20 00:38:00,0,2836.0,2177.0,0.768,13.583,364,207,150,57,157,114,43,17,0.0,0.0
1001,1717,2020-03-20 00:41:00,0,2501.0,1910.0,0.764,11.97,182,96,54,42,86,45,41,10,0.0,0.0
1001,1718,2020-03-20 00:44:00,0,2630.0,2006.0,0.763,12.582,342,184,128,56,158,111,47,31,0.0,0.0
1001,1719,2020-03-20 00:47:00,0,2505.0,1929.0,0.77,12.006,218,140,85,55,78,39,39,11,0.0,0.0
1001,1720,2020-03-20 00:50:00,0,2518.0,1889.0,0.75,12.012,53,35,8,27,18,3,15,0,0.0,0.0
1001,1721,2020-03-20 00:53:00,0,2449.0,1798.0,0.734,11.641,197,119,72,47,78,49,29,18,0.0,0.0
1001,1722,2020-03-20 00:56:00,0,2505.0,1888.0,0.754,11.961,124,83,28,55,41,26,15,9,0.0,0.0
1001,1723,2020-03-20 00:59:00,0,2835.0,2117.0,0.747,13.515,299,175,115,60,124,91,33,30,0.0,0.0
1001,1724,2020-03-20 01:02:00,0,2305.0,1770.0,0.768,11.044,321,180,123,57,141,100,41,55,0.0,0.0
1001,1725,2020-03-20 01:05:00,0,2645.0,2012.0,0.761,12.647,369,263,220,43,106,68,38,35,0.0,0.0
1001,1726,2020-03-20 01:08:00,0,2639.0,1977.0,0.749,12.587,525,201,137,64,324,233,91,7,0.0,0.0
1001,1727,2020-03-20 01:11:00,0,2645.0,1994.0,0.754,12.631,269,171,119,52,98,63,35,13,0.01,0.0
1001,1728,2020-03-20 01:14:00,0,2509.0,1886.0,0.751,11.975,276,178,126,52,98,64,34,22,0.0,0.0
1001,1729,2020-03-20 01:17:00,0,2490.0,1927.0,0.774,11.942,165,105,72,33,60,25,35,5,0.0,0.0
1001,1730,2020-03-20 01:20:00,0,2457.0,1801.0,0.733,11.674,52,32,0,32,20,0,20,0,0.0,0.0
1001,1731,2020-03-20 01:23:00,0,2250.0,1671.0,0.742,10.716,34,22,0,22,12,0,12,0,0.0,0.0
1001,1732,2020-03-20 01:26:00,0,2200.0,1563.0,0.71,10.398,29,26,0,26,3,0,3,0,0.0,0.0
1001,1733,2020-03-20 01:29:00,0,2064.0,1465.0,0.71,9.755,6,6,0,6,0,0,0,0,0.0,0.0
1001,1734,2020-03-20 01:32:00,0,1852.0,1383.0,0.747,8.829,17,14,9,5,3,0,3,0,0.01,0.0
1001,1735,2020-03-20 01:35:00,0,1850.0,1413.0,0.764,8.855,4,4,2,2,0,0,0,0,0.0,0.0
1001,1736,2020-03-20 01:38:00,0,1862.0,1335.0,0.717,8.813,10,10,7,3,0,0,0,2,0.0,0.0
1001,1737,2020-03-20 01:41:00,0,1711.0,1316.0,0.769,8.201,5,5,1,4,0,0,0,0,0.0,0.0
1001,1738,2020-03-20 01:44:00,0,1724.0,1262.0,0.732,8.191,4,4,2,2,0,0,0,0,0.0,0.0
1001,1739,2020-03-20 01:47:00,0,1735.0,1222.0,0.705,8.189,9,9,1,8,0,0,0,0,0.0,0.0
1001,1740,2020-03-20 01:50:00,0,1661.5,1202.0,0.7245,7.878,8,8,1,7,0,0,0,0,0.0,0.0
1001,1741,2020-03-20 01:53:00,0,1588.0,1182.0,0.744,7.567,33,31,15,16,2,0,2,1,0.0,0.0
1001,1742,2020-03-20 01:56:00,0,1733.0,1226.0,0.707,8.187,11,9,2,7,2,0,2,0,0.0,0.0
1001,1743,2020-03-20 01:59:00,0,1722.0,1272.0,0.739,8.195,38,34,2,32,4,0,4,0,0.0,0.0
1001,1744,2020-03-20 02:02:00,0,1717.0,1279.0,0.745,8.183,24,16,10,6,8,0,8,0,0.0,0.0
1001,1745,2020-03-20 02:05:00,0,1712.0,1329.0,0.776,8.218,109,67,25,42,42,15,27,24,0.0,0.0
1001,1746,2020-03-20 02:08:00,0,1907.0,1470.0,0.771,9.142,259,153,100,53,106,75,31,40,0.0,0.0
1001,1747,2020-03-20 02:11:00,0,2284.0,1812.0,0.793,11.005,409,233,184,49,176,132,44,28,0.0,0.0
1001,1748,2020-03-20 02:14:00,0,2171.0,1666.0,0.768,10.397,270,163,103,60,107,72,35,27,0.0,0.0
1001,1749,2020-03-20 02:17:00,0,2583.0,1963.0,0.76,12.349,398,217,153,64,181,127,54,9,0.0,0.0
1001,1750,2020-03-20 02:20:00,0,2648.0,2005.0,0.757,12.653,293,134,74,60,159,105,54,13,0.0,0.0
1001,1751,2020-03-20 02:23:00,0,2711.0,2035.0,0.75,12.936,217,91,51,40,126,84,42,4,0.02,0.0
1001,1752,2020-03-20 02:26:00,0,2510.0,1867.0,0.744,11.958,324,214,160,54,110,76,34,46,0.0,0.0
1001,1753,2020-03-20 02:29:00,0,2527.0,1843.0,0.729,11.999,468,322,258,64,146,113,33,140,0.0,0.0
1001,1754,2020-03-20 02:32:00,0,2629.0,2012.0,0.765,12.587,392,228,173,55,164,113,51,109,0.0,0.0
1001,1755,2020-03-20 02:35:00,0,2642.0,1982.0,0.75,12.605,543,292,229,63,251,186,65,53,0.05,0.0
1001,1756,2020-03-20 02:38:00,0,2503.0,1890.0,0.755,11.954,254,158,114,44,96,62,34,39,0.0,0.0
1001,1757,2020-03-20 02:41:00,0,2647.0,1988.0,0.751,12.629,107,82,48,34,25,1,24,11,0.0,0.0
1001,1758,2020-03-20 02:44:00,0,2570.0,1914.0,0.745,12.245,60,54,30,24,6,0,6,3,0.0,0.0
1001,1759,2020-03-20 02:47:00,0,2510.0,1886.0,0.751,11.978,52,40,0,40,12,0,12,0,0.0,0.0
1001,1760,2020-03-20 02:50:00,0,2307.0,1752.0,0.76,11.028,9,8,0,8,1,0,1,0,0.0,0.0
1001,1761,2020-03-20 02:53:00,0,2188.0,1623.0,0.742,10.417,36,29,0,29,7,0,7,0,0.0,0.0
1001,1762,2020-03-20 02:56:00,0,2056.0,1522.0,0.74,9.788,7,3,0,3,4,0,4,0,0.0,0.0
1001,1763,2020-03-20 02:59:00,0,1997.0,1462.0,0.732,9.487,52,48,14,34,4,0,4,0,0.0,0.0
1001,1764,2020-03-20 03:02:00,0,1857.0,1390.0,0.748,8.854,38,36,0,36,2,0,2,0,0.0,0.0
1001,1765,2020-03-20 03:05:00,0,1862.0,1349.0,0.724,8.83,53,39,0,39,14,0,14,0,0.0,0.0
1001,1766,2020-03-20 03:08:00,0,1706.0,1320.0,0.774,8.184,6,2,0,2,4,0,4,0,0.0,0.0
1001,1767,2020-03-20 03:11:00,0,1705.0,1307.0,0.767,8.165,5,4,0,4,1,0,1,0,0.0,0.0
1001,1768,2020-03-20 03:14:00,0,1773.0,1341.0,0.756,8.472,0,0,0,0,0,0,0,0,0.0,0.0
1001,1769,2020-03-20 03:17:00,0,1856.0,1347.0,0.726,8.804,102,75,48,27,27,0,27,7,0.0,0.0
1001,1770,2020-03-20 03:20:00,0,2069.0,1508.0,0.729,9.82,124,96,50,46,28,0,28,15,0.0,0.0
1001,1771,2020-03-20 03:23:00,0,2160.0,1675.0,0.776,10.364,183,89,48,41,94,51,43,5,0.0,0.0
1001,1772,2020-03-20 03:26:00,0,2308.0,1743.0,0.755,11.023,381,207,150,57,174,129,45,42,0.0,0.0
1001,1773,2020-03-20 03:29:00,0,2502.0,1950.0,0.779,12.016,361,208,146,62,153,105,48,19,0.03,0.0
1001,1774,2020-03-20 03:32:00,0,2513.0,1863.0,0.742,11.964,81,51,27,24,30,21,9,7,0.0,0.0
1001,1775,2020-03-20 03:35:00,0,2375.0,1777.0,0.748,11.324,282,158,105,53,124,91,33,12,0.0,0.0
1001,1776,2020-03-20 03:38:00,0,2166.0,1684.0,0.778,10.398,160,82,38,44,78,35,43,1,0.01,0.0
1001,1777,2020-03-20 03:41:00,0,2536.0,1841.0,0.726,12.032,199,100,73,27,99,57,42,21,0.0,0.0
1001,1778,2020-03-20 03:44:00,0,2513.0,1855.0,0.738,11.955,372,215,182,33,157,107,50,19,0.01,0.0
1001,1779,2020-03-20 03:47:00,0,2653.0,1965.0,0.741,12.629,865,513,439,74,352,275,77,48,0.0,0.0
1001,1780,2020-03-20 03:50:00,0,2493.0,1931.0,0.775,11.962,266,158,115,43,108,63,45,43,0.05,0.0
1001,1781,2020-03-20 03:53:00,0,2490.0,1922.0,0.772,11.938,304,151,100,51,153,99,54,15,0.0,0.0
1001,1782,2020-03-20 03:56:00,0,2503.0,1893.0,0.756,11.959,547,336,274,62,211,146,65,45,0.0,0.0
1001,1783,2020-03-20 03:59:00,0,2392.0,1795.0,0.75,11.412,86,56,18,38,30,4,26,2,0.0,0.0
1001,1784,2020-03-20 04:02:00,0,2383.0,1792.0,0.752,11.374,142,105,66,39,37,20,17,20,0.0,0.0
1001,1785,2020-03-20 04:05:00,0,2306.0,1767.0,0.766,11.042,34,17,1,16,17,5,12,1,0.0,0.0
1001,1786,2020-03-20 04:08:00,0,2331.0,1700.0,0.729,11.067,20,0,0,0,20,0,20,0,0.0,0.0
1001,1787,2020-03-20 04:11:00,0,2192.0,1578.0,0.72,10.384,22,9,5,4,13,0,13,0,0.0,0.0
1001,1788,2020-03-20 04:14:00,0,2047.0,1508.0,0.737,9.735,47,47,0,47,0,0,0,0,0.0,0.0
1001,1789,2020-03-20 04:17:00,0,1855.0,1431.0,0.772,8.893,53,53,0,53,0,0,0,0,0.0,0.0
1001,1790,2020-03-20 04:20:00,0,1860.0,1352.0,0.727,8.827,47,47,0,47,0,0,0,0,0.0,0.0
1001,1791,2020-03-20 04:23:00,0,1718.0,1313.0,0.764,8.224,3,3,0,3,0,0,0,0,0.0,0.0
1001,1792,2020-03-20 04:26:00,0,1725.0,1279.0,0.742,8.212,2,2,1,1,0,0,0,0,0.0,0.0
1001,1793,2020-03-20 04:29:00,0,1736.0,1234.0,0.711,8.205,2,2,1,1,0,0,0,0,0.0,0.0
1001,1794,2020-03-20 04:32:00,0,1658.0,1216.0,0.733,7.878,1,1,0,1,0,0,0,0,0.0,0.0
1001,1795,2020-03-20 04:35:00,0,1577.0,1208.0,0.766,7.552,0,0,0,0,0,0,0,0,0.01,0.0
1001,1796,2020-03-20 04:38:00,0,1729.0,1227.0,0.71,8.17,3,3,1,2,0,0,0,0,0.0,0.0
1001,1797,2020-03-20 04:41:00,0,1731.0,1264.0,0.73,8.219,2,2,1,1,0,0,0,0,0.0,0.0
1001,1798,2020-03-20 04:44:00,0,1720.0,1270.0,0.739,8.182,252,222,162,60,30,14,16,12,0.0,0.0
1001,1799,2020-03-20 04:47:00,0,1850.0,1391.0,0.752,8.83,264,152,108,44,112,77,35,39,0.0,0.0
1001,1800,2020-03-20 04:50:00,0,1948.0,1481.0,0.76,9.316,179,142,100,42,37,23,14,13,0.0,0.0
1001,1801,2020-03-20 04:53:00,0,2046.0,1571.0,0.768,9.802,64,57,24,33,7,4,3,44,0.0,0.0
1001,1802,2020-03-20 04:56:00,0,2189.0,1619.0,0.74,10.417,38,31,15,16,7,3,4,21,0.0,0.0
1001,1803,2020-03-20 04:59:00,0,2363.0,1818.0,0.769,11.323,289,175,136,39,114,67,47,39,0.02,0.0
1001,1804,2020-03-20 05:02:00,0,2304.0,1810.0,0.785,11.083,294,161,112,49,133,92,41,39,0.03,0.0
1001,1805,2020-03-20 05:05:00,0,2383.0,1819.0,0.763,11.401,474,270,225,45,204,145,59,66,0.07,0.0
1001,1806,2020-03-20 05:08:00,0,2524.0,1858.0,0.736,12.004,316,166,125,41,150,106,44,16,0.01,0.0
1001,1807,2020-03-20 05:11:00,0,2306.0,1768.0,0.766,11.043,86,35,10,25,51,13,38,0,0.0,0.0
1001,1808,2020-03-20 05:14:00,0,2306.0,1716.0,0.744,10.987,153,72,29,43,81,30,51,10,0.0,0.0
1001,1809,2020-03-20 05:17:00,0,2326.0,1732.0,0.745,11.083,254,165,116,49,89,55,34,42,0.01,0.0
1001,1810,2020-03-20 05:20:00,0,2369.0,1806.0,0.763,11.332,386,239,169,70,147,88,59,38,0.0,0.0
1001,1811,2020-03-20 05:23:00,0,2534.0,1863.0,0.735,12.046,298,169,121,48,129,82,47,16,0.0,0.0
1001,1812,2020-03-20 05:26:00,0,2529.0,1853.0,0.733,12.016,586,364,284,80,222,168,54,60,0.0,0.0
1001,1813,2020-03-20 05:29:00,0,2509.0,1907.0,0.76,11.997,331,135,97,38,196,138,58,25,0.03,0.0
1001,1814,2020-03-20 05:32:00,0,1846.0,1428.0,0.774,8.856,288,157,100,57,131,79,52,17,0.0,0.0
1001,1815,2020-03-20 05:35:00,0,2370.0,1804.0,0.761,11.337,172,118,70,48,54,36,18,5,0.0,0.0
1001,1816,2020-03-20 05:38:00,0,2365.0,1794.0,0.759,11.303,246,162,116,46,84,48,36,15,0.0,0.0
1001,1817,2020-03-20 05:41:00,0,2379.0,1796.0,0.755,11.362,616,393,304,89,223,155,68,21,0.0,0.0
1001,1818,2020-03-20 05:44:00,0,2379.0,1815.0,0.763,11.381,374,196,148,48,178,120,58,21,0.03,0.0
1001,1819,2020-03-20 05:47:00,0,2319.0,1750.0,0.754,11.076,232,175,113,62,57,35,22,4,0.0,0.0
1001,1820,2020-03-20 05:50:00,0,2318.0,1731.0,0.746,11.051,38,21,10,11,17,0,17,6,0.0,0.0
1001,1821,2020-03-20 05:53:00,0,2318.0,1700.0,0.733,11.015,59,46,14,32,13,0,13,3,0.0,0.0
1001,1822,2020-03-20 05:56:00,0,2242.0,1684.0,0.751,10.7,29,26,3,23,3,0,3,0,0.0,0.0
1001,1823,2020-03-20 05:59:00,0,2106.0,1578.0,0.749,10.047,5,5,2,3,0,0,0,0,0.0,0.0
1001,1824,2020-03-20 06:02:00,1,2062.0,1503.0,0.729,9.789,114,85,41,44,29,5,24,4,0.0,0.0
1001,1825,2020-03-20 06:05:00,1,1985.0,1493.0,0.752,9.475,49,40,17,23,9,4,5,0,0.0,0.0
1001,1826,2020-03-20 06:08:00,1,1849.0,1417.0,0.766,8.853,31,18,0,18,13,1,12,0,0.0,0.0
1001,1827,2020-03-20 06:11:00,1,1777.0,1330.0,0.748,8.473,6,4,1,3,2,0,2,0,0.0,0.0
1001,1828,2020-03-20 06:14:00,1,1723.0,1275.0,0.74,8.202,1,1,0,1,0,0,0,0,0.0,0.0
1001,1829,2020-03-20 06:17:00,1,1584.0,1206.0,0.761,7.576,0,0,0,0,0,0,0,0,0.0,0.0
1001,1830,2020-03-20 06:20:00,1,1584.0,1193.0,0.753,7.563,0,0,0,0,0,0,0,0,0.0,0.0
1001,1831,2020-03-20 06:23:00,1,1588.0,1176.0,0.741,7.558,0,0,0,0,0,0,0,0,0.0,0.0
1001,1832,2020-03-20 06:26:00,1,1585.0,1189.0,0.75,7.56,2,2,0,2,0,0,0,0,0.0,0.0
1001,1833,2020-03-20 06:29:00,1,1591.0,1193.0,0.75,7.591,0,0,0,0,0,0,0,0,0.0,0.0
1001,1834,2020-03-20 06:32:00,1,1588.0,1200.0,0.756,7.587,10,8,3,5,2,0,2,0,0.0,0.0
1001,1835,2020-03-20 06:35:00,1,1584.0,1196.0,0.755,7.566,6,6,1,5,0,0,0,0,0.0,0.0
1001,1836,2020-03-20 06:38:00,1,1578.0,1207.0,0.765,7.555,31,30,5,25,1,0,1,0,0.0,0.0
1001,1837,2020-03-20 06:41:00,1,1577.0,1196.0,0.759,7.538,3,3,0,3,0,0,0,0,0.0,0.0
1001,1838,2020-03-20 06:44:00,1,1574.0,1210.0,0.768,7.543,36,36,2,34,0,0,0,0,0.0,0.0
1001,1839,2020-03-20 06:47:00,1,1582.0,1208.0,0.763,7.571,16,10,1,9,6,0,6,0,0.0,0.0
1001,1840,2020-03-20 06:50:00,1,1595.0,1159.0,0.726,7.567,201,174,126,48,27,7,20,1,0.0,0.0
1001,1841,2020-03-20 06:53:00,1,1704.0,1333.0,0.782,8.188,108,69,33,36,39,17,22,9,0.0,0.0
1001,1842,2020-03-20 06:56:00,1,2037.0,1572.0,0.772,9.767,128,84,21,63,44,13,31,2,0.0,0.0
1001,1843,2020-03-20 06:59:00,1,2498.0,1895.0,0.759,11.94,354,233,171,62,121,75,46,39,0.0,0.0
1001,1844,2020-03-20 07:02:00,1,3078.0,2399.0,0.779,14.784,216,115,76,39,101,68,33,84,0.0,0.0
1001,1845,2020-03-20 07:05:00,1,2833.0,2201.0,0.777,13.598,26,21,12,9,5,0,5,19,0.0,0.26
1001,1846,2020-03-20 07:08:00,1,2795.0,2198.0,0.787,13.446,53,41,11,30,12,1,11,19,0.0,0.0
1001,1847,2020-03-20 07:11:00,1,3000.0,2405.0,0.801,14.483,182,100,57,43,82,42,40,85,0.05,0.05
1001,1848,2020-03-20 07:14:00,1,2947.0,2351.0,0.798,14.216,349,167,118,49,182,126,56,60,0.13,0.03
1001,1849,2020-03-20 07:17:00,1,3066.0,2519.0,0.822,14.87,273,157,111,46,116,76,40,82,0.15,0.04
1001,1850,2020-03-20 07:20:00,1,3236.0,2728.0,0.843,15.772,362,170,128,42,192,145,47,44,0.14,0.13
1001,1851,2020-03-20 07:23:00,1,3110.0,2584.0,0.831,15.115,223,123,73,50,100,58,42,64,0.1,0.0
1001,1852,2020-03-20 07:26:00,1,2729.0,2260.0,0.828,13.253,303,170,116,54,133,90,43,51,0.09,0.0
1001,1853,2020-03-20 07:29:00,1,2447.0,2124.0,0.868,11.994,48,43,20,23,5,2,3,0,0.0,0.0
1001,1854,2020-03-20 07:32:00,1,2161.0,1747.0,0.808,10.447,148,128,76,52,20,2,18,0,0.0,0.0
1001,1855,2020-03-20 07:35:00,1,2012.0,1658.0,0.824,9.765,92,79,40,39,13,3,10,4,0.0,0.0
1001,1856,2020-03-20 07:38:00,1,2133.0,1797.0,0.843,10.395,40,39,2,37,1,1,0,0,0.0,0.0
1001,1857,2020-03-20 07:41:00,1,2149.0,1749.0,0.814,10.404,29,29,8,21,0,0,0,0,0.0,0.0
1001,1858,2020-03-20 07:44:00,1,2337.0,2012.0,0.861,11.434,0,0,0,0,0,0,0,0,0.0,0.0
1001,1859,2020-03-20 07:47:00,1,2770.0,2407.0,0.869,13.579,38,25,10,15,13,0,13,0,0.0,0.0
1001,1860,2020-03-20 07:50:00,1,2605.5,2297.0,0.8825,12.808,12,0,0,0,12,0,12,0,0.0,0.0
1001,1861,2020-03-20 07:53:00,1,2441.0,2187.0,0.896,12.037,4,1,0,1,3,0,3,0,0.0,0.0
1001,1862,2020-03-20 07:56:00,1,2368.0,2084.0,0.88,11.639,8,0,0,0,8,0,8,0,0.0,0.0
1001,1863,2020-03-20 07:59:00,1,2241.0,2036.0,0.909,11.082,1,0,0,0,1,0,1,0,0.0,0.0
1001,1864,2020-03-20 08:02:00,1,2103.0,1962.0,0.933,10.46,86,49,23,26,37,12,25,2,0.0,0.0
1001,1865,2020-03-20 08:05:00,1,2229.0,2019.0,0.906,11.016,173,112,61,51,61,27,34,47,0.0,0.0
1001,1866,2020-03-20 08:08:00,1,2540.0,2398.0,0.944,12.661,194,84,34,50,110,62,48,82,0.0,0.0
1001,1867,2020-03-20 08:11:00,1,2602.0,2439.0,0.937,12.952,215,113,69,44,102,60,42,44,0.07,0.01
1001,1868,2020-03-20 08:14:00,1,2591.0,2462.0,0.95,12.933,213,85,44,41,128,87,41,60,0.0,0.02
1001,1869,2020-03-20 08:17:00,1,2546.0,2313.0,0.909,12.59,138,106,54,52,32,1,31,91,0.0,0.06
1001,1870,2020-03-20 08:20:00,1,2523.0,2367.0,0.938,12.562,121,83,37,46,38,3,35,98,0.0,0.09
1001,1871,2020-03-20 08:23:00,1,2719.0,2578.0,0.948,13.568,169,85,58,27,84,48,36,53,0.08,0.07
1001,1872,2020-03-20 08:26:00,1,2841.0,2714.0,0.955,14.198,289,185,122,63,104,70,34,28,0.01,0.07
1001,1873,2020-03-20 08:29:00,1,2426.0,2251.0,0.928,12.05,58,49,20,29,9,0,9,0,0.0,0.0
1001,1874,2020-03-20 08:32:00,1,2239.0,2017.0,0.901,11.053,19,13,8,5,6,1,5,0,0.0,0.0
1001,1875,2020-03-20 08:35:00,1,2101.0,1969.0,0.937,10.46,9,7,4,3,2,0,2,0,0.0,0.0
1001,1876,2020-03-20 08:38:00,1,2102.0,1937.0,0.922,10.424,11,10,6,4,1,0,1,0,0.0,0.0
1001,1877,2020-03-20 08:41:00,1,2115.0,1926.0,0.911,10.465,14,11,2,9,3,0,3,0,0.0,0.0
1001,1878,2020-03-20 08:44:00,1,2125.0,1929.0,0.908,10.508,53,52,25,27,1,0,1,0,0.0,0.0
1001,1879,2020-03-20 08:47:00,1,2108.0,1921.0,0.911,10.431,164,163,122,41,1,0,1,0,0.0,0.0
1001,1880,2020-03-20 08:50:00,1,2111.0,1937.0,0.918,10.464,94,94,34,60,0,0,0,0,0.0,0.0
1001,1881,2020-03-20 08:53:00,1,1759.0,1747.0,0.993,8.864,134,86,45,41,48,31,17,5,0.0,0.0
1001,1882,2020-03-20 08:56:00,1,2725.0,2637.0,0.968,13.657,131,72,36,36,59,32,27,49,0.08,0.0
1001,1883,2020-03-20 08:59:00,1,2716.0,2630.0,0.968,13.614,192,127,84,43,65,27,38,83,0.01,0.0
1001,1884,2020-03-20 09:02:00,1,2764.0,2678.0,0.969,13.853,149,95,43,52,54,4,50,92,0.01,0.01
1001,1885,2020-03-20 09:05:00,1,2717.0,2658.0,0.978,13.65,131,89,48,41,42,0,42,94,0.0,0.06
1001,1886,2020-03-20 09:08:00,1,2845.0,2816.0,0.99,14.329,174,87,50,37,87,49,38,11,0.21,0.02
1001,1887,2020-03-20 09:11:00,1,2078.0,2046.0,0.984,10.451,32,5,0,5,27,0,27,0,0.0,0.0
1001,1888,2020-03-20 09:14:00,1,1751.0,1759.0,1.005,8.845,47,0,0,0,47,0,47,0,0.01,0.0
1001,1889,2020-03-20 09:17:00,1,1641.0,1591.0,0.97,8.225,19,3,0,3,16,0,16,0,0.0,0.0
1001,1890,2020-03-20 09:20:00,1,1788.0,1646.0,0.921,8.868,16,12,1,11,4,0,4,0,0.0,0.0
1001,1891,2020-03-20 09:23:00,1,1965.0,1853.0,0.943,9.793,27,24,15,9,3,0,3,0,0.0,0.0
1001,1892,2020-03-20 09:26:00,1,1948.0,1913.0,0.982,9.794,29,28,5,23,1,0,1,0,0.0,0.0
1001,1893,2020-03-20 09:29:00,1,2094.0,1987.0,0.949,10.451,5,4,0,4,1,0,1,0,0.0,0.0
1001,1894,2020-03-20 09:32:00,1,1832.0,1775.0,0.969,9.183,5,0,0,0,5,0,5,0,0.0,0.0
1001,1895,2020-03-20 09:35:00,1,2091.0,1990.0,0.952,10.443,14,10,6,4,4,0,4,0,0.0,0.0
1001,1896,2020-03-20 09:38:00,1,2507.0,2547.0,1.016,12.698,42,37,16,21,5,2,3,0,0.0,0.0
1001,1897,2020-03-20 09:41:00,1,2511.0,2449.0,0.976,12.603,22,21,3,18,1,0,1,0,0.0,0.0
1001,1898,2020-03-20 09:44:00,1,2388.0,2379.0,0.996,12.041,1,1,0,1,0,0,0,0,0.0,0.0
1001,1899,2020-03-20 09:47:00,1,2397.0,2282.0,0.952,11.97,20,10,4,6,10,0,10,0,0.0,0.0
1001,1900,2020-03-20 09:50:00,1,2335.0,2270.0,0.972,11.713,94,70,38,32,24,1,23,1,0.0,0.0
1001,1901,2020-03-20 09:53:00,1,2397.0,2368.0,0.988,12.066,124,79,48,31,45,6,39,6,0.0,0.0
1001,1902,2020-03-20 09:56:00,1,2376.0,2408.0,1.013,12.026,90,72,33,39,18,1,17,5,0.0,0.0
1001,1903,2020-03-20 09:59:00,1,2362.0,2435.0,1.031,12.003,59,40,12,28,19,2,17,2,0.0,0.01
1001,1904,2020-03-20 10:02:00,1,2379.0,2376.0,0.999,12.003,28,27,2,25,1,1,0,0,0.0,0.0
1001,1905,2020-03-20 10:05:00,1,2262.0,2236.0,0.989,11.387,12,12,2,10,0,0,0,0,0.0,0.0
1001,1906,2020-03-20 10:08:00,1,2219.0,2116.0,0.954,11.085,25,25,0,25,0,0,0,0,0.0,0.0
1001,1907,2020-03-20 10:11:00,1,2067.0,2032.0,0.983,10.394,78,35,12,23,43,30,13,0,0.01,0.0
1001,1908,2020-03-20 10:14:00,1,2276.0,2224.0,0.977,11.429,229,147,90,57,82,39,43,79,0.0,0.05
1001,1909,2020-03-20 10:17:00,1,2532.0,2417.0,0.955,12.651,162,110,64,46,52,15,37,83,0.0,0.0
1001,1910,2020-03-20 10:20:00,1,2498.0,2505.0,1.003,12.615,219,119,70,49,100,58,42,85,0.0,0.01
1001,1911,2020-03-20 10:23:00,1,2709.0,2685.0,0.991,13.644,339,160,113,47,179,133,46,25,0.05,0.0
1001,1912,2020-03-20 10:26:00,1,2191.0,2218.0,1.012,11.088,312,193,148,45,119,82,37,12,0.0,0.0
1001,1913,2020-03-20 10:29:00,1,2201.0,2212.0,1.005,11.119,614,351,281,70,263,186,77,29,0.05,0.0
1001,1914,2020-03-20 10:32:00,1,2533.0,2403.0,0.949,12.64,367,217,162,55,150,98,52,14,0.0,0.03
1001,1915,2020-03-20 10:35:00,1,2154.0,2059.0,0.956,10.766,408,277,214,63,131,81,50,17,0.0,0.0
1001,1916,2020-03-20 10:38:00,1,2393.0,2386.0,0.997,12.068,194,141,107,34,53,24,29,17,0.0,0.0
1001,1917,2020-03-20 10:41:00,1,2146.0,2050.0,0.955,10.726,31,29,12,17,2,1,1,0,0.0,0.0
1001,1918,2020-03-20 10:44:00,1,2520.0,2443.0,0.969,12.633,20,19,5,14,1,0,1,0,0.0,0.0
1001,1919,2020-03-20 10:47:00,1,2374.0,2361.0,0.995,11.969,42,40,1,39,2,0,2,0,0.0,0.0
1001,1920,2020-03-20 10:50:00,1,2297.5,2232.0,0.971,11.5235,40,35,19,16,5,2,3,0,0.0,0.0
1001,1921,2020-03-20 10:53:00,1,2221.0,2103.0,0.947,11.078,25,24,0,24,1,0,1,0,0.0,0.0
1001,1922,2020-03-20 10:56:00,1,2087.0,2007.0,0.961,10.444,53,53,0,53,0,0,0,0,0.0,0.0
1001,1923,2020-03-20 10:59:00,1,2040.0,1919.0,0.941,10.162,61,58,8,50,3,0,3,0,0.01,0.0
1001,1924,2020-03-20 11:02:00,1,1976.0,1813.0,0.917,9.794,5,5,3,2,0,0,0,0,0.0,0.0
1001,1925,2020-03-20 11:05:00,1,1830.0,1754.0,0.959,9.152,52,50,19,31,2,0,2,0,0.0,0.0
1001,1926,2020-03-20 11:08:00,1,1760.0,1727.0,0.981,8.848,97,96,32,64,1,0,1,0,0.0,0.0
1001,1927,2020-03-20 11:11:00,1,1760.0,1720.0,0.977,8.837,33,27,3,24,6,0,6,0,0.0,0.0
1001,1928,2020-03-20 11:14:00,1,1752.0,1781.0,1.016,8.876,101,101,33,68,0,0,0,0,0.01,0.0
1001,1929,2020-03-20 11:17:00,1,1755.0,1770.0,1.009,8.873,69,67,27,40,2,0,2,0,0.0,0.0
1001,1930,2020-03-20 11:20:00,1,1768.0,1715.0,0.97,8.866,48,27,10,17,21,0,21,0,0.0,0.0
1001,1931,2020-03-20 11:23:00,1,1769.0,1688.0,0.954,8.836,37,34,15,19,3,0,3,0,0.0,0.0
1001,1932,2020-03-20 11:26:00,1,1767.0,1735.0,0.982,8.884,1,1,0,1,0,0,0,0,0.0,0.0
1001,1933,2020-03-20 11:29:00,1,1770.0,1690.0,0.954,8.846,28,28,1,27,0,0,0,0,0.0,0.0
1001,1934,2020-03-20 11:32:00,1,1776.0,1686.0,0.949,8.864,73,71,19,52,2,1,1,0,0.0,0.0
1001,1935,2020-03-20 11:35:00,1,1756.0,1737.0,0.989,8.839,9,9,1,8,0,0,0,0,0.0,0.0
1001,1936,2020-03-20 11:38:00,1,1755.0,1710.0,0.974,8.81,3,3,1,2,0,0,0,0,0.0,0.0
1001,1937,2020-03-20 11:41:00,1,1761.0,1734.0,0.985,8.856,11,11,1,10,0,0,0,0,0.0,0.0
1001,1938,2020-03-20 11:44:00,1,1765.0,1720.0,0.974,8.857,31,31,9,22,0,0,0,0,0.0,0.0
1001,1939,2020-03-20 11:47:00,1,1769.0,1661.0,0.939,8.809,2,2,1,1,0,0,0,0,0.0,0.0
1001,1940,2020-03-20 11:50:00,1,1633.0,1594.0,0.976,8.2,40,40,10,30,0,0,0,1,0.0,0.0
1001,1941,2020-03-20 11:53:00,1,1709.0,1636.0,0.958,8.543,61,61,0,61,0,0,0,0,0.0,0.0
1001,1942,2020-03-20 11:56:00,1,1633.0,1579.0,0.967,8.181,41,41,2,39,0,0,0,0,0.0,0.0
1001,1943,2020-03-20 11:59:00,1,1641.0,1598.0,0.974,8.235,184,166,101,65,18,5,13,28,0.0,0.0
1001,1944,2020-03-20 12:02:00,1,1968.0,1852.0,0.941,9.805,60,33,5,28,27,0,27,8,0.0,0.0
1001,1945,2020-03-20 12:05:00,1,1948.0,1930.0,0.991,9.81,212,177,111,66,35,4,31,22,0.0,0.0
1001,1946,2020-03-20 12:08:00,1,2142.0,2082.0,0.972,10.744,227,132,82,50,95,54,41,73,0.0,0.0
1002,1,2020-03-16 10:53:00,1,4922.0,3781.0,0.7685,23.5785,421,264,208,56,157,111,46,4,0.0,0.0
1002,2,2020-03-16 10:56:00,1,5010.0,3803.0,0.759,23.95,477,353,288,65,124,90,34,7,0.04,0.01
1002,3,2020-03-16 10:59:00,1,4611.0,3572.0,0.775,22.123,520,385,303,82,135,94,41,8,0.01,0.02
1002,4,2020-03-16 11:02:00,1,4760.0,3680.0,0.773,22.831,320,217,172,45,103,67,36,5,0.0,0.0
1002,5,2020-03-16 11:05:00,1,4616.0,3559.0,0.771,22.128,372,227,166,61,145,102,43,2,0.0,0.0
1002,6,2020-03-16 11:08:00,1,4612.0,3571.0,0.774,22.125,147,100,56,44,47,14,33,4,0.0,0.0
1002,7,2020-03-16 11:11:00,1,4439.0,3492.0,0.787,21.356,277,185,142,43,92,55,37,7,0.06,0.0
1002,8,2020-03-16 11:14:00,1,4217.0,3296.0,0.782,20.265,11,8,2,6,3,1,2,0,0.0,0.0
1002,9,2020-03-16 11:17:00,1,4241.0,3230.0,0.762,20.286,325,211,163,48,114,79,35,10,0.01,0.0
1002,10,2020-03-16 11:20:00,1,5190.0,3892.0,0.75,24.76,697,512,397,115,185,132,53,5,0.0,0.0
1002,11,2020-03-16 11:23:00,1,5151.0,3939.0,0.765,24.658,710,526,425,101,184,139,45,6,0.0,0.28
1002,12,2020-03-16 11:26:00,1,5156.0,3931.0,0.762,24.667,540,444,362,82,96,64,32,6,0.0,0.58
1002,13,2020-03-16 11:29:00,1,4401.0,3334.0,0.758,21.032,112,63,35,28,49,35,14,2,0.06,0.0
1002,14,2020-03-16 11:32:00,1,3688.0,2837.0,0.769,17.673,32,26,11,15,6,1,5,2,0.0,0.0
1002,15,2020-03-16 11:35:00,1,3703.0,2797.0,0.755,17.685,11,4,2,2,7,1,6,0,0.01,0.0
1002,16,2020-03-16 11:38:00,1,3535.0,2637.0,0.746,16.848,32,27,1,26,5,0,5,0,0.0,0.0
1002,17,2020-03-16 11:41:00,1,3400.0,2550.0,0.75,16.219,2,1,0,1,1,0,1,0,0.0,0.0
1002,18,2020-03-16 11:44:00,1,3070.0,2371.0,0.772,14.723,3,0,0,0,3,1,2,0,0.0,0.0
1002,19,2020-03-16 11:47:00,1,2926.0,2203.0,0.753,13.966,187,116,77,39,71,49,22,8,0.05,0.0
1002,20,2020-03-16 11:50:00,1,3848.0,2938.0,0.764,18.414,664,483,386,97,181,131,50,17,0.01,0.0
1002,21,2020-03-16 11:53:00,1,4254.0,3218.0,0.757,20.325,727,523,418,105,204,144,60,8,0.0,0.0
1002,22,2020-03-16 11:56:00,1,4468.0,3445.0,0.771,21.419,387,200,141,59,187,132,55,12,0.0,0.0
1002,23,2020-03-16 11:59:00,1,4442.0,3450.0,0.777,21.32,553,378,306,72,175,138,37,4,0.0,0.0
1002,24,2020-03-16 12:02:00,1,4157.0,3161.0,0.76,19.877,358,284,214,70,74,49,25,7,0.01,0.0
1002,25,2020-03-16 12:05:00,1,4213.0,3234.0,0.768,20.182,247,217,168,49,30,15,15,0,0.0,0.0
1002,26,2020-03-16 12:08:00,1,4071.0,3102.0,0.762,19.475,258,176,132,44,82,56,26,4,0.0,0.0
1002,27,2020-03-16 12:11:00,1,4238.0,3215.0,0.759,20.257,495,349,271,78,146,106,40,4,0.0,0.0
1002,28,2020-03-16 12:14:00,1,3992.0,3023.0,0.757,19.076,381,205,140,65,176,125,51,6,0.0,0.0
1002,29,2020-03-16 12:17:00,1,3916.0,3031.0,0.774,18.785,224,91,61,30,133,76,57,7,0.01,0.0
1002,30,2020-03-16 12:20:00,1,3676.0,2922.0,0.795,17.718,232,131,79,52,101,58,43,8,0.0,0.0
1002,31,2020-03-16 12:23:00,1,3731.0,2953.0,0.791,17.97,230,132,93,39,98,63,35,15,0.05,0.0
1002,32,2020-03-16 12:26:00,1,3761.0,2950.0,0.784,18.085,197,6,0,6,191,159,32,0,0.0,0.0
1002,33,2020-03-16 12:29:00,1,3395.0,2601.0,0.766,16.257,22,17,6,11,5,1,4,0,0.0,0.0
1002,34,2020-03-16 12:32:00,1,2977.0,2349.0,0.789,14.332,31,23,1,22,8,0,8,0,0.01,0.0
1002,35,2020-03-16 12:35:00,1,2991.0,2306.0,0.771,14.339,3,1,1,0,2,0,2,0,0.0,0.0
1002,36,2020-03-16 12:38:00,1,2853.0,2184.0,0.765,13.659,7,3,1,2,4,0,4,0,0.0,0.0
1002,37,2020-03-16 12:41:00,1,2692.0,2066.0,0.767,12.893,22,1,0,1,21,0,21,0,0.0,0.0
1002,38,2020-03-16 12:44:00,1,2460.0,1929.0,0.784,11.828,28,28,12,16,0,0,0,0,0.0,0.0
1002,39,2020-03-16 12:47:00,1,2468.0,1875.0,0.76,11.799,30,30,1,29,0,0,0,0,0.0,0.0
1002,40,2020-03-16 12:50:00,1,2458.0,1868.0,0.76,11.754,9,9,3,6,0,0,0,0,0.02,0.0
1002,41,2020-03-16 12:53:00,1,2475.0,1861.0,0.752,11.811,55,17,10,7,38,23,15,2,0.0,0.0
1002,42,2020-03-16 12:56:00,1,2591.0,2070.0,0.799,12.499,45,26,7,19,19,10,9,0,0.0,0.0
1002,43,2020-03-16 12:59:00,1,2612.0,2004.0,0.767,12.512,10,3,0,3,7,0,7,0,0.0,0.0
1002,44,2020-03-16 13:02:00,1,2451.0,1957.0,0.799,11.824,11,3,0,3,8,0,8,0,0.0,0.0
1002,45,2020-03-16 13:05:00,1,2463.0,1867.0,0.758,11.771,3,3,0,3,0,0,0,0,0.0,0.0
1002,46,2020-03-16 13:08:00,1,2468.0,1867.0,0.757,11.791,0,0,0,0,0,0,0,0,0.0,0.0
1002,47,2020-03-16 13:11:00,1,2472.0,1839.0,0.744,11.775,15,4,0,4,11,0,11,0,0.0,0.0
1002,48,2020-03-16 13:14:00,1,2312.0,1756.0,0.76,11.053,1,0,0,0,1,0,1,0,0.0,0.0
1002,49,2020-03-16 13:17:00,1,2305.0,1756.0,0.762,11.025,0,0,0,0,0,0,0,0,0.0,0.0
1002,50,2020-03-16 13:20:00,1,2304.0,1794.0,0.779,11.063,5,3,2,1,2,0,2,0,0.0,0.0
1002,51,2020-03-16 13:23:00,1,2382.0,1823.0,0.765,11.405,2,0,0,0,2,0,2,0,0.01,0.0
1002,52,2020-03-16 13:26:00,1,2252.0,1667.0,0.74,10.72,6,4,1,3,2,1,1,0,0.0,0.0
1002,53,2020-03-16 13:29:00,1,2071.0,1621.0,0.783,9.953,24,1,1,0,23,2,21,0,0.0,0.0
1002,54,2020-03-16 13:32:00,1,2258.0,1660.0,0.735,10.734,9,0,0,0,9,0,9,0,0.0,0.0
1002,55,2020-03-16 13:35:00,1,2313.0,1774.0,0.767,11.077,6,6,0,6,0,0,0,0,0.0,0.0
1002,56,2020-03-16 13:38:00,1,2305.0,1801.0,0.782,11.075,21,18,0,18,3,0,3,0,0.0,0.0
1002,57,2020-03-16 13:41:00,1,2384.0,1800.0,0.755,11.385,17,15,0,15,2,1,1,0,0.01,0.0
1002,58,2020-03-16 13:44:00,1,2460.0,1918.0,0.78,11.816,234,97,54,43,137,92,45,9,0.04,0.0
1002,59,2020-03-16 13:47:00,1,3005.0,2315.0,0.77,14.405,288,138,97,41,150,112,38,8,0.0,0.0
1002,60,2020-03-16 13:50:00,1,2983.0,2382.0,0.799,14.391,42,15,6,9,27,6,21,0,0.01,0.0
1002,61,2020-03-16 13:53:00,1,3239.5,2457.5,0.762,15.4845,227,130,81,49,97,71,26,3,0.0,0.0
1002,62,2020-03-16 13:56:00,1,3496.0,2533.0,0.725,16.578,528,374,287,87,154,105,49,7,0.0,0.0
1002,63,2020-03-16 13:59:00,1,3570.0,2592.0,0.726,16.936,433,292,216,76,141,86,55,9,0.0,0.0
1002,64,2020-03-16 14:02:00,1,3490.0,2509.0,0.719,16.529,131,73,42,31,58,18,40,0,0.0,0.0
1002,65,2020-03-16 14:05:00,1,3484.0,2578.0,0.74,16.58,97,65,26,39,32,13,19,1,0.0,0.0
1002,66,2020-03-16 14:08:00,1,3495.0,2573.0,0.736,16.618,58,40,18,22,18,6,12,2,0.0,0.0
1002,67,2020-03-16 14:11:00,1,3483.0,2535.0,0.728,16.532,115,66,37,29,49,17,32,2,0.0,0.0
1002,68,2020-03-16 14:14:00,1,3078.0,2342.0,0.761,14.721,10,5,0,5,5,1,4,0,0.0,0.0
1002,69,2020-03-16 14:17:00,1,2935.0,2159.0,0.735,13.955,0,0,0,0,0,0,0,0,0.01,0.0
1002,70,2020-03-16 14:20:00,1,2718.0,1980.0,0.729,12.903,10,5,0,5,5,2,3,0,0.0,0.0
1002,71,2020-03-16 14:23:00,1,2566.0,1873.0,0.73,12.184,3,0,0,0,3,0,3,0,0.0,0.0
1002,72,2020-03-16 14:26:00,1,2393.0,1761.0,0.736,11.378,5,3,2,1,2,1,1,0,0.0,0.0
1002,73,2020-03-16 14:29:00,1,2392.0,1756.0,0.734,11.37,10,7,0,7,3,0,3,0,0.01,0.0
1002,74,2020-03-16 14:32:00,1,2406.0,1753.0,0.729,11.423,4,4,0,4,0,0,0,0,0.0,0.0
1002,75,2020-03-16 14:35:00,1,2416.0,1725.0,0.714,11.428,17,12,0,12,5,1,4,0,0.0,0.0
1002,76,2020-03-16 14:38:00,1,2418.0,1730.0,0.715,11.445,0,0,0,0,0,0,0,0,0.0,0.0
1002,77,2020-03-16 14:41:00,1,2424.0,1715.0,0.707,11.451,13,11,0,11,2,1,1,0,0.0,0.0
1002,78,2020-03-16 14:44:00,1,2333.0,1646.0,0.706,11.013,2,2,1,1,0,0,0,0,0.0,0.0
1002,79,2020-03-16 14:47:00,1,2166.0,1581.0,0.73,10.284,5,0,0,0,5,1,4,0,0.0,0.0
1002,80,2020-03-16 14:50:00,1,2254.0,1615.0,0.717,10.669,5,2,1,1,3,1,2,0,0.0,0.0
1002,81,2020-03-16 14:53:00,1,2169.0,1596.0,0.736,10.315,7,0,0,0,7,1,6,0,0.0,0.0
1002,82,2020-03-16 14:56:00,1,2250.0,1616.0,0.718,10.654,13,11,6,5,2,0,2,0,0.0,0.0
1002,83,2020-03-16 14:59:00,1,2161.0,1581.0,0.731,10.266,13,6,1,5,7,2,5,0,0.01,0.0
1002,84,2020-03-16 15:02:00,1,2160.0,1569.0,0.726,10.248,1,1,1,0,0,0,0,0,0.0,0.0
1002,85,2020-03-16 15:05:00,1,2168.0,1589.0,0.733,10.303,0,0,0,0,0,0,0,0,0.0,0.0
1002,86,2020-03-16 15:08:00,1,2244.0,1607.0,0.716,10.619,4,0,0,0,4,0,4,0,0.01,0.0
1002,87,2020-03-16 15:11:00,1,2427.0,1660.0,0.684,11.401,140,63,43,20,77,53,24,4,0.0,0.0
1002,88,2020-03-16 15:14:00,1,2720.0,1981.0,0.728,12.912,95,47,25,22,48,25,23,1,0.0,0.0
1002,89,2020-03-16 15:17:00,1,2786.0,2072.0,0.744,13.271,130,52,16,36,78,30,48,3,0.0,0.0
1002,90,2020-03-16 15:20:00,1,2937.0,2152.0,0.733,13.955,57,23,3,20,34,12,22,4,0.0,0.0
1002,91,2020-03-16 15:23:00,1,2942.0,2192.0,0.745,14.018,68,36,14,22,32,7,25,0,0.0,0.0
1002,92,2020-03-16 15:26:00,1,2954.0,2189.0,0.741,14.062,244,161,98,63,83,49,34,0,0.0,0.0
1002,93,2020-03-16 15:29:00,1,2932.0,2243.0,0.765,14.037,146,109,72,37,37,27,10,10,0.0,0.0
1002,94,2020-03-16 15:32:00,1,2948.0,2159.0,0.733,14.005,8,0,0,0,8,0,8,0,0.0,0.0
1002,95,2020-03-16 15:35:00,1,2639.0,1952.0,0.74,12.561,10,0,0,0,10,3,7,0,0.0,0.0
1002,96,2020-03-16 15:38:00,1,2407.0,1763.0,0.733,11.435,35,17,9,8,18,10,8,0,0.0,0.0
1002,97,2020-03-16 15:41:00,1,2430.0,1667.0,0.686,11.419,9,0,0,0,9,2,7,0,0.0,0.0
1002,98,2020-03-16 15:44:00,1,2168.0,1581.0,0.729,10.294,8,0,0,0,8,3,5,0,0.0,0.0
1002,99,2020-03-16 15:47:00,1,2175.0,1560.0,0.717,10.296,58,9,4,5,49,23,26,0,0.0,0.0
1002,100,2020-03-16 15:50:00,1,2250.0,1637.0,0.727,10.677,1,0,0,0,1,0,1,0,0.01,0.0
1002,101,2020-03-16 15:53:00,1,2175.0,1603.0,0.737,10.345,5,0,0,0,5,1,4,0,0.0,0.0
1002,102,2020-03-16 15:56:00,1,2173.0,1577.0,0.726,10.307,17,4,1,3,13,5,8,0,0.0,0.0
1002,103,2020-03-16 15:59:00,1,2160.0,1599.0,0.74,10.28,42,17,11,6,25,9,16,0,0.0,0.0
1002,104,2020-03-16 16:02:00,1,2250.0,1633.0,0.726,10.675,6,5,1,4,1,0,1,0,0.0,0.0
1002,105,2020-03-16 16:05:00,1,2178.0,1538.0,0.706,10.285,0,0,0,0,0,0,0,0,0.0,0.0
1002,106,2020-03-16 16:08:00,1,2025.0,1426.0,0.704,9.558,6,4,1,3,2,0,2,0,0.0,0.0
1002,107,2020-03-16 16:11:00,1,2028.0,1396.0,0.689,9.537,8,3,0,3,5,2,3,0,0.01,0.0
1002,108,2020-03-16 16:14:00,1,2010.0,1474.0,0.734,9.552,60,60,0,60,0,0,0,0,0.0,0.0
1002,109,2020-03-16 16:17:00,1,2100.0,1499.0,0.714,9.933,11,5,0,5,6,1,5,0,0.0,0.0
1002,110,2020-03-16 16:20:00,1,2174.0,1567.0,0.721,10.301,7,1,0,1,6,2,4,0,0.0,0.0
1002,111,2020-03-16 16:23:00,1,2187.0,1509.0,0.69,10.289,0,0,0,0,0,0,0,0,0.0,0.0
1002,112,2020-03-16 16:26:00,1,2039.0,1409.0,0.691,9.592,2,2,0,2,0,0,0,0,0.0,0.0
1002,113,2020-03-16 16:29:00,1,2034.0,1389.0,0.683,9.551,0,0,0,0,0,0,0,0,0.0,0.0
1002,114,2020-03-16 16:32:00,1,1864.0,1353.0,0.726,8.841,3,1,0,1,2,0,2,0,0.01,0.0
1002,115,2020-03-16 16:35:00,1,2035.0,1416.0,0.696,9.586,3,0,0,0,3,2,1,0,0.0,0.0
1002,116,2020-03-16 16:38:00,1,2017.0,1423.0,0.706,9.523,40,6,1,5,34,16,18,0,0.0,0.0
1002,117,2020-03-16 16:41:00,1,2246.0,1665.0,0.741,10.693,67,47,22,25,20,8,12,3,0.0,0.0
1002,118,2020-03-16 16:44:00,1,2398.0,1763.0,0.735,11.399,28,0,0,0,28,0,28,0,0.0,0.0
1002,119,2020-03-16 16:47:00,1,2419.0,1705.0,0.705,11.419,1,0,0,0,1,0,1,0,0.0,0.0
1002,120,2020-03-16 16:50:00,1,2244.0,1636.0,0.729,10.652,10,1,0,1,9,3,6,0,0.01,0.0
1002,121,2020-03-16 16:53:00,1,2338.5,1653.5,0.708,11.0435,8,0,0,0,8,3,5,0,0.0,0.0
1002,122,2020-03-16 16:56:00,1,2433.0,1671.0,0.687,11.435,6,5,0,5,1,0,1,0,0.0,0.0
1002,123,2020-03-16 16:59:00,1,2353.0,1596.0,0.678,11.04,10,8,0,8,2,1,1,0,0.0,0.0
1002,124,2020-03-16 17:02:00,1,2194.0,1496.0,0.682,10.3,4,4,0,4,0,0,0,0,0.0,0.0
1002,125,2020-03-16 17:05:00,1,2284.0,1528.0,0.669,10.693,3,1,0,1,2,0,2,0,0.0,0.0
1002,126,2020-03-16 17:08:00,1,2192.0,1484.0,0.677,10.282,2,0,0,0,2,0,2,0,0.0,0.0
1002,127,2020-03-16 17:11:00,1,2203.0,1438.0,0.653,10.275,23,9,4,5,14,5,9,0,0.0,0.0
1002,128,2020-03-16 17:14:00,1,2351.0,1581.0,0.673,11.013,2,0,0,0,2,0,2,0,0.0,0.0
1002,129,2020-03-16 17:17:00,1,2360.0,1548.0,0.656,11.013,6,0,0,0,6,1,5,0,0.0,0.0
1002,130,2020-03-16 17:20:00,1,2374.0,1571.0,0.662,11.093,16,0,0,0,16,6,10,0,0.01,0.0
1002,131,2020-03-16 17:23:00,1,2361.0,1571.0,0.666,11.041,33,19,8,11,14,5,9,0,0.0,0.0
1002,132,2020-03-16 17:26:00,1,2567.0,1801.0,0.702,12.107,16,12,1,11,4,1,3,0,0.0,0.0
1002,133,2020-03-16 17:29:00,1,2712.0,1980.0,0.73,12.878,118,76,26,50,42,13,29,2,0.0,0.0
1002,134,2020-03-16 17:32:00,1,3112.0,2242.0,0.72,14.744,126,62,26,36,64,31,33,4,0.0,0.0
1002,135,2020-03-16 17:35:00,1,3265.0,2372.0,0.727,15.492,174,102,65,37,72,49,23,9,0.0,0.0
1002,136,2020-03-16 17:38:00,1,3106.0,2245.0,0.723,14.723,9,9,2,7,0,0,0,0,0.0,0.0
1002,137,2020-03-16 17:41:00,1,2884.0,2053.0,0.712,13.635,12,9,3,6,3,1,2,0,0.0,0.0
1002,138,2020-03-16 17:44:00,1,2723.0,1891.0,0.695,12.822,31,27,16,11,4,0,4,0,0.0,0.0
1002,139,2020-03-16 17:47:00,1,2582.0,1792.0,0.694,12.157,0,0,0,0,0,0,0,0,0.0,0.0
1002,140,2020-03-16 17:50:00,1,2584.0,1738.0,0.672,12.106,21,15,10,5,6,1,5,0,0.0,0.0
1002,141,2020-03-16 17:53:00,1,2600.0,1711.0,0.658,12.141,3,3,1,2,0,0,0,0,0.0,0.0
1002,142,2020-03-16 17:56:00,1,2522.0,1694.0,0.672,11.814,16,9,2,7,7,2,5,0,0.01,0.0
1002,143,2020-03-16 17:59:00,1,2524.0,1663.0,0.659,11.787,16,4,1,3,12,5,7,0,0.0,0.0
1002,144,2020-03-16 18:02:00,0,2358.0,1624.0,0.689,11.089,4,4,1,3,0,0,0,0,0.0,0.0
1002,145,2020-03-16 18:05:00,0,2433.0,1650.0,0.678,11.412,10,3,1,2,7,1,6,0,0.0,0.0
1002,146,2020-03-16 18:08:00,0,2429.0,1649.0,0.679,11.396,12,3,1,2,9,4,5,0,0.0,0.0
1002,147,2020-03-16 18:11:00,0,2341.0,1627.0,0.695,11.027,59,26,8,18,33,22,11,0,0.0,0.0
1002,148,2020-03-16 18:14:00,0,2602.0,1709.0,0.657,12.145,106,42,11,31,64,20,44,1,0.0,0.0
1002,149,2020-03-16 18:17:00,0,2890.0,2016.0,0.698,13.618,150,51,22,29,99,67,32,0,0.0,0.0
1002,150,2020-03-16 18:20:00,0,3119.0,2209.0,0.708,14.735,69,38,11,27,31,9,22,1,0.0,0.0
1002,151,2020-03-16 18:23:00,0,3098.0,2285.0,0.738,14.735,223,121,83,38,102,42,60,10,0.0,0.0
1002,152,2020-03-16 18:26:00,0,3413.0,2481.0,0.727,16.196,506,297,230,67,209,161,48,14,0.0,0.0
1002,153,2020-03-16 18:29:00,0,3663.0,2526.0,0.69,17.229,372,244,170,74,128,91,37,21,0.0,0.0
1002,154,2020-03-16 18:32:00,0,3408.0,2459.0,0.721,16.151,168,122,87,35,46,25,21,5,0.0,0.0
1002,155,2020-03-16 18:35:00,0,3604.0,2448.0,0.679,16.911,132,49,16,33,83,34,49,1,0.0,0.0
1002,156,2020-03-16 18:38:00,0,3328.0,2376.0,0.714,15.743,98,41,18,23,57,22,35,0,0.0,0.0
1002,157,2020-03-16 18:41:00,0,3361.0,2397.0,0.713,15.898,46,25,0,25,21,6,15,0,0.0,0.0
1002,158,2020-03-16 18:44:00,0,3120.0,2201.0,0.705,14.73,18,0,0,0,18,8,10,0,0.01,0.0
1002,159,2020-03-16 18:47:00,0,2891.0,1983.0,0.686,13.587,6,2,0,2,4,0,4,0,0.0,0.0
1002,160,2020-03-16 18:50:00,0,2666.0,1851.0,0.695,12.553,10,6,0,6,4,0,4,0,0.0,0.0
1002,161,2020-03-16 18:53:00,0,2588.0,1750.0,0.676,12.136,28,18,0,18,10,0,10,0,0.0,0.0
1002,162,2020-03-16 18:56:00,0,2528.0,1682.0,0.665,11.825,33,30,0,30,3,1,2,0,0.0,0.0
1002,163,2020-03-16 18:59:00,0,2443.0,1645.0,0.673,11.448,8,8,0,8,0,0,0,0,0.0,0.0
1002,164,2020-03-16 19:02:00,0,2347.0,1623.0,0.691,11.044,5,1,0,1,4,1,3,1,0.0,0.0
1002,165,2020-03-16 19:05:00,0,2358.0,1587.0,0.673,11.05,1,1,1,0,0,0,0,0,0.0,0.0
1002,166,2020-03-16 19:08:00,0,2374.0,1520.0,0.64,11.037,12,7,4,3,5,1,4,0,0.0,0.0
1002,167,2020-03-16 19:11:00,0,2430.0,1624.0,0.668,11.372,157,105,56,49,52,20,32,1,0.0,0.0
1002,168,2020-03-16 19:14:00,0,2882.0,2023.0,0.702,13.597,63,41,9,32,22,4,18,1,0.0,0.0
1002,169,2020-03-16 19:17:00,0,3191.0,2291.0,0.718,15.109,475,272,201,71,203,152,51,15,0.0,0.0
1002,170,2020-03-16 19:20:00,0,3434.0,2435.0,0.709,16.225,688,452,364,88,236,182,54,13,0.0,0.0
1002,171,2020-03-16 19:23:00,0,3750.0,2638.0,0.703,17.697,737,463,375,88,274,213,61,8,0.0,0.0
1002,172,2020-03-16 19:26:00,0,3828.0,2701.0,0.706,18.075,573,386,310,76,187,139,48,22,0.0,0.0
1002,173,2020-03-16 19:29:00,0,3845.0,2668.0,0.694,18.105,404,288,226,62,116,80,36,6,0.0,0.0
1002,174,2020-03-16 19:32:00,0,3994.0,2721.0,0.681,18.75,408,255,187,68,153,115,38,28,0.0,0.0
1002,175,2020-03-16 19:35:00,0,3853.0,2616.0,0.679,18.076,347,252,195,57,95,66,29,4,0.0,0.0
1002,176,2020-03-16 19:38:00,0,3921.0,2705.0,0.69,18.443,342,235,175,60,107,69,38,27,0.01,0.0
1002,177,2020-03-16 19:41:00,0,3270.0,2285.0,0.699,15.413,143,83,51,32,60,23,37,1,0.0,0.0
1002,178,2020-03-16 19:44:00,0,3843.0,2607.0,0.678,18.028,264,92,53,39,172,95,77,16,0.0,0.0
1002,179,2020-03-16 19:47:00,0,3917.0,2686.0,0.686,18.406,339,73,26,47,266,174,92,1,0.0,0.0
1002,180,2020-03-16 19:50:00,0,3989.0,2737.0,0.686,18.746,449,246,172,74,203,164,39,9,0.0,0.0
1002,181,2020-03-16 19:53:00,0,3977.0,2766.0,0.6955,18.731,599,311,237,74,288,228,60,9,0.0,0.0
1002,182,2020-03-16 19:56:00,0,3965.0,2795.0,0.705,18.716,675,329,246,83,346,272,74,15,0.0,0.0
1002,183,2020-03-16 19:59:00,0,3910.0,2679.0,0.685,18.37,43,17,11,6,26,0,26,0,0.0,0.0
1002,184,2020-03-16 20:02:00,0,3616.0,2439.0,0.675,16.949,13,5,3,2,8,0,8,0,0.0,0.0
1002,185,2020-03-16 20:05:00,0,3217.0,2214.0,0.688,15.125,97,43,28,15,54,36,18,0,0.0,0.0
1002,186,2020-03-16 20:08:00,0,3143.0,2067.0,0.657,14.673,41,16,11,5,25,15,10,0,0.0,0.0
1002,187,2020-03-16 20:11:00,0,2742.0,1902.0,0.693,12.911,17,9,4,5,8,0,8,0,0.0,0.0
1002,188,2020-03-16 20:14:00,0,2761.0,1819.0,0.659,12.894,0,0,0,0,0,0,0,0,0.0,0.0
1002,189,2020-03-16 20:17:00,0,2597.0,1718.0,0.662,12.134,2,0,0,0,2,0,2,0,0.0,0.0
1002,190,2020-03-16 20:20:00,0,2606.0,1658.0,0.636,12.102,13,6,1,5,7,1,6,0,0.0,0.0
1002,191,2020-03-16 20:23:00,0,2375.0,1568.0,0.66,11.092,51,35,16,19,16,7,9,0,0.0,0.0
1002,192,2020-03-16 20:26:00,0,2580.0,1741.0,0.675,12.095,283,160,117,43,123,63,60,8,0.0,0.0
1002,193,2020-03-16 20:29:00,0,3129.0,2129.0,0.68,14.687,298,148,101,47,150,96,54,2,0.0,0.0
1002,194,2020-03-16 20:32:00,0,3352.0,2373.0,0.708,15.833,175,56,24,32,119,62,57,2,0.01,0.0
1002,195,2020-03-16 20:35:00,0,3682.0,2549.0,0.692,17.332,498,283,222,61,215,162,53,17,0.0,0.0
1002,196,2020-03-16 20:38:00,0,3745.0,2589.0,0.691,17.623,445,317,250,67,128,89,39,13,0.0,0.0
1002,197,2020-03-16 20:41:00,0,3688.0,2536.0,0.688,17.339,458,301,232,69,157,113,44,10,0.0,0.0
1002,198,2020-03-16 20:44:00,0,3690.0,2520.0,0.683,17.331,474,271,207,64,203,145,58,8,0.0,0.0
1002,199,2020-03-16 20:47:00,0,3829.0,2648.0,0.692,18.018,398,290,232,58,108,66,42,10,0.0,0.0
1002,200,2020-03-16 20:50:00,0,3691.0,2476.0,0.671,17.283,272,191,138,53,81,55,26,1,0.0,0.0
1002,201,2020-03-16 20:53:00,0,3693.0,2488.0,0.674,17.307,84,42,24,18,42,22,20,3,0.0,0.0
1002,202,2020-03-16 20:56:00,0,3197.0,2185.0,0.684,15.017,11,8,0,8,3,1,2,0,0.01,0.0
1002,203,2020-03-16 20:59:00,0,2906.0,1962.0,0.675,13.62,13,13,6,7,0,0,0,0,0.0,0.0
1002,204,2020-03-16 21:02:00,0,2759.0,1835.0,0.665,12.903,23,15,2,13,8,2,6,0,0.0,0.0
1002,205,2020-03-16 21:05:00,0,2606.0,1710.0,0.656,12.16,8,6,2,4,2,1,1,0,0.0,0.0
1002,206,2020-03-16 21:08:00,0,2605.0,1652.0,0.634,12.092,6,6,2,4,0,0,0,0,0.0,0.0
1002,207,2020-03-16 21:11:00,0,2434.0,1603.0,0.658,11.367,11,2,0,2,9,2,7,0,0.0,0.0
1002,208,2020-03-16 21:14:00,0,2354.0,1566.0,0.665,11.008,35,14,6,8,21,3,18,0,0.0,0.0
1002,209,2020-03-16 21:17:00,0,2602.0,1710.0,0.657,12.145,267,190,119,71,77,45,32,1,0.0,0.0
1002,210,2020-03-16 21:20:00,0,2892.0,2015.0,0.697,13.625,216,143,104,39,73,41,32,10,0.0,0.0
1002,211,2020-03-16 21:23:00,0,2888.0,2017.0,0.698,13.611,183,93,57,36,90,33,57,5,0.0,0.0
1002,212,2020-03-16 21:26:00,0,3142.0,2144.0,0.682,14.755,172,107,53,54,65,32,33,11,0.0,0.0
1002,213,2020-03-16 21:29:00,0,3129.0,2156.0,0.689,14.717,268,167,114,53,101,72,29,3,0.0,0.0
1002,214,2020-03-16 21:32:00,0,3207.0,2249.0,0.701,15.127,124,75,49,26,49,33,16,5,0.0,0.0
1002,215,2020-03-16 21:35:00,0,3139.0,2086.0,0.664,14.677,31,27,3,24,4,1,3,0,0.0,0.0
1002,216,2020-03-16 21:38:00,0,2826.0,1911.0,0.676,13.252,1,1,0,1,0,0,0,0,0.0,0.0
1002,217,2020-03-16 21:41:00,0,2583.0,1768.0,0.685,12.135,34,18,10,8,16,8,8,0,0.0,0.0
1002,218,2020-03-16 21:44:00,0,2597.0,1696.0,0.653,12.109,3,3,1,2,0,0,0,0,0.0,0.0
1002,219,2020-03-16 21:47:00,0,2359.0,1577.0,0.668,11.042,72,42,14,28,30,12,18,3,0.0,0.0
1002,220,2020-03-16 21:50:00,0,2593.0,1748.0,0.674,12.153,167,111,58,53,56,17,39,18,0.0,0.0
1002,221,2020-03-16 21:53:00,0,2730.0,1913.0,0.701,12.875,153,78,37,41,75,26,49,1,0.0,0.0
1002,222,2020-03-16 21:56:00,0,2976.0,2047.0,0.688,13.991,77,65,12,53,12,4,8,4,0.0,0.0
1002,223,2020-03-16 21:59:00,0,3130.0,2143.0,0.685,14.707,479,289,229,60,190,145,45,4,0.0,0.0
1002,224,2020-03-16 22:02:00,0,3274.0,2266.0,0.692,15.41,415,246,187,59,169,114,55,9,0.0,0.0
1002,225,2020-03-16 22:05:00,0,3290.0,2279.0,0.693,15.487,379,223,175,48,156,112,44,15,0.0,0.0
1002,226,2020-03-16 22:08:00,0,3367.0,2360.0,0.701,15.88,325,193,142,51,132,94,38,18,0.0,0.0
1002,227,2020-03-16 22:11:00,0,3273.0,2315.0,0.707,15.458,282,209,151,58,73,43,30,9,0.0,0.0
1002,228,2020-03-16 22:14:00,0,3531.0,2393.0,0.678,16.562,358,235,166,69,123,80,43,19,0.0,0.0
1002,229,2020-03-16 22:17:00,0,3292.0,2305.0,0.7,15.524,458,288,219,69,170,124,46,20,0.0,0.0
1002,230,2020-03-16 22:20:00,0,3275.0,2266.0,0.692,15.414,418,238,178,60,180,113,67,2,0.01,0.0
1002,231,2020-03-16 22:23:00,0,3362.0,2337.0,0.695,15.837,342,191,134,57,151,101,50,22,0.0,0.0
1002,232,2020-03-16 22:26:00,0,3269.0,2317.0,0.709,15.445,193,106,71,35,87,46,41,2,0.0,0.0
1002,233,2020-03-16 22:29:00,0,3284.0,2283.0,0.695,15.467,224,101,61,40,123,74,49,0,0.0,0.0
1002,234,2020-03-16 22:32:00,0,3212.0,2203.0,0.686,15.095,328,197,143,54,131,89,42,15,0.0,0.0
1002,235,2020-03-16 22:35:00,0,3146.0,2128.0,0.676,14.753,389,160,102,58,229,162,67,2,0.0,0.0
1002,236,2020-03-16 22:38:00,0,3130.0,2145.0,0.686,14.706,214,116,82,34,98,65,33,13,0.0,0.0
1002,237,2020-03-16 22:41:00,0,3146.0,2126.0,0.676,14.751,205,153,92,61,52,15,37,8,0.0,0.0
1002,238,2020-03-16 22:44:00,0,3132.0,2125.0,0.678,14.694,423,195,143,52,228,181,47,24,0.0,0.0
1002,239,2020-03-16 22:47:00,0,3140.0,2072.0,0.66,14.667,186,79,49,30,107,66,41,1,0.0,0.0
1002,240,2020-03-16 22:50:00,0,3158.0,2109.0,0.668,14.776,118,85,46,39,33,10,23,0,0.0,0.0
1002,241,2020-03-16 22:53:00,0,3106.5,2083.5,0.671,14.546,116,84,53,31,32,4,28,0,0.0,0.0
1002,242,2020-03-16 22:56:00,0,3055.0,2058.0,0.674,14.316,34,21,8,13,13,2,11,0,0.0,0.0
1002,243,2020-03-16 22:59:00,0,2729.0,1884.0,0.69,12.839,3,3,1,2,0,0,0,0,0.0,0.0
1002,244,2020-03-16 23:02:00,0,2611.0,1742.0,0.667,12.218,0,0,0,0,0,0,0,0,0.0,0.0
1002,245,2020-03-16 23:05:00,0,2359.0,1597.0,0.677,11.062,0,0,0,0,0,0,0,0,0.01,0.0
1002,246,2020-03-16 23:08:00,0,2295.0,1479.0,0.644,10.68,6,0,0,0,6,0,6,0,0.0,0.0
1002,247,2020-03-16 23:11:00,0,2211.0,1434.0,0.649,10.298,16,15,4,11,1,0,1,0,0.0,0.0
1002,248,2020-03-16 23:14:00,0,2054.0,1313.0,0.639,9.549,17,8,6,2,9,0,9,0,0.0,0.0
1002,249,2020-03-16 23:17:00,0,1964.0,1288.0,0.656,9.164,2,0,0,0,2,0,2,0,0.0,0.0
1002,250,2020-03-16 23:20:00,0,1877.0,1288.0,0.686,8.824,4,3,2,1,1,0,1,0,0.0,0.0
1002,251,2020-03-16 23:23:00,0,1960.0,1304.0,0.666,9.165,28,18,11,7,10,3,7,0,0.0,0.0
1002,252,2020-03-16 23:26:00,0,2046.0,1354.0,0.662,9.563,4,3,1,2,1,0,1,0,0.0,0.0
1002,253,2020-03-16 23:29:00,0,2057.0,1353.0,0.658,9.603,4,0,0,0,4,0,4,0,0.0,0.0
1002,254,2020-03-16 23:32:00,0,2065.0,1290.0,0.625,9.564,8,7,1,6,1,0,1,0,0.0,0.0
1002,255,2020-03-16 23:35:00,0,1882.0,1256.0,0.667,8.807,1,1,0,1,0,0,0,0,0.0,0.0
1002,256,2020-03-16 23:38:00,0,2067.0,1294.0,0.626,9.579,8,6,0,6,2,1,1,0,0.0,0.0
1002,257,2020-03-16 23:41:00,0,1983.0,1265.0,0.638,9.213,20,17,7,10,3,0,3,0,0.0,0.0
1002,258,2020-03-16 23:44:00,0,1973.0,1298.0,0.658,9.21,15,8,3,5,7,0,7,0,0.0,0.0
1002,259,2020-03-16 23:47:00,0,2058.0,1360.0,0.661,9.613,42,27,15,12,15,5,10,0,0.0,0.0
1002,260,2020-03-16 23:50:00,0,2194.0,1475.0,0.672,10.28,310,169,119,50,141,96,45,11,0.0,0.0
1002,261,2020-03-16 23:53:00,0,2575.0,1770.0,0.687,12.107,432,291,235,56,141,96,45,15,0.0,0.0
1002,262,2020-03-16 23:56:00,0,2891.0,2008.0,0.694,13.615,381,217,171,46,164,112,52,10,0.0,0.0
1002,263,2020-03-16 23:59:00,0,3140.0,2146.0,0.684,14.747,347,198,146,52,149,107,42,14,0.0,0.0
1002,264,2020-03-17 00:02:00,0,3274.0,2290.0,0.699,15.436,231,115,60,55,116,60,56,6,0.0,0.0
1002,265,2020-03-17 00:05:00,0,3345.0,2341.0,0.7,15.772,353,187,132,55,166,116,50,12,0.0,0.0
1002,266,2020-03-17 00:08:00,0,3433.0,2399.0,0.699,16.183,467,329,253,76,138,92,46,11,0.0,0.0
1002,267,2020-03-17 00:11:00,0,3546.0,2418.0,0.682,16.65,631,389,324,65,242,186,56,17,0.01,0.0
1002,268,2020-03-17 00:14:00,0,3439.0,2399.0,0.698,16.207,423,269,214,55,154,108,46,12,0.0,0.0
1002,269,2020-03-17 00:17:00,0,3445.0,2384.0,0.692,16.214,227,142,109,33,85,54,31,5,0.0,0.0
1002,270,2020-03-17 00:20:00,0,3622.0,2423.0,0.669,16.954,302,141,92,49,161,106,55,6,0.0,0.0
1002,271,2020-03-17 00:23:00,0,3278.0,2311.0,0.705,15.476,313,174,129,45,139,87,52,15,0.0,0.0
1002,272,2020-03-17 00:26:00,0,3363.0,2337.0,0.695,15.839,342,211,153,58,131,79,52,10,0.0,0.0
1002,273,2020-03-17 00:29:00,0,3266.0,2300.0,0.704,15.417,200,102,59,43,98,63,35,18,0.0,0.0
1002,274,2020-03-17 00:32:00,0,3298.0,2217.0,0.672,15.449,220,131,86,45,89,38,51,1,0.0,0.0
1002,275,2020-03-17 00:35:00,0,3204.0,2182.0,0.681,15.04,173,56,29,27,117,57,60,4,0.0,0.0
1002,276,2020-03-17 00:38:00,0,3202.0,2197.0,0.686,15.049,260,106,51,55,154,96,58,4,0.0,0.0
1002,277,2020-03-17 00:41:00,0,3117.0,2204.0,0.707,14.723,246,152,102,50,94,58,36,13,0.0,0.0
1002,278,2020-03-17 00:44:00,0,3155.0,2138.0,0.677,14.8,338,202,155,47,136,94,42,3,0.0,0.0
1002,279,2020-03-17 00:47:00,0,3133.0,2135.0,0.682,14.707,371,221,162,59,150,98,52,15,0.0,0.0
1002,280,2020-03-17 00:50:00,0,3143.0,2116.0,0.673,14.726,249,180,131,49,69,40,29,11,0.0,0.0
1002,281,2020-03-17 00:53:00,0,3152.0,2084.0,0.661,14.726,183,106,79,27,77,33,44,18,0.0,0.0
1002,282,2020-03-17 00:56:00,0,3135.0,2105.0,0.671,14.681,387,215,155,60,172,125,47,11,0.0,0.0
1002,283,2020-03-17 00:59:00,0,3158.0,2051.0,0.649,14.713,285,153,99,54,132,88,44,24,0.0,0.0
1002,284,2020-03-17 01:02:00,0,2983.0,1994.0,0.668,13.963,196,82,48,34,114,65,49,0,0.0,0.0
1002,285,2020-03-17 01:05:00,0,2737.0,1913.0,0.699,12.901,35,14,7,7,21,5,16,0,0.0,0.0
1002,286,2020-03-17 01:08:00,0,2592.0,1707.0,0.659,12.104,15,7,6,1,8,5,3,0,0.0,0.0
1002,287,2020-03-17 01:11:00,0,2446.0,1596.0,0.652,11.407,56,26,19,7,30,25,5,0,0.0,0.0
1002,288,2020-03-17 01:14:00,0,2364.0,1516.0,0.641,10.991,4,4,0,4,0,0,0,0,0.0,0.0
1002,289,2020-03-17 01:17:00,0,2219.0,1412.0,0.636,10.309,20,10,4,6,10,3,7,0,0.0,0.0
1002,290,2020-03-17 01:20:00,0,2055.0,1337.0,0.65,9.576,45,27,13,14,18,10,8,0,0.0,0.0
1002,291,2020-03-17 01:23:00,0,1970.0,1289.0,0.654,9.189,11,10,2,8,1,1,0,0,0.0,0.0
1002,292,2020-03-17 01:26:00,0,1808.0,1216.0,0.673,8.469,21,17,4,13,4,0,4,0,0.0,0.0
1002,293,2020-03-17 01:29:00,0,1814.0,1194.0,0.658,8.468,50,37,17,20,13,2,11,0,0.01,0.0
1002,294,2020-03-17 01:32:00,0,1804.0,1223.0,0.678,8.463,5,4,0,4,1,1,0,0,0.0,0.0
1002,295,2020-03-17 01:35:00,0,1817.0,1179.0,0.649,8.465,340,212,144,68,128,83,45,5,0.0,0.0
1002,296,2020-03-17 01:38:00,0,2212.0,1442.0,0.652,10.313,213,113,65,48,100,34,66,10,0.0,0.0
1002,297,2020-03-17 01:41:00,0,2602.0,1725.0,0.663,12.164,219,106,61,45,113,66,47,3,0.0,0.0
1002,298,2020-03-17 01:44:00,0,2722.0,1896.0,0.697,12.823,200,127,77,50,73,32,41,12,0.0,0.0
1002,299,2020-03-17 01:47:00,0,2974.0,2046.0,0.688,13.984,281,161,111,50,120,83,37,7,0.0,0.0
1002,300,2020-03-17 01:50:00,0,2895.0,1986.0,0.686,13.607,258,171,129,42,87,59,28,6,0.0,0.0
1002,301,2020-03-17 01:53:00,0,2898.5,1984.5,0.6845,13.6185,320,211,151,60,109,63,46,5,0.0,0.0
1002,302,2020-03-17 01:56:00,0,2902.0,1983.0,0.683,13.63,383,234,184,50,149,103,46,31,0.0,0.0
1002,303,2020-03-17 01:59:00,0,3128.0,2137.0,0.683,14.691,551,389,312,77,162,121,41,29,0.0,0.0
1002,304,2020-03-17 02:02:00,0,3269.0,2300.0,0.703,15.428,295,173,122,51,122,70,52,16,0.0,0.0
1002,305,2020-03-17 02:05:00,0,3120.0,2192.0,0.702,14.721,382,250,193,57,132,87,45,11,0.01,0.0
1002,306,2020-03-17 02:08:00,0,3307.0,2209.0,0.668,15.476,291,201,137,64,90,14,76,72,0.0,0.0
1002,307,2020-03-17 02:11:00,0,2896.0,2007.0,0.693,13.631,306,187,128,59,119,64,55,8,0.0,0.0
1002,308,2020-03-17 02:14:00,0,3213.0,2183.0,0.679,15.076,221,119,76,43,102,62,40,11,0.0,0.0
1002,309,2020-03-17 02:17:00,0,3289.0,2210.0,0.672,15.407,221,154,101,53,67,35,32,25,0.0,0.0
1002,310,2020-03-17 02:20:00,0,3299.0,2244.0,0.68,15.482,436,251,191,60,185,135,50,40,0.0,0.0
1002,311,2020-03-17 02:23:00,0,3148.0,2093.0,0.665,14.72,296,209,151,58,87,49,38,10,0.0,0.0
1002,312,2020-03-17 02:26:00,0,3133.0,2180.0,0.696,14.758,227,138,79,59,89,31,58,35,0.0,0.0
1002,313,2020-03-17 02:29:00,0,3158.0,2053.0,0.65,14.717,377,243,170,73,134,74,60,83,0.0,0.0
1002,314,2020-03-17 02:32:00,0,2901.0,1976.0,0.681,13.618,298,163,114,49,135,84,51,12,0.0,0.0
1002,315,2020-03-17 02:35:00,0,3087.0,2022.0,0.655,14.4,329,171,118,53,158,98,60,17,0.0,0.0
1002,316,2020-03-17 02:38:00,0,3140.0,2062.0,0.657,14.655,124,59,25,34,65,29,36,0,0.0,0.0
1002,317,2020-03-17 02:41:00,0,2894.0,2000.0,0.691,13.616,141,42,10,32,99,54,45,2,0.0,0.0
1002,318,2020-03-17 02:44:00,0,3170.0,2067.0,0.652,14.779,148,61,23,38,87,30,57,1,0.0,0.0
1002,319,2020-03-17 02:47:00,0,3155.0,2060.0,0.653,14.711,225,135,89,46,90,52,38,5,0.0,0.0
1002,320,2020-03-17 02:50:00,0,3078.0,2045.0,0.664,14.391,196,126,85,41,70,40,30,9,0.0,0.0
1002,321,2020-03-17 02:53:00,0,2896.0,1974.0,0.682,13.595,176,94,48,46,82,53,29,0,0.0,0.0
1002,322,2020-03-17 02:56:00,0,2824.0,1922.0,0.68,13.254,204,123,71,52,81,42,39,0,0.0,0.0
1002,323,2020-03-17 02:59:00,0,2760.0,1858.0,0.673,12.932,370,219,172,47,151,111,40,23,0.0,0.0
1002,324,2020-03-17 03:02:00,0,2731.0,1906.0,0.698,12.871,334,181,132,49,153,105,48,17,0.0,0.0
1002,325,2020-03-17 03:05:00,0,2734.0,1903.0,0.696,12.878,188,117,84,33,71,48,23,7,0.0,0.0
1002,326,2020-03-17 03:08:00,0,2721.0,1901.0,0.699,12.828,236,142,108,34,94,52,42,18,0.0,0.0
1002,327,2020-03-17 03:11:00,0,2732.0,1888.0,0.691,12.854,255,156,115,41,99,55,44,20,0.0,0.0
1002,328,2020-03-17 03:14:00,0,2730.0,1886.0,0.691,12.846,282,168,120,48,114,58,56,30,0.01,0.0
1002,329,2020-03-17 03:17:00,0,2746.0,1857.0,0.676,12.877,207,116,80,36,91,45,46,12,0.0,0.0
1002,330,2020-03-17 03:20:00,0,2740.0,1882.0,0.687,12.881,277,179,143,36,98,62,36,23,0.0,0.0
1002,331,2020-03-17 03:23:00,0,2806.0,1916.0,0.683,13.177,180,102,66,36,78,42,36,2,0.0,0.0
1002,332,2020-03-17 03:26:00,0,2748.0,1843.0,0.671,12.867,8,3,1,2,5,1,4,0,0.0,0.0
1002,333,2020-03-17 03:29:00,0,2588.0,1742.0,0.673,12.124,26,26,6,20,0,0,0,0,0.0,0.0
1002,334,2020-03-17 03:32:00,0,2538.0,1623.0,0.64,11.796,148,83,49,34,65,38,27,4,0.0,0.0
1002,335,2020-03-17 03:35:00,0,2612.0,1648.0,0.631,12.117,250,145,100,45,105,57,48,8,0.0,0.0
1002,336,2020-03-17 03:38:00,0,2600.0,1678.0,0.645,12.105,171,67,35,32,104,50,54,7,0.0,0.0
1002,337,2020-03-17 03:41:00,0,2592.0,1715.0,0.662,12.113,213,125,87,38,88,44,44,6,0.0,0.0
1002,338,2020-03-17 03:44:00,0,2617.0,1671.0,0.639,12.16,119,69,20,49,50,11,39,0,0.0,0.0
1002,339,2020-03-17 03:47:00,0,2602.0,1695.0,0.651,12.131,313,173,117,56,140,89,51,11,0.0,0.0
1002,340,2020-03-17 03:50:00,0,2616.0,1660.0,0.635,12.144,299,167,129,38,132,85,47,2,0.0,0.0
1002,341,2020-03-17 03:53:00,0,2531.0,1644.0,0.65,11.792,42,24,11,13,18,7,11,0,0.01,0.0
1002,342,2020-03-17 03:56:00,0,2369.0,1534.0,0.647,11.033,7,0,0,0,7,1,6,0,0.0,0.0
1002,343,2020-03-17 03:59:00,0,2211.0,1439.0,0.651,10.305,5,0,0,0,5,2,3,0,0.0,0.0
1002,344,2020-03-17 04:02:00,0,2049.0,1356.0,0.662,9.576,23,13,5,8,10,6,4,0,0.0,0.0
1002,345,2020-03-17 04:05:00,0,1964.0,1282.0,0.653,9.16,1,0,0,0,1,1,0,0,0.0,0.0
1002,346,2020-03-17 04:08:00,0,1808.0,1207.0,0.668,8.461,2,2,0,2,0,0,0,0,0.0,0.0
1002,347,2020-03-17 04:11:00,0,1737.0,1127.0,0.649,8.092,22,12,4,8,10,3,7,0,0.0,0.0
1002,348,2020-03-17 04:14:00,0,1654.0,1088.0,0.658,7.721,6,6,0,6,0,0,0,0,0.0,0.0
1002,349,2020-03-17 04:17:00,0,1664.0,1043.0,0.627,7.71,3,3,0,3,0,0,0,0,0.0,0.0
1002,350,2020-03-17 04:20:00,0,1673.0,1002.0,0.599,7.7,2,0,0,0,2,0,2,0,0.0,0.0
1002,351,2020-03-17 04:23:00,0,1673.0,1025.0,0.613,7.726,13,0,0,0,13,7,6,0,0.0,0.0
1002,352,2020-03-17 04:26:00,0,1671.0,1056.0,0.632,7.751,8,5,2,3,3,1,2,0,0.0,0.0
1002,353,2020-03-17 04:29:00,0,1664.0,1059.0,0.636,7.729,5,4,3,1,1,0,1,0,0.0,0.0
1002,354,2020-03-17 04:32:00,0,1655.0,1055.0,0.638,7.691,14,6,1,5,8,0,8,0,0.0,0.0
1002,355,2020-03-17 04:35:00,0,1670.0,1041.0,0.623,7.732,2,2,0,2,0,0,0,0,0.0,0.0
1002,356,2020-03-17 04:38:00,0,1682.0,1000.0,0.595,7.735,27,5,0,5,22,1,21,0,0.0,0.0
1002,357,2020-03-17 04:41:00,0,1657.0,1078.0,0.65,7.723,50,36,14,22,14,5,9,0,0.0,0.0
1002,358,2020-03-17 04:44:00,0,1641.0,1129.0,0.688,7.717,44,37,20,17,7,0,7,0,0.0,0.0
1002,359,2020-03-17 04:47:00,0,1649.0,1125.0,0.683,7.742,12,2,0,2,10,0,10,0,0.0,0.0
1002,360,2020-03-17 04:50:00,0,1657.0,1074.0,0.648,7.719,13,7,2,5,6,0,6,0,0.0,0.0
1002,361,2020-03-17 04:53:00,0,1930.0,1284.5,0.6635,9.0265,276,180,113,67,96,63,33,4,0.0,0.0
1002,362,2020-03-17 04:56:00,0,2203.0,1495.0,0.679,10.334,260,119,77,42,141,83,58,8,0.0,0.0
1002,363,2020-03-17 04:59:00,0,2588.0,1741.0,0.673,12.125,235,148,104,44,87,48,39,9,0.0,0.0
1002,364,2020-03-17 05:02:00,0,2737.0,1876.0,0.685,12.859,139,68,36,32,71,31,40,3,0.0,0.0
1002,365,2020-03-17 05:05:00,0,2738.0,1926.0,0.704,12.919,107,69,25,44,38,6,32,0,0.0,0.0
1002,366,2020-03-17 05:08:00,0,2893.0,2001.0,0.692,13.614,157,61,25,36,96,44,52,0,0.01,0.0
1002,367,2020-03-17 05:11:00,0,3126.0,2136.0,0.683,14.681,339,185,130,55,154,105,49,13,0.0,0.0
1002,368,2020-03-17 05:14:00,0,3128.0,2180.0,0.697,14.737,357,242,180,62,115,64,51,24,0.0,0.0
1002,369,2020-03-17 05:17:00,0,3115.0,2191.0,0.703,14.698,329,209,159,50,120,72,48,41,0.0,0.0
1002,370,2020-03-17 05:20:00,0,3136.0,2193.0,0.699,14.785,218,118,84,34,100,59,41,0,0.0,0.0
1002,371,2020-03-17 05:23:00,0,3123.0,2133.0,0.683,14.668,160,86,58,28,74,39,35,11,0.0,0.0
1002,372,2020-03-17 05:26:00,0,2982.0,2061.0,0.691,14.032,296,157,114,43,139,87,52,13,0.0,0.0
1002,373,2020-03-17 05:29:00,0,2892.0,1985.0,0.686,13.594,139,62,37,25,77,43,34,0,0.01,0.0
1002,374,2020-03-17 05:32:00,0,2810.0,1930.0,0.687,13.211,276,199,140,59,77,47,30,1,0.0,0.0
1002,375,2020-03-17 05:35:00,0,2671.0,1809.0,0.677,12.526,17,10,5,5,7,7,0,0,0.0,0.0
1002,376,2020-03-17 05:38:00,0,2517.0,1649.0,0.655,11.742,17,10,1,9,7,4,3,0,0.0,0.0
1002,377,2020-03-17 05:41:00,0,2357.0,1589.0,0.674,11.045,1,0,0,0,1,0,1,0,0.0,0.0
1002,378,2020-03-17 05:44:00,0,2288.0,1492.0,0.652,10.668,0,0,0,0,0,0,0,0,0.0,0.0
1002,379,2020-03-17 05:47:00,0,2211.0,1405.0,0.635,10.265,0,0,0,0,0,0,0,0,0.0,0.0
1002,380,2020-03-17 05:50:00,0,2049.0,1356.0,0.662,9.577,181,110,73,37,71,41,30,11,0.0,0.0
1002,381,2020-03-17 05:53:00,0,2211.0,1436.0,0.65,10.303,177,85,56,29,92,58,34,3,0.0,0.0
1002,382,2020-03-17 05:56:00,0,2203.0,1485.0,0.674,10.323,100,49,13,36,51,28,23,2,0.0,0.0
1002,383,2020-03-17 05:59:00,0,2374.0,1525.0,0.643,11.042,170,110,69,41,60,21,39,8,0.0,0.0
1002,384,2020-03-17 06:02:00,1,2360.0,1630.0,0.691,11.105,344,187,144,43,157,111,46,16,0.0,0.0
1002,385,2020-03-17 06:05:00,1,2743.0,1861.0,0.678,12.869,164,79,52,27,85,56,29,26,0.0,0.0
1002,386,2020-03-17 06:08:00,1,2743.0,1857.0,0.677,12.862,213,123,94,29,90,58,32,7,0.0,0.0
1002,387,2020-03-17 06:11:00,1,2748.0,1818.0,0.662,12.842,179,106,68,38,73,37,36,6,0.0,0.0
1002,388,2020-03-17 06:14:00,1,2760.0,1828.0,0.662,12.9,175,97,63,34,78,38,40,0,0.0,0.0
1002,389,2020-03-17 06:17:00,1,2585.0,1736.0,0.672,12.108,147,97,68,29,50,32,18,4,0.0,0.0
1002,390,2020-03-17 06:20:00,1,2609.0,1663.0,0.637,12.123,13,9,1,8,4,1,3,0,0.0,0.0
1002,391,2020-03-17 06:23:00,1,2380.0,1550.0,0.651,11.094,18,12,2,10,6,1,5,0,0.0,0.0
1002,392,2020-03-17 06:26:00,1,2032.0,1380.0,0.679,9.536,8,3,0,3,5,1,4,0,0.0,0.0
1002,393,2020-03-17 06:29:00,1,2065.0,1318.0,0.638,9.598,8,3,0,3,5,0,5,0,0.0,0.0
1002,394,2020-03-17 06:32:00,1,1801.0,1233.0,0.684,8.463,13,7,0,7,6,1,5,0,0.0,0.0
1002,395,2020-03-17 06:35:00,1,1812.0,1163.0,0.642,8.427,5,4,0,4,1,0,1,0,0.0,0.0
1002,396,2020-03-17 06:38:00,1,1652.0,1117.0,0.676,7.748,23,23,0,23,0,0,0,0,0.0,0.0
1002,397,2020-03-17 06:41:00,1,1655.0,1072.0,0.648,7.708,0,0,0,0,0,0,0,0,0.0,0.0
1002,398,2020-03-17 06:44:00,1,1666.0,1055.0,0.633,7.734,19,10,5,5,9,3,6,0,0.0,0.0
1002,399,2020-03-17 06:47:00,1,1671.0,1036.0,0.62,7.731,0,0,0,0,0,0,0,0,0.0,0.0
1002,400,2020-03-17 06:50:00,1,1492.0,994.0,0.666,6.98,14,12,2,10,2,1,1,0,0.0,0.0
1002,401,2020-03-17 06:53:00,1,1500.0,960.0,0.64,6.975,19,15,3,12,4,2,2,0,0.0,0.0
1002,402,2020-03-17 06:56:00,1,1587.0,1005.0,0.633,7.365,19,3,2,1,16,5,11,0,0.0,0.0
1002,403,2020-03-17 06:59:00,1,1495.0,991.0,0.663,6.986,8,4,2,2,4,1,3,0,0.0,0.0
1002,404,2020-03-17 07:02:00,1,1511.0,929.0,0.615,6.981,37,27,3,24,10,1,9,0,0.0,0.0
1002,405,2020-03-17 07:05:00,1,1503.0,947.0,0.63,6.971,3,1,0,1,2,0,2,0,0.0,0.0
1002,406,2020-03-17 07:08:00,1,1496.0,982.0,0.656,6.98,4,0,0,0,4,0,4,0,0.0,0.0
1002,407,2020-03-17 07:11:00,1,1673.0,1039.0,0.621,7.742,4,0,0,0,4,0,4,0,0.0,0.0
1002,408,2020-03-17 07:14:00,1,1669.0,1049.0,0.629,7.737,9,0,0,0,9,0,9,0,0.0,0.0
1002,409,2020-03-17 07:17:00,1,1664.0,1058.0,0.636,7.727,9,1,0,1,8,1,7,0,0.0,0.0
1002,410,2020-03-17 07:20:00,1,1643.0,1115.0,0.679,7.709,163,116,78,38,47,28,19,2,0.0,0.0
1002,411,2020-03-17 07:23:00,1,1959.0,1314.0,0.671,9.173,128,61,34,27,67,38,29,3,0.0,0.0
1002,412,2020-03-17 07:26:00,1,2363.0,1568.0,0.663,11.048,120,61,38,23,59,34,25,0,0.01,0.0
1002,413,2020-03-17 07:29:00,1,2357.0,1594.0,0.676,11.052,75,34,13,21,41,11,30,1,0.0,0.0
1002,414,2020-03-17 07:32:00,1,2609.0,1722.0,0.66,12.187,178,86,58,28,92,50,42,4,0.0,0.0
1002,415,2020-03-17 07:35:00,1,2582.0,1764.0,0.683,12.127,167,103,71,32,64,33,31,5,0.0,0.0
1002,416,2020-03-17 07:38:00,1,2656.0,1848.0,0.696,12.51,178,149,118,31,29,10,19,6,0.0,0.0
1002,417,2020-03-17 07:41:00,1,2582.0,1754.0,0.679,12.116,32,22,16,6,10,6,4,0,0.0,0.0
1002,418,2020-03-17 07:44:00,1,2361.0,1578.0,0.668,11.051,3,1,1,0,2,1,1,0,0.0,0.0
1002,419,2020-03-17 07:47:00,1,2136.0,1395.0,0.653,9.962,16,12,5,7,4,0,4,0,0.0,0.0
1002,420,2020-03-17 07:50:00,1,2042.0,1388.0,0.68,9.581,1,0,0,0,1,0,1,0,0.0,0.0
1002,421,2020-03-17 07:53:00,1,1937.0,1272.5,0.6555,9.0405,58,42,19,23,16,9,7,0,0.0,0.0
1002,422,2020-03-17 07:56:00,1,1832.0,1157.0,0.631,8.5,57,50,28,22,7,0,7,0,0.0,0.0
1002,423,2020-03-17 07:59:00,1,1647.0,1139.0,0.692,7.753,21,1,0,1,20,0,20,0,0.0,0.0
1002,424,2020-03-17 08:02:00,1,1649.0,1101.0,0.668,7.716,44,2,0,2,42,2,40,0,0.0,0.0
1002,425,2020-03-17 08:05:00,1,1659.0,1055.0,0.636,7.706,22,4,2,2,18,6,12,0,0.0,0.0
1002,426,2020-03-17 08:08:00,1,1492.0,977.0,0.655,6.96,12,0,0,0,12,1,11,0,0.0,0.0
1002,427,2020-03-17 08:11:00,1,1520.0,925.0,0.609,7.012,71,33,14,19,38,20,18,0,0.0,0.0
1002,428,2020-03-17 08:14:00,1,1675.0,1022.0,0.61,7.733,92,57,39,18,35,20,15,0,0.0,0.0
1002,429,2020-03-17 08:17:00,1,1801.0,1245.0,0.691,8.475,163,83,50,33,80,43,37,3,0.0,0.0
1002,430,2020-03-17 08:20:00,1,2035.0,1393.0,0.684,9.562,212,147,108,39,65,41,24,0,0.0,0.0
1002,431,2020-03-17 08:23:00,1,2120.0,1440.0,0.679,9.946,305,166,130,36,139,88,51,2,0.0,0.0
1002,432,2020-03-17 08:26:00,1,2188.0,1487.0,0.68,10.268,270,153,109,44,117,75,42,1,0.0,0.0
1002,433,2020-03-17 08:29:00,1,2211.0,1473.0,0.666,10.341,69,42,24,18,27,8,19,0,0.0,0.0
1002,434,2020-03-17 08:32:00,1,2371.0,1535.0,0.647,11.04,123,84,35,49,39,9,30,0,0.0,0.0
1002,435,2020-03-17 08:35:00,1,2207.0,1466.0,0.664,10.319,18,16,4,12,2,1,1,0,0.0,0.0
1002,436,2020-03-17 08:38:00,1,2208.0,1455.0,0.659,10.311,117,84,33,51,33,20,13,0,0.01,0.0
1002,437,2020-03-17 08:41:00,1,2205.0,1482.0,0.672,10.331,103,77,25,52,26,8,18,0,0.0,0.0
1002,438,2020-03-17 08:44:00,1,2203.0,1476.0,0.67,10.315,345,181,135,46,164,104,60,0,0.0,0.0
1002,439,2020-03-17 08:47:00,1,2190.0,1473.0,0.673,10.258,476,241,177,64,235,165,70,0,0.0,0.0
1002,440,2020-03-17 08:50:00,1,2205.0,1443.0,0.654,10.285,157,95,69,26,62,39,23,0,0.0,0.0
1002,441,2020-03-17 08:53:00,1,2044.0,1351.0,0.661,9.548,12,10,1,9,2,0,2,0,0.0,0.0
1002,442,2020-03-17 08:56:00,1,1890.0,1290.0,0.683,8.876,1,1,0,1,0,0,0,0,0.0,0.0
1002,443,2020-03-17 08:59:00,1,1807.0,1190.0,0.658,8.439,5,2,1,1,3,1,2,0,0.0,0.0
1002,444,2020-03-17 09:02:00,1,1741.0,1125.0,0.646,8.108,13,1,0,1,12,7,5,0,0.0,0.0
1002,445,2020-03-17 09:05:00,1,1671.0,1040.0,0.623,7.736,6,3,2,1,3,0,3,0,0.0,0.0
1002,446,2020-03-17 09:08:00,1,1500.0,973.0,0.649,6.988,2,0,0,0,2,0,2,0,0.0,0.0
1002,447,2020-03-17 09:11:00,1,1503.0,972.0,0.647,6.999,7,5,2,3,2,0,2,0,0.0,0.0
1002,448,2020-03-17 09:14:00,1,1502.0,987.0,0.657,7.013,11,11,6,5,0,0,0,0,0.0,0.0
1002,449,2020-03-17 09:17:00,1,1501.0,972.0,0.647,6.991,17,15,8,7,2,1,1,0,0.0,0.0
1002,450,2020-03-17 09:20:00,1,1507.0,970.0,0.644,7.011,40,35,15,20,5,0,5,0,0.0,0.0
1002,451,2020-03-17 09:23:00,1,1668.0,1043.0,0.625,7.726,20,18,10,8,2,1,1,0,0.0,0.0
1002,452,2020-03-17 09:26:00,1,1674.0,1022.0,0.611,7.729,3,0,0,0,3,1,2,0,0.01,0.0
1002,453,2020-03-17 09:29:00,1,1597.0,987.0,0.618,7.384,21,19,6,13,2,1,1,0,0.0,0.0
1002,454,2020-03-17 09:32:00,1,1674.0,1040.0,0.621,7.747,209,114,93,21,95,59,36,24,0.61,0.0
1002,455,2020-03-17 09:35:00,1,938.0,657.0,0.701,4.425,153,104,64,40,49,24,25,7,0.08,0.0
1002,456,2020-03-17 09:38:00,1,1861.0,1343.0,0.722,8.821,182,142,88,54,40,22,18,6,0.0,0.0
1002,457,2020-03-17 09:41:00,1,3119.0,2123.0,0.68,14.64,223,155,118,37,68,45,23,8,0.0,0.0
1002,458,2020-03-17 09:44:00,1,2740.0,1859.0,0.678,12.855,115,76,47,29,39,18,21,3,0.0,0.0
1002,459,2020-03-17 09:47:00,1,2661.0,1838.0,0.691,12.518,18,5,2,3,13,8,5,0,0.0,0.0
1002,460,2020-03-17 09:50:00,1,2587.0,1779.0,0.688,12.164,11,9,6,3,2,0,2,0,0.0,0.0
1002,461,2020-03-17 09:53:00,1,2513.0,1653.0,0.658,11.732,20,16,11,5,4,0,4,0,0.0,0.0
1002,462,2020-03-17 09:56:00,1,2201.0,1471.0,0.668,10.302,5,2,1,1,3,1,2,0,0.0,0.0
1002,463,2020-03-17 09:59:00,1,2052.0,1353.0,0.66,9.582,28,26,8,18,2,2,0,0,0.0,0.0
1002,464,2020-03-17 10:02:00,1,2049.0,1337.0,0.653,9.553,19,18,8,10,1,0,1,0,0.0,0.0
1002,465,2020-03-17 10:05:00,1,1799.0,1231.0,0.684,8.452,2,2,0,2,0,0,0,0,0.0,0.0
1002,466,2020-03-17 10:08:00,1,1652.0,1109.0,0.671,7.737,6,4,1,3,2,1,1,0,0.0,0.0
1002,467,2020-03-17 10:11:00,1,1670.0,1035.0,0.619,7.727,6,1,0,1,5,0,5,0,0.0,0.0
1002,468,2020-03-17 10:14:00,1,1660.0,1096.0,0.66,7.756,2,2,0,2,0,0,0,0,0.0,0.0
1002,469,2020-03-17 10:17:00,1,1813.0,1202.0,0.663,8.472,11,8,0,8,3,1,2,0,0.0,0.0
1002,470,2020-03-17 10:20:00,1,1820.0,1176.0,0.646,8.474,1,1,0,1,0,0,0,0,0.0,0.0
1002,471,2020-03-17 10:23:00,1,1649.0,1093.0,0.663,7.707,8,5,0,5,3,0,3,0,0.0,0.0
1002,472,2020-03-17 10:26:00,1,1676.0,1033.0,0.616,7.746,34,27,9,18,7,2,5,0,0.0,0.0
1002,473,2020-03-17 10:29:00,1,2067.0,1311.0,0.634,9.596,17,13,5,8,4,1,3,2,0.0,0.0
1002,474,2020-03-17 10:32:00,1,2212.0,1449.0,0.655,10.321,2,0,0,0,2,0,2,0,0.0,0.0
1002,475,2020-03-17 10:35:00,1,2033.0,1386.0,0.682,9.544,130,95,56,39,35,12,23,2,0.0,0.0
1002,476,2020-03-17 10:38:00,1,2370.0,1522.0,0.642,11.023,100,70,39,31,30,6,24,0,0.0,0.0
1002,477,2020-03-17 10:41:00,1,2589.0,1760.0,0.68,12.148,248,157,106,51,91,52,39,8,0.0,0.0
1002,478,2020-03-17 10:44:00,1,2597.0,1768.0,0.681,12.189,246,162,112,50,84,47,37,3,0.0,0.0
1002,479,2020-03-17 10:47:00,1,2581.0,1783.0,0.691,12.144,281,181,129,52,100,67,33,26,0.0,0.0
1002,480,2020-03-17 10:50:00,1,2600.0,1714.0,0.659,12.142,269,236,168,68,33,10,23,8,0.0,0.0
1002,481,2020-03-17 10:53:00,1,2608.5,1699.5,0.6515,12.1585,129,104,53,51,25,4,21,9,0.0,0.0
1002,482,2020-03-17 10:56:00,1,2617.0,1685.0,0.644,12.175,77,52,24,28,25,5,20,0,0.0,0.0
1002,483,2020-03-17 10:59:00,1,2535.0,1653.0,0.652,11.82,73,73,24,49,0,0,0,0,0.0,0.0
1002,484,2020-03-17 11:02:00,1,2435.0,1615.0,0.663,11.383,18,14,3,11,4,0,4,0,0.0,0.0
1002,485,2020-03-17 11:05:00,1,2123.0,1393.0,0.656,9.907,1,1,0,1,0,0,0,0,0.0,0.0
1002,486,2020-03-17 11:08:00,1,1790.0,1243.0,0.694,8.431,2,0,0,0,2,1,1,0,0.0,0.0
1002,487,2020-03-17 11:11:00,1,1828.0,1159.0,0.634,8.485,20,14,8,6,6,0,6,0,0.0,0.0
1002,488,2020-03-17 11:14:00,1,1801.0,1214.0,0.674,8.442,3,2,0,2,1,0,1,0,0.0,0.0
1002,489,2020-03-17 11:17:00,1,1799.0,1215.0,0.676,8.434,0,0,0,0,0,0,0,0,0.0,0.0
1002,490,2020-03-17 11:20:00,1,1810.0,1236.0,0.683,8.501,8,6,0,6,2,0,2,0,0.0,0.0
1002,491,2020-03-17 11:23:00,1,1810.0,1220.0,0.674,8.484,14,10,6,4,4,0,4,0,0.0,0.0
1002,492,2020-03-17 11:26:00,1,1811.0,1201.0,0.663,8.466,2,1,0,1,1,0,1,0,0.0,0.0
1002,493,2020-03-17 11:29:00,1,1813.0,1202.0,0.663,8.472,1,0,0,0,1,0,1,0,0.0,0.0
1002,494,2020-03-17 11:32:00,1,1801.0,1232.0,0.684,8.461,3,3,1,2,0,0,0,0,0.0,0.0
1002,495,2020-03-17 11:35:00,1,1888.0,1250.0,0.662,8.823,1,1,0,1,0,0,0,0,0.0,0.0
1002,496,2020-03-17 11:38:00,1,1804.0,1199.0,0.665,8.438,1,1,1,0,0,0,0,0,0.0,0.0
1002,497,2020-03-17 11:41:00,1,1811.0,1208.0,0.667,8.474,0,0,0,0,0,0,0,0,0.0,0.0
1002,498,2020-03-17 11:44:00,1,1823.0,1178.0,0.646,8.488,20,19,8,11,1,0,1,0,0.0,0.0
1002,499,2020-03-17 11:47:00,1,1820.0,1152.0,0.633,8.446,3,1,0,1,2,0,2,0,0.0,0.0
1002,500,2020-03-17 11:50:00,1,1888.0,1256.0,0.665,8.831,2,2,1,1,0,0,0,0,0.0,0.0
1002,501,2020-03-17 11:53:00,1,1811.0,1217.0,0.672,8.483,58,40,22,18,18,12,6,0,0.0,0.0
1002,502,2020-03-17 11:56:00,1,2057.0,1333.0,0.648,9.581,40,37,12,25,3,2,1,0,0.0,0.0
1002,503,2020-03-17 11:59:00,1,1880.0,1279.0,0.68,8.825,26,21,10,11,5,2,3,0,0.0,0.0
1002,504,2020-03-17 12:02:00,1,1812.0,1215.0,0.67,8.484,6,6,1,5,0,0,0,0,0.0,0.0
1002,505,2020-03-17 12:05:00,1,1650.0,1104.0,0.669,7.725,7,5,1,4,2,1,1,0,0.0,0.0
1002,506,2020-03-17 12:08:00,1,1656.0,1088.0,0.657,7.731,26,17,10,7,9,3,6,0,0.0,0.0
1002,507,2020-03-17 12:11:00,1,1646.0,1120.0,0.68,7.726,24,24,0,24,0,0,0,0,0.0,0.0
1002,508,2020-03-17 12:14:00,1,1655.0,1074.0,0.649,7.711,36,36,0,36,0,0,0,0,0.0,0.0
1002,509,2020-03-17 12:17:00,1,1668.0,1031.0,0.618,7.715,9,5,0,5,4,0,4,0,0.0,0.0
1002,510,2020-03-17 12:20:00,1,1672.0,1011.0,0.605,7.709,13,7,1,6,6,2,4,0,0.0,0.0
1002,511,2020-03-17 12:23:00,1,1510.0,979.0,0.648,7.035,26,21,0,21,5,2,3,0,0.0,0.0
1002,512,2020-03-17 12:26:00,1,1501.0,976.0,0.65,6.993,17,8,0,8,9,4,5,0,0.0,0.0
1002,513,2020-03-17 12:29:00,1,1595.0,988.0,0.62,7.379,27,24,6,18,3,0,3,0,0.0,0.0
1002,514,2020-03-17 12:32:00,1,1661.0,1074.0,0.646,7.734,0,0,0,0,0,0,0,0,0.0,0.0
1002,515,2020-03-17 12:35:00,1,1651.0,1093.0,0.662,7.717,5,5,2,3,0,0,0,0,0.0,0.0
1002,516,2020-03-17 12:38:00,1,1668.0,1059.0,0.635,7.744,24,17,3,14,7,1,6,0,0.0,0.0
1002,517,2020-03-17 12:41:00,1,1669.0,1032.0,0.618,7.719,5,3,1,2,2,1,1,0,0.0,0.0
1002,518,2020-03-17 12:44:00,1,1816.0,1167.0,0.643,8.45,9,2,0,2,7,1,6,0,0.0,0.0
1002,519,2020-03-17 12:47:00,1,1817.0,1155.0,0.635,8.439,19,6,2,4,13,0,13,0,0.0,0.0
1002,520,2020-03-17 12:50:00,1,1674.0,1013.0,0.605,7.719,11,11,6,5,0,0,0,0,0.0,0.0
1002,521,2020-03-17 12:53:00,1,1349.0,839.0,0.622,6.243,4,3,0,3,1,0,1,0,0.0,0.0
1002,522,2020-03-17 12:56:00,1,1276.0,777.0,0.609,5.889,14,11,5,6,3,2,1,0,0.0,0.0
1002,523,2020-03-17 12:59:00,1,1280.0,760.0,0.594,5.884,0,0,0,0,0,0,0,0,0.0,0.0
1002,524,2020-03-17 13:02:00,1,1261.0,799.0,0.633,5.854,18,18,0,18,0,0,0,0,0.0,0.0
1002,525,2020-03-17 13:05:00,1,1505.0,931.0,0.619,6.96,35,18,2,16,17,3,14,0,0.0,0.0
1002,526,2020-03-17 13:08:00,1,1834.0,1113.0,0.607,8.459,16,3,1,2,13,4,9,0,0.0,0.0
1002,527,2020-03-17 13:11:00,1,2433.0,1642.0,0.675,11.405,4,1,1,0,3,1,2,0,0.0,0.0
1002,528,2020-03-17 13:14:00,1,2336.0,1629.0,0.697,11.007,3,3,1,2,0,0,0,0,0.0,0.0
1002,529,2020-03-17 13:17:00,1,2358.0,1553.0,0.659,11.009,52,42,24,18,10,3,7,0,0.0,0.0
1002,530,2020-03-17 13:20:00,1,2574.0,1809.0,0.703,12.144,81,67,27,40,14,6,8,8,0.0,0.0
1002,531,2020-03-17 13:23:00,1,2726.0,1921.0,0.705,12.869,167,100,70,30,67,44,23,3,0.0,0.0
1002,532,2020-03-17 13:26:00,1,2738.0,1891.0,0.69,12.883,283,164,101,63,119,75,44,3,0.0,0.0
1002,533,2020-03-17 13:29:00,1,2735.0,1882.0,0.688,12.862,458,265,210,55,193,131,62,0,0.0,0.0
1002,534,2020-03-17 13:32:00,1,2727.0,1923.0,0.705,12.872,178,106,71,35,72,52,20,13,0.0,0.0
1002,535,2020-03-17 13:35:00,1,2742.0,1894.0,0.691,12.9,91,65,30,35,26,9,17,4,0.01,0.0
1002,536,2020-03-17 13:38:00,1,2755.0,1869.0,0.678,12.926,169,91,49,42,78,42,36,2,0.0,0.0
1002,537,2020-03-17 13:41:00,1,2757.0,1828.0,0.663,12.888,475,268,198,70,207,143,64,3,0.0,0.0
1002,538,2020-03-17 13:44:00,1,2575.0,1765.0,0.685,12.098,390,220,158,62,170,119,51,3,0.0,0.0
1002,539,2020-03-17 13:47:00,1,2599.0,1743.0,0.67,12.171,522,308,256,52,214,138,76,10,0.0,0.0
1002,540,2020-03-17 13:50:00,1,2583.0,1710.0,0.662,12.071,214,143,113,30,71,34,37,5,0.0,0.0
1002,541,2020-03-17 13:53:00,1,2589.5,1707.0,0.659,12.093,48,9,1,8,39,19,20,0,0.0,0.0
1002,542,2020-03-17 13:56:00,1,2596.0,1704.0,0.656,12.115,115,76,23,53,39,18,21,0,0.0,0.0
1002,543,2020-03-17 13:59:00,1,2528.0,1674.0,0.662,11.812,77,17,7,10,60,10,50,0,0.0,0.0
1002,544,2020-03-17 14:02:00,1,2347.0,1601.0,0.682,11.02,0,0,0,0,0,0,0,0,0.0,0.0
1002,545,2020-03-17 14:05:00,1,2210.0,1472.0,0.666,10.336,52,1,0,1,51,37,14,0,0.0,0.0
1002,546,2020-03-17 14:08:00,1,2052.0,1328.0,0.647,9.555,45,13,5,8,32,4,28,0,0.0,0.0
1002,547,2020-03-17 14:11:00,1,1972.0,1303.0,0.661,9.213,0,0,0,0,0,0,0,0,0.0,0.0
1002,548,2020-03-17 14:14:00,1,1794.0,1227.0,0.684,8.425,10,3,1,2,7,2,5,0,0.0,0.0
1002,549,2020-03-17 14:17:00,1,1803.0,1218.0,0.676,8.451,1,0,0,0,1,0,1,0,0.0,0.0
1002,550,2020-03-17 14:20:00,1,1805.0,1213.0,0.672,8.456,9,0,0,0,9,2,7,0,0.0,0.0
1002,551,2020-03-17 14:23:00,1,1815.0,1202.0,0.662,8.481,19,14,5,9,5,2,3,0,0.0,0.0
1002,552,2020-03-17 14:26:00,1,1813.0,1179.0,0.65,8.447,58,53,0,53,5,1,4,0,0.0,0.0
1002,553,2020-03-17 14:29:00,1,1819.0,1172.0,0.644,8.466,16,14,4,10,2,0,2,0,0.0,0.0
1002,554,2020-03-17 14:32:00,1,1815.0,1174.0,0.647,8.452,39,13,7,6,26,8,18,0,0.0,0.0
1002,555,2020-03-17 14:35:00,1,1812.0,1201.0,0.663,8.47,3,0,0,0,3,2,1,0,0.0,0.0
1002,556,2020-03-17 14:38:00,1,1808.0,1195.0,0.661,8.448,6,0,0,0,6,2,4,0,0.0,0.0
1002,557,2020-03-17 14:41:00,1,1819.0,1210.0,0.665,8.509,9,0,0,0,9,3,6,0,0.0,0.0
1002,558,2020-03-17 14:44:00,1,1815.0,1195.0,0.658,8.473,35,18,5,13,17,7,10,0,0.0,0.0
1002,559,2020-03-17 14:47:00,1,1808.0,1210.0,0.669,8.466,2,0,0,0,2,0,2,0,0.0,0.0
1002,560,2020-03-17 14:50:00,1,1819.0,1176.0,0.647,8.469,18,0,0,0,18,6,12,0,0.0,0.0
1002,561,2020-03-17 14:53:00,1,1813.0,1201.0,0.662,8.471,4,1,0,1,3,2,1,0,0.0,0.0
1002,562,2020-03-17 14:56:00,1,1809.0,1233.0,0.682,8.495,13,7,2,5,6,3,3,0,0.0,0.0
1002,563,2020-03-17 14:59:00,1,1816.0,1203.0,0.662,8.485,3,0,0,0,3,1,2,0,0.0,0.0
1002,564,2020-03-17 15:02:00,1,1818.0,1167.0,0.642,8.456,0,0,0,0,0,0,0,0,0.0,0.0
1002,565,2020-03-17 15:05:00,1,1641.0,1132.0,0.69,7.718,7,0,0,0,7,0,7,0,0.0,0.0
1002,566,2020-03-17 15:08:00,1,1824.0,1169.0,0.641,8.483,12,0,0,0,12,4,8,0,0.01,0.0
1002,567,2020-03-17 15:11:00,1,1817.0,1207.0,0.664,8.497,30,16,9,7,14,4,10,0,0.0,0.0
1002,568,2020-03-17 15:14:00,1,1817.0,1184.0,0.651,8.47,10,4,0,4,6,0,6,0,0.0,0.0
1002,569,2020-03-17 15:17:00,1,1826.0,1164.0,0.638,8.484,28,10,4,6,18,8,10,0,0.0,0.0
1002,570,2020-03-17 15:20:00,1,1807.0,1186.0,0.656,8.434,3,0,0,0,3,1,2,0,0.0,0.0
1002,571,2020-03-17 15:23:00,1,1735.0,1153.0,0.664,8.113,0,0,0,0,0,0,0,0,0.0,0.0
1002,572,2020-03-17 15:26:00,1,1822.0,1168.0,0.641,8.474,2,0,0,0,2,1,1,0,0.0,0.0
1002,573,2020-03-17 15:29:00,1,1812.0,1203.0,0.663,8.473,1,0,0,0,1,0,1,0,0.0,0.0
1002,574,2020-03-17 15:32:00,1,1814.0,1189.0,0.655,8.466,14,0,0,0,14,1,13,0,0.0,0.0
1002,575,2020-03-17 15:35:00,1,1803.0,1210.0,0.671,8.446,2,0,0,0,2,1,1,0,0.0,0.0
1002,576,2020-03-17 15:38:00,1,1809.0,1203.0,0.665,8.459,30,17,4,13,13,2,11,0,0.0,0.0
1002,577,2020-03-17 15:41:00,1,2058.0,1339.0,0.65,9.59,197,73,37,36,124,67,57,0,0.0,0.0
1002,578,2020-03-17 15:44:00,1,2210.0,1455.0,0.659,10.317,139,49,20,29,90,52,38,4,0.0,0.0
1002,579,2020-03-17 15:47:00,1,2361.0,1562.0,0.662,11.034,267,166,117,49,101,67,34,13,0.0,0.0
1002,580,2020-03-17 15:50:00,1,2363.0,1581.0,0.669,11.062,342,203,145,58,139,94,45,3,0.01,0.0
1002,581,2020-03-17 15:53:00,1,2353.0,1605.0,0.682,11.05,191,104,70,34,87,60,27,1,0.0,0.0
1002,582,2020-03-17 15:56:00,1,2195.0,1468.0,0.669,10.275,31,28,9,19,3,0,3,0,0.0,0.0
1002,583,2020-03-17 15:59:00,1,2363.0,1565.0,0.662,11.044,52,45,2,43,7,3,4,0,0.0,0.0
1002,584,2020-03-17 16:02:00,1,2358.0,1588.0,0.674,11.048,13,6,3,3,7,0,7,0,0.0,0.0
1002,585,2020-03-17 16:05:00,1,2119.0,1399.0,0.66,9.899,0,0,0,0,0,0,0,0,0.0,0.0
1002,586,2020-03-17 16:08:00,1,2061.0,1290.0,0.626,9.549,6,2,1,1,4,1,3,0,0.0,0.0
1002,587,2020-03-17 16:11:00,1,1797.0,1241.0,0.691,8.453,1,1,0,1,0,0,0,0,0.0,0.0
1002,588,2020-03-17 16:14:00,1,1644.0,1131.0,0.688,7.729,5,5,0,5,0,0,0,0,0.0,0.0
1002,589,2020-03-17 16:17:00,1,1650.0,1105.0,0.67,7.726,28,28,0,28,0,0,0,0,0.0,0.0
1002,590,2020-03-17 16:20:00,1,1641.0,1136.0,0.692,7.725,16,16,2,14,0,0,0,0,0.0,0.0
1002,591,2020-03-17 16:23:00,1,1732.0,1162.0,0.671,8.112,11,11,3,8,0,0,0,0,0.0,0.0
1002,592,2020-03-17 16:26:00,1,1819.0,1176.0,0.646,8.47,5,5,1,4,0,0,0,0,0.0,0.0
1002,593,2020-03-17 16:29:00,1,1813.0,1200.0,0.662,8.473,5,5,2,3,0,0,0,0,0.0,0.0
1002,594,2020-03-17 16:32:00,1,1814.0,1207.0,0.665,8.483,1,0,0,0,1,0,1,0,0.0,0.0
1002,595,2020-03-17 16:35:00,1,1805.0,1239.0,0.686,8.484,8,5,2,3,3,0,3,0,0.0,0.0
1002,596,2020-03-17 16:38:00,1,1794.0,1209.0,0.674,8.406,0,0,0,0,0,0,0,0,0.0,0.0
1002,597,2020-03-17 16:41:00,1,1824.0,1161.0,0.636,8.471,3,3,0,3,0,0,0,0,0.0,0.0
1002,598,2020-03-17 16:44:00,1,1830.0,1162.0,0.635,8.498,7,5,1,4,2,0,2,0,0.0,0.0
1002,599,2020-03-17 16:47:00,1,1823.0,1138.0,0.624,8.445,6,4,2,2,2,0,2,0,0.0,0.0
1002,600,2020-03-17 16:50:00,1,1661.0,1082.0,0.651,7.745,56,40,11,29,16,5,11,0,0.0,0.0
1002,601,2020-03-17 16:53:00,1,1933.0,1276.0,0.659,9.03,87,75,34,41,12,2,10,2,0.0,0.0
1002,602,2020-03-17 16:56:00,1,2205.0,1470.0,0.667,10.315,216,131,66,65,85,33,52,6,0.0,0.0
1002,603,2020-03-17 16:59:00,1,2193.0,1529.0,0.697,10.332,76,61,31,30,15,4,11,3,0.0,0.0
1002,604,2020-03-17 17:02:00,1,2371.0,1540.0,0.65,11.049,0,0,0,0,0,0,0,0,0.0,0.0
1002,605,2020-03-17 17:05:00,1,2049.0,1404.0,0.685,9.628,11,3,0,3,8,0,8,0,0.0,0.0
1002,606,2020-03-17 17:08:00,1,2044.0,1332.0,0.652,9.527,3,3,0,3,0,0,0,0,0.0,0.0
1002,607,2020-03-17 17:11:00,1,2058.0,1320.0,0.641,9.569,18,8,3,5,10,4,6,0,0.01,0.0
1002,608,2020-03-17 17:14:00,1,2049.0,1374.0,0.67,9.594,32,12,7,5,20,6,14,0,0.0,0.0
1002,609,2020-03-17 17:17:00,1,2053.0,1336.0,0.651,9.568,0,0,0,0,0,0,0,0,0.0,0.0
1002,610,2020-03-17 17:20:00,1,1887.0,1275.0,0.676,8.846,15,6,5,1,9,0,9,0,0.0,0.0
1002,611,2020-03-17 17:23:00,1,1968.0,1270.0,0.645,9.159,31,0,0,0,31,0,31,0,0.0,0.0
1002,612,2020-03-17 17:26:00,1,1880.0,1270.0,0.675,8.813,15,6,3,3,9,0,9,0,0.0,0.0
1002,613,2020-03-17 17:29:00,1,1892.0,1275.0,0.674,8.864,17,10,6,4,7,0,7,0,0.0,0.0
1002,614,2020-03-17 17:32:00,1,2054.0,1309.0,0.637,9.545,37,34,18,16,3,1,2,0,0.0,0.0
1002,615,2020-03-17 17:35:00,1,2047.0,1379.0,0.674,9.591,23,22,11,11,1,1,0,0,0.0,0.0
1002,616,2020-03-17 17:38:00,1,2045.0,1354.0,0.662,9.556,25,4,0,4,21,0,21,0,0.0,0.0
1002,617,2020-03-17 17:41:00,1,2051.0,1331.0,0.649,9.553,7,7,0,7,0,0,0,0,0.0,0.0
1002,618,2020-03-17 17:44:00,1,2051.0,1351.0,0.659,9.577,2,2,0,2,0,0,0,0,0.0,0.0
1002,619,2020-03-17 17:47:00,1,2041.0,1390.0,0.681,9.579,34,19,14,5,15,7,8,0,0.0,0.0
1002,620,2020-03-17 17:50:00,1,2032.0,1380.0,0.679,9.536,2,0,0,0,2,0,2,0,0.0,0.0
1002,621,2020-03-17 17:53:00,1,2050.0,1367.0,0.667,9.593,14,1,0,1,13,5,8,0,0.0,0.0
1002,622,2020-03-17 17:56:00,1,2041.0,1361.0,0.667,9.547,83,45,19,26,38,10,28,3,0.0,0.0
1002,623,2020-03-17 17:59:00,1,2193.0,1507.0,0.687,10.309,101,55,23,32,46,14,32,0,0.0,0.0
1002,624,2020-03-17 18:02:00,0,2352.0,1614.0,0.686,11.053,96,52,22,30,44,8,36,4,0.0,0.0
1002,625,2020-03-17 18:05:00,0,2512.0,1674.0,0.666,11.751,169,86,62,24,83,44,39,24,0.0,0.0
1002,626,2020-03-17 18:08:00,0,2737.0,1861.0,0.68,12.844,377,218,187,31,159,105,54,34,0.0,0.0
1002,627,2020-03-17 18:11:00,0,2749.0,1868.0,0.68,12.9,280,173,133,40,107,70,37,18,0.0,0.0
1002,628,2020-03-17 18:14:00,0,2734.0,1950.0,0.713,12.933,276,178,127,51,98,55,43,27,0.0,0.0
1002,629,2020-03-17 18:17:00,0,2661.0,1824.0,0.685,12.503,251,150,114,36,101,63,38,16,0.0,0.0
1002,630,2020-03-17 18:20:00,0,2744.0,1897.0,0.691,12.911,265,118,74,44,147,88,59,22,0.0,0.0
1002,631,2020-03-17 18:23:00,0,2749.0,1907.0,0.694,12.941,134,84,39,45,50,13,37,20,0.0,0.0
1002,632,2020-03-17 18:26:00,0,2806.0,1963.0,0.7,13.229,253,134,96,38,119,76,43,17,0.0,0.0
1002,633,2020-03-17 18:29:00,0,2574.0,1774.0,0.689,12.105,220,130,94,36,90,53,37,17,0.0,0.0
1002,634,2020-03-17 18:32:00,0,2750.0,1866.0,0.678,12.901,299,185,143,42,114,76,38,17,0.0,0.0
1002,635,2020-03-17 18:35:00,0,2752.0,1838.0,0.668,12.877,216,129,99,30,87,56,31,16,0.0,0.0
1002,636,2020-03-17 18:38:00,0,2737.0,1878.0,0.686,12.861,176,57,22,35,119,79,40,7,0.0,0.0
1002,637,2020-03-17 18:41:00,0,2823.0,1924.0,0.682,13.253,142,85,50,35,57,25,32,7,0.0,0.0
1002,638,2020-03-17 18:44:00,0,2906.0,1983.0,0.682,13.648,76,26,6,20,50,26,24,0,0.0,0.0
1002,639,2020-03-17 18:47:00,0,2753.0,1812.0,0.658,12.855,3,2,1,1,1,0,1,0,0.0,0.0
1002,640,2020-03-17 18:50:00,0,2521.0,1660.0,0.658,11.77,63,23,10,13,40,18,22,0,0.0,0.0
1002,641,2020-03-17 18:53:00,0,2582.0,1780.0,0.69,12.145,247,103,54,49,144,76,68,9,0.0,0.0
1002,642,2020-03-17 18:56:00,0,2746.0,1879.0,0.684,12.899,429,226,184,42,203,144,59,8,0.0,0.0
1002,643,2020-03-17 18:59:00,0,2901.0,1964.0,0.677,13.606,309,174,133,41,135,88,47,29,0.0,0.0
1002,644,2020-03-17 19:02:00,0,2748.0,1889.0,0.687,12.918,357,207,147,60,150,85,65,20,0.0,0.0
1002,645,2020-03-17 19:05:00,0,2739.0,1879.0,0.686,12.871,348,188,148,40,160,123,37,25,0.0,0.0
1002,646,2020-03-17 19:08:00,0,2733.0,1852.0,0.678,12.821,369,208,169,39,161,110,51,18,0.01,0.0
1002,647,2020-03-17 19:11:00,0,2753.0,1840.0,0.669,12.885,372,186,135,51,186,120,66,10,0.0,0.0
1002,648,2020-03-17 19:14:00,0,2590.0,1765.0,0.681,12.157,160,76,54,22,84,44,40,19,0.0,0.0
1002,649,2020-03-17 19:17:00,0,2664.0,1813.0,0.681,12.504,59,46,16,30,13,4,9,0,0.0,0.0
1002,650,2020-03-17 19:20:00,0,2602.0,1732.0,0.666,12.17,181,77,38,39,104,57,47,3,0.0,0.0
1002,651,2020-03-17 19:23:00,0,2676.0,1804.0,0.674,12.542,137,53,12,41,84,34,50,8,0.0,0.0
1002,652,2020-03-17 19:26:00,0,2596.0,1758.0,0.677,12.173,269,121,78,43,148,97,51,12,0.0,0.0
1002,653,2020-03-17 19:29:00,0,2599.0,1733.0,0.667,12.159,399,232,187,45,167,113,54,51,0.0,0.0
1002,654,2020-03-17 19:32:00,0,2590.0,1740.0,0.672,12.132,260,145,108,37,115,70,45,32,0.0,0.0
1002,655,2020-03-17 19:35:00,0,2382.0,1494.0,0.627,11.04,35,8,2,6,27,10,17,0,0.0,0.0
1002,656,2020-03-17 19:38:00,0,2359.0,1549.0,0.657,11.008,3,0,0,0,3,0,3,0,0.0,0.0
1002,657,2020-03-17 19:41:00,0,2379.0,1537.0,0.646,11.075,3,0,0,0,3,0,3,0,0.0,0.0
1002,658,2020-03-17 19:44:00,0,2215.0,1477.0,0.667,10.362,53,16,10,6,37,25,12,0,0.0,0.0
1002,659,2020-03-17 19:47:00,0,2129.0,1405.0,0.66,9.946,24,0,0,0,24,1,23,0,0.0,0.0
1002,660,2020-03-17 19:50:00,0,2057.0,1331.0,0.647,9.578,9,0,0,0,9,1,8,0,0.0,0.0
1002,661,2020-03-17 19:53:00,0,2094.5,1360.0,0.649,9.759,173,101,77,24,72,30,42,3,0.0,0.0
1002,662,2020-03-17 19:56:00,0,2132.0,1389.0,0.651,9.94,305,191,140,51,114,59,55,7,0.0,0.0
1002,663,2020-03-17 19:59:00,0,2450.0,1610.0,0.657,11.434,285,135,84,51,150,99,51,7,0.01,0.0
1002,664,2020-03-17 20:02:00,0,2691.0,1709.0,0.635,12.495,243,119,86,33,124,83,41,11,0.0,0.0
1002,665,2020-03-17 20:05:00,0,2682.0,1755.0,0.654,12.512,363,213,170,43,150,97,53,32,0.0,0.0
1002,666,2020-03-17 20:08:00,0,2694.0,1680.0,0.624,12.476,114,61,38,23,53,26,27,3,0.0,0.0
1002,667,2020-03-17 20:11:00,0,2613.0,1662.0,0.636,12.136,133,68,43,25,65,40,25,6,0.0,0.0
1002,668,2020-03-17 20:14:00,0,2687.0,1714.0,0.638,12.486,182,87,40,47,95,44,51,5,0.0,0.0
1002,669,2020-03-17 20:17:00,0,2845.0,1850.0,0.65,13.259,300,179,131,48,121,72,49,8,0.0,0.0
1002,670,2020-03-17 20:20:00,0,2915.0,1915.0,0.657,13.604,420,251,214,37,169,124,45,32,0.0,0.0
1002,671,2020-03-17 20:23:00,0,2998.0,1962.0,0.655,13.985,343,168,130,38,175,131,44,15,0.0,0.0
1002,672,2020-03-17 20:26:00,0,2825.0,1912.0,0.677,13.248,393,206,162,44,187,141,46,19,0.0,0.0
1002,673,2020-03-17 20:29:00,0,3011.0,1939.0,0.644,14.011,363,188,138,50,175,122,53,16,0.0,0.0
1002,674,2020-03-17 20:32:00,0,2835.0,1873.0,0.66,13.245,370,210,156,54,160,114,46,37,0.0,0.0
1002,675,2020-03-17 20:35:00,0,2859.0,1830.0,0.64,13.29,258,158,103,55,100,46,54,49,0.0,0.0
1002,676,2020-03-17 20:38:00,0,2758.0,1795.0,0.651,12.853,259,172,119,53,87,43,44,47,0.0,0.0
1002,677,2020-03-17 20:41:00,0,2702.0,1666.0,0.616,12.491,252,110,62,48,142,77,65,24,0.0,0.0
1002,678,2020-03-17 20:44:00,0,2679.0,1766.0,0.659,12.51,224,134,93,41,90,62,28,29,0.01,0.0
1002,679,2020-03-17 20:47:00,0,2703.0,1727.0,0.639,12.562,265,154,113,41,111,72,39,40,0.0,0.0
1002,680,2020-03-17 20:50:00,0,2700.0,1675.0,0.62,12.495,138,85,51,34,53,27,26,12,0.0,0.0
1002,681,2020-03-17 20:53:00,0,2690.0,1773.0,0.659,12.562,178,62,31,31,116,66,50,2,0.0,0.0
1002,682,2020-03-17 20:56:00,0,2669.0,1758.0,0.659,12.463,252,130,92,38,122,63,59,8,0.0,0.0
1002,683,2020-03-17 20:59:00,0,2691.0,1714.0,0.637,12.502,194,118,72,46,76,40,36,27,0.0,0.0
1002,684,2020-03-17 21:02:00,0,2685.0,1716.0,0.639,12.48,159,75,49,26,84,51,33,2,0.0,0.0
1002,685,2020-03-17 21:05:00,0,2534.0,1604.0,0.633,11.762,0,0,0,0,0,0,0,0,0.0,0.0
1002,686,2020-03-17 21:08:00,0,2471.0,1500.0,0.607,11.396,3,0,0,0,3,1,2,0,0.0,0.0
1002,687,2020-03-17 21:11:00,0,2322.0,1393.0,0.6,10.691,21,2,2,0,19,8,11,0,0.0,0.0
1002,688,2020-03-17 21:14:00,0,2149.0,1323.0,0.616,9.932,36,3,1,2,33,15,18,0,0.0,0.0
1002,689,2020-03-17 21:17:00,0,1977.0,1248.0,0.631,9.172,6,0,0,0,6,1,5,0,0.0,0.0
1002,690,2020-03-17 21:20:00,0,1902.0,1189.0,0.625,8.813,38,14,8,6,24,10,14,0,0.0,0.0
1002,691,2020-03-17 21:23:00,0,1907.0,1217.0,0.638,8.863,24,2,0,2,22,0,22,0,0.0,0.0
1002,692,2020-03-17 21:26:00,0,1909.0,1172.0,0.614,8.819,14,3,0,3,11,1,10,0,0.0,0.0
1002,693,2020-03-17 21:29:00,0,1825.0,1147.0,0.628,8.462,27,13,0,13,14,0,14,0,0.0,0.0
1002,694,2020-03-17 21:32:00,0,1823.0,1147.0,0.63,8.453,7,3,0,3,4,0,4,0,0.0,0.0
1002,695,2020-03-17 21:35:00,0,1821.0,1145.0,0.629,8.443,44,15,8,7,29,12,17,0,0.0,0.0
1002,696,2020-03-17 21:38:00,0,1914.0,1172.0,0.613,8.838,15,5,0,5,10,2,8,0,0.0,0.0
1002,697,2020-03-17 21:41:00,0,1821.0,1150.0,0.632,8.448,101,43,12,31,58,24,34,3,0.0,0.0
1002,698,2020-03-17 21:44:00,0,2291.0,1459.0,0.637,10.641,421,210,167,43,211,139,72,45,0.0,0.0
1002,699,2020-03-17 21:47:00,0,2367.0,1528.0,0.646,11.018,246,160,119,41,86,51,35,39,0.0,0.0
1002,700,2020-03-17 21:50:00,0,2678.0,1753.0,0.655,12.491,241,156,104,52,85,38,47,58,0.0,0.0
1002,701,2020-03-17 21:53:00,0,2762.0,1802.0,0.652,12.879,188,113,87,26,75,46,29,17,0.0,0.0
1002,702,2020-03-17 21:56:00,0,2697.0,1688.0,0.626,12.496,411,250,200,50,161,112,49,42,0.0,0.0
1002,703,2020-03-17 21:59:00,0,2673.0,1778.0,0.665,12.502,683,429,371,58,254,183,71,55,0.0,0.0
1002,704,2020-03-17 22:02:00,0,2831.0,1899.0,0.671,13.257,772,476,407,69,296,228,68,80,0.0,0.0
1002,705,2020-03-17 22:05:00,0,2979.0,2001.0,0.671,13.954,492,271,214,57,221,149,72,38,0.0,0.0
1002,706,2020-03-17 22:08:00,0,3247.0,2063.0,0.635,15.079,347,229,170,59,118,79,39,51,0.0,0.0
1002,707,2020-03-17 22:11:00,0,2916.0,1927.0,0.661,13.622,360,216,171,45,144,99,45,31,0.0,0.0
1002,708,2020-03-17 22:14:00,0,2913.0,1943.0,0.667,13.629,256,137,82,55,119,79,40,31,0.0,0.0
1002,709,2020-03-17 22:17:00,0,3256.0,2048.0,0.629,15.095,427,220,166,54,207,152,55,19,0.0,0.0
1002,710,2020-03-17 22:20:00,0,2987.0,1973.0,0.661,13.955,301,186,132,54,115,58,57,40,0.0,0.0
1002,711,2020-03-17 22:23:00,0,3025.0,1919.0,0.634,14.043,276,166,111,55,110,62,48,31,0.0,0.0
1002,712,2020-03-17 22:26:00,0,2997.0,1926.0,0.642,13.942,221,107,77,30,114,66,48,21,0.0,0.0
1002,713,2020-03-17 22:29:00,0,2831.0,1880.0,0.664,13.236,371,212,178,34,159,109,50,17,0.0,0.0
1002,714,2020-03-17 22:32:00,0,2760.0,1782.0,0.646,12.847,263,130,75,55,133,85,48,8,0.0,0.0
1002,715,2020-03-17 22:35:00,0,3005.0,1935.0,0.644,13.982,246,109,57,52,137,94,43,23,0.0,0.0
1002,716,2020-03-17 22:38:00,0,2869.0,1826.0,0.637,13.325,318,151,115,36,167,126,41,19,0.0,0.0
1002,717,2020-03-17 22:41:00,0,2674.0,1788.0,0.668,12.517,190,115,74,41,75,45,30,16,0.0,0.0
1002,718,2020-03-17 22:44:00,0,2700.0,1723.0,0.638,12.545,332,201,152,49,131,86,45,42,0.0,0.0
1002,719,2020-03-17 22:47:00,0,2681.0,1739.0,0.648,12.491,245,90,68,22,155,102,53,26,0.0,0.0
1002,720,2020-03-17 22:50:00,0,2768.0,1803.0,0.651,12.901,192,77,27,50,115,68,47,38,0.0,0.0
1002,721,2020-03-17 22:53:00,0,2719.5,1791.0,0.6585,12.697,292,145,101,44,147,92,55,13,0.0,0.0
1002,722,2020-03-17 22:56:00,0,2671.0,1779.0,0.666,12.493,273,151,110,41,122,84,38,6,0.0,0.0
1002,723,2020-03-17 22:59:00,0,2584.0,1760.0,0.681,12.13,148,34,16,18,114,80,34,0,0.0,0.0
1002,724,2020-03-17 23:02:00,0,2450.0,1615.0,0.659,11.443,46,0,0,0,46,0,46,0,0.0,0.0
1002,725,2020-03-17 23:05:00,0,2381.0,1486.0,0.624,11.029,9,0,0,0,9,2,7,0,0.0,0.0
1002,726,2020-03-17 23:08:00,0,2134.0,1393.0,0.653,9.952,127,37,19,18,90,68,22,0,0.01,0.0
1002,727,2020-03-17 23:11:00,0,2217.0,1433.0,0.646,10.321,333,154,103,51,179,134,45,28,0.0,0.0
1002,728,2020-03-17 23:14:00,0,2214.0,1468.0,0.663,10.351,275,140,98,42,135,100,35,25,0.0,0.0
1002,729,2020-03-17 23:17:00,0,2373.0,1554.0,0.655,11.07,365,231,173,58,134,94,40,54,0.0,0.0
1002,730,2020-03-17 23:20:00,0,2623.0,1671.0,0.637,12.183,537,298,246,52,239,175,64,48,0.0,0.0
1002,731,2020-03-17 23:23:00,0,2591.0,1710.0,0.66,12.104,274,163,109,54,111,62,49,92,0.0,0.0
1002,732,2020-03-17 23:26:00,0,2765.0,1818.0,0.657,12.909,483,286,213,73,197,140,57,95,0.0,0.0
1002,733,2020-03-17 23:29:00,0,2928.0,1938.0,0.662,13.683,363,218,151,67,145,89,56,83,0.0,0.0
1002,734,2020-03-17 23:32:00,0,3149.0,2062.0,0.655,14.693,322,223,152,71,99,33,66,118,0.0,0.0
1002,735,2020-03-17 23:35:00,0,2901.0,1971.0,0.679,13.614,180,117,76,41,63,6,57,70,0.0,0.0
1002,736,2020-03-17 23:38:00,0,3279.0,2283.0,0.696,15.446,421,269,211,58,152,83,69,81,0.0,0.0
1002,737,2020-03-17 23:41:00,0,3358.0,2342.0,0.697,15.826,377,227,158,69,150,74,76,103,0.0,0.0
1002,738,2020-03-17 23:44:00,0,3263.0,2300.0,0.705,15.405,511,314,235,79,197,111,86,99,0.0,0.0
1002,739,2020-03-17 23:47:00,0,3522.0,2395.0,0.68,16.53,440,271,202,69,169,84,85,96,0.0,0.0
1002,740,2020-03-17 23:50:00,0,3839.0,2642.0,0.688,18.053,410,215,150,65,195,126,69,72,0.0,0.0
1002,741,2020-03-17 23:53:00,0,3271.0,2279.0,0.697,15.409,323,223,164,59,100,53,47,90,0.0,0.0
1002,742,2020-03-17 23:56:00,0,3894.0,2774.0,0.713,18.413,270,187,116,71,83,11,72,115,0.0,0.0
1002,743,2020-03-17 23:59:00,0,3814.0,2636.0,0.691,17.946,285,182,110,72,103,18,85,114,0.0,0.0
1002,744,2020-03-18 00:02:00,0,3360.0,2411.0,0.718,15.91,302,221,152,69,81,31,50,67,0.0,0.0
1002,745,2020-03-18 00:05:00,0,3035.0,2177.0,0.718,14.367,384,203,149,54,181,127,54,13,0.0,0.0
1002,746,2020-03-18 00:08:00,0,3263.0,2346.0,0.719,15.453,421,269,198,71,152,82,70,108,0.0,0.0
1002,747,2020-03-18 00:11:00,0,3786.0,2801.0,0.74,18.019,229,147,74,73,82,11,71,118,0.0,0.0
1002,748,2020-03-18 00:14:00,0,3110.0,2234.0,0.718,14.728,325,192,122,70,133,93,40,14,0.0,0.0
1002,749,2020-03-18 00:17:00,0,3639.0,2622.0,0.721,17.241,468,281,229,52,187,143,44,35,0.0,0.0
1002,750,2020-03-18 00:20:00,0,3162.0,2395.0,0.758,15.109,553,282,221,61,271,196,75,27,0.0,0.0
1002,751,2020-03-18 00:23:00,0,3099.0,2294.0,0.74,14.751,577,269,211,58,308,223,85,34,0.0,0.0
1002,752,2020-03-18 00:26:00,0,3796.0,2762.0,0.728,18.013,217,155,87,68,62,6,56,68,0.0,0.0
1002,753,2020-03-18 00:29:00,0,2642.0,1959.0,0.742,12.579,494,220,165,55,274,207,67,11,0.0,0.0
1002,754,2020-03-18 00:32:00,0,3155.0,2381.0,0.755,15.066,293,183,129,54,110,75,35,26,0.0,0.0
1002,755,2020-03-18 00:35:00,0,2023.0,1447.0,0.715,9.572,101,54,30,24,47,26,21,0,0.0,0.0
1002,756,2020-03-18 00:38:00,0,1784.0,1307.0,0.732,8.476,11,4,3,1,7,5,2,0,0.0,0.0
1002,757,2020-03-18 00:41:00,0,1641.0,1159.0,0.706,7.748,4,4,1,3,0,0,0,0,0.0,0.0
1002,758,2020-03-18 00:44:00,0,1651.0,1135.0,0.687,7.763,41,25,14,11,16,9,7,0,0.0,0.0
1002,759,2020-03-18 00:47:00,0,1806.0,1245.0,0.69,8.493,23,5,2,3,18,3,15,0,0.0,0.0
1002,760,2020-03-18 00:50:00,0,1780.0,1295.0,0.728,8.446,20,8,4,4,12,2,10,0,0.0,0.0
1002,761,2020-03-18 00:53:00,0,1797.0,1270.0,0.707,8.489,4,0,0,0,4,0,4,0,0.0,0.0
1002,762,2020-03-18 00:56:00,0,1802.0,1232.0,0.684,8.464,12,0,0,0,12,0,12,0,0.0,0.0
1002,763,2020-03-18 00:59:00,0,1791.0,1277.0,0.713,8.472,132,63,48,15,69,43,26,10,0.0,0.0
1002,764,2020-03-18 01:02:00,0,3623.0,2763.0,0.762,17.334,396,243,180,63,153,80,73,80,0.0,0.0
1002,765,2020-03-18 01:05:00,0,3769.0,2932.0,0.778,18.096,217,132,70,62,85,6,79,110,0.0,0.0
1002,766,2020-03-18 01:08:00,0,3725.0,2974.0,0.798,17.967,229,147,89,58,82,0,82,129,0.0,0.0
1002,767,2020-03-18 01:11:00,0,3185.0,2609.0,0.819,15.44,375,248,181,67,127,75,52,21,0.0,0.0
1002,768,2020-03-18 01:14:00,0,1991.0,1519.0,0.763,9.528,402,211,160,51,191,136,55,16,0.0,0.0
1002,769,2020-03-18 01:17:00,0,2328.0,1720.0,0.739,11.078,376,195,157,38,181,132,49,22,0.0,0.0
1002,770,2020-03-18 01:20:00,0,2483.0,1802.0,0.726,11.78,372,179,130,49,193,121,72,49,0.0,0.0
1002,771,2020-03-18 01:23:00,0,3919.0,2976.0,0.759,18.737,219,144,81,63,75,4,71,115,0.0,0.0
1002,772,2020-03-18 01:26:00,0,3912.0,3012.0,0.77,18.746,228,143,66,77,85,8,77,99,0.0,0.0
1002,773,2020-03-18 01:29:00,0,2626.0,1949.0,0.742,12.503,396,209,149,60,187,117,70,23,0.0,0.0
1002,774,2020-03-18 01:32:00,0,3009.0,2228.0,0.74,14.324,435,270,203,67,165,107,58,36,0.0,0.0
1002,775,2020-03-18 01:35:00,0,2867.0,2148.0,0.749,13.674,440,201,143,58,239,168,71,24,0.0,0.0
1002,776,2020-03-18 01:38:00,0,3150.0,2427.0,0.77,15.101,277,181,117,64,96,58,38,21,0.0,0.0
1002,777,2020-03-18 01:41:00,0,3619.0,2744.0,0.758,17.296,281,169,111,58,112,66,46,17,0.0,0.0
1002,778,2020-03-18 01:44:00,0,2252.0,1635.0,0.726,10.684,360,207,139,68,153,90,63,45,0.0,0.0
1002,779,2020-03-18 01:47:00,0,3140.0,2445.0,0.779,15.077,670,293,206,87,377,277,100,14,0.0,0.0
1002,780,2020-03-18 01:50:00,0,3560.0,2712.0,0.762,17.03,594,353,271,82,241,156,85,70,0.0,0.0
1002,781,2020-03-18 01:53:00,0,3699.5,2835.0,0.7665,17.7155,748,447,379,68,301,227,74,51,0.43,0.0
1002,782,2020-03-18 01:56:00,0,3839.0,2958.0,0.771,18.401,518,303,245,58,215,158,57,0,0.1,0.0
1002,783,2020-03-18 01:59:00,0,3751.0,2941.0,0.784,18.038,581,309,255,54,272,195,77,7,0.36,0.0
1002,784,2020-03-18 02:02:00,0,2673.0,2087.0,0.781,12.842,478,200,152,48,278,204,74,28,0.0,0.0
1002,785,2020-03-18 02:05:00,0,3938.0,2968.0,0.754,18.802,730,420,354,66,310,228,82,63,0.18,0.0
1002,786,2020-03-18 02:08:00,0,4141.0,3189.0,0.77,19.848,402,231,187,44,171,122,49,59,0.0,0.0
1002,787,2020-03-18 02:11:00,0,3895.0,3079.0,0.791,18.757,382,142,100,42,240,184,56,3,0.07,0.0
1002,788,2020-03-18 02:14:00,0,3918.0,2965.0,0.757,18.719,635,299,235,64,336,238,98,24,0.0,0.0
1002,789,2020-03-18 02:17:00,0,3803.0,2747.0,0.722,18.025,542,336,251,85,206,110,96,119,0.0,0.0
1002,790,2020-03-18 02:20:00,0,3789.0,2831.0,0.747,18.063,638,319,243,76,319,227,92,45,0.24,0.0
1002,791,2020-03-18 02:23:00,0,3637.0,2711.0,0.745,17.329,746,324,251,73,422,326,96,40,0.0,0.0
1002,792,2020-03-18 02:26:00,0,3643.0,2730.0,0.749,17.375,580,285,219,66,295,205,90,25,0.0,0.0
1002,793,2020-03-18 02:29:00,0,3730.0,2745.0,0.736,17.734,608,352,276,76,256,170,86,93,0.0,0.0
1002,794,2020-03-18 02:32:00,0,3861.0,2878.0,0.746,18.399,596,237,166,71,359,264,95,9,0.0,0.0
1002,795,2020-03-18 02:35:00,0,3865.0,2838.0,0.734,18.373,520,249,191,58,271,195,76,29,0.0,0.0
1002,796,2020-03-18 02:38:00,0,3025.0,2169.0,0.717,14.32,769,387,315,72,382,301,81,42,0.0,0.0
1002,797,2020-03-18 02:41:00,0,3930.0,2964.0,0.754,18.766,1479,829,740,89,650,523,127,156,0.0,0.0
1002,798,2020-03-18 02:44:00,0,3781.0,2873.0,0.76,18.08,1108,610,513,97,498,380,118,294,0.0,0.0
1002,799,2020-03-18 02:47:00,0,3624.0,2729.0,0.753,17.302,436,210,166,44,226,175,51,302,0.0,0.0
1002,800,2020-03-18 02:50:00,0,3937.0,2909.0,0.739,18.735,614,261,211,50,353,259,94,183,0.31,0.0
1002,801,2020-03-18 02:53:00,0,3642.0,2655.0,0.729,17.289,491,239,191,48,252,200,52,236,0.0,0.0
1002,802,2020-03-18 02:56:00,0,3947.0,2936.0,0.744,18.802,670,340,270,70,330,249,81,198,0.0,0.0
1002,803,2020-03-18 02:59:00,0,3941.0,2875.0,0.73,18.71,699,349,268,81,350,270,80,191,0.12,0.0
1002,804,2020-03-18 03:02:00,0,3948.0,2901.0,0.735,18.766,589,271,214,57,318,239,79,221,0.0,0.0
1002,805,2020-03-18 03:05:00,0,3960.0,2865.0,0.724,18.776,642,416,317,99,226,149,77,142,0.0,0.0
1002,806,2020-03-18 03:08:00,0,3736.0,2699.0,0.722,17.709,769,364,293,71,405,321,84,120,0.0,0.0
1002,807,2020-03-18 03:11:00,0,3642.0,2657.0,0.73,17.29,705,313,249,64,392,291,101,173,0.0,0.0
1002,808,2020-03-18 03:14:00,0,3120.0,2227.0,0.714,14.76,231,115,83,32,116,72,44,131,0.0,0.0
1002,809,2020-03-18 03:17:00,0,3731.0,2637.0,0.707,17.62,546,200,149,51,346,264,82,158,0.0,0.0
1002,810,2020-03-18 03:20:00,0,3675.0,2585.0,0.703,17.341,427,182,130,52,245,171,74,142,0.0,0.0
1002,811,2020-03-18 03:23:00,0,3678.0,2555.0,0.695,17.319,645,303,218,85,342,258,84,97,0.01,0.0
1002,812,2020-03-18 03:26:00,0,3655.0,2629.0,0.719,17.313,584,302,224,78,282,199,83,109,0.03,0.0
1002,813,2020-03-18 03:29:00,0,3259.0,2375.0,0.729,15.469,444,192,152,40,252,182,70,117,0.0,0.0
1002,814,2020-03-18 03:32:00,0,3322.0,2435.0,0.733,15.784,549,235,177,58,314,240,74,202,0.0,0.0
1002,815,2020-03-18 03:35:00,0,3435.0,2452.0,0.714,16.248,362,194,136,58,168,94,74,145,0.0,0.0
1002,816,2020-03-18 03:38:00,0,3596.0,2489.0,0.692,16.927,173,124,71,53,49,2,47,61,0.0,0.0
1002,817,2020-03-18 03:41:00,0,3347.0,2413.0,0.721,15.858,376,205,146,59,171,93,78,92,0.0,0.0
1002,818,2020-03-18 03:44:00,0,3270.0,2354.0,0.72,15.491,310,190,121,69,120,48,72,85,0.0,0.0
1002,819,2020-03-18 03:47:00,0,3121.0,2217.0,0.71,14.752,578,272,202,70,306,233,73,126,0.0,0.0
1002,820,2020-03-18 03:50:00,0,3116.0,2200.0,0.706,14.713,447,197,155,42,250,193,57,176,0.11,0.0
1002,821,2020-03-18 03:53:00,0,2893.0,2002.0,0.692,13.614,68,41,34,7,27,20,7,147,0.0,0.0
1002,822,2020-03-18 03:56:00,0,2814.0,1985.0,0.706,13.285,365,173,119,54,192,144,48,77,0.0,0.0
1002,823,2020-03-18 03:59:00,0,2958.0,2048.0,0.692,13.922,527,211,150,61,316,237,79,13,0.0,0.0
1002,824,2020-03-18 04:02:00,0,3126.0,2172.0,0.695,14.723,323,151,116,35,172,129,43,115,0.0,0.0
1002,825,2020-03-18 04:05:00,0,3132.0,2167.0,0.692,14.741,50,36,26,10,14,9,5,97,0.0,0.0
1002,826,2020-03-18 04:08:00,0,2884.0,2064.0,0.716,13.65,297,172,132,40,125,91,34,140,0.0,0.0
1002,827,2020-03-18 04:11:00,0,2876.0,2032.0,0.707,13.584,147,68,36,32,79,48,31,13,0.0,0.0
1002,828,2020-03-18 04:14:00,0,3056.0,2108.0,0.69,14.377,194,97,61,36,97,64,33,58,0.0,0.0
1002,829,2020-03-18 04:17:00,0,2889.0,2042.0,0.707,13.645,204,118,91,27,86,59,27,38,0.0,0.0
1002,830,2020-03-18 04:20:00,0,2509.0,1687.0,0.673,11.752,0,0,0,0,0,0,0,1,0.0,0.0
1002,831,2020-03-18 04:23:00,0,2373.0,1535.0,0.647,11.051,0,0,0,0,0,0,0,25,0.0,0.0
1002,832,2020-03-18 04:26:00,0,2190.0,1488.0,0.68,10.275,101,49,28,21,52,36,16,60,0.0,0.0
1002,833,2020-03-18 04:29:00,0,2578.0,1819.0,0.706,12.172,265,136,90,46,129,94,35,148,0.0,0.0
1002,834,2020-03-18 04:32:00,0,2740.0,1960.0,0.715,12.965,244,98,72,26,146,105,41,44,0.0,0.0
1002,835,2020-03-18 04:35:00,0,2893.0,1979.0,0.684,13.589,82,41,20,21,41,28,13,42,0.0,0.0
1002,836,2020-03-18 04:38:00,0,2590.0,1740.0,0.672,12.132,187,105,84,21,82,55,27,103,0.0,0.0
1002,837,2020-03-18 04:41:00,0,2949.0,2099.0,0.712,13.942,173,68,36,32,105,78,27,4,0.0,0.0
1002,838,2020-03-18 04:44:00,0,2595.0,1739.0,0.67,12.149,363,184,131,53,179,119,60,48,0.01,0.0
1002,839,2020-03-18 04:47:00,0,2736.0,1901.0,0.695,12.884,371,204,147,57,167,114,53,53,0.0,0.0
1002,840,2020-03-18 04:50:00,0,2512.0,1667.0,0.664,11.742,47,23,16,7,24,17,7,69,0.0,0.0
1002,841,2020-03-18 04:53:00,0,2554.5,1688.0,0.661,11.933,0,0,0,0,0,0,0,14,0.0,0.0
1002,842,2020-03-18 04:56:00,0,2597.0,1709.0,0.658,12.124,183,94,62,32,89,61,28,93,0.0,0.0
1002,843,2020-03-18 04:59:00,0,2610.0,1713.0,0.656,12.179,192,80,41,39,112,57,55,7,0.0,0.0
1002,844,2020-03-18 05:02:00,0,2736.0,1875.0,0.685,12.854,207,115,83,32,92,69,23,115,0.0,0.0
1002,845,2020-03-18 05:05:00,0,2579.0,1810.0,0.702,12.166,368,163,122,41,205,137,68,46,0.0,0.0
1002,846,2020-03-18 05:08:00,0,2587.0,1810.0,0.7,12.197,217,82,55,27,135,90,45,40,0.0,0.0
1002,847,2020-03-18 05:11:00,0,2732.0,1912.0,0.7,12.881,3,3,1,2,0,0,0,30,0.0,0.0
1002,848,2020-03-18 05:14:00,0,2597.0,1727.0,0.665,12.146,0,0,0,0,0,0,0,0,0.0,0.0
1002,849,2020-03-18 05:17:00,0,2347.0,1626.0,0.693,11.047,0,0,0,0,0,0,0,0,0.0,0.0
1002,850,2020-03-18 05:20:00,0,2279.0,1509.0,0.662,10.65,0,0,0,0,0,0,0,0,0.0,0.0
1002,851,2020-03-18 05:23:00,0,2198.0,1460.0,0.664,10.279,3,3,1,2,0,0,0,62,0.0,0.0
1002,852,2020-03-18 05:26:00,0,1785.0,1266.0,0.709,8.435,0,0,0,0,0,0,0,0,0.0,0.0
1002,853,2020-03-18 05:29:00,0,1807.0,1204.0,0.666,8.455,0,0,0,0,0,0,0,0,0.0,0.0
1002,854,2020-03-18 05:32:00,0,1725.0,1147.0,0.665,8.065,0,0,0,0,0,0,0,0,0.0,0.0
1002,855,2020-03-18 05:35:00,0,1656.0,1115.0,0.673,7.761,0,0,0,0,0,0,0,2,0.0,0.0
1002,856,2020-03-18 05:38:00,0,1660.0,1055.0,0.636,7.71,0,0,0,0,0,0,0,0,0.0,0.0
1002,857,2020-03-18 05:41:00,0,1663.0,1056.0,0.635,7.721,1,1,0,1,0,0,0,3,0.0,0.0
1002,858,2020-03-18 05:44:00,0,1585.0,1027.0,0.648,7.384,4,4,1,3,0,0,0,50,0.0,0.0
1002,859,2020-03-18 05:47:00,0,2042.0,1363.0,0.667,9.556,62,36,22,14,26,19,7,103,0.0,0.0
1002,860,2020-03-18 05:50:00,0,2110.0,1452.0,0.688,9.923,327,194,139,55,133,80,53,79,0.0,0.0
1002,861,2020-03-18 05:53:00,0,2357.0,1591.0,0.675,11.049,81,29,19,10,52,35,17,20,0.0,0.0
1002,862,2020-03-18 05:56:00,0,2186.0,1508.0,0.69,10.284,0,0,0,0,0,0,0,5,0.0,0.0
1002,863,2020-03-18 05:59:00,0,2120.0,1417.0,0.668,9.922,0,0,0,0,0,0,0,5,0.0,0.0
1002,864,2020-03-18 06:02:00,1,2052.0,1380.0,0.673,9.611,286,151,105,46,135,99,36,95,0.0,0.0
1002,865,2020-03-18 06:05:00,1,2335.0,1633.0,0.7,11.008,274,131,88,43,143,84,59,38,0.0,0.0
1002,866,2020-03-18 06:08:00,1,2592.0,1758.0,0.678,12.158,86,27,11,16,59,25,34,7,0.0,0.0
1002,867,2020-03-18 06:11:00,1,2749.0,1846.0,0.672,12.876,132,78,58,20,54,33,21,45,0.11,0.0
1002,868,2020-03-18 06:14:00,1,2735.0,1912.0,0.699,12.894,277,167,114,53,110,67,43,64,0.0,0.0
1002,869,2020-03-18 06:17:00,1,2721.0,1930.0,0.709,12.856,388,163,108,55,225,143,82,35,0.0,0.0
1002,870,2020-03-18 06:20:00,1,2884.0,2009.0,0.697,13.586,375,195,148,47,180,125,55,54,0.0,0.0
1002,871,2020-03-18 06:23:00,1,2813.0,1947.0,0.692,13.239,143,47,31,16,96,46,50,1,0.0,0.0
1002,872,2020-03-18 06:26:00,1,2575.0,1779.0,0.691,12.114,83,24,13,11,59,6,53,2,0.0,0.0
1002,873,2020-03-18 06:29:00,1,2516.0,1636.0,0.65,11.725,73,1,0,1,72,0,72,0,0.0,0.0
1002,874,2020-03-18 06:32:00,1,2373.0,1509.0,0.636,11.023,9,2,0,2,7,4,3,0,0.0,0.0
1002,875,2020-03-18 06:35:00,1,2129.0,1407.0,0.661,9.945,33,5,1,4,28,7,21,0,0.0,0.0
1002,876,2020-03-18 06:38:00,1,1972.0,1299.0,0.659,9.207,88,8,0,8,80,21,59,1,0.0,0.0
1002,877,2020-03-18 06:41:00,1,2058.0,1318.0,0.64,9.566,153,73,37,36,80,41,39,3,0.0,0.0
1002,878,2020-03-18 06:44:00,1,2040.0,1362.0,0.668,9.545,42,27,9,18,15,6,9,0,0.0,0.0
1002,879,2020-03-18 06:47:00,1,1798.0,1263.0,0.703,8.483,31,21,8,13,10,0,10,0,0.0,0.0
1002,880,2020-03-18 06:50:00,1,1813.0,1201.0,0.662,8.472,0,0,0,0,0,0,0,0,0.0,0.0
1002,881,2020-03-18 06:53:00,1,1642.0,1141.0,0.695,7.732,20,17,0,17,3,0,3,0,0.0,0.0
1002,882,2020-03-18 06:56:00,1,1646.0,1119.0,0.68,7.726,2,0,0,0,2,1,1,0,0.0,0.0
1002,883,2020-03-18 06:59:00,1,1656.0,1084.0,0.655,7.725,8,4,0,4,4,2,2,0,0.0,0.0
1002,884,2020-03-18 07:02:00,1,1659.0,1092.0,0.658,7.744,2,2,0,2,0,0,0,0,0.0,0.0
1002,885,2020-03-18 07:05:00,1,1661.0,1074.0,0.646,7.733,36,21,6,15,15,7,8,0,0.0,0.0
1002,886,2020-03-18 07:08:00,1,1818.0,1162.0,0.639,8.448,21,1,0,1,20,1,19,0,0.0,0.0
1002,887,2020-03-18 07:11:00,1,1818.0,1183.0,0.651,8.475,86,29,13,16,57,23,34,4,0.0,0.0
1002,888,2020-03-18 07:14:00,1,2052.0,1341.0,0.654,9.571,122,43,19,24,79,43,36,2,0.0,0.0
1002,889,2020-03-18 07:17:00,1,2055.0,1327.0,0.645,9.568,26,6,0,6,20,7,13,0,0.0,0.0
1002,890,2020-03-18 07:20:00,1,1802.0,1250.0,0.693,8.485,48,27,11,16,21,11,10,0,0.0,0.0
1002,891,2020-03-18 07:23:00,1,1794.0,1254.0,0.699,8.456,17,0,0,0,17,7,10,0,0.0,0.0
1002,892,2020-03-18 07:26:00,1,1803.0,1248.0,0.692,8.485,6,0,0,0,6,0,6,0,0.0,0.0
1002,893,2020-03-18 07:29:00,1,1810.0,1189.0,0.657,8.449,19,15,8,7,4,2,2,0,0.0,0.0
1002,894,2020-03-18 07:32:00,1,1822.0,1168.0,0.641,8.474,11,4,0,4,7,1,6,0,0.0,0.0
1002,895,2020-03-18 07:35:00,1,1636.0,1127.0,0.689,7.693,5,3,1,2,2,0,2,0,0.0,0.0
1002,896,2020-03-18 07:38:00,1,1649.0,1100.0,0.667,7.716,2,0,0,0,2,1,1,0,0.0,0.0
1002,897,2020-03-18 07:41:00,1,1654.0,1093.0,0.661,7.727,1,0,0,0,1,0,1,0,0.0,0.0
1002,898,2020-03-18 07:44:00,1,1654.0,1077.0,0.651,7.71,15,0,0,0,15,2,13,0,0.0,0.0
1002,899,2020-03-18 07:47:00,1,1814.0,1188.0,0.655,8.461,110,36,22,14,74,40,34,35,0.0,0.0
1002,900,2020-03-18 07:50:00,1,2725.0,1890.0,0.693,12.828,66,38,17,21,28,19,9,7,0.0,0.0
1002,901,2020-03-18 07:53:00,1,2739.5,1853.0,0.676,12.8445,314,164,118,46,150,107,43,57,0.0,0.0
1002,902,2020-03-18 07:56:00,1,2754.0,1816.0,0.659,12.861,129,64,49,15,65,44,21,4,0.0,0.0
1002,903,2020-03-18 07:59:00,1,2129.0,1419.0,0.666,9.96,229,98,62,36,131,83,48,22,0.0,0.0
1002,904,2020-03-18 08:02:00,1,2601.0,1741.0,0.669,12.176,193,77,43,34,116,67,49,33,0.0,0.0
1002,905,2020-03-18 08:05:00,1,2618.0,1677.0,0.641,12.173,216,122,83,39,94,64,30,28,0.0,0.0
1002,906,2020-03-18 08:08:00,1,2616.0,1668.0,0.637,12.154,130,82,45,37,48,29,19,1,0.0,0.0
1002,907,2020-03-18 08:11:00,1,2691.0,1806.0,0.671,12.603,67,41,16,25,26,15,11,1,0.0,0.0
1002,908,2020-03-18 08:14:00,1,2353.0,1602.0,0.681,11.044,277,128,78,50,149,93,56,6,0.0,0.0
1002,909,2020-03-18 08:17:00,1,2386.0,1492.0,0.625,11.052,291,154,102,52,137,74,63,13,0.0,0.0
1002,910,2020-03-18 08:20:00,1,2601.0,1746.0,0.671,12.184,271,111,80,31,160,89,71,16,0.0,0.0
1002,911,2020-03-18 08:23:00,1,2817.0,1915.0,0.68,13.22,196,93,73,20,103,75,28,62,0.0,0.0
1002,912,2020-03-18 08:26:00,1,2829.0,1879.0,0.664,13.225,127,76,49,27,51,37,14,66,0.04,0.0
1002,913,2020-03-18 08:29:00,1,2759.0,1820.0,0.66,12.887,105,51,36,15,54,22,32,6,0.0,0.0
1002,914,2020-03-18 08:32:00,1,2199.0,1455.0,0.661,10.276,324,151,111,40,173,113,60,6,0.0,0.0
1002,915,2020-03-18 08:35:00,1,2764.0,1823.0,0.659,12.908,435,219,159,60,216,136,80,5,0.0,0.0
1002,916,2020-03-18 08:38:00,1,2583.0,1760.0,0.681,12.125,643,313,235,78,330,227,103,5,0.0,0.0
1002,917,2020-03-18 08:41:00,1,2670.0,1779.0,0.667,12.49,165,33,15,18,132,59,73,5,0.0,0.0
1002,918,2020-03-18 08:44:00,1,2760.0,1796.0,0.651,12.864,90,29,18,11,61,24,37,0,0.0,0.0
1002,919,2020-03-18 08:47:00,1,2599.0,1713.0,0.659,12.138,15,11,4,7,4,1,3,0,0.0,0.0
1002,920,2020-03-18 08:50:00,1,2353.0,1569.0,0.667,11.01,38,37,14,23,1,0,1,0,0.0,0.0
1002,921,2020-03-18 08:53:00,1,2212.0,1421.0,0.642,10.288,19,12,0,12,7,2,5,0,0.0,0.0
1002,922,2020-03-18 08:56:00,1,2067.0,1287.0,0.623,9.571,85,30,17,13,55,25,30,0,0.0,0.0
1002,923,2020-03-18 08:59:00,1,1799.0,1231.0,0.684,8.45,1,0,0,0,1,0,1,0,0.0,0.0
1002,924,2020-03-18 09:02:00,1,1816.0,1181.0,0.65,8.462,52,18,6,12,34,18,16,3,0.0,0.0
1002,925,2020-03-18 09:05:00,1,1808.0,1209.0,0.669,8.462,0,0,0,0,0,0,0,0,0.0,0.0
1002,926,2020-03-18 09:08:00,1,1812.0,1195.0,0.659,8.463,82,14,7,7,68,6,62,0,0.0,0.0
1002,927,2020-03-18 09:11:00,1,1812.0,1194.0,0.659,8.464,77,6,0,6,71,9,62,0,0.0,0.0
1002,928,2020-03-18 09:14:00,1,1825.0,1156.0,0.634,8.472,43,1,1,0,42,0,42,0,0.0,0.0
1002,929,2020-03-18 09:17:00,1,1652.0,1110.0,0.672,7.737,2,0,0,0,2,0,2,0,0.0,0.0
1002,930,2020-03-18 09:20:00,1,1653.0,1102.0,0.667,7.731,97,32,16,16,65,6,59,3,0.0,0.0
1002,931,2020-03-18 09:23:00,1,1815.0,1182.0,0.651,8.462,107,31,10,21,76,2,74,0,0.0,0.0
1002,932,2020-03-18 09:26:00,1,1809.0,1213.0,0.67,8.472,87,2,0,2,85,9,76,0,0.0,0.0
1002,933,2020-03-18 09:29:00,1,1808.0,1208.0,0.668,8.461,99,14,7,7,85,7,78,0,0.0,0.0
1002,934,2020-03-18 09:32:00,1,1806.0,1221.0,0.676,8.469,74,23,4,19,51,4,47,9,0.0,0.0
1002,935,2020-03-18 09:35:00,1,1798.0,1229.0,0.684,8.445,19,2,1,1,17,6,11,0,0.0,0.0
1002,936,2020-03-18 09:38:00,1,1812.0,1192.0,0.658,8.46,7,1,0,1,6,3,3,0,0.0,0.0
1002,937,2020-03-18 09:41:00,1,1644.0,1128.0,0.686,7.728,3,2,0,2,1,0,1,0,0.0,0.0
1002,938,2020-03-18 09:44:00,1,1659.0,1079.0,0.65,7.733,17,1,0,1,16,9,7,0,0.0,0.0
1002,939,2020-03-18 09:47:00,1,1662.0,1070.0,0.644,7.735,6,2,1,1,4,1,3,0,0.0,0.0
1002,940,2020-03-18 09:50:00,1,1646.0,1134.0,0.689,7.739,60,21,11,10,39,23,16,0,0.0,0.0
1002,941,2020-03-18 09:53:00,1,1816.0,1173.0,0.646,8.453,4,0,0,0,4,2,2,0,0.0,0.0
1002,942,2020-03-18 09:56:00,1,1815.0,1173.0,0.646,8.449,12,5,3,2,7,3,4,0,0.0,0.0
1002,943,2020-03-18 09:59:00,1,1817.0,1171.0,0.644,8.455,6,3,1,2,3,1,2,0,0.0,0.0
1002,944,2020-03-18 10:02:00,1,1644.0,1114.0,0.677,7.711,28,24,1,23,4,2,2,0,0.0,0.0
1002,945,2020-03-18 10:05:00,1,1648.0,1121.0,0.681,7.733,5,2,1,1,3,1,2,0,0.0,0.0
1002,946,2020-03-18 10:08:00,1,1648.0,1088.0,0.66,7.697,26,23,4,19,3,2,1,0,0.0,0.0
1002,947,2020-03-18 10:11:00,1,1660.0,1087.0,0.655,7.744,135,57,28,29,78,43,35,4,0.0,0.0
1002,948,2020-03-18 10:14:00,1,2207.0,1498.0,0.679,10.354,173,95,67,28,78,36,42,10,0.0,0.0
1002,949,2020-03-18 10:17:00,1,2604.0,1664.0,0.639,12.105,81,42,17,25,39,24,15,3,0.0,0.0
1002,950,2020-03-18 10:20:00,1,2743.0,1852.0,0.675,12.858,234,138,99,39,96,75,21,46,0.18,0.0
1002,951,2020-03-18 10:23:00,1,2198.0,1501.0,0.683,10.322,590,314,242,72,276,206,70,8,0.0,0.0
1002,952,2020-03-18 10:26:00,1,2360.0,1568.0,0.664,11.036,540,222,155,67,318,221,97,15,0.0,0.0
1002,953,2020-03-18 10:29:00,1,2594.0,1744.0,0.672,12.15,1034,402,309,93,632,490,142,7,0.0,0.0
1002,954,2020-03-18 10:32:00,1,2596.0,1728.0,0.666,12.143,831,397,307,90,434,321,113,19,0.0,0.0
1002,955,2020-03-18 10:35:00,1,2677.0,1807.0,0.675,12.55,590,307,232,75,283,211,72,20,0.0,0.0
1002,956,2020-03-18 10:38:00,1,2200.0,1463.0,0.665,10.289,892,486,390,96,406,300,106,66,0.0,0.0
1002,957,2020-03-18 10:41:00,1,2351.0,1563.0,0.665,10.995,409,263,186,77,146,92,54,58,0.0,0.0
1002,958,2020-03-18 10:44:00,1,2519.0,1616.0,0.641,11.715,58,18,2,16,40,3,37,3,0.0,0.0
1002,959,2020-03-18 10:47:00,1,2361.0,1569.0,0.665,11.039,63,24,10,14,39,18,21,13,0.0,0.0
1002,960,2020-03-18 10:50:00,1,2364.0,1527.0,0.646,11.007,61,15,6,9,46,14,32,28,0.0,0.0
1002,961,2020-03-18 10:53:00,1,2010.0,1306.0,0.6505,9.366,0,0,0,0,0,0,0,0,0.0,0.0
1002,962,2020-03-18 10:56:00,1,1656.0,1085.0,0.655,7.725,7,4,0,4,3,1,2,0,0.0,0.0
1002,963,2020-03-18 10:59:00,1,1814.0,1187.0,0.654,8.461,0,0,0,0,0,0,0,0,0.0,0.0
1002,964,2020-03-18 11:02:00,1,1991.0,1244.0,0.625,9.222,17,13,3,10,4,1,3,2,0.0,0.0
1002,965,2020-03-18 11:05:00,1,2057.0,1284.0,0.624,9.527,11,10,0,10,1,1,0,0,0.0,0.0
1002,966,2020-03-18 11:08:00,1,1740.0,1120.0,0.644,8.096,0,0,0,0,0,0,0,0,0.0,0.0
1002,967,2020-03-18 11:11:00,1,1674.0,1008.0,0.602,7.711,6,3,0,3,3,0,3,0,0.0,0.0
1002,968,2020-03-18 11:14:00,1,1675.0,984.0,0.587,7.691,0,0,0,0,0,0,0,0,0.0,0.0
1002,969,2020-03-18 11:17:00,1,1686.0,977.0,0.579,7.727,19,6,1,5,13,1,12,3,0.0,0.0
1002,970,2020-03-18 11:20:00,1,1670.0,1011.0,0.605,7.7,7,1,0,1,6,3,3,1,0.0,0.0
1002,971,2020-03-18 11:23:00,1,1657.0,1089.0,0.657,7.735,61,61,1,60,0,0,0,0,0.0,0.0
1002,972,2020-03-18 11:26:00,1,1674.0,1003.0,0.599,7.708,5,5,0,5,0,0,0,0,0.0,0.0
1002,973,2020-03-18 11:29:00,1,1513.0,920.0,0.608,6.979,1,0,0,0,1,1,0,1,0.0,0.0
1002,974,2020-03-18 11:32:00,1,1528.0,883.0,0.578,6.998,3,3,0,3,0,0,0,0,0.0,0.0
1002,975,2020-03-18 11:35:00,1,1521.0,873.0,0.574,6.958,17,17,0,17,0,0,0,0,0.0,0.0
1002,976,2020-03-18 11:38:00,1,1528.0,863.0,0.565,6.975,2,2,0,2,0,0,0,0,0.0,0.0
1002,977,2020-03-18 11:41:00,1,1520.0,897.0,0.59,6.983,21,0,0,0,21,12,9,9,0.0,0.0
1002,978,2020-03-18 11:44:00,1,2056.0,1366.0,0.664,9.615,217,95,70,25,122,77,45,42,0.0,0.0
1002,979,2020-03-18 11:47:00,1,2590.0,1760.0,0.679,12.155,219,50,26,24,169,117,52,2,0.0,0.0
1002,980,2020-03-18 11:50:00,1,2042.0,1403.0,0.687,9.601,251,94,73,21,157,80,77,54,0.0,0.0
1002,981,2020-03-18 11:53:00,1,1817.0,1184.0,0.651,8.471,285,133,79,54,152,103,49,25,0.0,0.0
1002,982,2020-03-18 11:56:00,1,2058.0,1328.0,0.645,9.579,229,114,68,46,115,35,80,27,0.0,0.0
1002,983,2020-03-18 11:59:00,1,1507.0,940.0,0.624,6.98,80,5,1,4,75,0,75,0,0.0,0.0
1002,984,2020-03-18 12:02:00,1,1521.0,878.0,0.577,6.967,75,12,0,12,63,0,63,0,0.0,0.0
1002,985,2020-03-18 12:05:00,1,1525.0,893.0,0.586,6.998,63,5,1,4,58,0,58,0,0.0,0.0
1002,986,2020-03-18 12:08:00,1,1520.0,899.0,0.591,6.986,89,34,16,18,55,9,46,1,0.0,0.0
1002,987,2020-03-18 12:11:00,1,1595.0,951.0,0.596,7.339,50,2,0,2,48,4,44,0,0.0,0.0
1002,988,2020-03-18 12:14:00,1,1800.0,1245.0,0.691,8.472,59,20,8,12,39,5,34,4,0.0,0.0
1002,989,2020-03-18 12:17:00,1,1815.0,1194.0,0.658,8.473,5,4,2,2,1,1,0,0,0.0,0.0
1002,990,2020-03-18 12:20:00,1,1664.0,1027.0,0.617,7.695,4,4,0,4,0,0,0,0,0.0,0.0
1002,991,2020-03-18 12:23:00,1,1585.0,990.0,0.625,7.343,15,15,0,15,0,0,0,0,0.0,0.0
1002,992,2020-03-18 12:26:00,1,1588.0,979.0,0.616,7.342,12,12,2,10,0,0,0,0,0.0,0.0
1002,993,2020-03-18 12:29:00,1,1677.0,992.0,0.592,7.708,50,46,0,46,4,1,3,0,0.0,0.0
1002,994,2020-03-18 12:32:00,1,1830.0,1126.0,0.615,8.455,6,2,0,2,4,0,4,0,0.0,0.0
1002,995,2020-03-18 12:35:00,1,1810.0,1214.0,0.671,8.475,0,0,0,0,0,0,0,0,0.0,0.0
1002,996,2020-03-18 12:38:00,1,1737.0,1114.0,0.641,8.078,0,0,0,0,0,0,0,0,0.0,0.0
1002,997,2020-03-18 12:41:00,1,1667.0,1054.0,0.633,7.736,3,1,1,0,2,0,2,0,0.0,0.0
1002,998,2020-03-18 12:44:00,1,1665.0,1045.0,0.628,7.719,3,2,2,0,1,0,1,0,0.0,0.0
1002,999,2020-03-18 12:47:00,1,1805.0,1229.0,0.681,8.473,73,15,6,9,58,1,57,0,0.0,0.0
1002,1000,2020-03-18 12:50:00,1,1821.0,1152.0,0.633,8.449,5,0,0,0,5,0,5,0,0.0,0.0
1002,1001,2020-03-18 12:53:00,1,1677.0,1018.0,0.607,7.735,298,181,122,59,117,67,50,56,0.0,0.0
1002,1002,2020-03-18 12:56:00,1,2042.0,1374.0,0.673,9.566,177,58,23,35,119,63,56,46,0.0,0.0
1002,1003,2020-03-18 12:59:00,1,2201.0,1464.0,0.665,10.294,55,22,3,19,33,16,17,2,0.0,0.0
1002,1004,2020-03-18 13:02:00,1,1884.0,1265.0,0.672,8.822,9,7,1,6,2,0,2,0,0.0,0.0
1002,1005,2020-03-18 13:05:00,1,1822.0,1169.0,0.642,8.474,31,30,6,24,1,0,1,0,0.0,0.0
1002,1006,2020-03-18 13:08:00,1,1817.0,1165.0,0.641,8.449,2,2,1,1,0,0,0,0,0.0,0.0
1002,1007,2020-03-18 13:11:00,1,1880.0,1257.0,0.669,8.799,9,9,3,6,0,0,0,0,0.0,0.0
1002,1008,2020-03-18 13:14:00,1,1796.0,1235.0,0.688,8.443,3,1,0,1,2,1,1,0,0.0,0.0
1002,1009,2020-03-18 13:17:00,1,2064.0,1296.0,0.628,9.568,4,3,0,3,1,0,1,0,0.0,0.0
1002,1010,2020-03-18 13:20:00,1,1808.0,1197.0,0.662,8.45,0,0,0,0,0,0,0,0,0.0,0.0
1002,1011,2020-03-18 13:23:00,1,1660.0,1059.0,0.638,7.713,0,0,0,0,0,0,0,0,0.0,0.0
1002,1012,2020-03-18 13:26:00,1,1669.0,1057.0,0.633,7.748,9,6,2,4,3,1,2,0,0.0,0.0
1002,1013,2020-03-18 13:29:00,1,1655.0,1059.0,0.64,7.695,1,1,0,1,0,0,0,0,0.0,0.0
1002,1014,2020-03-18 13:32:00,1,1655.0,1094.0,0.661,7.73,0,0,0,0,0,0,0,0,0.0,0.0
1002,1015,2020-03-18 13:35:00,1,1738.0,1107.0,0.637,8.074,27,23,10,13,4,1,3,2,0.0,0.0
1002,1016,2020-03-18 13:38:00,1,1811.0,1176.0,0.649,8.438,4,4,0,4,0,0,0,0,0.0,0.0
1002,1017,2020-03-18 13:41:00,1,1729.0,1120.0,0.648,8.052,5,1,0,1,4,1,3,0,0.0,0.0
1002,1018,2020-03-18 13:44:00,1,1807.0,1190.0,0.658,8.438,4,4,0,4,0,0,0,0,0.0,0.0
1002,1019,2020-03-18 13:47:00,1,1656.0,1092.0,0.66,7.733,35,24,16,8,11,7,4,5,0.0,0.0
1002,1020,2020-03-18 13:50:00,1,1667.0,1035.0,0.621,7.713,0,0,0,0,0,0,0,0,0.0,0.0
1002,1021,2020-03-18 13:53:00,1,1664.0,1053.0,0.6325,7.722,4,2,0,2,2,0,2,0,0.0,0.0
1002,1022,2020-03-18 13:56:00,1,1661.0,1071.0,0.644,7.731,0,0,0,0,0,0,0,0,0.0,0.0
1002,1023,2020-03-18 13:59:00,1,1656.0,1052.0,0.636,7.688,47,35,7,28,12,2,10,18,0.0,0.0
1002,1024,2020-03-18 14:02:00,1,2040.0,1369.0,0.671,9.554,42,22,7,15,20,1,19,4,0.0,0.0
1002,1025,2020-03-18 14:05:00,1,2044.0,1368.0,0.669,9.57,69,47,7,40,22,4,18,20,0.0,0.0
1002,1026,2020-03-18 14:08:00,1,2343.0,1602.0,0.684,11.004,211,99,51,48,112,66,46,22,0.0,0.0
1002,1027,2020-03-18 14:11:00,1,2271.0,1520.0,0.67,10.631,187,88,58,30,99,67,32,23,0.0,0.0
1002,1028,2020-03-18 14:14:00,1,2214.0,1465.0,0.662,10.347,42,35,10,25,7,2,5,11,0.0,0.0
1002,1029,2020-03-18 14:17:00,1,2434.0,1635.0,0.672,11.402,90,61,20,41,29,10,19,27,0.0,0.0
1002,1030,2020-03-18 14:20:00,1,2282.0,1512.0,0.663,10.667,43,10,4,6,33,3,30,0,0.0,0.0
1002,1031,2020-03-18 14:23:00,1,2221.0,1411.0,0.635,10.314,42,26,16,10,16,1,15,2,0.0,0.0
1002,1032,2020-03-18 14:26:00,1,2048.0,1334.0,0.651,9.548,32,16,3,13,16,0,16,0,0.0,0.0
1002,1033,2020-03-18 14:29:00,1,1890.0,1252.0,0.662,8.835,12,12,0,12,0,0,0,0,0.0,0.0
1002,1034,2020-03-18 14:32:00,1,1820.0,1178.0,0.647,8.476,15,8,2,6,7,1,6,0,0.0,0.0
1002,1035,2020-03-18 14:35:00,1,1823.0,1143.0,0.627,8.45,3,1,0,1,2,0,2,0,0.0,0.0
1002,1036,2020-03-18 14:38:00,1,1649.0,1093.0,0.663,7.707,14,9,2,7,5,2,3,0,0.0,0.0
1002,1037,2020-03-18 14:41:00,1,1660.0,1070.0,0.644,7.723,7,1,1,0,6,2,4,0,0.0,0.0
1002,1038,2020-03-18 14:44:00,1,1661.0,1071.0,0.645,7.731,0,0,0,0,0,0,0,0,0.0,0.0
1002,1039,2020-03-18 14:47:00,1,1668.0,1034.0,0.62,7.715,21,5,2,3,16,10,6,0,0.0,0.0
1002,1040,2020-03-18 14:50:00,1,1658.0,1105.0,0.667,7.755,3,0,0,0,3,1,2,0,0.0,0.0
1002,1041,2020-03-18 14:53:00,1,1647.0,1112.0,0.675,7.722,12,3,0,3,9,2,7,0,0.0,0.0
1002,1042,2020-03-18 14:56:00,1,1646.0,1132.0,0.688,7.738,2,2,1,1,0,0,0,0,0.0,0.0
1002,1043,2020-03-18 14:59:00,1,1659.0,1077.0,0.649,7.73,10,10,4,6,0,0,0,2,0.0,0.0
1002,1044,2020-03-18 15:02:00,1,1668.0,1044.0,0.626,7.727,7,4,1,3,3,0,3,0,0.0,0.0
1002,1045,2020-03-18 15:05:00,1,1659.0,1060.0,0.639,7.708,2,0,0,0,2,0,2,0,0.0,0.0
1002,1046,2020-03-18 15:08:00,1,1654.0,1090.0,0.659,7.726,4,3,2,1,1,0,1,0,0.0,0.0
1002,1047,2020-03-18 15:11:00,1,1642.0,1131.0,0.688,7.723,218,149,93,56,69,40,29,22,0.0,0.0
1002,1048,2020-03-18 15:14:00,1,2047.0,1346.0,0.658,9.556,124,78,34,44,46,13,33,16,0.0,0.0
1002,1049,2020-03-18 15:17:00,1,2202.0,1487.0,0.675,10.321,151,87,51,36,64,39,25,48,0.0,0.0
1002,1050,2020-03-18 15:20:00,1,2412.0,1699.0,0.704,11.385,325,188,145,43,137,90,47,86,0.0,0.0
1002,1051,2020-03-18 15:23:00,1,2273.0,1555.0,0.684,10.677,282,151,107,44,131,87,44,84,0.0,0.0
1002,1052,2020-03-18 15:26:00,1,2347.0,1622.0,0.691,11.043,229,113,81,32,116,73,43,102,0.0,0.0
1002,1053,2020-03-18 15:29:00,1,2427.0,1661.0,0.684,11.4,105,46,24,22,59,29,30,11,0.0,0.0
1002,1054,2020-03-18 15:32:00,1,2205.0,1455.0,0.66,10.298,1,0,0,0,1,0,1,0,0.0,0.0
1002,1055,2020-03-18 15:35:00,1,2052.0,1337.0,0.651,9.564,2,0,0,0,2,0,2,0,0.0,0.0
1002,1056,2020-03-18 15:38:00,1,1802.0,1235.0,0.685,8.468,0,0,0,0,0,0,0,0,0.0,0.0
1002,1057,2020-03-18 15:41:00,1,1823.0,1176.0,0.645,8.484,8,6,3,3,2,1,1,0,0.0,0.0
1002,1058,2020-03-18 15:44:00,1,1733.0,1142.0,0.659,8.093,7,2,0,2,5,1,4,0,0.0,0.0
1002,1059,2020-03-18 15:47:00,1,1819.0,1158.0,0.636,8.45,2,2,0,2,0,0,0,0,0.0,0.0
1002,1060,2020-03-18 15:50:00,1,1653.0,1123.0,0.679,7.759,10,10,3,7,0,0,0,0,0.0,0.0
1002,1061,2020-03-18 15:53:00,1,1746.0,1124.0,0.644,8.124,22,22,5,17,0,0,0,0,0.0,0.0
1002,1062,2020-03-18 15:56:00,1,1735.0,1116.0,0.643,8.07,2,2,0,2,0,0,0,0,0.0,0.0
1002,1063,2020-03-18 15:59:00,1,1741.0,1125.0,0.646,8.104,7,6,2,4,1,0,1,0,0.0,0.0
1002,1064,2020-03-18 16:02:00,1,1820.0,1179.0,0.648,8.476,8,6,0,6,2,0,2,0,0.0,0.0
1002,1065,2020-03-18 16:05:00,1,1814.0,1182.0,0.652,8.456,2,2,0,2,0,0,0,0,0.0,0.0
1002,1066,2020-03-18 16:08:00,1,1729.0,1150.0,0.665,8.086,0,0,0,0,0,0,0,0,0.0,0.0
1002,1067,2020-03-18 16:11:00,1,1728.0,1145.0,0.663,8.076,0,0,0,0,0,0,0,0,0.0,0.0
1002,1068,2020-03-18 16:14:00,1,1830.0,1159.0,0.633,8.495,2,0,0,0,2,0,2,0,0.0,0.0
1002,1069,2020-03-18 16:17:00,1,1647.0,1142.0,0.693,7.754,36,31,25,6,5,3,2,5,0.0,0.0
1002,1070,2020-03-18 16:20:00,1,1826.0,1178.0,0.645,8.497,132,119,53,66,13,3,10,11,0.0,0.0
1002,1071,2020-03-18 16:23:00,1,2063.0,1334.0,0.646,9.606,99,45,17,28,54,27,27,33,0.0,0.0
1002,1072,2020-03-18 16:26:00,1,2211.0,1438.0,0.65,10.304,234,144,83,61,90,35,55,36,0.0,0.0
1002,1073,2020-03-18 16:29:00,1,2356.0,1632.0,0.692,11.091,70,46,35,11,24,16,8,16,0.0,0.0
1002,1074,2020-03-18 16:32:00,1,2274.0,1534.0,0.675,10.657,7,7,2,5,0,0,0,0,0.0,0.0
1002,1075,2020-03-18 16:35:00,1,2031.0,1385.0,0.682,9.537,26,26,1,25,0,0,0,0,0.0,0.0
1002,1076,2020-03-18 16:38:00,1,1973.0,1293.0,0.655,9.207,24,20,0,20,4,1,3,0,0.0,0.0
1002,1077,2020-03-18 16:41:00,1,1794.0,1257.0,0.701,8.459,26,19,13,6,7,4,3,0,0.0,0.0
1002,1078,2020-03-18 16:44:00,1,1818.0,1165.0,0.641,8.453,2,0,0,0,2,0,2,0,0.0,0.0
1002,1079,2020-03-18 16:47:00,1,1647.0,1109.0,0.674,7.716,0,0,0,0,0,0,0,0,0.0,0.0
1002,1080,2020-03-18 16:50:00,1,1637.0,1131.0,0.691,7.701,7,2,1,1,5,0,5,0,0.0,0.0
1002,1081,2020-03-18 16:53:00,1,1725.0,1160.5,0.674,8.0815,0,0,0,0,0,0,0,0,0.0,0.0
1002,1082,2020-03-18 16:56:00,1,1813.0,1190.0,0.657,8.462,0,0,0,0,0,0,0,0,0.0,0.0
1002,1083,2020-03-18 16:59:00,1,1809.0,1206.0,0.667,8.463,1,1,0,1,0,0,0,0,0.0,0.0
1002,1084,2020-03-18 17:02:00,1,1804.0,1207.0,0.669,8.445,2,2,0,2,0,0,0,0,0.0,0.0
1002,1085,2020-03-18 17:05:00,1,1801.0,1213.0,0.673,8.441,9,5,0,5,4,1,3,0,0.0,0.0
1002,1086,2020-03-18 17:08:00,1,2062.0,1317.0,0.639,9.583,136,67,27,40,69,34,35,37,0.0,0.0
1002,1087,2020-03-18 17:11:00,1,2117.0,1427.0,0.674,9.923,178,86,38,48,92,38,54,37,0.0,0.0
1002,1088,2020-03-18 17:14:00,1,2369.0,1580.0,0.667,11.086,261,161,109,52,100,67,33,54,0.0,0.0
1002,1089,2020-03-18 17:17:00,1,2265.0,1556.0,0.687,10.648,374,176,133,43,198,145,53,39,0.0,0.0
1002,1090,2020-03-18 17:20:00,1,2191.0,1514.0,0.691,10.312,56,47,18,29,9,1,8,0,0.0,0.0
1002,1091,2020-03-18 17:23:00,1,2365.0,1537.0,0.65,11.02,53,35,10,25,18,2,16,4,0.0,0.0
1002,1092,2020-03-18 17:26:00,1,2437.0,1632.0,0.67,11.41,73,38,15,23,35,12,23,4,0.0,0.0
1002,1093,2020-03-18 17:29:00,1,2284.0,1515.0,0.664,10.676,1,1,0,1,0,0,0,0,0.0,0.0
1002,1094,2020-03-18 17:32:00,1,2036.0,1379.0,0.677,9.549,0,0,0,0,0,0,0,0,0.0,0.0
1002,1095,2020-03-18 17:35:00,1,1970.0,1294.0,0.657,9.193,3,0,0,0,3,0,3,0,0.0,0.0
1002,1096,2020-03-18 17:38:00,1,1802.0,1239.0,0.687,8.471,8,2,0,2,6,1,5,0,0.0,0.0
1002,1097,2020-03-18 17:41:00,1,1816.0,1196.0,0.658,8.481,27,22,2,20,5,2,3,0,0.0,0.0
1002,1098,2020-03-18 17:44:00,1,1644.0,1108.0,0.674,7.703,13,4,1,3,9,1,8,0,0.0,0.0
1002,1099,2020-03-18 17:47:00,1,1648.0,1108.0,0.672,7.721,6,2,0,2,4,0,4,0,0.0,0.0
1002,1100,2020-03-18 17:50:00,1,1644.0,1118.0,0.68,7.716,1,1,0,1,0,0,0,0,0.0,0.0
1002,1101,2020-03-18 17:53:00,1,1736.0,1150.0,0.663,8.112,17,8,1,7,9,1,8,0,0.0,0.0
1002,1102,2020-03-18 17:56:00,1,1824.0,1166.0,0.639,8.477,28,0,0,0,28,1,27,0,0.0,0.0
1002,1103,2020-03-18 17:59:00,1,1643.0,1133.0,0.69,7.728,126,83,39,44,43,5,38,14,0.0,0.0
1002,1104,2020-03-18 18:02:00,0,1963.0,1339.0,0.682,9.216,28,28,5,23,0,0,0,0,0.0,0.0
1002,1105,2020-03-18 18:05:00,0,1883.0,1294.0,0.687,8.854,29,26,4,22,3,1,2,0,0.0,0.0
1002,1106,2020-03-18 18:08:00,0,1971.0,1315.0,0.667,9.22,12,9,2,7,3,0,3,0,0.0,0.0
1002,1107,2020-03-18 18:11:00,0,1801.0,1239.0,0.688,8.47,20,20,14,6,0,0,0,0,0.0,0.0
1002,1108,2020-03-18 18:14:00,0,2052.0,1338.0,0.652,9.568,572,496,411,85,76,45,31,39,0.0,0.0
1002,1109,2020-03-18 18:17:00,0,2431.0,1659.0,0.683,11.414,441,199,144,55,242,168,74,145,0.0,0.0
1002,1110,2020-03-18 18:20:00,0,2729.0,1895.0,0.694,12.85,487,237,189,48,250,194,56,171,0.0,0.0
1002,1111,2020-03-18 18:23:00,0,2742.0,1837.0,0.67,12.839,381,197,147,50,184,130,54,90,0.0,0.0
1002,1112,2020-03-18 18:26:00,0,2747.0,1863.0,0.678,12.886,522,264,204,60,258,190,68,139,0.0,0.0
1002,1113,2020-03-18 18:29:00,0,2739.0,1946.0,0.711,12.945,640,295,233,62,345,265,80,90,0.0,0.0
1002,1114,2020-03-18 18:32:00,0,2736.0,1871.0,0.684,12.854,622,289,235,54,333,250,83,142,0.0,0.0
1002,1115,2020-03-18 18:35:00,0,2812.0,1919.0,0.682,13.203,688,366,309,57,322,240,82,255,0.0,0.0
1002,1116,2020-03-18 18:38:00,0,3141.0,2129.0,0.678,14.735,1192,656,570,86,536,432,104,361,0.0,0.0
1002,1117,2020-03-18 18:41:00,0,3138.0,2126.0,0.677,14.718,668,361,292,69,307,234,73,200,0.0,0.0
1002,1118,2020-03-18 18:44:00,0,3377.0,2310.0,0.684,15.864,406,224,176,48,182,145,37,231,0.0,0.0
1002,1119,2020-03-18 18:47:00,0,3118.0,2175.0,0.697,14.695,681,352,288,64,329,249,80,242,0.0,0.0
1002,1120,2020-03-18 18:50:00,0,3226.0,2190.0,0.679,15.134,522,299,232,67,223,171,52,159,0.0,0.0
1002,1121,2020-03-18 18:53:00,0,3128.0,2187.0,0.699,14.746,388,216,174,42,172,123,49,184,0.0,0.0
1002,1122,2020-03-18 18:56:00,0,3205.0,2178.0,0.68,15.041,606,330,270,60,276,211,65,154,0.0,0.0
1002,1123,2020-03-18 18:59:00,0,2982.0,2043.0,0.685,14.011,194,121,91,30,73,52,21,197,0.0,0.0
1002,1124,2020-03-18 19:02:00,0,3071.0,2030.0,0.661,14.347,532,296,234,62,236,183,53,136,0.0,0.0
1002,1125,2020-03-18 19:05:00,0,3139.0,2073.0,0.66,14.666,305,190,144,46,115,83,32,143,0.0,0.0
1002,1126,2020-03-18 19:08:00,0,3300.0,2193.0,0.664,15.431,358,193,155,38,165,121,44,136,0.0,0.0
1002,1127,2020-03-18 19:11:00,0,3146.0,2100.0,0.667,14.721,629,312,260,52,317,248,69,183,0.0,0.0
1002,1128,2020-03-18 19:14:00,0,3151.0,2115.0,0.671,14.757,191,133,98,35,58,44,14,144,0.0,0.0
1002,1129,2020-03-18 19:17:00,0,3229.0,2149.0,0.666,15.1,268,150,119,31,118,91,27,170,0.0,0.0
1002,1130,2020-03-18 19:20:00,0,3147.0,2104.0,0.668,14.729,425,214,166,48,211,154,57,206,0.0,0.0
1002,1131,2020-03-18 19:23:00,0,3143.0,2064.0,0.657,14.671,546,308,247,61,238,189,49,175,0.0,0.0
1002,1132,2020-03-18 19:26:00,0,3131.0,2069.0,0.661,14.629,366,209,165,44,157,111,46,102,0.0,0.0
1002,1133,2020-03-18 19:29:00,0,3160.0,2095.0,0.663,14.771,231,140,71,69,91,13,78,116,0.0,0.0
1002,1134,2020-03-18 19:32:00,0,3132.0,2109.0,0.673,14.677,195,133,62,71,62,0,62,104,0.0,0.0
1002,1135,2020-03-18 19:35:00,0,3134.0,2094.0,0.668,14.667,332,199,134,65,133,66,67,169,0.0,0.0
1002,1136,2020-03-18 19:38:00,0,2918.0,1914.0,0.656,13.617,406,218,168,50,188,133,55,151,0.0,0.0
1002,1137,2020-03-18 19:41:00,0,3287.0,2243.0,0.682,15.436,543,296,237,59,247,180,67,134,0.0,0.0
1002,1138,2020-03-18 19:44:00,0,3166.0,2070.0,0.654,14.765,414,245,175,70,169,86,83,198,0.0,0.0
1002,1139,2020-03-18 19:47:00,0,3273.0,2295.0,0.701,15.436,488,270,214,56,218,155,63,148,0.0,0.0
1002,1140,2020-03-18 19:50:00,0,3159.0,2060.0,0.652,14.73,352,203,137,66,149,77,72,173,0.0,0.0
1002,1141,2020-03-18 19:53:00,0,3144.5,2100.5,0.668,14.717,447,243,183,60,204,148,56,110,0.0,0.0
1002,1142,2020-03-18 19:56:00,0,3130.0,2141.0,0.684,14.704,549,249,199,50,300,233,67,148,0.06,0.0
1002,1143,2020-03-18 19:59:00,0,2748.0,1852.0,0.674,12.878,468,217,160,57,251,160,91,92,0.0,0.0
1002,1144,2020-03-18 20:02:00,0,2737.0,1889.0,0.69,12.877,455,257,212,45,198,149,49,148,0.0,0.0
1002,1145,2020-03-18 20:05:00,0,2443.0,1616.0,0.661,11.414,98,57,25,32,41,21,20,100,0.0,0.0
1002,1146,2020-03-18 20:08:00,0,3135.0,2151.0,0.686,14.736,459,230,193,37,229,173,56,179,0.0,0.0
1002,1147,2020-03-18 20:11:00,0,2896.0,1982.0,0.684,13.605,402,214,172,42,188,131,57,161,0.0,0.0
1002,1148,2020-03-18 20:14:00,0,3080.0,2058.0,0.668,14.414,240,150,110,40,90,58,32,49,0.0,0.0
1002,1149,2020-03-18 20:17:00,0,2983.0,2016.0,0.676,13.984,383,187,142,45,196,133,63,124,0.0,0.0
1002,1150,2020-03-18 20:20:00,0,2580.0,1784.0,0.692,12.14,21,9,7,2,12,10,2,65,0.0,0.0
1002,1151,2020-03-18 20:23:00,0,2574.0,1763.0,0.685,12.095,15,15,5,10,0,0,0,58,0.0,0.0
1002,1152,2020-03-18 20:26:00,0,2665.0,1818.0,0.682,12.512,17,11,3,8,6,3,3,87,0.0,0.0
1002,1153,2020-03-18 20:29:00,0,2725.0,1922.0,0.705,12.865,288,164,131,33,124,88,36,119,0.0,0.0
1002,1154,2020-03-18 20:32:00,0,2897.0,2023.0,0.698,13.654,340,206,145,61,134,74,60,163,0.0,0.0
1002,1155,2020-03-18 20:35:00,0,3153.0,2141.0,0.679,14.793,203,130,64,66,73,2,71,87,0.0,0.0
1002,1156,2020-03-18 20:38:00,0,3121.0,2163.0,0.693,14.692,239,149,91,58,90,19,71,105,0.0,0.0
1002,1157,2020-03-18 20:41:00,0,3147.0,2102.0,0.668,14.726,269,163,98,65,106,33,73,94,0.0,0.0
1002,1158,2020-03-18 20:44:00,0,3148.0,2094.0,0.665,14.724,185,118,63,55,67,4,63,108,0.0,0.0
1002,1159,2020-03-18 20:47:00,0,3166.0,2089.0,0.66,14.787,258,155,94,61,103,24,79,123,0.0,0.0
1002,1160,2020-03-18 20:50:00,0,2973.0,2027.0,0.682,13.958,238,154,94,60,84,12,72,101,0.0,0.0
1002,1161,2020-03-18 20:53:00,0,2718.0,1916.0,0.705,12.832,554,274,204,70,280,216,64,129,0.0,0.0
1002,1162,2020-03-18 20:56:00,0,2667.0,1839.0,0.689,12.544,417,207,151,56,210,144,66,95,0.01,0.0
1002,1163,2020-03-18 20:59:00,0,3135.0,2140.0,0.683,14.723,365,198,155,43,167,122,45,117,0.0,0.0
1002,1164,2020-03-18 21:02:00,0,2806.0,1962.0,0.699,13.227,411,228,178,50,183,130,53,110,0.0,0.0
1002,1165,2020-03-18 21:05:00,0,3134.0,2156.0,0.688,14.736,183,101,51,50,82,7,75,153,0.0,0.0
1002,1166,2020-03-18 21:08:00,0,3285.0,2295.0,0.699,15.487,234,141,67,74,93,14,79,116,0.0,0.0
1002,1167,2020-03-18 21:11:00,0,3148.0,2150.0,0.683,14.784,245,147,85,62,98,0,98,141,0.0,0.0
1002,1168,2020-03-18 21:14:00,0,3144.0,2118.0,0.673,14.735,230,147,72,75,83,11,72,117,0.0,0.0
1002,1169,2020-03-18 21:17:00,0,3153.0,2125.0,0.674,14.776,235,150,81,69,85,11,74,132,0.0,0.0
1002,1170,2020-03-18 21:20:00,0,3137.0,2166.0,0.691,14.757,229,168,98,70,61,17,44,99,0.0,0.0
1002,1171,2020-03-18 21:23:00,0,3260.0,2333.0,0.716,15.427,275,198,120,78,77,12,65,120,0.0,0.0
1002,1172,2020-03-18 21:26:00,0,3590.0,2516.0,0.701,16.93,281,181,113,68,100,48,52,134,0.04,0.0
1002,1173,2020-03-18 21:29:00,0,3403.0,2487.0,0.731,16.16,222,150,90,60,72,9,63,119,0.01,0.0
1002,1174,2020-03-18 21:32:00,0,3505.0,2518.0,0.719,16.597,343,185,117,68,158,94,64,113,0.04,0.0
1002,1175,2020-03-18 21:35:00,0,3243.0,2411.0,0.744,15.446,280,190,128,62,90,27,63,150,0.09,0.0
1002,1176,2020-03-18 21:38:00,0,3674.0,2622.0,0.714,17.38,290,188,112,76,102,33,69,125,0.0,0.0
1002,1177,2020-03-18 21:41:00,0,3644.0,2622.0,0.72,17.259,286,198,127,71,88,24,64,117,0.0,0.0
1002,1178,2020-03-18 21:44:00,0,3774.0,2857.0,0.757,18.035,287,207,129,78,80,22,58,118,0.0,0.0
1002,1179,2020-03-18 21:47:00,0,3314.0,2561.0,0.773,15.894,367,224,154,70,143,85,58,135,0.08,0.0
1002,1180,2020-03-18 21:50:00,0,3255.0,2423.0,0.744,15.509,548,276,224,52,272,201,71,131,0.0,0.0
1002,1181,2020-03-18 21:53:00,0,3166.0,2384.0,0.753,15.114,594,351,300,51,243,191,52,179,0.0,0.0
1002,1182,2020-03-18 21:56:00,0,3390.0,2535.0,0.748,16.165,328,211,131,80,117,45,72,129,0.02,0.0
1002,1183,2020-03-18 21:59:00,0,3640.0,2660.0,0.731,17.285,328,186,120,66,142,61,81,168,0.06,0.0
1002,1184,2020-03-18 22:02:00,0,3099.0,2261.0,0.729,14.714,291,167,100,67,124,70,54,39,0.0,0.0
1002,1185,2020-03-18 22:05:00,0,2342.0,1611.0,0.688,11.011,82,38,29,9,44,20,24,64,0.07,0.0
1002,1186,2020-03-18 22:08:00,0,2975.0,2092.0,0.703,14.039,202,114,79,35,88,60,28,45,0.0,0.0
1002,1187,2020-03-18 22:11:00,0,3397.0,2565.0,0.755,16.226,506,262,193,69,244,184,60,128,0.0,0.0
1002,1188,2020-03-18 22:14:00,0,3785.0,2807.0,0.742,18.02,583,334,271,63,249,192,57,195,0.09,0.0
1002,1189,2020-03-18 22:17:00,0,3076.0,2343.0,0.762,14.714,388,206,160,46,182,136,46,137,0.0,0.0
1002,1190,2020-03-18 22:20:00,0,2610.0,1997.0,0.765,12.494,309,182,130,52,127,86,41,81,0.0,0.0
1002,1191,2020-03-18 22:23:00,0,3168.0,2372.0,0.749,15.107,394,242,184,58,152,103,49,108,0.0,0.0
1002,1192,2020-03-18 22:26:00,0,2310.0,1740.0,0.753,11.029,332,205,152,53,127,92,35,86,0.0,0.0
1002,1193,2020-03-18 22:29:00,0,3097.0,2292.0,0.74,14.741,296,187,113,74,109,48,61,101,0.0,0.0
1002,1194,2020-03-18 22:32:00,0,3644.0,2640.0,0.724,17.281,312,198,122,76,114,41,73,133,0.0,0.0
1002,1195,2020-03-18 22:35:00,0,3464.0,2618.0,0.756,16.548,241,168,107,61,73,2,71,133,0.0,0.0
1002,1196,2020-03-18 22:38:00,0,3490.0,2604.0,0.746,16.633,342,261,180,81,81,9,72,141,0.0,0.0
1002,1197,2020-03-18 22:41:00,0,3611.0,2748.0,0.761,17.269,343,252,161,91,91,17,74,134,0.0,0.0
1002,1198,2020-03-18 22:44:00,0,3141.0,2429.0,0.773,15.064,293,186,134,52,107,58,49,109,0.0,0.0
1002,1199,2020-03-18 22:47:00,0,3091.0,2305.0,0.746,14.73,583,356,273,83,227,167,60,229,0.0,0.0
1002,1200,2020-03-18 22:50:00,0,3091.0,2328.0,0.753,14.757,363,242,165,77,121,62,59,134,0.06,0.0
1002,1201,2020-03-18 22:53:00,0,3076.5,2345.0,0.7625,14.718,399,233,165,68,166,116,50,70,0.0,0.0
1002,1202,2020-03-18 22:56:00,0,3062.0,2362.0,0.772,14.679,478,293,234,59,185,137,48,209,0.0,0.0
1002,1203,2020-03-18 22:59:00,0,2568.0,1831.0,0.713,12.147,304,148,99,49,156,109,47,43,0.0,0.0
1002,1204,2020-03-18 23:02:00,0,3223.0,2479.0,0.769,15.443,429,244,192,52,185,130,55,141,0.0,0.0
1002,1205,2020-03-18 23:05:00,0,3298.0,2525.0,0.766,15.789,142,86,57,29,56,38,18,71,0.0,0.0
1002,1206,2020-03-18 23:08:00,0,2345.0,1633.0,0.696,11.046,111,73,53,20,38,28,10,96,0.0,0.0
1002,1207,2020-03-18 23:11:00,0,3784.0,2831.0,0.748,18.044,371,205,163,42,166,110,56,90,0.0,0.0
1002,1208,2020-03-18 23:14:00,0,3765.0,2845.0,0.756,17.986,250,151,88,63,99,37,62,78,0.0,0.0
1002,1209,2020-03-18 23:17:00,0,3775.0,2875.0,0.762,18.056,264,178,102,76,86,15,71,143,0.0,0.0
1002,1210,2020-03-18 23:20:00,0,3765.0,2845.0,0.756,17.985,235,162,89,73,73,5,68,119,0.0,0.0
1002,1211,2020-03-18 23:23:00,0,3633.0,2731.0,0.752,17.339,249,164,87,77,85,14,71,116,0.0,0.0
1002,1212,2020-03-18 23:26:00,0,3752.0,2924.0,0.779,18.02,261,166,100,66,95,26,69,110,0.0,0.0
1002,1213,2020-03-18 23:29:00,0,3691.0,2847.0,0.771,17.697,255,174,98,76,81,16,65,121,0.0,0.0
1002,1214,2020-03-18 23:32:00,0,3745.0,2989.0,0.798,18.067,246,146,91,55,100,37,63,94,0.4,0.0
1002,1215,2020-03-18 23:35:00,0,3764.0,2882.0,0.766,18.02,218,141,74,67,77,20,57,103,0.0,0.0
1002,1216,2020-03-18 23:38:00,0,3759.0,2947.0,0.784,18.074,242,164,97,67,78,18,60,131,0.0,0.0
1002,1217,2020-03-18 23:41:00,0,3903.0,3054.0,0.783,18.761,271,203,129,74,68,17,51,146,0.0,0.0
1002,1218,2020-03-18 23:44:00,0,3819.0,3062.0,0.802,18.435,258,179,100,79,79,10,69,136,0.0,0.0
1002,1219,2020-03-18 23:47:00,0,3912.0,3086.0,0.789,18.831,226,136,72,64,90,31,59,107,0.0,0.0
1002,1220,2020-03-18 23:50:00,0,3741.0,2970.0,0.794,18.029,306,208,129,79,98,27,71,140,0.0,0.0
1002,1221,2020-03-18 23:53:00,0,3199.0,2604.0,0.814,15.487,554,325,250,75,229,174,55,125,0.0,0.0
1002,1222,2020-03-18 23:56:00,0,3619.0,2774.0,0.767,17.33,408,244,170,74,164,100,64,177,0.03,0.0
1002,1223,2020-03-18 23:59:00,0,3731.0,3079.0,0.825,18.111,271,183,110,73,88,22,66,163,0.0,0.0
1002,1224,2020-03-19 00:02:00,0,3846.0,3234.0,0.841,18.733,229,156,82,74,73,22,51,129,0.0,0.0
1002,1225,2020-03-19 00:05:00,0,3033.0,2564.0,0.845,14.789,278,171,124,47,107,68,39,65,0.0,0.0
1002,1226,2020-03-19 00:08:00,0,3058.0,2426.0,0.793,14.733,459,244,180,64,215,163,52,79,0.0,0.0
1002,1227,2020-03-19 00:11:00,0,2451.0,1920.0,0.784,11.781,56,20,14,6,36,19,17,67,0.0,0.0
1002,1228,2020-03-19 00:14:00,0,2322.0,1737.0,0.748,11.07,7,7,0,7,0,0,0,8,0.0,0.0
1002,1229,2020-03-19 00:17:00,0,3131.0,2521.0,0.805,15.129,206,125,89,36,81,39,42,82,0.0,0.0
1002,1230,2020-03-19 00:20:00,0,3790.0,3140.0,0.829,18.409,232,160,95,65,72,12,60,144,0.0,0.0
1002,1231,2020-03-19 00:23:00,0,3715.0,3140.0,0.845,18.112,278,181,100,81,97,24,73,134,0.0,0.0
1002,1232,2020-03-19 00:26:00,0,3864.0,3173.0,0.821,18.739,284,183,104,79,101,29,72,140,0.0,0.0
1002,1233,2020-03-19 00:29:00,0,3740.0,3052.0,0.816,18.115,122,70,39,31,52,17,35,107,0.09,0.0
1002,1234,2020-03-19 00:32:00,0,3600.0,2937.0,0.816,17.434,288,160,112,48,128,86,42,28,0.0,0.0
1002,1235,2020-03-19 00:35:00,0,3567.0,2960.0,0.83,17.333,397,185,141,44,212,149,63,82,0.05,0.0
1002,1236,2020-03-19 00:38:00,0,2370.0,1947.0,0.822,11.492,235,116,75,41,119,72,47,47,0.0,0.0
1002,1237,2020-03-19 00:41:00,0,2138.0,1703.0,0.797,10.31,28,24,12,12,4,0,4,3,0.0,0.0
1002,1238,2020-03-19 00:44:00,0,1997.0,1549.0,0.776,9.582,124,76,44,32,48,11,37,0,0.0,0.0
1002,1239,2020-03-19 00:47:00,0,1751.0,1422.0,0.812,8.475,81,43,22,21,38,24,14,0,0.0,0.0
1002,1240,2020-03-19 00:50:00,0,1914.0,1485.0,0.776,9.187,84,8,4,4,76,53,23,0,0.0,0.0
1002,1241,2020-03-19 00:53:00,0,1772.0,1342.0,0.758,8.467,17,1,0,1,16,0,16,0,0.0,0.0
1002,1242,2020-03-19 00:56:00,0,1690.0,1285.0,0.76,8.081,22,4,1,3,18,0,18,0,0.0,0.0
1002,1243,2020-03-19 00:59:00,0,1767.0,1355.0,0.767,8.461,77,34,24,10,43,25,18,0,0.0,0.0
1002,1244,2020-03-19 01:02:00,0,3715.0,3056.0,0.823,18.022,305,186,117,69,119,51,68,93,0.13,0.0
1002,1245,2020-03-19 01:05:00,0,3715.0,3130.0,0.842,18.102,228,145,82,63,83,8,75,140,0.0,0.0
1002,1246,2020-03-19 01:08:00,0,3687.0,3183.0,0.863,18.052,263,169,100,69,94,27,67,149,0.0,0.0
1002,1247,2020-03-19 01:11:00,0,3795.0,3219.0,0.848,18.517,302,169,103,66,133,92,41,67,0.16,0.02
1002,1248,2020-03-19 01:14:00,0,3706.0,3142.0,0.848,18.08,225,133,67,66,92,20,72,134,0.0,0.03
1002,1249,2020-03-19 01:17:00,0,3682.0,3170.0,0.861,18.017,178,124,67,57,54,9,45,145,0.0,0.02
1002,1250,2020-03-19 01:20:00,0,3694.0,3110.0,0.842,17.997,291,182,113,69,109,63,46,101,0.0,0.02
1002,1251,2020-03-19 01:23:00,0,3548.0,3012.0,0.849,17.316,201,123,67,56,78,32,46,145,0.23,0.0
1002,1252,2020-03-19 01:26:00,0,3629.0,3068.0,0.845,17.695,229,146,78,68,83,20,63,135,0.0,0.0
1002,1253,2020-03-19 01:29:00,0,3643.0,3089.0,0.848,17.773,223,156,91,65,67,12,55,123,0.0,0.14
1002,1254,2020-03-19 01:32:00,0,3548.0,3043.0,0.857,17.349,192,132,69,63,60,13,47,127,0.0,0.06
1002,1255,2020-03-19 01:35:00,0,3720.0,3203.0,0.861,18.203,190,144,77,67,46,16,30,100,0.0,0.14
1002,1256,2020-03-19 01:38:00,0,3615.0,3117.0,0.862,17.696,373,187,128,59,186,139,47,42,0.02,0.0
1002,1257,2020-03-19 01:41:00,0,3977.0,3518.0,0.885,19.564,456,258,193,65,198,150,48,122,0.07,0.0
1002,1258,2020-03-19 01:44:00,0,2479.0,2177.0,0.878,12.176,298,163,117,46,135,98,37,58,0.0,0.01
1002,1259,2020-03-19 01:47:00,0,3036.0,2547.0,0.839,14.783,207,117,81,36,90,68,22,93,0.25,0.0
1002,1260,2020-03-19 01:50:00,0,3565.0,2959.0,0.83,17.322,245,163,97,66,82,36,46,156,0.0,0.05
1002,1261,2020-03-19 01:53:00,0,3358.0,2862.0,0.854,16.3985,67,38,17,21,29,12,17,29,0.0,0.24
1002,1262,2020-03-19 01:56:00,0,3151.0,2765.0,0.878,15.475,173,59,47,12,114,90,24,2,0.0,0.0
1002,1263,2020-03-19 01:59:00,0,2516.0,2063.0,0.82,12.197,250,135,101,34,115,85,30,164,0.13,0.01
1002,1264,2020-03-19 02:02:00,0,3530.0,3060.0,0.867,17.296,710,454,377,77,256,202,54,241,0.0,0.03
1002,1265,2020-03-19 02:05:00,0,3082.0,2702.0,0.877,15.135,244,146,101,45,98,65,33,33,0.0,0.0
1002,1266,2020-03-19 02:08:00,0,3013.0,2569.0,0.853,14.714,508,241,176,65,267,191,76,47,0.08,0.0
1002,1267,2020-03-19 02:11:00,0,2570.0,2167.0,0.843,12.525,59,51,15,36,8,0,8,70,0.0,0.0
1002,1268,2020-03-19 02:14:00,0,3822.0,3356.0,0.878,18.774,713,403,341,62,310,246,64,236,0.0,0.0
1002,1269,2020-03-19 02:17:00,0,3963.0,3549.0,0.895,19.544,368,211,159,52,157,115,42,105,0.0,0.0
1002,1270,2020-03-19 02:20:00,0,3605.0,3181.0,0.882,17.724,566,292,228,64,274,204,70,29,0.03,0.0
1002,1271,2020-03-19 02:23:00,0,3154.0,2825.0,0.896,15.555,242,95,54,41,147,96,51,33,0.0,0.0
1002,1272,2020-03-19 02:26:00,0,2777.0,2425.0,0.873,13.625,138,82,35,47,56,27,29,7,0.0,0.0
1002,1273,2020-03-19 02:29:00,0,3451.0,2970.0,0.861,16.884,199,99,45,54,100,56,44,3,0.0,0.0
1002,1274,2020-03-19 02:32:00,0,3615.0,3163.0,0.875,17.746,139,48,11,37,91,48,43,1,0.0,0.0
1002,1275,2020-03-19 02:35:00,0,3131.0,2883.0,0.921,15.527,50,3,3,0,47,22,25,0,0.0,0.0
1002,1276,2020-03-19 02:38:00,0,3161.0,2726.0,0.862,15.475,14,5,4,1,9,2,7,0,0.0,0.0
1002,1277,2020-03-19 02:41:00,0,3032.0,2521.0,0.832,14.736,7,0,0,0,7,2,5,0,0.0,0.0
1002,1278,2020-03-19 02:44:00,0,2646.0,2288.0,0.865,12.958,65,12,6,6,53,37,16,0,0.0,0.0
1002,1279,2020-03-19 02:47:00,0,2501.0,2117.0,0.847,12.197,24,0,0,0,24,2,22,0,0.0,0.0
1002,1280,2020-03-19 02:50:00,0,2280.0,1871.0,0.821,11.057,11,0,0,0,11,3,8,0,0.0,0.0
1002,1281,2020-03-19 02:53:00,0,1966.0,1638.0,0.833,9.558,43,7,2,5,36,17,19,0,0.0,0.0
1002,1282,2020-03-19 02:56:00,0,1726.0,1534.0,0.889,8.501,64,29,17,12,35,21,14,0,0.0,0.0
1002,1283,2020-03-19 02:59:00,0,2109.0,1796.0,0.852,10.297,24,18,3,15,6,1,5,0,0.0,0.0
1002,1284,2020-03-19 03:02:00,0,2270.0,1949.0,0.859,11.1,16,16,6,10,0,0,0,0,0.0,0.0
1002,1285,2020-03-19 03:05:00,0,2280.0,1865.0,0.818,11.048,6,6,3,3,0,0,0,0,0.0,0.0
1002,1286,2020-03-19 03:08:00,0,2129.0,1768.0,0.831,10.345,18,18,6,12,0,0,0,0,0.0,0.0
1002,1287,2020-03-19 03:11:00,0,2118.0,1776.0,0.838,10.313,2,2,2,0,0,0,0,0,0.0,0.0
1002,1288,2020-03-19 03:14:00,0,2137.0,1726.0,0.808,10.331,129,84,47,37,45,28,17,0,0.0,0.02
1002,1289,2020-03-19 03:17:00,0,2511.0,2036.0,0.811,12.15,184,71,43,28,113,72,41,28,0.0,0.0
1002,1290,2020-03-19 03:20:00,0,2471.0,2178.0,0.881,12.147,252,110,70,40,142,69,73,72,0.0,0.0
1002,1291,2020-03-19 03:23:00,0,2644.0,2278.0,0.861,12.941,281,152,95,57,129,60,69,46,0.0,0.14
1002,1292,2020-03-19 03:26:00,0,2185.0,1886.0,0.863,10.697,56,24,17,7,32,6,26,4,0.0,0.0
1002,1293,2020-03-19 03:29:00,0,1734.0,1474.0,0.85,8.463,0,0,0,0,0,0,0,0,0.0,0.0
1002,1294,2020-03-19 03:32:00,0,2282.0,1905.0,0.835,11.101,63,15,7,8,48,26,22,0,0.0,0.0
1002,1295,2020-03-19 03:35:00,0,2483.0,2112.0,0.85,12.123,47,16,1,15,31,18,13,0,0.0,0.0
1002,1296,2020-03-19 03:38:00,0,2515.0,2059.0,0.819,12.19,140,64,48,16,76,51,25,3,0.0,0.0
1002,1297,2020-03-19 03:41:00,0,2493.0,2103.0,0.843,12.151,0,0,0,0,0,0,0,0,0.0,0.0
1002,1298,2020-03-19 03:44:00,0,2249.0,2018.0,0.898,11.094,4,3,1,2,1,0,1,0,0.0,0.0
1002,1299,2020-03-19 03:47:00,0,2254.0,1942.0,0.862,11.03,8,4,1,3,4,1,3,0,0.0,0.0
1002,1300,2020-03-19 03:50:00,0,2256.0,1925.0,0.853,11.02,1,0,0,0,1,0,1,0,0.0,0.0
1002,1301,2020-03-19 03:53:00,0,2182.0,1880.0,0.861,10.679,245,139,89,50,106,63,43,9,0.0,0.0
1002,1302,2020-03-19 03:56:00,0,2493.0,2127.0,0.853,12.179,219,91,49,42,128,74,54,6,0.0,0.0
1002,1303,2020-03-19 03:59:00,0,2484.0,2206.0,0.888,12.229,10,0,0,0,10,1,9,0,0.0,0.0
1002,1304,2020-03-19 04:02:00,0,2245.0,2035.0,0.907,11.1,122,69,47,22,53,29,24,3,0.0,0.0
1002,1305,2020-03-19 04:05:00,0,2474.0,2194.0,0.887,12.178,63,39,24,15,24,12,12,14,0.0,0.0
1002,1306,2020-03-19 04:08:00,0,2337.0,2015.0,0.863,11.437,5,5,0,5,0,0,0,0,0.0,0.0
1002,1307,2020-03-19 04:11:00,0,2247.0,1932.0,0.86,10.99,196,106,62,44,90,38,52,61,0.0,0.0
1002,1308,2020-03-19 04:14:00,0,2465.0,2211.0,0.897,12.159,238,167,94,73,71,11,60,112,0.0,0.0
1002,1309,2020-03-19 04:17:00,0,2601.0,2391.0,0.919,12.897,295,165,90,75,130,43,87,100,0.0,0.0
1002,1310,2020-03-19 04:20:00,0,2693.0,2403.0,0.892,13.271,220,132,87,45,88,43,45,27,0.0,0.0
1002,1311,2020-03-19 04:23:00,0,2643.0,2279.0,0.862,12.936,339,174,122,52,165,106,59,16,0.0,0.0
1002,1312,2020-03-19 04:26:00,0,2694.0,2396.0,0.889,13.267,929,555,463,92,374,303,71,352,0.0,0.0
1002,1313,2020-03-19 04:29:00,0,3025.0,2640.0,0.873,14.841,832,518,420,98,314,241,73,245,0.0,0.0
1002,1314,2020-03-19 04:32:00,0,2630.0,2349.0,0.893,12.963,605,288,211,77,317,226,91,166,0.0,0.0
1002,1315,2020-03-19 04:35:00,0,3224.0,2858.0,0.887,15.866,965,573,477,96,392,320,72,311,0.0,0.0
1002,1316,2020-03-19 04:38:00,0,3687.0,3175.0,0.861,18.044,520,288,231,57,232,178,54,107,0.0,0.0
1002,1317,2020-03-19 04:41:00,0,3185.0,2708.0,0.85,15.547,270,140,82,58,130,82,48,44,0.0,0.17
1002,1318,2020-03-19 04:44:00,0,3322.0,2828.0,0.851,16.222,331,179,118,61,152,108,44,49,0.0,0.0
1002,1319,2020-03-19 04:47:00,0,3143.0,2774.0,0.883,15.456,763,397,321,76,366,290,76,177,0.0,0.0
1002,1320,2020-03-19 04:50:00,0,3641.0,3055.0,0.839,17.728,1053,669,577,92,384,289,95,343,0.23,0.0
1002,1321,2020-03-19 04:53:00,0,3432.5,2922.5,0.852,16.7605,786,547,456,91,239,156,83,169,0.0,0.0
1002,1322,2020-03-19 04:56:00,0,3224.0,2790.0,0.865,15.793,873,613,507,106,260,179,81,248,0.0,0.0
1002,1323,2020-03-19 04:59:00,0,3569.0,2938.0,0.823,17.314,594,331,269,62,263,191,72,124,0.0,0.0
1002,1324,2020-03-19 05:02:00,0,3253.0,2743.0,0.843,15.853,402,215,166,49,187,142,45,57,0.0,0.0
1002,1325,2020-03-19 05:05:00,0,3592.0,2929.0,0.816,17.394,629,330,260,70,299,233,66,118,0.0,0.0
1002,1326,2020-03-19 05:08:00,0,3056.0,2411.0,0.789,14.712,187,117,46,71,70,24,46,2,0.0,0.0
1002,1327,2020-03-19 05:11:00,0,3183.0,2637.0,0.829,15.459,363,192,127,65,171,113,58,32,0.0,0.0
1002,1328,2020-03-19 05:14:00,0,3045.0,2531.0,0.831,14.801,155,115,57,58,40,20,20,24,0.0,0.0
1002,1329,2020-03-19 05:17:00,0,3200.0,2603.0,0.813,15.489,320,178,120,58,142,88,54,50,0.0,0.0
1002,1330,2020-03-19 05:20:00,0,3026.0,2577.0,0.852,14.775,502,253,201,52,249,198,51,82,0.0,0.0
1002,1331,2020-03-19 05:23:00,0,3190.0,2592.0,0.813,15.438,359,197,141,56,162,106,56,42,0.0,0.0
1002,1332,2020-03-19 05:26:00,0,2685.0,2111.0,0.786,12.918,564,318,246,72,246,178,68,9,0.0,0.0
1002,1333,2020-03-19 05:29:00,0,3085.0,2367.0,0.767,14.776,749,358,270,88,391,284,107,28,0.0,0.0
1002,1334,2020-03-19 05:32:00,0,2812.0,2284.0,0.812,13.61,691,341,260,81,350,255,95,8,0.0,0.0
1002,1335,2020-03-19 05:35:00,0,3002.0,2323.0,0.774,14.401,281,94,41,53,187,124,63,55,0.0,0.0
1002,1336,2020-03-19 05:38:00,0,2836.0,2229.0,0.786,13.642,205,113,63,50,92,58,34,14,0.0,0.0
1002,1337,2020-03-19 05:41:00,0,3069.0,2395.0,0.78,14.742,79,47,5,42,32,13,19,1,0.0,0.0
1002,1338,2020-03-19 05:44:00,0,2990.0,2323.0,0.777,14.352,221,55,26,29,166,116,50,0,0.0,0.0
1002,1339,2020-03-19 05:47:00,0,2824.0,2257.0,0.799,13.625,22,17,2,15,5,3,2,0,0.0,0.0
1002,1340,2020-03-19 05:50:00,0,2552.0,1924.0,0.754,12.186,44,41,1,40,3,1,2,0,0.0,0.0
1002,1341,2020-03-19 05:53:00,0,2305.0,1755.0,0.761,11.027,11,9,0,9,2,0,2,0,0.0,0.0
1002,1342,2020-03-19 05:56:00,0,2159.0,1640.0,0.76,10.32,33,21,13,8,12,4,8,0,0.0,0.0
1002,1343,2020-03-19 05:59:00,0,2237.0,1689.0,0.755,10.685,891,490,390,100,401,305,96,36,0.0,0.0
1002,1344,2020-03-19 06:02:00,1,3009.0,2274.0,0.756,14.374,414,249,189,60,165,111,54,70,0.0,0.0
1002,1345,2020-03-19 06:05:00,1,2654.0,2170.0,0.818,12.857,366,216,162,54,150,106,44,86,0.0,0.0
1002,1346,2020-03-19 06:08:00,1,2848.0,2209.0,0.776,13.666,324,204,146,58,120,80,40,16,0.0,0.0
1002,1347,2020-03-19 06:11:00,1,2533.0,1948.0,0.769,12.135,423,255,195,60,168,123,45,1,0.0,0.0
1002,1348,2020-03-19 06:14:00,1,2673.0,2108.0,0.788,12.867,282,129,93,36,153,101,52,7,0.0,0.0
1002,1349,2020-03-19 06:17:00,1,2693.0,2116.0,0.786,12.952,35,10,2,8,25,7,18,0,0.0,0.0
1002,1350,2020-03-19 06:20:00,1,2523.0,1989.0,0.788,12.143,23,12,7,5,11,6,5,0,0.0,0.0
1002,1351,2020-03-19 06:23:00,1,2379.0,1817.0,0.764,11.387,2,0,0,0,2,1,1,0,0.0,0.0
1002,1352,2020-03-19 06:26:00,1,2157.0,1648.0,0.764,10.325,5,3,1,2,2,1,1,0,0.0,0.0
1002,1353,2020-03-19 06:29:00,1,2002.0,1510.0,0.754,9.558,4,3,2,1,1,0,1,0,0.0,0.0
1002,1354,2020-03-19 06:32:00,1,1931.0,1450.0,0.751,9.214,2,1,0,1,1,0,1,0,0.0,0.0
1002,1355,2020-03-19 06:35:00,1,1765.0,1405.0,0.796,8.511,8,5,1,4,3,1,2,0,0.0,0.0
1002,1356,2020-03-19 06:38:00,1,1771.0,1377.0,0.778,8.5,2,0,0,0,2,0,2,0,0.0,0.0
1002,1357,2020-03-19 06:41:00,1,1771.0,1347.0,0.761,8.469,3,2,1,1,1,1,0,0,0.0,0.0
1002,1358,2020-03-19 06:44:00,1,1601.0,1286.0,0.803,7.733,32,29,0,29,3,1,2,0,0.0,0.0
1002,1359,2020-03-19 06:47:00,1,1612.0,1259.0,0.781,7.746,17,15,0,15,2,0,2,0,0.0,0.0
1002,1360,2020-03-19 06:50:00,1,1609.0,1272.0,0.791,7.746,20,14,4,10,6,2,4,0,0.0,0.0
1002,1361,2020-03-19 06:53:00,1,1601.0,1301.0,0.812,7.749,2,0,0,0,2,0,2,0,0.0,0.0
1002,1362,2020-03-19 06:56:00,1,1602.0,1298.0,0.81,7.749,1,1,1,0,0,0,0,0,0.0,0.0
1002,1363,2020-03-19 06:59:00,1,1696.0,1317.0,0.776,8.141,51,26,19,7,25,17,8,0,0.0,0.0
1002,1364,2020-03-19 07:02:00,1,1762.0,1356.0,0.77,8.446,4,2,0,2,2,0,2,0,0.0,0.0
1002,1365,2020-03-19 07:05:00,1,1691.0,1321.0,0.781,8.127,8,6,0,6,2,0,2,0,0.0,0.0
1002,1366,2020-03-19 07:08:00,1,1779.0,1339.0,0.753,8.492,10,4,0,4,6,2,4,0,0.0,0.0
1002,1367,2020-03-19 07:11:00,1,1686.0,1310.0,0.777,8.092,8,6,0,6,2,1,1,0,0.0,0.0
1002,1368,2020-03-19 07:14:00,1,1621.0,1233.0,0.761,7.751,8,6,0,6,2,0,2,0,0.0,0.0
1002,1369,2020-03-19 07:17:00,1,1618.0,1242.0,0.767,7.75,8,4,2,2,4,1,3,0,0.0,0.0
1002,1370,2020-03-19 07:20:00,1,1601.0,1260.0,0.787,7.702,4,2,0,2,2,1,1,0,0.0,0.0
1002,1371,2020-03-19 07:23:00,1,1614.0,1249.0,0.774,7.742,1,1,0,1,0,0,0,0,0.0,0.0
1002,1372,2020-03-19 07:26:00,1,1612.0,1249.0,0.775,7.736,2,2,0,2,0,0,0,0,0.0,0.0
1002,1373,2020-03-19 07:29:00,1,1607.0,1281.0,0.797,7.751,14,7,4,3,7,2,5,0,0.0,0.0
1002,1374,2020-03-19 07:32:00,1,1766.0,1343.0,0.761,8.447,3,1,0,1,2,1,1,0,0.0,0.0
1002,1375,2020-03-19 07:35:00,1,1758.0,1402.0,0.797,8.48,10,1,1,0,9,1,8,0,0.0,0.0
1002,1376,2020-03-19 07:38:00,1,1752.0,1406.0,0.803,8.46,4,2,0,2,2,0,2,0,0.0,0.0
1002,1377,2020-03-19 07:41:00,1,1765.0,1348.0,0.764,8.447,3,0,0,0,3,1,2,0,0.0,0.0
1002,1378,2020-03-19 07:44:00,1,1759.0,1409.0,0.801,8.49,0,0,0,0,0,0,0,0,0.0,0.0
1002,1379,2020-03-19 07:47:00,1,1755.0,1389.0,0.792,8.453,10,3,1,2,7,2,5,0,0.0,0.0
1002,1380,2020-03-19 07:50:00,1,1761.0,1394.0,0.792,8.483,7,0,0,0,7,1,6,0,0.0,0.0
1002,1381,2020-03-19 07:53:00,1,1815.5,1365.5,0.7535,8.665,4,3,1,2,1,0,1,0,0.0,0.0
1002,1382,2020-03-19 07:56:00,1,1870.0,1337.0,0.715,8.847,4,0,0,0,4,0,4,0,0.0,0.0
1002,1383,2020-03-19 07:59:00,1,1873.0,1338.0,0.714,8.862,137,84,35,49,53,4,49,7,0.0,0.0
1002,1384,2020-03-19 08:02:00,1,2077.0,1610.0,0.775,9.967,28,13,6,7,15,7,8,0,0.0,0.0
1002,1385,2020-03-19 08:05:00,1,2616.0,2009.0,0.768,12.533,260,141,101,40,119,96,23,58,0.0,0.0
1002,1386,2020-03-19 08:08:00,1,2851.0,2200.0,0.772,13.671,274,137,98,39,137,99,38,17,0.0,0.0
1002,1387,2020-03-19 08:11:00,1,2764.0,2151.0,0.778,13.272,501,278,217,61,223,167,56,161,0.0,0.0
1002,1388,2020-03-19 08:14:00,1,2835.0,2221.0,0.783,13.63,415,209,141,68,206,152,54,35,0.0,0.0
1002,1389,2020-03-19 08:17:00,1,2930.0,2239.0,0.764,14.025,488,272,198,74,216,146,70,148,0.03,0.0
1002,1390,2020-03-19 08:20:00,1,3097.0,2299.0,0.742,14.748,167,104,52,52,63,12,51,115,0.0,0.0
1002,1391,2020-03-19 08:23:00,1,3181.0,2335.0,0.734,15.118,363,220,128,92,143,65,78,82,0.0,0.0
1002,1392,2020-03-19 08:26:00,1,2925.0,2254.0,0.771,14.02,461,258,207,51,203,155,48,56,0.0,0.0
1002,1393,2020-03-19 08:29:00,1,2766.0,2143.0,0.775,13.272,576,302,221,81,274,182,92,56,0.0,0.0
1002,1394,2020-03-19 08:32:00,1,2618.0,1939.0,0.741,12.464,959,506,393,113,453,343,110,5,0.0,0.0
1002,1395,2020-03-19 08:35:00,1,2692.0,2046.0,0.76,12.871,916,519,407,112,397,294,103,6,0.0,0.0
1002,1396,2020-03-19 08:38:00,1,2929.0,2215.0,0.756,13.993,496,285,221,64,211,148,63,5,0.0,0.0
1002,1397,2020-03-19 08:41:00,1,2644.0,1881.0,0.711,12.501,316,147,105,42,169,108,61,5,0.0,0.0
1002,1398,2020-03-19 08:44:00,1,2776.0,2069.0,0.746,13.227,190,56,26,30,134,79,55,0,0.0,0.0
1002,1399,2020-03-19 08:47:00,1,2770.0,2143.0,0.774,13.285,56,0,0,0,56,13,43,0,0.0,0.0
1002,1400,2020-03-19 08:50:00,1,2619.0,2014.0,0.769,12.55,49,2,2,0,47,14,33,0,0.0,0.0
1002,1401,2020-03-19 08:53:00,1,2394.0,1798.0,0.751,11.424,10,2,2,0,8,2,6,0,0.0,0.0
1002,1402,2020-03-19 08:56:00,1,2251.0,1634.0,0.726,10.677,49,3,1,2,46,2,44,0,0.0,0.0
1002,1403,2020-03-19 08:59:00,1,1934.0,1429.0,0.739,9.205,23,6,2,4,17,2,15,0,0.0,0.0
1002,1404,2020-03-19 09:02:00,1,1856.0,1372.0,0.739,8.831,24,15,0,15,9,0,9,0,0.0,0.0
1002,1405,2020-03-19 09:05:00,1,1872.0,1336.0,0.714,8.857,25,11,1,10,14,7,7,0,0.0,0.0
1002,1406,2020-03-19 09:08:00,1,1858.0,1343.0,0.723,8.807,2,0,0,0,2,1,1,0,0.0,0.0
1002,1407,2020-03-19 09:11:00,1,1780.0,1315.0,0.739,8.471,2,0,0,0,2,0,2,0,0.0,0.0
1002,1408,2020-03-19 09:14:00,1,1790.0,1294.0,0.723,8.487,35,16,5,11,19,12,7,0,0.0,0.0
1002,1409,2020-03-19 09:17:00,1,1689.0,1285.0,0.761,8.075,15,12,0,12,3,0,3,0,0.0,0.0
1002,1410,2020-03-19 09:20:00,1,1691.0,1279.0,0.757,8.078,6,6,0,6,0,0,0,0,0.0,0.0
1002,1411,2020-03-19 09:23:00,1,1700.0,1271.0,0.748,8.106,5,0,0,0,5,1,4,0,0.0,0.0
1002,1412,2020-03-19 09:26:00,1,1700.0,1259.0,0.741,8.09,15,15,0,15,0,0,0,0,0.0,0.0
1002,1413,2020-03-19 09:29:00,1,1715.0,1248.0,0.728,8.141,74,31,7,24,43,16,27,1,0.0,0.0
1002,1414,2020-03-19 09:32:00,1,1698.0,1268.0,0.746,8.095,56,0,0,0,56,5,51,0,0.0,0.0
1002,1415,2020-03-19 09:35:00,1,1712.0,1249.0,0.73,8.127,33,9,6,3,24,11,13,0,0.0,0.0
1002,1416,2020-03-19 09:38:00,1,1791.0,1267.0,0.707,8.46,25,16,3,13,9,0,9,0,0.0,0.0
1002,1417,2020-03-19 09:41:00,1,1785.0,1270.0,0.711,8.438,5,2,1,1,3,1,2,0,0.0,0.0
1002,1418,2020-03-19 09:44:00,1,1786.0,1285.0,0.72,8.46,11,5,2,3,6,1,5,0,0.0,0.0
1002,1419,2020-03-19 09:47:00,1,1791.0,1281.0,0.716,8.474,6,1,0,1,5,1,4,0,0.0,0.0
1002,1420,2020-03-19 09:50:00,1,1697.0,1262.0,0.743,8.085,2,0,0,0,2,0,2,0,0.0,0.0
1002,1421,2020-03-19 09:53:00,1,1870.0,1294.0,0.692,8.8,4,0,0,0,4,0,4,0,0.0,0.0
1002,1422,2020-03-19 09:56:00,1,1877.0,1296.0,0.691,8.83,11,5,1,4,6,1,5,0,0.0,0.0
1002,1423,2020-03-19 09:59:00,1,1790.0,1286.0,0.719,8.478,2,2,1,1,0,0,0,0,0.0,0.0
1002,1424,2020-03-19 10:02:00,1,1790.0,1271.0,0.71,8.46,31,28,0,28,3,1,2,0,0.0,0.0
1002,1425,2020-03-19 10:05:00,1,1875.0,1283.0,0.684,8.809,75,40,15,25,35,19,16,0,0.0,0.0
1002,1426,2020-03-19 10:08:00,1,1865.0,1343.0,0.72,8.836,71,30,12,18,41,12,29,0,0.0,0.0
1002,1427,2020-03-19 10:11:00,1,1868.0,1351.0,0.723,8.857,36,5,0,5,31,14,17,0,0.0,0.0
1002,1428,2020-03-19 10:14:00,1,1862.0,1345.0,0.722,8.823,50,4,2,2,46,12,34,2,0.0,0.0
1002,1429,2020-03-19 10:17:00,1,1862.0,1359.0,0.73,8.841,2,0,0,0,2,0,2,0,0.0,0.0
1002,1430,2020-03-19 10:20:00,1,1879.0,1324.0,0.705,8.87,88,33,12,21,55,26,29,3,0.0,0.0
1002,1431,2020-03-19 10:23:00,1,2093.0,1531.0,0.732,9.94,202,75,25,50,127,77,50,1,0.0,0.0
1002,1432,2020-03-19 10:26:00,1,2315.0,1724.0,0.745,11.032,234,117,83,34,117,84,33,9,0.0,0.0
1002,1433,2020-03-19 10:29:00,1,2646.0,1916.0,0.724,12.546,800,425,343,82,375,264,111,46,0.0,0.0
1002,1434,2020-03-19 10:32:00,1,2779.0,2068.0,0.744,13.238,588,316,250,66,272,208,64,61,0.0,0.0
1002,1435,2020-03-19 10:35:00,1,2704.0,2017.0,0.746,12.887,534,268,202,66,266,199,67,107,0.0,0.0
1002,1436,2020-03-19 10:38:00,1,2633.0,1949.0,0.74,12.533,579,353,248,105,226,148,78,2,0.0,0.0
1002,1437,2020-03-19 10:41:00,1,2785.0,2079.0,0.746,13.275,862,457,361,96,405,310,95,6,0.0,0.0
1002,1438,2020-03-19 10:44:00,1,2793.0,2016.0,0.722,13.237,627,287,225,62,340,258,82,27,0.03,0.0
1002,1439,2020-03-19 10:47:00,1,2788.0,2058.0,0.738,13.265,1088,613,512,101,475,365,110,13,0.0,0.0
1002,1440,2020-03-19 10:50:00,1,2711.0,1989.0,0.734,12.885,563,313,231,82,250,177,73,72,0.0,0.0
1002,1441,2020-03-19 10:53:00,1,2599.5,1890.5,0.727,12.335,214,47,12,35,167,103,64,29,0.0,0.0
1002,1442,2020-03-19 10:56:00,1,2488.0,1792.0,0.72,11.785,101,33,17,16,68,32,36,5,0.0,0.0
1002,1443,2020-03-19 10:59:00,1,2745.0,1850.0,0.674,12.864,80,51,2,49,29,13,16,1,0.0,0.0
1002,1444,2020-03-19 11:02:00,1,2746.0,1860.0,0.677,12.88,61,14,0,14,47,2,45,0,0.0,0.0
1002,1445,2020-03-19 11:05:00,1,2497.0,1769.0,0.708,11.799,19,9,0,9,10,0,10,0,0.0,0.0
1002,1446,2020-03-19 11:08:00,1,2337.0,1640.0,0.702,11.026,8,5,2,3,3,2,1,0,0.0,0.0
1002,1447,2020-03-19 11:11:00,1,2201.0,1483.0,0.674,10.313,15,4,0,4,11,6,5,0,0.0,0.0
1002,1448,2020-03-19 11:14:00,1,2124.0,1426.0,0.671,9.949,0,0,0,0,0,0,0,0,0.0,0.0
1002,1449,2020-03-19 11:17:00,1,1968.0,1318.0,0.67,9.213,11,11,1,10,0,0,0,0,0.0,0.0
1002,1450,2020-03-19 11:20:00,1,1823.0,1147.0,0.629,8.454,1,1,0,1,0,0,0,0,0.0,0.0
1002,1451,2020-03-19 11:23:00,1,1657.0,1092.0,0.659,7.738,0,0,0,0,0,0,0,0,0.0,0.0
1002,1452,2020-03-19 11:26:00,1,1661.0,1068.0,0.643,7.728,20,20,10,10,0,0,0,0,0.0,0.0
1002,1453,2020-03-19 11:29:00,1,1658.0,1091.0,0.658,7.741,0,0,0,0,0,0,0,0,0.0,0.0
1002,1454,2020-03-19 11:32:00,1,1736.0,1121.0,0.646,8.08,0,0,0,0,0,0,0,0,0.0,0.0
1002,1455,2020-03-19 11:35:00,1,1830.0,1158.0,0.633,8.492,0,0,0,0,0,0,0,0,0.0,0.0
1002,1456,2020-03-19 11:38:00,1,1816.0,1180.0,0.65,8.461,26,14,5,9,12,6,6,0,0.0,0.0
1002,1457,2020-03-19 11:41:00,1,1803.0,1219.0,0.676,8.452,0,0,0,0,0,0,0,0,0.0,0.0
1002,1458,2020-03-19 11:44:00,1,1824.0,1155.0,0.633,8.467,0,0,0,0,0,0,0,0,0.0,0.0
1002,1459,2020-03-19 11:47:00,1,1824.0,1125.0,0.617,8.432,9,5,0,5,4,0,4,0,0.0,0.0
1002,1460,2020-03-19 11:50:00,1,1828.0,1157.0,0.633,8.482,17,14,0,14,3,1,2,0,0.0,0.0
1002,1461,2020-03-19 11:53:00,1,1836.0,1135.0,0.618,8.489,32,9,0,9,23,6,17,0,0.0,0.0
1002,1462,2020-03-19 11:56:00,1,1659.0,1080.0,0.651,7.733,20,15,0,15,5,1,4,0,0.0,0.0
1002,1463,2020-03-19 11:59:00,1,1664.0,1068.0,0.642,7.738,40,30,16,14,10,6,4,0,0.0,0.0
1002,1464,2020-03-19 12:02:00,1,1825.0,1139.0,0.624,8.452,0,0,0,0,0,0,0,0,0.0,0.0
1002,1465,2020-03-19 12:05:00,1,1657.0,1103.0,0.665,7.751,0,0,0,0,0,0,0,0,0.0,0.0
1002,1466,2020-03-19 12:08:00,1,1834.0,1125.0,0.614,8.473,5,0,0,0,5,1,4,0,0.0,0.0
1002,1467,2020-03-19 12:11:00,1,1836.0,1124.0,0.612,8.48,3,0,0,0,3,0,3,0,0.0,0.0
1002,1468,2020-03-19 12:14:00,1,1828.0,1137.0,0.622,8.462,13,0,0,0,13,0,13,0,0.0,0.0
1002,1469,2020-03-19 12:17:00,1,1823.0,1152.0,0.632,8.459,0,0,0,0,0,0,0,0,0.0,0.0
1002,1470,2020-03-19 12:20:00,1,1821.0,1167.0,0.641,8.466,76,37,17,20,39,17,22,0,0.0,0.0
1002,1471,2020-03-19 12:23:00,1,1943.0,1409.0,0.725,9.216,97,73,27,46,24,8,16,6,0.0,0.0
1002,1472,2020-03-19 12:26:00,1,2190.0,1503.0,0.686,10.291,103,65,34,31,38,24,14,7,0.0,0.0
1002,1473,2020-03-19 12:29:00,1,2338.0,1659.0,0.71,11.05,151,82,51,31,69,45,24,9,0.0,0.0
1002,1474,2020-03-19 12:32:00,1,2029.0,1455.0,0.717,9.607,14,13,8,5,1,1,0,0,0.0,0.0
1002,1475,2020-03-19 12:35:00,1,2036.0,1407.0,0.691,9.579,0,0,0,0,0,0,0,0,0.0,0.0
1002,1476,2020-03-19 12:38:00,1,1960.0,1328.0,0.678,9.192,0,0,0,0,0,0,0,0,0.0,0.0
1002,1477,2020-03-19 12:41:00,1,1800.0,1248.0,0.693,8.476,19,9,0,9,10,3,7,0,0.0,0.0
1002,1478,2020-03-19 12:44:00,1,1795.0,1232.0,0.687,8.436,1,0,0,0,1,0,1,0,0.0,0.0
1002,1479,2020-03-19 12:47:00,1,1814.0,1221.0,0.673,8.5,7,3,0,3,4,1,3,0,0.0,0.0
1002,1480,2020-03-19 12:50:00,1,1824.0,1146.0,0.628,8.458,0,0,0,0,0,0,0,0,0.0,0.0
1002,1481,2020-03-19 12:53:00,1,1833.0,1128.0,0.615,8.472,0,0,0,0,0,0,0,0,0.0,0.0
1002,1482,2020-03-19 12:56:00,1,1743.0,1114.0,0.639,8.103,24,9,2,7,15,0,15,0,0.0,0.0
1002,1483,2020-03-19 12:59:00,1,1834.0,1142.0,0.623,8.489,20,0,0,0,20,0,20,0,0.0,0.0
1002,1484,2020-03-19 13:02:00,1,1805.0,1196.0,0.663,8.435,4,0,0,0,4,1,3,0,0.0,0.0
1002,1485,2020-03-19 13:05:00,1,1808.0,1208.0,0.668,8.461,16,5,2,3,11,2,9,0,0.0,0.0
1002,1486,2020-03-19 13:08:00,1,1812.0,1221.0,0.674,8.49,8,3,0,3,5,1,4,0,0.0,0.0
1002,1487,2020-03-19 13:11:00,1,1828.0,1163.0,0.636,8.492,11,0,0,0,11,0,11,0,0.0,0.0
1002,1488,2020-03-19 13:14:00,1,1833.0,1134.0,0.619,8.478,5,2,0,2,3,0,3,0,0.0,0.0
1002,1489,2020-03-19 13:17:00,1,1827.0,1146.0,0.627,8.467,0,0,0,0,0,0,0,0,0.0,0.0
1002,1490,2020-03-19 13:20:00,1,1826.0,1140.0,0.624,8.456,4,0,0,0,4,1,3,0,0.0,0.0
1002,1491,2020-03-19 13:23:00,1,1811.0,1179.0,0.651,8.442,0,0,0,0,0,0,0,0,0.0,0.0
1002,1492,2020-03-19 13:26:00,1,1821.0,1148.0,0.631,8.447,3,0,0,0,3,1,2,0,0.0,0.0
1002,1493,2020-03-19 13:29:00,1,1835.0,1118.0,0.61,8.468,12,6,4,2,6,2,4,0,0.0,0.0
1002,1494,2020-03-19 13:32:00,1,1822.0,1145.0,0.628,8.447,7,1,0,1,6,3,3,0,0.0,0.0
1002,1495,2020-03-19 13:35:00,1,1822.0,1155.0,0.633,8.459,9,0,0,0,9,5,4,0,0.0,0.0
1002,1496,2020-03-19 13:38:00,1,1820.0,1170.0,0.643,8.467,15,10,4,6,5,1,4,0,0.0,0.0
1002,1497,2020-03-19 13:41:00,1,1826.0,1167.0,0.639,8.488,2,0,0,0,2,0,2,0,0.0,0.0
1002,1498,2020-03-19 13:44:00,1,1821.0,1171.0,0.643,8.471,5,2,0,2,3,1,2,0,0.0,0.0
1002,1499,2020-03-19 13:47:00,1,1813.0,1171.0,0.646,8.442,5,1,0,1,4,2,2,0,0.0,0.0
1002,1500,2020-03-19 13:50:00,1,1814.0,1200.0,0.661,8.478,138,100,44,56,38,8,30,2,0.0,0.0
1002,1501,2020-03-19 13:53:00,1,2078.5,1410.0,0.676,9.7515,51,46,12,34,5,0,5,0,0.0,0.0
1002,1502,2020-03-19 13:56:00,1,2343.0,1620.0,0.691,11.025,175,132,81,51,43,10,33,24,0.0,0.0
1002,1503,2020-03-19 13:59:00,1,2661.0,1843.0,0.693,12.525,191,126,92,34,65,40,25,52,0.0,0.0
1002,1504,2020-03-19 14:02:00,1,2493.0,1780.0,0.714,11.792,31,29,0,29,2,1,1,0,0.0,0.0
1002,1505,2020-03-19 14:05:00,1,2343.0,1665.0,0.71,11.076,61,50,17,33,11,1,10,0,0.0,0.0
1002,1506,2020-03-19 14:08:00,1,2500.0,1707.0,0.683,11.742,73,57,19,38,16,2,14,0,0.0,0.0
1002,1507,2020-03-19 14:11:00,1,2489.0,1788.0,0.719,11.787,34,28,18,10,6,1,5,0,0.0,0.0
1002,1508,2020-03-19 14:14:00,1,2351.0,1573.0,0.669,11.006,8,8,2,6,0,0,0,0,0.0,0.0
1002,1509,2020-03-19 14:17:00,1,2350.0,1616.0,0.687,11.05,240,143,97,46,97,71,26,29,0.0,0.0
1002,1510,2020-03-19 14:20:00,1,2744.0,1883.0,0.686,12.899,472,266,208,58,206,149,57,115,0.0,0.0
1002,1511,2020-03-19 14:23:00,1,2738.0,1922.0,0.702,12.917,454,128,62,66,326,296,30,113,0.0,0.0
1002,1512,2020-03-19 14:26:00,1,2965.0,2069.0,0.698,13.973,350,129,67,62,221,198,23,48,0.0,0.0
1002,1513,2020-03-19 14:29:00,1,2352.0,1608.0,0.684,11.047,20,20,3,17,0,0,0,0,0.0,0.0
1002,1514,2020-03-19 14:32:00,1,2525.0,1705.0,0.675,11.837,0,0,0,0,0,0,0,0,0.0,0.0
1002,1515,2020-03-19 14:35:00,1,2517.0,1664.0,0.661,11.758,0,0,0,0,0,0,0,0,0.0,0.0
1002,1516,2020-03-19 14:38:00,1,2514.0,1687.0,0.671,11.775,8,4,0,4,4,1,3,0,0.0,0.0
1002,1517,2020-03-19 14:41:00,1,2436.0,1642.0,0.674,11.417,0,0,0,0,0,0,0,0,0.0,0.0
1002,1518,2020-03-19 14:44:00,1,2194.0,1525.0,0.695,10.334,5,1,1,0,4,1,3,0,0.0,0.0
1002,1519,2020-03-19 14:47:00,1,2209.0,1462.0,0.662,10.321,0,0,0,0,0,0,0,0,0.0,0.0
1002,1520,2020-03-19 14:50:00,1,1807.0,1206.0,0.667,8.457,7,7,5,2,0,0,0,0,0.0,0.0
1002,1521,2020-03-19 14:53:00,1,1825.0,1128.0,0.618,8.441,0,0,0,0,0,0,0,0,0.0,0.0
1002,1522,2020-03-19 14:56:00,1,1806.0,1198.0,0.663,8.442,0,0,0,0,0,0,0,0,0.0,0.0
1002,1523,2020-03-19 14:59:00,1,1806.0,1240.0,0.687,8.487,0,0,0,0,0,0,0,0,0.0,0.0
1002,1524,2020-03-19 15:02:00,1,1963.0,1304.0,0.664,9.179,25,17,6,11,8,4,4,0,0.0,0.0
1002,1525,2020-03-19 15:05:00,1,1955.0,1322.0,0.676,9.169,4,4,0,4,0,0,0,0,0.0,0.0
1002,1526,2020-03-19 15:08:00,1,1961.0,1323.0,0.675,9.19,15,15,0,15,0,0,0,0,0.0,0.0
1002,1527,2020-03-19 15:11:00,1,1969.0,1309.0,0.665,9.208,0,0,0,0,0,0,0,0,0.0,0.0
1002,1528,2020-03-19 15:14:00,1,1972.0,1296.0,0.658,9.204,13,6,2,4,7,3,4,0,0.0,0.0
1002,1529,2020-03-19 15:17:00,1,1971.0,1277.0,0.648,9.178,15,7,0,7,8,1,7,0,0.0,0.0
1002,1530,2020-03-19 15:20:00,1,1803.0,1226.0,0.68,8.462,8,5,0,5,3,0,3,0,0.0,0.0
1002,1531,2020-03-19 15:23:00,1,1799.0,1246.0,0.693,8.467,5,2,0,2,3,1,2,0,0.0,0.0
1002,1532,2020-03-19 15:26:00,1,1800.0,1256.0,0.698,8.482,7,5,3,2,2,0,2,0,0.0,0.0
1002,1533,2020-03-19 15:29:00,1,1793.0,1272.0,0.71,8.472,16,8,4,4,8,3,5,0,0.0,0.0
1002,1534,2020-03-19 15:32:00,1,1795.0,1247.0,0.695,8.453,0,0,0,0,0,0,0,0,0.0,0.0
1002,1535,2020-03-19 15:35:00,1,1800.0,1250.0,0.694,8.475,2,0,0,0,2,0,2,0,0.0,0.0
1002,1536,2020-03-19 15:38:00,1,1890.0,1269.0,0.672,8.854,4,1,1,0,3,1,2,0,0.0,0.0
1002,1537,2020-03-19 15:41:00,1,1969.0,1276.0,0.648,9.173,0,0,0,0,0,0,0,0,0.0,0.0
1002,1538,2020-03-19 15:44:00,1,1810.0,1213.0,0.67,8.476,1,1,0,1,0,0,0,0,0.0,0.0
1002,1539,2020-03-19 15:47:00,1,1803.0,1242.0,0.689,8.479,1,1,0,1,0,0,0,0,0.0,0.0
1002,1540,2020-03-19 15:50:00,1,1887.0,1270.0,0.673,8.839,0,0,0,0,0,0,0,0,0.0,0.0
1002,1541,2020-03-19 15:53:00,1,1887.0,1250.0,0.662,8.821,4,0,0,0,4,1,3,0,0.0,0.0
1002,1542,2020-03-19 15:56:00,1,1800.0,1250.0,0.694,8.478,3,0,0,0,3,1,2,0,0.0,0.0
1002,1543,2020-03-19 15:59:00,1,1807.0,1214.0,0.672,8.464,0,0,0,0,0,0,0,0,0.0,0.0
1002,1544,2020-03-19 16:02:00,1,1808.0,1193.0,0.66,8.446,0,0,0,0,0,0,0,0,0.0,0.0
1002,1545,2020-03-19 16:05:00,1,1826.0,1166.0,0.639,8.484,7,4,3,1,3,0,3,0,0.0,0.0
1002,1546,2020-03-19 16:08:00,1,1808.0,1208.0,0.668,8.461,6,0,0,0,6,0,6,0,0.0,0.0
1002,1547,2020-03-19 16:11:00,1,1888.0,1260.0,0.667,8.835,8,0,0,0,8,4,4,0,0.0,0.0
1002,1548,2020-03-19 16:14:00,1,1961.0,1339.0,0.683,9.211,25,5,1,4,20,0,20,0,0.0,0.0
1002,1549,2020-03-19 16:17:00,1,1958.0,1334.0,0.681,9.192,31,8,1,7,23,10,13,0,0.0,0.0
1002,1550,2020-03-19 16:20:00,1,1969.0,1339.0,0.68,9.239,10,10,3,7,0,0,0,0,0.0,0.0
1002,1551,2020-03-19 16:23:00,1,2207.0,1449.0,0.657,10.299,167,126,79,47,41,20,21,7,0.0,0.0
1002,1552,2020-03-19 16:26:00,1,2494.0,1788.0,0.717,11.808,291,160,102,58,131,89,42,48,0.0,0.0
1002,1553,2020-03-19 16:29:00,1,2523.0,1675.0,0.664,11.795,281,135,92,43,146,92,54,87,0.01,0.0
1002,1554,2020-03-19 16:32:00,1,2676.0,1810.0,0.676,12.549,215,133,45,88,82,13,69,116,0.0,0.0
1002,1555,2020-03-19 16:35:00,1,2756.0,1809.0,0.656,12.864,179,108,52,56,71,14,57,113,0.0,0.0
1002,1556,2020-03-19 16:38:00,1,2736.0,1940.0,0.709,12.928,146,84,34,50,62,4,58,100,0.0,0.0
1002,1557,2020-03-19 16:41:00,1,2484.0,1789.0,0.72,11.766,195,115,69,46,80,41,39,32,0.0,0.0
1002,1558,2020-03-19 16:44:00,1,1659.0,1072.0,0.646,7.724,53,35,19,16,18,7,11,0,0.0,0.0
1002,1559,2020-03-19 16:47:00,1,1508.0,929.0,0.616,6.969,65,31,4,27,34,2,32,0,0.0,0.0
1002,1560,2020-03-19 16:50:00,1,1598.0,938.0,0.587,7.334,3,0,0,0,3,1,2,0,0.0,0.0
1002,1561,2020-03-19 16:53:00,1,1593.0,958.5,0.602,7.3375,4,2,1,1,2,1,1,0,0.0,0.0
1002,1562,2020-03-19 16:56:00,1,1588.0,979.0,0.617,7.341,2,0,0,0,2,1,1,0,0.0,0.0
1002,1563,2020-03-19 16:59:00,1,1737.0,1117.0,0.643,8.08,1,0,0,0,1,0,1,0,0.0,0.0
1002,1564,2020-03-19 17:02:00,1,1742.0,1123.0,0.644,8.109,25,14,8,6,11,6,5,0,0.0,0.0
1002,1565,2020-03-19 17:05:00,1,1879.0,1295.0,0.689,8.837,4,2,1,1,2,0,2,0,0.0,0.0
1002,1566,2020-03-19 17:08:00,1,1864.0,1368.0,0.734,8.859,21,14,7,7,7,4,3,0,0.0,0.0
1002,1567,2020-03-19 17:11:00,1,2159.0,1602.0,0.742,10.282,0,0,0,0,0,0,0,0,0.0,0.0
1002,1568,2020-03-19 17:14:00,1,2543.0,1925.0,0.757,12.152,58,41,16,25,17,0,17,3,0.0,0.0
1002,1569,2020-03-19 17:17:00,1,2988.0,2350.0,0.787,14.376,417,130,72,58,287,220,67,56,0.0,0.0
1002,1570,2020-03-19 17:20:00,1,3153.0,2437.0,0.773,15.122,376,75,39,36,301,216,85,88,0.0,0.0
1002,1571,2020-03-19 17:23:00,1,3285.0,2646.0,0.806,15.871,432,80,38,42,352,284,68,94,0.0,0.0
1002,1572,2020-03-19 17:26:00,1,3072.0,2375.0,0.773,14.736,543,157,99,58,386,306,80,119,0.01,0.0
1002,1573,2020-03-19 17:29:00,1,3295.0,2590.0,0.786,15.852,546,220,157,63,326,235,91,139,0.27,0.0
1002,1574,2020-03-19 17:32:00,1,3152.0,2472.0,0.784,15.154,212,105,56,49,107,37,70,98,0.0,0.0
1002,1575,2020-03-19 17:35:00,1,2902.0,2322.0,0.8,14.005,173,117,60,57,56,23,33,48,0.0,0.0
1002,1576,2020-03-19 17:38:00,1,1697.0,1265.0,0.745,8.088,76,60,33,27,16,10,6,3,0.0,0.0
1002,1577,2020-03-19 17:41:00,1,1724.0,1181.0,0.685,8.101,1,1,0,1,0,0,0,0,0.0,0.0
1002,1578,2020-03-19 17:44:00,1,1724.0,1189.0,0.689,8.11,2,2,0,2,0,0,0,0,0.0,0.0
1002,1579,2020-03-19 17:47:00,1,1710.0,1219.0,0.713,8.087,8,6,0,6,2,2,0,0,0.0,0.0
1002,1580,2020-03-19 17:50:00,1,1709.0,1258.0,0.736,8.125,12,12,0,12,0,0,0,0,0.0,0.0
1002,1581,2020-03-19 17:53:00,1,1849.0,1393.0,0.753,8.827,14,6,1,5,8,2,6,0,0.0,0.0
1002,1582,2020-03-19 17:56:00,1,1846.0,1429.0,0.774,8.857,11,9,0,9,2,1,1,0,0.0,0.0
1002,1583,2020-03-19 17:59:00,1,1843.0,1435.0,0.779,8.851,19,6,0,6,13,9,4,0,0.0,0.0
1002,1584,2020-03-19 18:02:00,0,3107.0,2632.0,0.847,15.155,435,231,151,80,204,141,63,43,0.0,0.0
1002,1585,2020-03-19 18:05:00,0,3649.0,3057.0,0.838,17.761,303,183,130,53,120,72,48,44,0.0,0.0
1002,1586,2020-03-19 18:08:00,0,3638.0,3023.0,0.831,17.679,625,369,296,73,256,196,60,122,0.0,0.0
1002,1587,2020-03-19 18:11:00,0,3322.0,2826.0,0.851,16.218,624,383,307,76,241,190,51,181,0.0,0.0
1002,1588,2020-03-19 18:14:00,0,3785.0,3157.0,0.834,18.408,593,329,261,68,264,198,66,102,0.0,0.0
1002,1589,2020-03-19 18:17:00,0,2761.0,2172.0,0.787,13.281,239,89,36,53,150,91,59,21,0.0,0.0
1002,1590,2020-03-19 18:20:00,0,3677.0,2958.0,0.804,17.765,226,127,78,49,99,62,37,32,0.0,0.0
1002,1591,2020-03-19 18:23:00,0,3673.0,2897.0,0.789,17.68,600,338,270,68,262,200,62,155,0.0,0.0
1002,1592,2020-03-19 18:26:00,0,3444.0,2730.0,0.793,16.591,507,311,242,69,196,148,48,58,0.0,0.0
1002,1593,2020-03-19 18:29:00,0,3139.0,2466.0,0.786,15.097,166,113,70,43,53,29,24,99,0.0,0.0
1002,1594,2020-03-19 18:32:00,0,3280.0,2662.0,0.812,15.868,700,454,368,86,246,189,57,147,0.0,0.0
1002,1595,2020-03-19 18:35:00,0,3704.0,2786.0,0.752,17.677,600,374,284,90,226,179,47,37,0.0,0.0
1002,1596,2020-03-19 18:38:00,0,3279.0,2615.0,0.798,15.814,379,222,166,56,157,115,42,75,0.0,0.0
1002,1597,2020-03-19 18:41:00,0,3333.0,2556.0,0.767,15.961,374,212,161,51,162,110,52,57,0.0,0.0
1002,1598,2020-03-19 18:44:00,0,2776.0,2086.0,0.751,13.248,421,263,210,53,158,115,43,121,0.0,0.0
1002,1599,2020-03-19 18:47:00,0,3302.0,2536.0,0.768,15.817,721,552,440,112,169,122,47,25,0.0,0.0
1002,1600,2020-03-19 18:50:00,0,3236.0,2439.0,0.754,15.45,221,157,110,47,64,45,19,23,0.0,0.0
1002,1601,2020-03-19 18:53:00,0,3100.0,2263.0,0.73,14.718,238,136,79,57,102,61,41,40,0.0,0.0
1002,1602,2020-03-19 18:56:00,0,3171.0,2375.0,0.749,15.122,406,214,160,54,192,148,44,113,0.0,0.0
1002,1603,2020-03-19 18:59:00,0,3191.0,2347.0,0.736,15.172,530,395,296,99,135,98,37,50,0.0,0.0
1002,1604,2020-03-19 19:02:00,0,3185.0,2296.0,0.721,15.092,377,242,174,68,135,86,49,37,0.0,0.0
1002,1605,2020-03-19 19:05:00,0,3104.0,2251.0,0.725,14.721,344,194,138,56,150,96,54,33,0.0,0.0
1002,1606,2020-03-19 19:08:00,0,2425.0,1677.0,0.692,11.411,112,110,61,49,2,0,2,32,0.0,0.0
1002,1607,2020-03-19 19:11:00,0,2947.0,2151.0,0.73,13.992,55,53,24,29,2,0,2,10,0.0,0.0
1002,1608,2020-03-19 19:14:00,0,3177.0,2279.0,0.718,15.04,19,17,9,8,2,0,2,2,0.0,0.0
1002,1609,2020-03-19 19:17:00,0,2780.0,2042.0,0.734,13.216,149,86,64,22,63,34,29,9,0.0,0.0
1002,1610,2020-03-19 19:20:00,0,2800.0,2080.0,0.743,13.338,326,169,117,52,157,107,50,35,0.0,0.0
1002,1611,2020-03-19 19:23:00,0,2646.0,1857.0,0.702,12.481,85,35,1,34,50,14,36,0,0.0,0.0
1002,1612,2020-03-19 19:26:00,0,2413.0,1719.0,0.712,11.41,83,15,1,14,68,21,47,0,0.0,0.0
1002,1613,2020-03-19 19:29:00,0,2348.0,1614.0,0.687,11.041,47,5,1,4,42,2,40,0,0.0,0.0
1002,1614,2020-03-19 19:32:00,0,2186.0,1514.0,0.692,10.291,168,67,47,20,101,54,47,17,0.0,0.0
1002,1615,2020-03-19 19:35:00,0,2424.0,1697.0,0.7,11.429,363,222,162,60,141,114,27,66,0.0,0.0
1002,1616,2020-03-19 19:38:00,0,2406.0,1744.0,0.725,11.412,442,268,200,68,174,142,32,108,0.0,0.0
1002,1617,2020-03-19 19:41:00,0,2953.0,2117.0,0.717,13.978,236,168,108,60,68,41,27,20,0.0,0.0
1002,1618,2020-03-19 19:44:00,0,2654.0,1855.0,0.699,12.512,512,274,195,79,238,175,63,48,0.0,0.0
1002,1619,2020-03-19 19:47:00,0,2649.0,1882.0,0.71,12.519,176,31,11,20,145,85,60,0,0.0,0.0
1002,1620,2020-03-19 19:50:00,0,2494.0,1768.0,0.709,11.784,251,121,79,42,130,83,47,31,0.0,0.0
1002,1621,2020-03-19 19:53:00,0,2619.5,1821.0,0.696,12.338,585,368,281,87,217,156,61,150,0.0,0.0
1002,1622,2020-03-19 19:56:00,0,2745.0,1874.0,0.683,12.892,244,166,118,48,78,57,21,82,0.0,0.0
1002,1623,2020-03-19 19:59:00,0,2768.0,1794.0,0.648,12.892,304,169,117,52,135,90,45,96,0.0,0.0
1002,1624,2020-03-19 20:02:00,0,2909.0,1952.0,0.671,13.623,193,97,47,50,96,55,41,4,0.0,0.0
1002,1625,2020-03-19 20:05:00,0,2921.0,1949.0,0.667,13.666,334,212,149,63,122,82,40,74,0.0,0.0
1002,1626,2020-03-19 20:08:00,0,3049.0,2165.0,0.71,14.41,602,369,293,76,233,177,56,87,0.0,0.0
1002,1627,2020-03-19 20:11:00,0,3036.0,2116.0,0.697,14.307,406,266,212,54,140,104,36,121,0.0,0.0
1002,1628,2020-03-19 20:14:00,0,3122.0,2159.0,0.692,14.694,568,379,315,64,189,142,47,230,0.0,0.0
1002,1629,2020-03-19 20:17:00,0,2878.0,2065.0,0.718,13.626,301,197,127,70,104,55,49,4,0.0,0.0
1002,1630,2020-03-19 20:20:00,0,2756.0,1799.0,0.653,12.849,330,202,149,53,128,90,38,61,0.0,0.0
1002,1631,2020-03-19 20:23:00,0,3049.0,2132.0,0.699,14.373,727,475,385,90,252,189,63,93,0.0,0.0
1002,1632,2020-03-19 20:26:00,0,2741.0,1895.0,0.692,12.897,332,202,150,52,130,95,35,48,0.0,0.0
1002,1633,2020-03-19 20:29:00,0,3073.0,2059.0,0.67,14.387,422,290,217,73,132,102,30,61,0.0,0.0
1002,1634,2020-03-19 20:32:00,0,3373.0,2264.0,0.671,15.797,218,138,98,40,80,52,28,82,0.0,0.0
1002,1635,2020-03-19 20:35:00,0,3137.0,2179.0,0.695,14.771,294,172,132,40,122,82,40,63,0.0,0.0
1002,1636,2020-03-19 20:38:00,0,3041.0,2134.0,0.702,14.346,592,455,360,95,137,101,36,69,0.0,0.0
1002,1637,2020-03-19 20:41:00,0,2744.0,1870.0,0.681,12.88,30,16,7,9,14,1,13,25,0.0,0.0
1002,1638,2020-03-19 20:44:00,0,2590.0,1735.0,0.67,12.128,51,23,6,17,28,13,15,29,0.0,0.0
1002,1639,2020-03-19 20:47:00,0,2894.0,2019.0,0.698,13.638,395,231,186,45,164,123,41,47,0.0,0.0
1002,1640,2020-03-19 20:50:00,0,2510.0,1741.0,0.693,11.818,126,62,39,23,64,35,29,30,0.0,0.0
1002,1641,2020-03-19 20:53:00,0,2900.0,1975.0,0.681,13.615,222,86,47,39,136,76,60,43,0.0,0.0
1002,1642,2020-03-19 20:56:00,0,2886.0,2022.0,0.701,13.611,26,14,2,12,12,3,9,30,0.0,0.0
1002,1643,2020-03-19 20:59:00,0,3053.0,2105.0,0.689,14.36,41,20,10,10,21,11,10,29,0.0,0.0
1002,1644,2020-03-19 21:02:00,0,2971.0,2059.0,0.693,13.985,422,240,170,70,182,119,63,47,0.0,0.0
1002,1645,2020-03-19 21:05:00,0,3066.0,2115.0,0.69,14.422,777,458,388,70,319,256,63,126,0.0,0.0
1002,1646,2020-03-19 21:08:00,0,2886.0,2006.0,0.695,13.59,78,46,38,8,32,22,10,35,0.0,0.0
1002,1647,2020-03-19 21:11:00,0,2820.0,1908.0,0.677,13.223,8,2,1,1,6,2,4,0,0.0,0.0
1002,1648,2020-03-19 21:14:00,0,2671.0,1756.0,0.657,12.466,12,5,1,4,7,3,4,3,0.0,0.0
1002,1649,2020-03-19 21:17:00,0,2527.0,1620.0,0.641,11.752,9,6,0,6,3,1,2,2,0.0,0.0
1002,1650,2020-03-19 21:20:00,0,2525.0,1618.0,0.641,11.74,187,146,75,71,41,6,35,1,0.0,0.0
1002,1651,2020-03-19 21:23:00,0,2768.0,1779.0,0.643,12.874,137,106,51,55,31,2,29,4,0.0,0.0
1002,1652,2020-03-19 21:26:00,0,2898.0,1983.0,0.684,13.616,510,303,249,54,207,155,52,95,0.0,0.0
1002,1653,2020-03-19 21:29:00,0,2895.0,1931.0,0.667,13.546,687,452,373,79,235,182,53,226,0.0,0.0
1002,1654,2020-03-19 21:32:00,0,2768.0,1792.0,0.647,12.891,206,122,92,30,84,61,23,88,0.0,0.0
1002,1655,2020-03-19 21:35:00,0,2358.0,1566.0,0.664,11.027,12,9,4,5,3,1,2,83,0.0,0.0
1002,1656,2020-03-19 21:38:00,0,2542.0,1598.0,0.629,11.785,13,9,1,8,4,1,3,85,0.0,0.0
1002,1657,2020-03-19 21:41:00,0,2516.0,1639.0,0.651,11.728,1,1,0,1,0,0,0,88,0.0,0.0
1002,1658,2020-03-19 21:44:00,0,2451.0,1580.0,0.645,11.408,154,67,32,35,87,45,42,91,0.0,0.0
1002,1659,2020-03-19 21:47:00,0,2506.0,1681.0,0.671,11.738,122,43,12,31,79,26,53,89,0.0,0.0
1002,1660,2020-03-19 21:50:00,0,2611.0,1722.0,0.659,12.196,558,322,240,82,236,180,56,123,0.0,0.0
1002,1661,2020-03-19 21:53:00,0,2528.0,1629.0,0.644,11.764,59,43,26,17,16,9,7,78,0.0,0.0
1002,1662,2020-03-19 21:56:00,0,2349.0,1566.0,0.667,10.988,2,2,0,2,0,0,0,40,0.0,0.0
1002,1663,2020-03-19 21:59:00,0,2284.0,1496.0,0.655,10.656,1,0,0,0,1,1,0,26,0.0,0.0
1002,1664,2020-03-19 22:02:00,0,2215.0,1385.0,0.625,10.26,13,6,1,5,7,1,6,26,0.0,0.0
1002,1665,2020-03-19 22:05:00,0,1978.0,1259.0,0.636,9.189,26,11,8,3,15,6,9,36,0.0,0.0
1002,1666,2020-03-19 22:08:00,0,2146.0,1343.0,0.626,9.943,24,2,1,1,22,1,21,59,0.0,0.0
1002,1667,2020-03-19 22:11:00,0,1975.0,1278.0,0.647,9.197,22,2,1,1,20,8,12,64,0.0,0.0
1002,1668,2020-03-19 22:14:00,0,1983.0,1241.0,0.626,9.187,39,7,0,7,32,5,27,61,0.0,0.0
1002,1669,2020-03-19 22:17:00,0,1897.0,1201.0,0.633,8.803,61,5,0,5,56,2,54,64,0.0,0.0
1002,1670,2020-03-19 22:20:00,0,1810.0,1173.0,0.648,8.43,185,51,33,18,134,69,65,71,0.0,0.0
1002,1671,2020-03-19 22:23:00,0,2200.0,1475.0,0.67,10.301,205,138,94,44,67,40,27,109,0.0,0.0
1002,1672,2020-03-19 22:26:00,0,2213.0,1430.0,0.646,10.301,260,123,71,52,137,92,45,17,0.0,0.0
1002,1673,2020-03-19 22:29:00,0,2542.0,1589.0,0.625,11.775,532,307,229,78,225,173,52,158,0.0,0.0
1002,1674,2020-03-19 22:32:00,0,2755.0,1840.0,0.668,12.893,693,481,376,105,212,162,50,89,0.03,0.0
1002,1675,2020-03-19 22:35:00,0,2930.0,1925.0,0.657,13.676,473,355,273,82,118,83,35,81,0.0,0.0
1002,1676,2020-03-19 22:38:00,0,2840.0,1846.0,0.65,13.232,221,135,86,49,86,47,39,39,0.0,0.0
1002,1677,2020-03-19 22:41:00,0,2758.0,1816.0,0.659,12.877,302,174,141,33,128,93,35,60,0.0,0.0
1002,1678,2020-03-19 22:44:00,0,2752.0,1810.0,0.658,12.846,395,250,203,47,145,115,30,178,0.0,0.0
1002,1679,2020-03-19 22:47:00,0,2751.0,1881.0,0.684,12.922,248,124,85,39,124,71,53,29,0.0,0.0
1002,1680,2020-03-19 22:50:00,0,2915.0,1919.0,0.658,13.61,604,377,305,72,227,176,51,89,0.0,0.0
1002,1681,2020-03-19 22:53:00,0,2921.0,1897.5,0.6495,13.61,240,102,69,33,138,82,56,2,0.0,0.0
1002,1682,2020-03-19 22:56:00,0,2927.0,1876.0,0.641,13.61,282,176,132,44,106,84,22,139,0.0,0.0
1002,1683,2020-03-19 22:59:00,0,2925.0,1874.0,0.641,13.601,42,26,7,19,16,4,12,4,0.0,0.0
1002,1684,2020-03-19 23:02:00,0,2751.0,1816.0,0.66,12.852,68,33,19,14,35,16,19,6,0.0,0.0
1002,1685,2020-03-19 23:05:00,0,2766.0,1799.0,0.65,12.891,292,160,113,47,132,85,47,50,0.03,0.0
1002,1686,2020-03-19 23:08:00,0,2772.0,1793.0,0.647,12.907,217,146,101,45,71,44,27,6,0.0,0.0
1002,1687,2020-03-19 23:11:00,0,2608.0,1708.0,0.655,12.168,487,321,237,84,166,122,44,84,0.0,0.0
1002,1688,2020-03-19 23:14:00,0,2909.0,1928.0,0.663,13.597,362,219,147,72,143,95,48,27,0.0,0.0
1002,1689,2020-03-19 23:17:00,0,2909.0,1977.0,0.679,13.652,115,70,26,44,45,23,22,0,0.0,0.0
1002,1690,2020-03-19 23:20:00,0,2753.0,1841.0,0.668,12.887,105,62,42,20,43,27,16,38,0.0,0.0
1002,1691,2020-03-19 23:23:00,0,1977.0,1306.0,0.661,9.235,1,1,0,1,0,0,0,6,0.0,0.0
1002,1692,2020-03-19 23:26:00,0,1671.0,1016.0,0.608,7.711,9,0,0,0,9,2,7,13,0.0,0.0
1002,1693,2020-03-19 23:29:00,0,1849.0,1053.0,0.569,8.453,206,113,87,26,93,64,29,48,0.0,0.0
1002,1694,2020-03-19 23:32:00,0,2778.0,1761.0,0.634,12.895,545,366,302,64,179,143,36,162,0.0,0.0
1002,1695,2020-03-19 23:35:00,0,2763.0,1767.0,0.64,12.842,119,77,47,30,42,22,20,28,0.0,0.0
1002,1696,2020-03-19 23:38:00,0,2602.0,1692.0,0.65,12.127,59,22,0,22,37,0,37,7,0.0,0.0
1002,1697,2020-03-19 23:41:00,0,2531.0,1658.0,0.655,11.808,44,0,0,0,44,1,43,1,0.0,0.0
1002,1698,2020-03-19 23:44:00,0,2445.0,1568.0,0.641,11.371,20,0,0,0,20,4,16,0,0.0,0.0
1002,1699,2020-03-19 23:47:00,0,2382.0,1481.0,0.622,11.025,37,0,0,0,37,3,34,0,0.0,0.0
1002,1700,2020-03-19 23:50:00,0,2220.0,1394.0,0.628,10.29,38,11,7,4,27,6,21,0,0.0,0.0
1002,1701,2020-03-19 23:53:00,0,1964.0,1309.0,0.667,9.188,9,5,0,5,4,1,3,0,0.0,0.0
1002,1702,2020-03-19 23:56:00,0,1985.0,1240.0,0.625,9.193,34,23,0,23,11,1,10,0,0.0,0.0
1002,1703,2020-03-19 23:59:00,0,1811.0,1191.0,0.658,8.457,7,0,0,0,7,0,7,0,0.0,0.0
1002,1704,2020-03-20 00:02:00,0,1821.0,1139.0,0.625,8.436,0,0,0,0,0,0,0,0,0.0,0.0
1002,1705,2020-03-20 00:05:00,0,1847.0,1073.0,0.581,8.463,73,55,29,26,18,8,10,2,0.0,0.0
1002,1706,2020-03-20 00:08:00,0,1836.0,1132.0,0.616,8.489,181,98,71,27,83,49,34,26,0.0,0.0
1002,1707,2020-03-20 00:11:00,0,1900.0,1224.0,0.644,8.84,126,67,28,39,59,31,28,5,0.0,0.0
1002,1708,2020-03-20 00:14:00,0,2050.0,1349.0,0.658,9.571,3,3,1,2,0,0,0,0,0.0,0.0
1002,1709,2020-03-20 00:17:00,0,1985.0,1278.0,0.644,9.237,0,0,0,0,0,0,0,0,0.0,0.0
1002,1710,2020-03-20 00:20:00,0,1896.0,1219.0,0.643,8.82,0,0,0,0,0,0,0,0,0.0,0.0
1002,1711,2020-03-20 00:23:00,0,1821.0,1185.0,0.651,8.486,0,0,0,0,0,0,0,0,0.0,0.0
1002,1712,2020-03-20 00:26:00,0,1815.0,1152.0,0.635,8.425,98,58,40,18,40,23,17,1,0.0,0.0
1002,1713,2020-03-20 00:29:00,0,2205.0,1434.0,0.65,10.275,318,212,158,54,106,69,37,45,0.0,0.0
1002,1714,2020-03-20 00:32:00,0,2356.0,1540.0,0.654,10.987,310,151,102,49,159,98,61,27,0.01,0.0
1002,1715,2020-03-20 00:35:00,0,2376.0,1531.0,0.644,11.055,169,114,70,44,55,30,25,32,0.0,0.0
1002,1716,2020-03-20 00:38:00,0,2533.0,1620.0,0.639,11.776,435,293,230,63,142,100,42,43,0.0,0.0
1002,1717,2020-03-20 00:41:00,0,2609.0,1699.0,0.651,12.162,392,244,196,48,148,97,51,111,0.0,0.0
1002,1718,2020-03-20 00:44:00,0,2778.0,1733.0,0.624,12.865,194,120,70,50,74,29,45,4,0.0,0.0
1002,1719,2020-03-20 00:47:00,0,2748.0,1843.0,0.671,12.868,265,141,71,70,124,58,66,2,0.0,0.0
1002,1720,2020-03-20 00:50:00,0,2895.0,1966.0,0.679,13.581,575,332,269,63,243,179,64,103,0.23,0.0
1002,1721,2020-03-20 00:53:00,0,2591.0,1700.0,0.656,12.09,183,132,72,60,51,21,30,0,0.0,0.0
1002,1722,2020-03-20 00:56:00,0,2749.0,1855.0,0.675,12.886,350,190,132,58,160,111,49,70,0.0,0.0
1002,1723,2020-03-20 00:59:00,0,2752.0,1823.0,0.662,12.86,320,213,168,45,107,83,24,128,0.0,0.0
1002,1724,2020-03-20 01:02:00,0,3056.0,2057.0,0.673,14.319,465,311,225,86,154,106,48,13,0.0,0.0
1002,1725,2020-03-20 01:05:00,0,2838.0,1888.0,0.665,13.271,261,164,84,80,97,46,51,0,0.0,0.0
1002,1726,2020-03-20 01:08:00,0,2881.0,2025.0,0.703,13.596,310,200,157,43,110,83,27,35,0.16,0.0
1002,1727,2020-03-20 01:11:00,0,2919.0,1898.0,0.65,13.602,145,72,51,21,73,50,23,19,0.0,0.0
1002,1728,2020-03-20 01:14:00,0,2766.0,1781.0,0.644,12.871,206,125,61,64,81,31,50,0,0.0,0.0
1002,1729,2020-03-20 01:17:00,0,2235.0,1377.0,0.616,10.332,132,70,38,32,62,16,46,0,0.0,0.0
1002,1730,2020-03-20 01:20:00,0,2771.0,1751.0,0.632,12.859,96,45,35,10,51,34,17,0,0.0,0.0
1002,1731,2020-03-20 01:23:00,0,2049.0,1347.0,0.658,9.565,2,2,0,2,0,0,0,0,0.0,0.0
1002,1732,2020-03-20 01:26:00,0,2224.0,1374.0,0.618,10.284,0,0,0,0,0,0,0,0,0.0,0.0
1002,1733,2020-03-20 01:29:00,0,2383.0,1496.0,0.628,11.047,0,0,0,0,0,0,0,0,0.0,0.0
1002,1734,2020-03-20 01:32:00,0,2291.0,1467.0,0.64,10.651,0,0,0,0,0,0,0,0,0.0,0.0
1002,1735,2020-03-20 01:35:00,0,2223.0,1401.0,0.63,10.309,0,0,0,0,0,0,0,0,0.0,0.0
1002,1736,2020-03-20 01:38:00,0,2143.0,1361.0,0.635,9.949,79,36,18,18,43,30,13,1,0.0,0.0
1002,1737,2020-03-20 01:41:00,0,1964.0,1309.0,0.667,9.189,4,4,2,2,0,0,0,0,0.0,0.0
1002,1738,2020-03-20 01:44:00,0,1987.0,1229.0,0.619,9.19,0,0,0,0,0,0,0,0,0.0,0.0
1002,1739,2020-03-20 01:47:00,0,1808.0,1176.0,0.65,8.427,0,0,0,0,0,0,0,0,0.0,0.0
1002,1740,2020-03-20 01:50:00,0,1827.0,1133.0,0.62,8.453,2,0,0,0,2,1,1,0,0.0,0.0
1002,1741,2020-03-20 01:53:00,0,1790.5,1091.0,0.609,8.2625,0,0,0,0,0,0,0,0,0.0,0.0
1002,1742,2020-03-20 01:56:00,0,1754.0,1049.0,0.598,8.072,76,61,42,19,15,9,6,1,0.0,0.0
1002,1743,2020-03-20 01:59:00,0,1823.0,1162.0,0.637,8.468,239,152,109,43,87,60,27,29,0.0,0.0
1002,1744,2020-03-20 02:02:00,0,2357.0,1548.0,0.657,11.001,196,125,109,16,71,58,13,55,0.0,0.0
1002,1745,2020-03-20 02:05:00,0,2054.0,1325.0,0.645,9.56,191,124,82,42,67,27,40,9,0.0,0.0
1002,1746,2020-03-20 02:08:00,0,2370.0,1531.0,0.646,11.035,160,71,31,40,89,41,48,0,0.0,0.0
1002,1747,2020-03-20 02:11:00,0,2132.0,1398.0,0.656,9.948,398,254,208,46,144,99,45,48,0.0,0.0
1002,1748,2020-03-20 02:14:00,0,2378.0,1518.0,0.639,11.049,258,157,93,64,101,53,48,5,0.0,0.0
1002,1749,2020-03-20 02:17:00,0,2383.0,1509.0,0.633,11.062,314,203,158,45,111,78,33,67,0.0,0.0
1002,1750,2020-03-20 02:20:00,0,2774.0,1765.0,0.636,12.885,285,164,123,41,121,84,37,59,0.09,0.0
1002,1751,2020-03-20 02:23:00,0,2755.0,1813.0,0.658,12.864,97,64,44,20,33,18,15,4,0.0,0.0
1002,1752,2020-03-20 02:26:00,0,2695.0,1747.0,0.648,12.553,208,120,74,46,88,54,34,36,0.0,0.0
1002,1753,2020-03-20 02:29:00,0,2376.0,1523.0,0.641,11.049,131,85,51,34,46,20,26,1,0.0,0.0
1002,1754,2020-03-20 02:32:00,0,1906.0,1209.0,0.634,8.849,103,43,18,25,60,27,33,20,0.0,0.0
1002,1755,2020-03-20 02:35:00,0,2604.0,1708.0,0.656,12.153,68,17,5,12,51,20,31,0,0.0,0.0
1002,1756,2020-03-20 02:38:00,0,2529.0,1658.0,0.655,11.802,67,0,0,0,67,0,67,0,0.0,0.0
1002,1757,2020-03-20 02:41:00,0,2365.0,1526.0,0.645,11.009,40,2,0,2,38,0,38,0,0.0,0.0
1002,1758,2020-03-20 02:44:00,0,2211.0,1434.0,0.649,10.302,28,2,0,2,26,0,26,0,0.0,0.0
1002,1759,2020-03-20 02:47:00,0,2047.0,1343.0,0.656,9.552,7,5,0,5,2,0,2,0,0.0,0.0
1002,1760,2020-03-20 02:50:00,0,1975.0,1266.0,0.641,9.184,0,0,0,0,0,0,0,0,0.0,0.0
1002,1761,2020-03-20 02:53:00,0,1822.0,1181.0,0.648,8.487,170,96,71,25,74,54,20,11,0.0,0.0
1002,1762,2020-03-20 02:56:00,0,1841.0,1111.0,0.603,8.483,6,0,0,0,6,0,6,0,0.0,0.0
1002,1763,2020-03-20 02:59:00,0,1846.0,1086.0,0.588,8.476,3,0,0,0,3,0,3,0,0.0,0.0
1002,1764,2020-03-20 03:02:00,0,1660.0,1051.0,0.633,7.702,1,0,0,0,1,0,1,0,0.0,0.0
1002,1765,2020-03-20 03:05:00,0,1682.0,1015.0,0.603,7.75,15,3,0,3,12,0,12,0,0.0,0.0
1002,1766,2020-03-20 03:08:00,0,1673.0,1018.0,0.608,7.718,16,7,6,1,9,5,4,0,0.0,0.0
1002,1767,2020-03-20 03:11:00,0,1687.0,966.0,0.573,7.717,4,0,0,0,4,0,4,0,0.0,0.0
1002,1768,2020-03-20 03:14:00,0,1514.0,913.0,0.603,6.975,3,0,0,0,3,0,3,0,0.0,0.0
1002,1769,2020-03-20 03:17:00,0,1514.0,913.0,0.603,6.976,24,7,0,7,17,0,17,0,0.0,0.0
1002,1770,2020-03-20 03:20:00,0,1825.0,1123.0,0.615,8.433,177,98,63,35,79,45,34,4,0.0,0.0
1002,1771,2020-03-20 03:23:00,0,1808.0,1199.0,0.663,8.451,184,40,8,32,144,86,58,1,0.0,0.0
1002,1772,2020-03-20 03:26:00,0,2354.0,1561.0,0.663,11.002,249,92,63,29,157,98,59,23,0.0,0.0
1002,1773,2020-03-20 03:29:00,0,2545.0,1636.0,0.643,11.84,433,288,222,66,145,113,32,83,0.0,0.0
1002,1774,2020-03-20 03:32:00,0,2359.0,1543.0,0.654,11.004,121,58,36,22,63,31,32,14,0.0,0.0
1002,1775,2020-03-20 03:35:00,0,2537.0,1637.0,0.645,11.807,121,65,33,32,56,28,28,26,0.0,0.0
1002,1776,2020-03-20 03:38:00,0,2681.0,1749.0,0.652,12.5,32,0,0,0,32,0,32,0,0.0,0.0
1002,1777,2020-03-20 03:41:00,0,2523.0,1671.0,0.662,11.79,1,0,0,0,1,0,1,0,0.0,0.0
1002,1778,2020-03-20 03:44:00,0,2362.0,1533.0,0.649,11.006,5,0,0,0,5,1,4,0,0.0,0.0
1002,1779,2020-03-20 03:47:00,0,2381.0,1512.0,0.635,11.054,244,129,109,20,115,71,44,36,0.0,0.0
1002,1780,2020-03-20 03:50:00,0,2198.0,1456.0,0.662,10.274,56,32,21,11,24,12,12,5,0.0,0.0
1002,1781,2020-03-20 03:53:00,0,2529.0,1586.0,0.627,11.721,187,90,68,22,97,66,31,2,0.11,0.0
1002,1782,2020-03-20 03:56:00,0,2544.0,1594.0,0.627,11.79,219,132,88,44,87,61,26,14,0.0,0.0
1002,1783,2020-03-20 03:59:00,0,1975.0,1287.0,0.652,9.207,77,42,27,15,35,22,13,0,0.0,0.0
1002,1784,2020-03-20 04:02:00,0,2057.0,1327.0,0.645,9.575,13,1,0,1,12,1,11,0,0.0,0.0
1002,1785,2020-03-20 04:05:00,0,2210.0,1413.0,0.64,10.271,6,1,0,1,5,0,5,0,0.0,0.0
1002,1786,2020-03-20 04:08:00,0,2047.0,1345.0,0.657,9.553,19,12,0,12,7,0,7,0,0.0,0.0
1002,1787,2020-03-20 04:11:00,0,1972.0,1286.0,0.652,9.196,1,1,0,1,0,0,0,0,0.0,0.0
1002,1788,2020-03-20 04:14:00,0,1806.0,1203.0,0.666,8.449,10,5,1,4,5,1,4,0,0.0,0.0
1002,1789,2020-03-20 04:17:00,0,1826.0,1123.0,0.615,8.439,9,7,2,5,2,0,2,0,0.0,0.0
1002,1790,2020-03-20 04:20:00,0,1827.0,1121.0,0.614,8.442,43,30,14,16,13,4,9,0,0.0,0.0
1002,1791,2020-03-20 04:23:00,0,1835.0,1132.0,0.617,8.484,7,0,0,0,7,0,7,0,0.0,0.0
1002,1792,2020-03-20 04:26:00,0,1842.0,1101.0,0.598,8.478,1,0,0,0,1,0,1,0,0.0,0.0
1002,1793,2020-03-20 04:29:00,0,1663.0,1043.0,0.628,7.707,25,1,1,0,24,0,24,0,0.0,0.0
1002,1794,2020-03-20 04:32:00,0,1682.0,1008.0,0.6,7.744,0,0,0,0,0,0,0,0,0.0,0.0
1002,1795,2020-03-20 04:35:00,0,1682.0,986.0,0.586,7.72,4,0,0,0,4,1,3,0,0.0,0.0
1002,1796,2020-03-20 04:38:00,0,1679.0,969.0,0.577,7.689,16,1,1,0,15,1,14,0,0.0,0.0
1002,1797,2020-03-20 04:41:00,0,1592.0,957.0,0.601,7.333,2,2,0,2,0,0,0,0,0.0,0.0
1002,1798,2020-03-20 04:44:00,0,1601.0,961.0,0.601,7.371,2,2,0,2,0,0,0,0,0.0,0.0
1002,1799,2020-03-20 04:47:00,0,1419.0,924.0,0.651,6.613,1,1,0,1,0,0,0,0,0.0,0.0
1002,1800,2020-03-20 04:50:00,0,1435.0,890.0,0.62,6.64,6,6,0,6,0,0,0,0,0.0,0.0
1002,1801,2020-03-20 04:53:00,0,1433.0,876.0,0.611,6.6175,7,7,0,7,0,0,0,0,0.0,0.0
1002,1802,2020-03-20 04:56:00,0,1431.0,862.0,0.602,6.595,17,17,0,17,0,0,0,0,0.0,0.0
1002,1803,2020-03-20 04:59:00,0,1508.0,944.0,0.626,6.988,129,83,52,31,46,28,18,0,0.01,0.0
1002,1804,2020-03-20 05:02:00,0,1827.0,1145.0,0.627,8.468,206,129,87,42,77,45,32,57,0.0,0.0
1002,1805,2020-03-20 05:05:00,0,1810.0,1223.0,0.676,8.485,146,42,28,14,104,53,51,2,0.0,0.0
1002,1806,2020-03-20 05:08:00,0,2209.0,1432.0,0.648,10.291,195,77,46,31,118,74,44,4,0.0,0.0
1002,1807,2020-03-20 05:11:00,0,2754.0,1772.0,0.643,12.812,314,204,157,47,110,78,32,78,0.22,0.0
1002,1808,2020-03-20 05:14:00,0,2513.0,1694.0,0.674,11.778,161,103,69,34,58,40,18,3,0.0,0.0
1002,1809,2020-03-20 05:17:00,0,2523.0,1696.0,0.672,11.818,0,0,0,0,0,0,0,0,0.0,0.0
1002,1810,2020-03-20 05:20:00,0,2362.0,1572.0,0.665,11.047,134,56,41,15,78,52,26,34,0.0,0.0
1002,1811,2020-03-20 05:23:00,0,2530.0,1630.0,0.644,11.773,136,77,55,22,59,29,30,0,0.01,0.0
1002,1812,2020-03-20 05:26:00,0,2356.0,1546.0,0.656,10.993,224,122,73,49,102,65,37,11,0.0,0.0
1002,1813,2020-03-20 05:29:00,0,2370.0,1549.0,0.654,11.054,46,31,5,26,15,3,12,0,0.0,0.0
1002,1814,2020-03-20 05:32:00,0,2359.0,1545.0,0.655,11.006,6,1,1,0,5,0,5,0,0.0,0.0
1002,1815,2020-03-20 05:35:00,0,2196.0,1468.0,0.668,10.279,5,2,1,1,3,0,3,0,0.0,0.0
1002,1816,2020-03-20 05:38:00,0,2225.0,1384.0,0.622,10.301,5,4,0,4,1,0,1,0,0.0,0.0
1002,1817,2020-03-20 05:41:00,0,1972.0,1288.0,0.653,9.196,28,1,0,1,27,0,27,0,0.0,0.0
1002,1818,2020-03-20 05:44:00,0,1801.0,1212.0,0.673,8.439,10,1,0,1,9,0,9,0,0.0,0.0
1002,1819,2020-03-20 05:47:00,0,1813.0,1157.0,0.638,8.423,5,0,0,0,5,0,5,0,0.0,0.0
1002,1820,2020-03-20 05:50:00,0,1838.0,1123.0,0.611,8.485,33,0,0,0,33,2,31,0,0.0,0.0
1002,1821,2020-03-20 05:53:00,0,1838.0,1081.0,0.588,8.438,2,0,0,0,2,1,1,0,0.0,0.0
1002,1822,2020-03-20 05:56:00,0,1662.0,1040.0,0.626,7.701,12,0,0,0,12,0,12,0,0.0,0.0
1002,1823,2020-03-20 05:59:00,0,1670.0,1004.0,0.601,7.691,5,0,0,0,5,0,5,0,0.0,0.0
1002,1824,2020-03-20 06:02:00,1,1598.0,969.0,0.606,7.37,8,0,0,0,8,2,6,0,0.0,0.0
1002,1825,2020-03-20 06:05:00,1,1413.0,931.0,0.659,6.599,4,4,1,3,0,0,0,0,0.0,0.0
1002,1826,2020-03-20 06:08:00,1,1435.0,882.0,0.615,6.631,13,13,0,13,0,0,0,0,0.0,0.0
1002,1827,2020-03-20 06:11:00,1,1347.0,861.0,0.639,6.261,1,1,0,1,0,0,0,0,0.0,0.0
1002,1828,2020-03-20 06:14:00,1,1249.0,846.0,0.677,5.86,63,34,25,9,29,15,14,16,0.0,0.0
1002,1829,2020-03-20 06:17:00,1,1656.0,1073.0,0.648,7.713,164,94,38,56,70,10,60,53,0.0,0.0
1002,1830,2020-03-20 06:20:00,1,2207.0,1423.0,0.645,10.274,250,160,95,65,90,22,68,96,0.0,0.0
1002,1831,2020-03-20 06:23:00,1,2772.0,1750.0,0.631,12.862,205,143,81,62,62,2,60,89,0.0,0.0
1002,1832,2020-03-20 06:26:00,1,2913.0,1932.0,0.663,13.617,245,172,108,64,73,2,71,68,0.0,0.0
1002,1833,2020-03-20 06:29:00,1,3058.0,2084.0,0.682,14.356,200,131,80,51,69,0,69,69,0.0,0.0
1002,1834,2020-03-20 06:32:00,1,3149.0,2114.0,0.671,14.747,223,146,79,67,77,8,69,81,0.0,0.0
1002,1835,2020-03-20 06:35:00,1,3219.0,2157.0,0.67,15.073,191,139,76,63,52,2,50,55,0.0,0.0
1002,1836,2020-03-20 06:38:00,1,3286.0,2259.0,0.687,15.449,201,135,78,57,66,5,61,85,0.0,0.0
1002,1837,2020-03-20 06:41:00,1,3769.0,2573.0,0.683,17.7,182,110,48,62,72,4,68,88,0.0,0.0
1002,1838,2020-03-20 06:44:00,1,3263.0,2325.0,0.712,15.429,224,150,78,72,74,3,71,89,0.0,0.0
1002,1839,2020-03-20 06:47:00,1,3274.0,2322.0,0.709,15.47,344,218,149,69,126,72,54,81,0.2,0.0
1002,1840,2020-03-20 06:50:00,1,3830.0,2706.0,0.707,18.086,256,154,95,59,102,37,65,74,0.0,0.0
1002,1841,2020-03-20 06:53:00,1,3561.0,2709.0,0.761,17.031,171,104,57,47,67,4,63,82,0.0,0.09
1002,1842,2020-03-20 06:56:00,1,3626.0,2729.0,0.753,17.309,225,153,80,73,72,2,70,108,0.0,0.09
1002,1843,2020-03-20 06:59:00,1,3444.0,2681.0,0.778,16.54,164,115,64,51,49,0,49,74,0.0,0.07
1002,1844,2020-03-20 07:02:00,1,3782.0,2833.0,0.749,18.04,247,155,87,68,92,32,60,68,0.21,0.08
1002,1845,2020-03-20 07:05:00,1,3240.0,2495.0,0.77,15.529,321,158,117,41,163,114,49,45,0.32,0.01
1002,1846,2020-03-20 07:08:00,1,3391.0,2588.0,0.763,16.227,238,159,98,61,79,16,63,112,0.0,0.03
1002,1847,2020-03-20 07:11:00,1,3775.0,2905.0,0.77,18.089,254,182,110,72,72,11,61,130,0.0,0.04
1002,1848,2020-03-20 07:14:00,1,3908.0,3049.0,0.78,18.774,276,177,101,76,99,43,56,118,0.0,0.05
1002,1849,2020-03-20 07:17:00,1,3876.0,3122.0,0.805,18.726,239,142,81,61,97,44,53,111,0.07,0.02
1002,1850,2020-03-20 07:20:00,1,3730.0,2980.0,0.799,17.997,242,135,76,59,107,63,44,103,0.06,0.0
1002,1851,2020-03-20 07:23:00,1,3585.0,2877.0,0.803,17.31,238,167,92,75,71,17,54,130,0.0,0.0
1002,1852,2020-03-20 07:26:00,1,3749.0,2934.0,0.783,18.017,218,150,92,58,68,16,52,127,0.0,0.06
1002,1853,2020-03-20 07:29:00,1,3795.0,3084.0,0.813,18.369,235,167,90,77,68,17,51,136,0.0,0.07
1002,1854,2020-03-20 07:32:00,1,3889.0,3134.0,0.806,18.794,330,199,138,61,131,88,43,59,0.19,0.01
1002,1855,2020-03-20 07:35:00,1,3748.0,3052.0,0.814,18.148,227,157,100,57,70,17,53,133,0.0,0.01
1002,1856,2020-03-20 07:38:00,1,3573.0,2945.0,0.824,17.339,176,118,71,47,58,16,42,80,0.0,0.12
1002,1857,2020-03-20 07:41:00,1,3320.0,2801.0,0.844,16.184,240,137,70,67,103,44,59,86,0.19,0.02
1002,1858,2020-03-20 07:44:00,1,3332.0,2778.0,0.834,16.203,405,230,172,58,175,116,59,66,0.0,0.0
1002,1859,2020-03-20 07:47:00,1,3126.0,2558.0,0.818,15.147,369,204,159,45,165,121,44,37,0.06,0.1
1002,1860,2020-03-20 07:50:00,1,3331.0,2843.0,0.854,16.27,197,127,67,60,70,14,56,84,0.0,0.0
1002,1861,2020-03-20 07:53:00,1,3534.5,2941.5,0.8335,17.182,225,141,83,58,84,26,58,108,0.0,0.0
1002,1862,2020-03-20 07:56:00,1,3738.0,3040.0,0.813,18.094,197,129,70,59,68,18,50,108,0.0,0.03
1002,1863,2020-03-20 07:59:00,1,3647.0,3031.0,0.831,17.723,197,112,76,36,85,56,29,20,0.2,0.02
1002,1864,2020-03-20 08:02:00,1,2956.0,2451.0,0.829,14.361,588,326,249,77,262,188,74,8,0.0,0.01
1002,1865,2020-03-20 08:05:00,1,2463.0,1878.0,0.763,11.785,770,345,268,77,425,324,101,6,0.0,0.0
1002,1866,2020-03-20 08:08:00,1,2240.0,1727.0,0.771,10.737,596,307,237,70,289,204,85,3,0.0,0.0
1002,1867,2020-03-20 08:11:00,1,2137.0,1715.0,0.803,10.317,108,54,33,21,54,31,23,0,0.0,0.0
1002,1868,2020-03-20 08:14:00,1,1904.0,1504.0,0.79,9.166,51,39,9,30,12,1,11,0,0.0,0.0
1002,1869,2020-03-20 08:17:00,1,2372.0,1869.0,0.788,11.416,11,7,0,7,4,0,4,0,0.0,0.0
1002,1870,2020-03-20 08:20:00,1,2370.0,1868.0,0.788,11.405,10,5,2,3,5,0,5,0,0.0,0.0
1002,1871,2020-03-20 08:23:00,1,2292.0,1827.0,0.797,11.055,12,0,0,0,12,0,12,0,0.0,0.0
1002,1872,2020-03-20 08:26:00,1,2141.0,1688.0,0.789,10.304,21,6,2,4,15,0,15,0,0.0,0.0
1002,1873,2020-03-20 08:29:00,1,1992.0,1609.0,0.808,9.628,10,2,0,2,8,5,3,0,0.0,0.0
1002,1874,2020-03-20 08:32:00,1,1912.0,1522.0,0.796,9.217,14,7,4,3,7,5,2,0,0.0,0.0
1002,1875,2020-03-20 08:35:00,1,1943.0,1423.0,0.732,9.231,1,1,1,0,0,0,0,0,0.0,0.0
1002,1876,2020-03-20 08:38:00,1,1759.0,1363.0,0.775,8.438,3,1,0,1,2,1,1,0,0.0,0.0
1002,1877,2020-03-20 08:41:00,1,1785.0,1285.0,0.72,8.456,1,0,0,0,1,0,1,0,0.0,0.0
1002,1878,2020-03-20 08:44:00,1,1780.0,1306.0,0.733,8.46,130,70,41,29,60,31,29,0,0.0,0.0
1002,1879,2020-03-20 08:47:00,1,1769.0,1371.0,0.775,8.489,9,0,0,0,9,6,3,0,0.0,0.0
1002,1880,2020-03-20 08:50:00,1,1753.0,1438.0,0.821,8.499,4,0,0,0,4,1,3,0,0.0,0.0
1002,1881,2020-03-20 08:53:00,1,2356.0,1952.0,0.829,11.445,8,0,0,0,8,1,7,0,0.0,0.0
1002,1882,2020-03-20 08:56:00,1,2578.0,2161.0,0.838,12.552,225,123,71,52,102,40,62,61,0.0,0.0
1002,1883,2020-03-20 08:59:00,1,3308.0,2913.0,0.881,16.259,222,150,73,77,72,19,53,109,0.0,0.0
1002,1884,2020-03-20 09:02:00,1,3362.0,3056.0,0.909,16.631,189,132,82,50,57,14,43,113,0.0,0.06
1002,1885,2020-03-20 09:05:00,1,3351.0,3040.0,0.907,16.568,171,111,49,62,60,13,47,103,0.0,0.1
1002,1886,2020-03-20 09:08:00,1,3274.0,3030.0,0.926,16.253,208,118,62,56,90,24,66,116,0.0,0.04
1002,1887,2020-03-20 09:11:00,1,3291.0,2969.0,0.902,16.254,188,98,46,52,90,23,67,99,0.18,0.01
1002,1888,2020-03-20 09:14:00,1,3294.0,2948.0,0.895,16.243,187,111,53,58,76,24,52,92,0.0,0.09
1002,1889,2020-03-20 09:17:00,1,3281.0,2925.0,0.891,16.165,207,123,75,48,84,32,52,83,0.16,0.0
1002,1890,2020-03-20 09:20:00,1,2292.0,1852.0,0.808,11.082,54,10,3,7,44,0,44,0,0.0,0.0
1002,1891,2020-03-20 09:23:00,1,1831.0,1466.0,0.801,8.839,55,7,1,6,48,4,44,0,0.0,0.0
1002,1892,2020-03-20 09:26:00,1,1892.0,1574.0,0.832,9.199,4,0,0,0,4,1,3,0,0.0,0.0
1002,1893,2020-03-20 09:29:00,1,2133.0,1736.0,0.814,10.327,19,12,4,8,7,1,6,0,0.0,0.0
1002,1894,2020-03-20 09:32:00,1,1895.0,1603.0,0.846,9.241,0,0,0,0,0,0,0,0,0.0,0.0
1002,1895,2020-03-20 09:35:00,1,1907.0,1567.0,0.821,9.25,0,0,0,0,0,0,0,0,0.0,0.0
1002,1896,2020-03-20 09:38:00,1,1823.0,1501.0,0.823,8.845,11,5,3,2,6,3,3,0,0.0,0.0
1002,1897,2020-03-20 09:41:00,1,2193.0,1815.0,0.828,10.648,205,117,79,38,88,58,30,8,0.09,0.0
1002,1898,2020-03-20 09:44:00,1,2097.0,1840.0,0.878,10.298,79,29,8,21,50,12,38,1,0.0,0.0
1002,1899,2020-03-20 09:47:00,1,1891.0,1581.0,0.836,9.202,66,21,10,11,45,13,32,6,0.0,0.0
1002,1900,2020-03-20 09:50:00,1,2279.0,1881.0,0.825,11.06,17,13,4,9,4,0,4,0,0.0,0.0
1002,1901,2020-03-20 09:53:00,1,2406.0,2118.0,0.88,11.825,0,0,0,0,0,0,0,0,0.0,0.0
1002,1902,2020-03-20 09:56:00,1,2110.0,1824.0,0.865,10.332,10,6,4,2,4,3,1,0,0.0,0.0
1002,1903,2020-03-20 09:59:00,1,2113.0,1790.0,0.847,10.307,1,0,0,0,1,0,1,0,0.0,0.0
1002,1904,2020-03-20 10:02:00,1,2423.0,2081.0,0.859,11.851,1,0,0,0,1,0,1,0,0.0,0.0
1002,1905,2020-03-20 10:05:00,1,2628.0,2339.0,0.89,12.942,2,1,1,0,1,0,1,0,0.0,0.0
1002,1906,2020-03-20 10:08:00,1,2676.0,2418.0,0.903,13.221,209,120,75,45,89,28,61,73,0.0,0.0
1002,1907,2020-03-20 10:11:00,1,2990.0,2702.0,0.904,14.771,199,128,67,61,71,3,68,105,0.0,0.02
1002,1908,2020-03-20 10:14:00,1,3132.0,2891.0,0.923,15.541,139,87,42,45,52,9,43,100,0.0,0.06
1002,1909,2020-03-20 10:17:00,1,3134.0,2837.0,0.905,15.488,181,118,60,58,63,14,49,124,0.0,0.01
1002,1910,2020-03-20 10:20:00,1,2982.0,2697.0,0.904,14.736,171,118,67,51,53,4,49,88,0.0,0.09
1002,1911,2020-03-20 10:23:00,1,3073.0,2703.0,0.88,15.099,227,124,76,48,103,56,47,74,0.0,0.07
1002,1912,2020-03-20 10:26:00,1,2273.0,1898.0,0.835,11.057,49,23,17,6,26,7,19,0,0.17,0.01
1002,1913,2020-03-20 10:29:00,1,2641.0,2241.0,0.848,12.886,107,60,44,16,47,31,16,13,0.0,0.0
1002,1914,2020-03-20 10:32:00,1,1956.0,1698.0,0.868,9.588,1,0,0,0,1,0,1,0,0.0,0.0
1002,1915,2020-03-20 10:35:00,1,1826.0,1516.0,0.83,8.872,42,42,0,42,0,0,0,0,0.0,0.0
1002,1916,2020-03-20 10:38:00,1,1759.0,1393.0,0.792,8.474,39,31,5,26,8,3,5,0,0.0,0.0
1002,1917,2020-03-20 10:41:00,1,1767.0,1364.0,0.772,8.472,19,17,0,17,2,0,2,0,0.0,0.0
1002,1918,2020-03-20 10:44:00,1,1600.0,1307.0,0.816,7.752,36,20,14,6,16,6,10,0,0.0,0.0
1002,1919,2020-03-20 10:47:00,1,1596.0,1292.0,0.81,7.721,6,0,0,0,6,3,3,0,0.0,0.0
1002,1920,2020-03-20 10:50:00,1,1889.0,1625.0,0.86,9.242,8,2,1,1,6,1,5,0,0.0,0.0
1002,1921,2020-03-20 10:53:00,1,2252.5,1999.0,0.8835,11.0875,16,4,1,3,12,4,8,0,0.0,0.0
1002,1922,2020-03-20 10:56:00,1,2616.0,2373.0,0.907,12.933,44,25,11,14,19,10,9,0,0.0,0.0
1002,1923,2020-03-20 10:59:00,1,2687.0,2456.0,0.914,13.305,13,5,0,5,8,2,6,0,0.0,0.0
1002,1924,2020-03-20 11:02:00,1,2620.0,2299.0,0.878,12.866,0,0,0,0,0,0,0,0,0.0,0.0
1002,1925,2020-03-20 11:05:00,1,2333.0,2039.0,0.874,11.451,21,10,0,10,11,1,10,0,0.0,0.0
1002,1926,2020-03-20 11:08:00,1,2254.0,1977.0,0.877,11.071,34,4,0,4,30,0,30,0,0.0,0.0
1002,1927,2020-03-20 11:11:00,1,2093.0,1898.0,0.907,10.347,4,0,0,0,4,1,3,0,0.0,0.0
1002,1928,2020-03-20 11:14:00,1,2102.0,1828.0,0.87,10.304,8,3,1,2,5,0,5,0,0.0,0.0
1002,1929,2020-03-20 11:17:00,1,2237.0,2033.0,0.908,11.066,237,157,102,55,80,31,49,69,0.0,0.01
1002,1930,2020-03-20 11:20:00,1,2601.0,2377.0,0.914,12.881,72,46,9,37,26,3,23,34,0.0,0.47
1002,1931,2020-03-20 11:23:00,1,2694.0,2429.0,0.902,13.303,27,18,0,18,9,0,9,0,0.0,0.0
1002,1932,2020-03-20 11:26:00,1,2672.0,2431.0,0.91,13.218,67,39,31,8,28,17,11,12,0.13,0.0
1002,1933,2020-03-20 11:29:00,1,2242.0,2042.0,0.911,11.092,24,21,3,18,3,1,2,0,0.0,0.0
1002,1934,2020-03-20 11:32:00,1,1744.0,1430.0,0.82,8.454,9,4,2,2,5,3,2,0,0.0,0.0
1002,1935,2020-03-20 11:35:00,1,2428.0,2044.0,0.842,11.828,82,55,25,30,27,18,9,1,0.06,0.0
1002,1936,2020-03-20 11:38:00,1,2610.0,2400.0,0.92,12.94,136,99,47,52,37,25,12,21,0.06,0.0
1002,1937,2020-03-20 11:41:00,1,2250.0,1990.0,0.884,11.07,485,220,164,56,265,194,71,41,0.0,0.0
1002,1938,2020-03-20 11:44:00,1,2410.0,2045.0,0.849,11.758,638,280,211,69,358,262,96,9,0.0,0.0
1002,1939,2020-03-20 11:47:00,1,2767.0,2508.0,0.906,13.679,53,20,9,11,33,7,26,0,0.0,0.0
1002,1940,2020-03-20 11:50:00,1,3125.0,2804.0,0.897,15.415,675,334,266,68,341,272,69,24,0.1,0.04
1002,1941,2020-03-20 11:53:00,1,3133.0,2837.0,0.905,15.486,912,470,381,89,442,352,90,108,0.0,0.01
1002,1942,2020-03-20 11:56:00,1,3154.0,2815.0,0.893,15.542,787,401,323,78,386,295,91,6,0.0,0.0
1002,1943,2020-03-20 11:59:00,1,2931.0,2611.0,0.891,14.439,954,555,447,108,399,301,98,20,0.0,0.0
1002,1944,2020-03-20 12:02:00,1,2921.0,2636.0,0.902,14.425,93,63,40,23,30,9,21,1,0.0,0.0
1002,1945,2020-03-20 12:05:00,1,2625.0,2286.0,0.871,12.873,26,20,7,13,6,0,6,2,0.0,0.0
1002,1946,2020-03-20 12:08:00,1,2566.0,2198.0,0.857,12.543,1,1,0,1,0,0,0,0,0.0,0.0
1003,1,2020-03-16 10:53:00,1,4960.0,3751.0,0.756,23.696,971,522,432,90,449,340,109,12,0.05,0.06
1003,2,2020-03-16 10:56:00,1,4687.5,3552.5,0.758,22.4015,478,255,194,61,223,159,64,18,0.0,0.12
1003,3,2020-03-16 10:59:00,1,4415.0,3354.0,0.76,21.107,586,293,221,72,293,209,84,11,0.0,1.06
1003,4,2020-03-16 11:02:00,1,4308.0,3311.0,0.768,20.639,443,233,176,57,210,136,74,3,0.0,0.0
1003,5,2020-03-16 11:05:00,1,4030.0,3149.0,0.782,19.364,480,219,149,70,261,185,76,10,0.0,0.0
1003,6,2020-03-16 11:08:00,1,3783.0,3000.0,0.793,18.227,233,72,40,32,161,99,62,1,0.0,0.0
1003,7,2020-03-16 11:11:00,1,3938.0,3016.0,0.766,18.854,267,84,47,37,183,116,67,8,0.06,0.0
1003,8,2020-03-16 11:14:00,1,3618.0,2867.0,0.792,17.431,563,296,221,75,267,197,70,2,0.0,0.0
1003,9,2020-03-16 11:17:00,1,3622.0,2725.0,0.752,17.289,47,32,18,14,15,0,15,0,0.0,0.0
1003,10,2020-03-16 11:20:00,1,3223.0,2531.0,0.785,15.502,92,52,21,31,40,20,20,5,0.0,0.0
1003,11,2020-03-16 11:23:00,1,3164.0,2532.0,0.8,15.269,223,118,85,33,105,67,38,0,0.01,0.0
1003,12,2020-03-16 11:26:00,1,3178.0,2435.0,0.766,15.217,28,28,10,18,0,0,0,0,0.0,0.0
1003,13,2020-03-16 11:29:00,1,2841.0,2186.0,0.769,13.613,27,22,9,13,5,0,5,0,0.06,0.0
1003,14,2020-03-16 11:32:00,1,2599.0,2029.0,0.781,12.487,288,159,106,53,129,77,52,13,0.0,0.0
1003,15,2020-03-16 11:35:00,1,3007.0,2373.0,0.789,14.476,628,352,277,75,276,198,78,20,0.0,0.0
1003,16,2020-03-16 11:38:00,1,3102.0,2409.0,0.777,14.889,229,63,43,20,166,118,48,4,0.0,0.0
1003,17,2020-03-16 11:41:00,1,2988.0,2367.0,0.792,14.392,509,263,195,68,246,169,77,5,0.01,0.0
1003,18,2020-03-16 11:44:00,1,3238.0,2480.0,0.766,15.502,467,240,174,66,227,165,62,5,0.0,0.0
1003,19,2020-03-16 11:47:00,1,3111.0,2401.0,0.772,14.916,125,66,48,18,59,29,30,1,0.05,0.0
1003,20,2020-03-16 11:50:00,1,2783.0,2179.0,0.783,13.378,47,7,1,6,40,2,38,0,0.0,0.0
1003,21,2020-03-16 11:53:00,1,2443.0,1977.0,0.81,11.814,292,0,0,0,292,235,57,0,0.0,0.0
1003,22,2020-03-16 11:56:00,1,2224.0,1805.0,0.812,10.76,117,0,0,0,117,76,41,0,0.0,0.0
1003,23,2020-03-16 11:59:00,1,2169.0,1727.0,0.796,10.459,73,5,5,0,68,30,38,0,0.01,0.0
1003,24,2020-03-16 12:02:00,1,2162.0,1723.0,0.797,10.426,64,4,1,3,60,22,38,0,0.0,0.0
1003,25,2020-03-16 12:05:00,1,2163.0,1673.0,0.773,10.376,46,9,0,9,37,3,34,0,0.0,0.0
1003,26,2020-03-16 12:08:00,1,1964.0,1633.0,0.831,9.546,37,0,0,0,37,2,35,0,0.01,0.0
1003,27,2020-03-16 12:11:00,1,1976.0,1617.0,0.818,9.577,41,0,0,0,41,0,41,0,0.0,0.0
1003,28,2020-03-16 12:14:00,1,1969.0,1543.0,0.784,9.466,197,17,10,7,180,126,54,0,0.0,0.0
1003,29,2020-03-16 12:17:00,1,2000.0,1565.0,0.783,9.614,198,0,0,0,198,179,19,0,0.0,0.0
1003,30,2020-03-16 12:20:00,1,1984.0,1569.0,0.791,9.552,192,0,0,0,192,167,25,0,0.01,0.0
1003,31,2020-03-16 12:23:00,1,1999.0,1660.0,0.83,9.715,191,19,8,11,172,101,71,0,0.06,0.0
1003,32,2020-03-16 12:26:00,1,1996.0,1638.0,0.821,9.677,75,0,0,0,75,8,67,0,0.0,0.0
1003,33,2020-03-16 12:29:00,1,1995.0,1562.0,0.783,9.588,187,6,3,3,181,103,78,0,0.0,0.0
1003,34,2020-03-16 12:32:00,1,1930.0,1565.0,0.811,9.335,76,0,0,0,76,7,69,0,0.01,0.0
1003,35,2020-03-16 12:35:00,1,1865.0,1511.0,0.81,9.022,64,0,0,0,64,0,64,0,0.0,0.0
1003,36,2020-03-16 12:38:00,1,1710.0,1473.0,0.861,8.368,73,0,0,0,73,0,73,0,0.0,0.0
1003,37,2020-03-16 12:41:00,1,1721.0,1475.0,0.857,8.416,65,0,0,0,65,0,65,0,0.0,0.0
1003,38,2020-03-16 12:44:00,1,1706.0,1401.0,0.821,8.273,102,2,1,1,100,30,70,0,0.0,0.0
1003,39,2020-03-16 12:47:00,1,1695.0,1458.0,0.86,8.294,102,7,4,3,95,24,71,0,0.0,0.0
1003,40,2020-03-16 12:50:00,1,2138.0,1801.0,0.842,10.419,268,75,46,29,193,123,70,9,0.01,0.0
1003,41,2020-03-16 12:53:00,1,2258.0,1940.0,0.859,11.046,309,114,73,41,195,126,69,11,0.0,0.0
1003,42,2020-03-16 12:56:00,1,2394.0,2042.0,0.853,11.692,305,63,23,40,242,146,96,0,0.0,0.0
1003,43,2020-03-16 12:59:00,1,2369.0,2016.0,0.851,11.568,173,19,7,12,154,91,63,1,0.0,0.0
1003,44,2020-03-16 13:02:00,1,2475.0,2071.0,0.837,12.043,120,24,9,15,96,61,35,0,0.0,0.0
1003,45,2020-03-16 13:05:00,1,2398.0,2023.0,0.843,11.689,118,40,9,31,78,35,43,1,0.0,0.0
1003,46,2020-03-16 13:08:00,1,2302.0,2014.0,0.875,11.301,263,40,19,21,223,139,84,0,0.01,0.0
1003,47,2020-03-16 13:11:00,1,2301.0,1934.0,0.841,11.206,96,7,1,6,89,19,70,0,0.0,0.0
1003,48,2020-03-16 13:14:00,1,2054.0,1695.0,0.825,9.971,60,2,0,2,58,2,56,0,0.0,0.0
1003,49,2020-03-16 13:17:00,1,1953.0,1598.0,0.818,9.466,65,1,0,1,64,0,64,0,0.0,0.0
1003,50,2020-03-16 13:20:00,1,1649.0,1477.0,0.896,8.132,55,3,0,3,52,0,52,0,0.04,0.0
1003,51,2020-03-16 13:23:00,1,1700.0,1433.0,0.843,8.283,57,1,0,1,56,0,56,0,0.0,0.0
1003,52,2020-03-16 13:26:00,1,1538.0,1334.0,0.867,7.536,73,6,0,6,67,2,65,0,0.0,0.0
1003,53,2020-03-16 13:29:00,1,1550.0,1319.0,0.851,7.566,72,16,0,16,56,0,56,0,0.01,0.0
1003,54,2020-03-16 13:32:00,1,1465.0,1280.0,0.873,7.19,56,0,0,0,56,0,56,0,0.0,0.0
1003,55,2020-03-16 13:35:00,1,1632.0,1393.0,0.854,7.972,70,8,0,8,62,3,59,0,0.0,0.0
1003,56,2020-03-16 13:38:00,1,1722.0,1449.0,0.841,8.388,4,0,0,0,4,2,2,0,0.0,0.0
1003,57,2020-03-16 13:41:00,1,1684.0,1437.0,0.853,8.227,40,2,0,2,38,1,37,0,0.01,0.0
1003,58,2020-03-16 13:44:00,1,1713.0,1428.0,0.834,8.33,54,1,0,1,53,0,53,0,0.0,0.0
1003,59,2020-03-16 13:47:00,1,1710.0,1446.0,0.846,8.337,64,0,0,0,64,0,64,0,0.0,0.0
1003,60,2020-03-16 13:50:00,1,1510.0,1353.0,0.896,7.448,36,7,4,3,29,5,24,0,0.0,0.0
1003,61,2020-03-16 13:53:00,1,1693.0,1451.0,0.857,8.278,6,6,1,5,0,0,0,0,0.0,0.0
1003,62,2020-03-16 13:56:00,1,1753.5,1475.5,0.842,8.543,1,1,1,0,0,0,0,0,0.01,0.0
1003,63,2020-03-16 13:59:00,1,1814.0,1500.0,0.827,8.808,0,0,0,0,0,0,0,0,0.0,0.0
1003,64,2020-03-16 14:02:00,1,1804.0,1518.0,0.842,8.788,104,46,24,22,58,29,29,0,0.0,0.0
1003,65,2020-03-16 14:05:00,1,2047.0,1623.0,0.793,9.862,82,0,0,0,82,38,44,0,0.0,0.0
1003,66,2020-03-16 14:08:00,1,1988.0,1572.0,0.791,9.573,189,10,1,9,179,135,44,0,0.0,0.0
1003,67,2020-03-16 14:11:00,1,1790.0,1521.0,0.85,8.735,49,8,2,6,41,10,31,0,0.0,0.0
1003,68,2020-03-16 14:14:00,1,1832.0,1445.0,0.789,8.818,115,0,0,0,115,65,50,0,0.01,0.0
1003,69,2020-03-16 14:17:00,1,1819.0,1414.0,0.777,8.735,128,0,0,0,128,67,61,0,0.0,0.0
1003,70,2020-03-16 14:20:00,1,1603.0,1373.0,0.857,7.836,63,2,2,0,61,6,55,0,0.0,0.0
1003,71,2020-03-16 14:23:00,1,1727.0,1404.0,0.813,8.358,56,0,0,0,56,3,53,0,0.0,0.0
1003,72,2020-03-16 14:26:00,1,1615.0,1321.0,0.818,7.827,0,0,0,0,0,0,0,0,0.0,0.0
1003,73,2020-03-16 14:29:00,1,1676.0,1275.0,0.761,8.015,14,2,1,1,12,1,11,0,0.0,0.0
1003,74,2020-03-16 14:32:00,1,1635.0,1226.0,0.749,7.8,1,0,0,0,1,1,0,0,0.0,0.0
1003,75,2020-03-16 14:35:00,1,1579.0,1255.0,0.795,7.609,40,0,0,0,40,1,39,0,0.01,0.0
1003,76,2020-03-16 14:38:00,1,1649.0,1367.0,0.829,8.012,58,2,1,1,56,0,56,0,0.0,0.0
1003,77,2020-03-16 14:41:00,1,1609.0,1320.0,0.82,7.803,0,0,0,0,0,0,0,0,0.0,0.0
1003,78,2020-03-16 14:44:00,1,1663.0,1300.0,0.782,7.991,3,0,0,0,3,0,3,0,0.0,0.0
1003,79,2020-03-16 14:47:00,1,1623.0,1266.0,0.78,7.795,51,32,0,32,19,2,17,0,0.0,0.0
1003,80,2020-03-16 14:50:00,1,1724.0,1513.0,0.878,8.467,232,101,47,54,131,56,75,6,0.01,0.0
1003,81,2020-03-16 14:53:00,1,2082.0,1712.0,0.822,10.098,89,15,1,14,74,24,50,0,0.0,0.0
1003,82,2020-03-16 14:56:00,1,2038.0,1718.0,0.843,9.931,115,36,15,21,79,45,34,2,0.0,0.0
1003,83,2020-03-16 14:59:00,1,2273.0,1791.0,0.788,10.939,219,31,17,14,188,114,74,2,0.0,0.0
1003,84,2020-03-16 15:02:00,1,2188.0,1753.0,0.801,10.563,169,26,7,19,143,77,66,0,0.0,0.0
1003,85,2020-03-16 15:05:00,1,2282.0,1814.0,0.795,11.001,306,45,14,31,261,166,95,0,0.0,0.0
1003,86,2020-03-16 15:08:00,1,2234.0,1772.0,0.793,10.763,257,28,11,17,229,140,89,0,0.0,0.0
1003,87,2020-03-16 15:11:00,1,2064.0,1739.0,0.843,10.058,159,16,6,10,143,70,73,0,0.01,0.0
1003,88,2020-03-16 15:14:00,1,1772.0,1561.0,0.881,8.709,91,11,7,4,80,18,62,0,0.01,0.0
1003,89,2020-03-16 15:17:00,1,1787.0,1495.0,0.837,8.695,34,12,2,10,22,0,22,0,0.0,0.0
1003,90,2020-03-16 15:20:00,1,1775.0,1450.0,0.817,8.599,0,0,0,0,0,0,0,0,0.0,0.0
1003,91,2020-03-16 15:23:00,1,1801.0,1458.0,0.81,8.711,5,5,1,4,0,0,0,0,0.0,0.0
1003,92,2020-03-16 15:26:00,1,1593.0,1418.0,0.89,7.848,16,16,1,15,0,0,0,0,0.0,0.0
1003,93,2020-03-16 15:29:00,1,1703.0,1427.0,0.838,8.288,8,8,0,8,0,0,0,0,0.0,0.0
1003,94,2020-03-16 15:32:00,1,1711.0,1435.0,0.838,8.33,0,0,0,0,0,0,0,0,0.0,0.0
1003,95,2020-03-16 15:35:00,1,1646.0,1409.0,0.856,8.045,0,0,0,0,0,0,0,0,0.0,0.0
1003,96,2020-03-16 15:38:00,1,1600.0,1358.0,0.849,7.81,0,0,0,0,0,0,0,0,0.0,0.0
1003,97,2020-03-16 15:41:00,1,1600.0,1331.0,0.832,7.776,0,0,0,0,0,0,0,0,0.0,0.0
1003,98,2020-03-16 15:44:00,1,1635.0,1270.0,0.776,7.85,0,0,0,0,0,0,0,0,0.0,0.0
1003,99,2020-03-16 15:47:00,1,1522.0,1222.0,0.803,7.35,9,0,0,0,9,0,9,0,0.0,0.0
1003,100,2020-03-16 15:50:00,1,1667.0,1342.0,0.805,8.055,2,0,0,0,2,0,2,0,0.0,0.0
1003,101,2020-03-16 15:53:00,1,1616.0,1325.0,0.82,7.836,0,0,0,0,0,0,0,0,0.01,0.0
1003,102,2020-03-16 15:56:00,1,1577.0,1337.0,0.848,7.694,0,0,0,0,0,0,0,0,0.0,0.0
1003,103,2020-03-16 15:59:00,1,1624.0,1340.0,0.825,7.882,0,0,0,0,0,0,0,0,0.0,0.0
1003,104,2020-03-16 16:02:00,1,1668.0,1327.0,0.796,8.041,0,0,0,0,0,0,0,0,0.0,0.0
1003,105,2020-03-16 16:05:00,1,1460.0,1219.0,0.835,7.104,0,0,0,0,0,0,0,0,0.0,0.0
1003,106,2020-03-16 16:08:00,1,1352.0,1235.0,0.913,6.695,0,0,0,0,0,0,0,0,0.01,0.0
1003,107,2020-03-16 16:11:00,1,1635.0,1323.0,0.809,7.908,0,0,0,0,0,0,0,0,0.0,0.0
1003,108,2020-03-16 16:14:00,1,1621.0,1348.0,0.832,7.879,0,0,0,0,0,0,0,0,0.0,0.0
1003,109,2020-03-16 16:17:00,1,1641.0,1369.0,0.834,7.982,0,0,0,0,0,0,0,0,0.0,0.0
1003,110,2020-03-16 16:20:00,1,1652.0,1408.0,0.852,8.066,2,2,1,1,0,0,0,0,0.0,0.0
1003,111,2020-03-16 16:23:00,1,1608.0,1343.0,0.835,7.824,0,0,0,0,0,0,0,0,0.0,0.0
1003,112,2020-03-16 16:26:00,1,1613.0,1342.0,0.832,7.84,0,0,0,0,0,0,0,0,0.01,0.0
1003,113,2020-03-16 16:29:00,1,1592.0,1325.0,0.832,7.741,0,0,0,0,0,0,0,0,0.0,0.0
1003,114,2020-03-16 16:32:00,1,1611.0,1324.0,0.822,7.815,0,0,0,0,0,0,0,0,0.0,0.0
1003,115,2020-03-16 16:35:00,1,1608.0,1342.0,0.834,7.822,2,2,1,1,0,0,0,0,0.0,0.0
1003,116,2020-03-16 16:38:00,1,1647.0,1340.0,0.813,7.974,1,1,0,1,0,0,0,0,0.0,0.0
1003,117,2020-03-16 16:41:00,1,1643.0,1323.0,0.805,7.937,0,0,0,0,0,0,0,0,0.0,0.0
1003,118,2020-03-16 16:44:00,1,1645.0,1359.0,0.826,7.987,1,1,0,1,0,0,0,0,0.0,0.0
1003,119,2020-03-16 16:47:00,1,1638.0,1358.0,0.829,7.956,13,5,3,2,8,6,2,2,0.0,0.0
1003,120,2020-03-16 16:50:00,1,1583.0,1401.0,0.885,7.787,264,57,33,24,207,140,67,4,0.01,0.0
1003,121,2020-03-16 16:53:00,1,1829.0,1576.0,0.862,8.949,257,69,37,32,188,112,76,2,0.0,0.0
1003,122,2020-03-16 16:56:00,1,2038.0,1614.5,0.799,9.817,221,97,77,20,124,53,71,0,0.0,0.0
1003,123,2020-03-16 16:59:00,1,2247.0,1653.0,0.736,10.685,64,0,0,0,64,0,64,0,0.0,0.0
1003,124,2020-03-16 17:02:00,1,2023.0,1541.0,0.762,9.678,75,1,0,1,74,0,74,0,0.0,0.0
1003,125,2020-03-16 17:05:00,1,1843.0,1434.0,0.778,8.848,74,1,0,1,73,2,71,0,0.0,0.0
1003,126,2020-03-16 17:08:00,1,1755.0,1311.0,0.747,8.368,72,1,0,1,71,0,71,0,0.0,0.0
1003,127,2020-03-16 17:11:00,1,1553.0,1202.0,0.774,7.45,67,2,1,1,65,0,65,0,0.01,0.0
1003,128,2020-03-16 17:14:00,1,1563.0,1177.0,0.753,7.46,70,1,0,1,69,2,67,0,0.0,0.0
1003,129,2020-03-16 17:17:00,1,1584.0,1173.0,0.74,7.539,71,1,0,1,70,2,68,0,0.0,0.0
1003,130,2020-03-16 17:20:00,1,1563.0,1217.0,0.779,7.507,78,0,0,0,78,0,78,0,0.0,0.0
1003,131,2020-03-16 17:23:00,1,1534.0,1232.0,0.804,7.407,63,0,0,0,63,0,63,0,0.0,0.0
1003,132,2020-03-16 17:26:00,1,1557.0,1215.0,0.78,7.482,118,27,14,13,91,25,66,0,0.0,0.0
1003,133,2020-03-16 17:29:00,1,1832.0,1449.0,0.791,8.822,205,0,0,0,205,120,85,0,0.0,0.0
1003,134,2020-03-16 17:32:00,1,1814.0,1437.0,0.792,8.738,104,0,0,0,104,61,43,0,0.0,0.0
1003,135,2020-03-16 17:35:00,1,1806.0,1452.0,0.804,8.722,110,0,0,0,110,53,57,0,0.0,0.0
1003,136,2020-03-16 17:38:00,1,1842.0,1404.0,0.762,8.811,59,2,0,2,57,9,48,0,0.0,0.0
1003,137,2020-03-16 17:41:00,1,1827.0,1460.0,0.799,8.813,120,49,11,38,71,18,53,0,0.01,0.0
1003,138,2020-03-16 17:44:00,1,2106.0,1682.0,0.799,10.158,274,60,9,51,214,130,84,1,0.0,0.0
1003,139,2020-03-16 17:47:00,1,2439.0,1829.0,0.75,11.637,142,42,8,34,100,45,55,0,0.0,0.0
1003,140,2020-03-16 17:50:00,1,2372.0,1958.0,0.825,11.514,259,87,56,31,172,119,53,8,0.0,0.0
1003,141,2020-03-16 17:53:00,1,2616.0,2077.0,0.794,12.608,301,158,114,44,143,92,51,5,0.0,0.0
1003,142,2020-03-16 17:56:00,1,2597.0,2075.0,0.799,12.531,257,131,88,43,126,87,39,16,0.0,0.0
1003,143,2020-03-16 17:59:00,1,2597.0,2007.0,0.773,12.454,155,36,4,32,119,60,59,2,0.0,0.0
1003,144,2020-03-16 18:02:00,0,2607.0,1996.0,0.766,12.483,554,382,307,75,172,109,63,10,0.0,0.0
1003,145,2020-03-16 18:05:00,0,2573.0,2058.0,0.8,12.416,768,431,340,91,337,241,96,42,0.0,0.0
1003,146,2020-03-16 18:08:00,0,2942.0,2191.0,0.745,14.018,604,416,349,67,188,118,70,45,0.0,0.0
1003,147,2020-03-16 18:11:00,0,2919.0,2252.0,0.772,13.994,410,205,148,57,205,139,66,19,0.0,0.0
1003,148,2020-03-16 18:14:00,0,2863.0,2153.0,0.752,13.663,485,254,188,66,231,145,86,37,0.01,0.0
1003,149,2020-03-16 18:17:00,0,2733.0,2084.0,0.762,13.073,251,76,41,35,175,104,71,0,0.0,0.0
1003,150,2020-03-16 18:20:00,0,2593.0,2041.0,0.787,12.476,272,75,29,46,197,114,83,0,0.0,0.0
1003,151,2020-03-16 18:23:00,0,2608.0,1997.0,0.766,12.486,131,71,43,28,60,32,28,0,0.0,0.0
1003,152,2020-03-16 18:26:00,0,2441.0,1804.0,0.739,11.617,0,0,0,0,0,0,0,0,0.0,0.0
1003,153,2020-03-16 18:29:00,0,2101.0,1612.0,0.767,10.061,0,0,0,0,0,0,0,0,0.0,0.0
1003,154,2020-03-16 18:32:00,0,2009.0,1484.0,0.739,9.558,0,0,0,0,0,0,0,0,0.0,0.0
1003,155,2020-03-16 18:35:00,0,1818.0,1389.0,0.764,8.703,0,0,0,0,0,0,0,0,0.0,0.0
1003,156,2020-03-16 18:38:00,0,1858.0,1337.0,0.719,8.801,0,0,0,0,0,0,0,0,0.0,0.0
1003,157,2020-03-16 18:41:00,0,1728.0,1289.0,0.746,8.236,0,0,0,0,0,0,0,0,0.0,0.0
1003,158,2020-03-16 18:44:00,0,1735.0,1299.0,0.749,8.275,142,66,34,32,76,41,35,0,0.01,0.0
1003,159,2020-03-16 18:47:00,0,2006.0,1583.0,0.789,9.656,272,43,19,24,229,157,72,5,0.0,0.0
1003,160,2020-03-16 18:50:00,0,2429.0,1771.0,0.729,11.532,249,90,61,29,159,98,61,12,0.0,0.0
1003,161,2020-03-16 18:53:00,0,2564.0,2005.0,0.782,12.324,83,24,16,8,59,37,22,8,0.0,0.0
1003,162,2020-03-16 18:56:00,0,2463.0,1918.0,0.779,11.827,38,4,1,3,34,17,17,0,0.0,0.0
1003,163,2020-03-16 18:59:00,0,2257.0,1726.0,0.765,10.803,60,22,6,16,38,15,23,2,0.0,0.0
1003,164,2020-03-16 19:02:00,0,2448.0,1788.0,0.73,11.626,212,30,6,24,182,118,64,3,0.0,0.0
1003,165,2020-03-16 19:05:00,0,2490.0,1955.0,0.785,11.975,398,181,124,57,217,155,62,22,0.0,0.0
1003,166,2020-03-16 19:08:00,0,2855.0,2171.0,0.761,13.652,719,526,423,103,193,139,54,4,0.0,0.0
1003,167,2020-03-16 19:11:00,0,3051.0,2293.0,0.752,14.562,301,194,151,43,107,83,24,21,0.0,0.0
1003,168,2020-03-16 19:14:00,0,2782.0,2120.0,0.762,13.306,106,21,2,19,85,43,42,0,0.01,0.0
1003,169,2020-03-16 19:17:00,0,2401.0,1892.0,0.788,11.555,201,97,67,30,104,58,46,7,0.0,0.0
1003,170,2020-03-16 19:20:00,0,2426.0,1851.0,0.763,11.607,184,65,34,31,119,69,50,10,0.0,0.0
1003,171,2020-03-16 19:23:00,0,2571.0,2023.0,0.787,12.371,508,376,296,80,132,86,46,16,0.0,0.0
1003,172,2020-03-16 19:26:00,0,2784.0,2128.0,0.764,13.326,405,279,216,63,126,80,46,20,0.0,0.0
1003,173,2020-03-16 19:29:00,0,2889.0,2237.0,0.774,13.859,657,368,290,78,289,210,79,24,0.0,0.0
1003,174,2020-03-16 19:32:00,0,2792.0,2127.0,0.762,13.354,635,457,373,84,178,105,73,20,0.0,0.0
1003,175,2020-03-16 19:35:00,0,2851.0,2095.0,0.735,13.553,181,60,30,30,121,81,40,3,0.0,0.0
1003,176,2020-03-16 19:38:00,0,2781.0,2069.0,0.744,13.247,197,40,12,28,157,89,68,0,0.0,0.0
1003,177,2020-03-16 19:41:00,0,2554.0,1862.0,0.729,12.125,95,3,0,3,92,39,53,0,0.0,0.0
1003,178,2020-03-16 19:44:00,0,2489.0,1785.0,0.717,11.782,51,1,0,1,50,9,41,0,0.0,0.0
1003,179,2020-03-16 19:47:00,0,2236.0,1595.0,0.713,10.577,45,0,0,0,45,1,44,0,0.0,0.0
1003,180,2020-03-16 19:50:00,0,2016.0,1524.0,0.756,9.63,121,30,18,12,91,30,61,0,0.01,0.0
1003,181,2020-03-16 19:53:00,0,1989.0,1531.0,0.77,9.53,33,8,0,8,25,2,23,0,0.0,0.0
1003,182,2020-03-16 19:56:00,0,1966.0,1454.5,0.7395,9.3565,2,1,0,1,1,0,1,0,0.0,0.0
1003,183,2020-03-16 19:59:00,0,1943.0,1378.0,0.709,9.183,167,48,22,26,119,79,40,12,0.0,0.0
1003,184,2020-03-16 20:02:00,0,2056.0,1545.0,0.752,9.811,412,283,218,65,129,83,46,10,0.0,0.0
1003,185,2020-03-16 20:05:00,0,2546.0,1869.0,0.734,12.102,505,263,195,68,242,166,76,23,0.0,0.0
1003,186,2020-03-16 20:08:00,0,2683.0,2061.0,0.768,12.852,599,461,358,103,138,95,43,41,0.0,0.0
1003,187,2020-03-16 20:11:00,0,3037.0,2196.0,0.723,14.397,764,575,448,127,189,134,55,46,0.0,0.0
1003,188,2020-03-16 20:14:00,0,2922.0,2146.0,0.734,13.891,717,558,453,105,159,117,42,40,0.0,0.0
1003,189,2020-03-16 20:17:00,0,3072.0,2213.0,0.72,14.554,496,352,283,69,144,96,48,35,0.0,0.0
1003,190,2020-03-16 20:20:00,0,2959.0,2170.0,0.733,14.061,689,428,343,85,261,189,72,37,0.0,0.0
1003,191,2020-03-16 20:23:00,0,3028.0,2204.0,0.728,14.372,446,237,161,76,209,150,59,29,0.0,0.0
1003,192,2020-03-16 20:26:00,0,2946.0,2167.0,0.735,14.008,395,217,135,82,178,127,51,26,0.0,0.0
1003,193,2020-03-16 20:29:00,0,2961.0,2123.0,0.717,14.016,338,200,152,48,138,93,45,13,0.01,0.0
1003,194,2020-03-16 20:32:00,0,3059.0,2175.0,0.711,14.461,393,224,173,51,169,123,46,27,0.0,0.0
1003,195,2020-03-16 20:35:00,0,2822.0,2069.0,0.733,13.409,201,94,45,49,107,73,34,7,0.0,0.0
1003,196,2020-03-16 20:38:00,0,2784.0,2043.0,0.734,13.23,269,118,66,52,151,104,47,5,0.0,0.0
1003,197,2020-03-16 20:41:00,0,2742.0,1973.0,0.719,12.987,58,7,2,5,51,26,25,0,0.0,0.0
1003,198,2020-03-16 20:44:00,0,2351.0,1719.0,0.731,11.169,54,5,2,3,49,16,33,0,0.0,0.0
1003,199,2020-03-16 20:47:00,0,2221.0,1574.0,0.708,10.495,114,29,13,16,85,45,40,0,0.0,0.0
1003,200,2020-03-16 20:50:00,0,2089.0,1581.0,0.757,9.979,548,336,276,60,212,149,63,7,0.0,0.0
1003,201,2020-03-16 20:53:00,0,2385.0,1765.0,0.74,11.353,245,126,78,48,119,74,45,9,0.0,0.0
1003,202,2020-03-16 20:56:00,0,2549.0,1816.0,0.712,12.053,473,333,259,74,140,94,46,9,0.0,0.0
1003,203,2020-03-16 20:59:00,0,2489.0,1881.0,0.756,11.891,481,341,269,72,140,90,50,11,0.0,0.0
1003,204,2020-03-16 21:02:00,0,2517.0,1901.0,0.755,12.02,281,193,141,52,88,43,45,8,0.0,0.0
1003,205,2020-03-16 21:05:00,0,2499.0,1859.0,0.744,11.903,228,161,119,42,67,33,34,5,0.0,0.0
1003,206,2020-03-16 21:08:00,0,2522.0,1779.0,0.705,11.908,6,0,0,0,6,2,4,0,0.0,0.0
1003,207,2020-03-16 21:11:00,0,2309.0,1656.0,0.717,10.93,141,45,32,13,96,43,53,0,0.0,0.0
1003,208,2020-03-16 21:14:00,0,2054.0,1517.0,0.739,9.773,20,17,7,10,3,2,1,0,0.0,0.0
1003,209,2020-03-16 21:17:00,0,1931.0,1453.0,0.752,9.218,30,25,3,22,5,2,3,0,0.0,0.0
1003,210,2020-03-16 21:20:00,0,2140.0,1561.0,0.73,10.159,442,239,182,57,203,147,56,23,0.0,0.0
1003,211,2020-03-16 21:23:00,0,2509.0,1823.0,0.727,11.904,367,225,173,52,142,90,52,32,0.0,0.0
1003,212,2020-03-16 21:26:00,0,2548.0,1810.0,0.71,12.044,371,219,160,59,152,103,49,21,0.0,0.0
1003,213,2020-03-16 21:29:00,0,2539.0,1913.0,0.753,12.122,300,219,170,49,81,45,36,15,0.0,0.0
1003,214,2020-03-16 21:32:00,0,2583.0,1885.0,0.73,12.263,134,53,33,20,81,27,54,0,0.0,0.0
1003,215,2020-03-16 21:35:00,0,2433.0,1737.0,0.714,11.511,75,16,7,9,59,16,43,0,0.0,0.0
1003,216,2020-03-16 21:38:00,0,2086.0,1526.0,0.732,9.907,36,0,0,0,36,10,26,0,0.01,0.0
1003,217,2020-03-16 21:41:00,0,1930.0,1349.0,0.699,9.098,125,28,12,16,97,48,49,0,0.0,0.0
1003,218,2020-03-16 21:44:00,0,2079.0,1493.0,0.718,9.846,324,179,126,53,145,99,46,10,0.0,0.0
1003,219,2020-03-16 21:47:00,0,2185.0,1645.0,0.753,10.431,340,249,182,67,91,58,33,3,0.0,0.0
1003,220,2020-03-16 21:50:00,0,2058.0,1566.0,0.761,9.843,45,2,0,2,43,10,33,0,0.0,0.0
1003,221,2020-03-16 21:53:00,0,2074.0,1549.0,0.747,9.887,294,145,93,52,149,97,52,13,0.0,0.0
1003,222,2020-03-16 21:56:00,0,2334.0,1695.0,0.726,11.072,337,221,167,54,116,83,33,38,0.0,0.0
1003,223,2020-03-16 21:59:00,0,2535.0,1805.0,0.712,11.986,564,397,316,81,167,122,45,16,0.0,0.0
1003,224,2020-03-16 22:02:00,0,2540.0,1843.0,0.725,12.048,494,321,251,70,173,112,61,31,0.0,0.0
1003,225,2020-03-16 22:05:00,0,2569.0,1913.0,0.745,12.241,264,135,87,48,129,85,44,12,0.0,0.0
1003,226,2020-03-16 22:08:00,0,2687.0,1967.0,0.732,12.766,245,65,32,33,180,107,73,1,0.0,0.0
1003,227,2020-03-16 22:11:00,0,2625.0,1908.0,0.727,12.455,269,115,71,44,154,96,58,11,0.0,0.0
1003,228,2020-03-16 22:14:00,0,2483.0,1864.0,0.751,11.846,237,128,105,23,109,68,41,4,0.0,0.0
1003,229,2020-03-16 22:17:00,0,2552.0,1788.0,0.7,12.036,48,1,1,0,47,0,47,0,0.0,0.0
1003,230,2020-03-16 22:20:00,0,2307.0,1654.0,0.717,10.923,65,19,12,7,46,8,38,0,0.0,0.0
1003,231,2020-03-16 22:23:00,0,2078.0,1565.0,0.753,9.919,385,253,186,67,132,86,46,24,0.0,0.0
1003,232,2020-03-16 22:26:00,0,2400.0,1707.0,0.711,11.347,353,223,169,54,130,89,41,13,0.0,0.0
1003,233,2020-03-16 22:29:00,0,2355.0,1736.0,0.737,11.199,326,232,171,61,94,56,38,8,0.0,0.0
1003,234,2020-03-16 22:32:00,0,2412.0,1699.0,0.705,11.384,44,1,0,1,43,2,41,0,0.0,0.0
1003,235,2020-03-16 22:35:00,0,2129.0,1496.0,0.703,10.044,109,2,1,1,107,56,51,0,0.0,0.0
1003,236,2020-03-16 22:38:00,0,1930.0,1396.0,0.723,9.151,333,184,146,38,149,96,53,10,0.01,0.0
1003,237,2020-03-16 22:41:00,0,2167.0,1606.0,0.741,10.316,425,227,169,58,198,133,65,29,0.0,0.0
1003,238,2020-03-16 22:44:00,0,2360.0,1769.0,0.75,11.256,535,387,304,83,148,85,63,33,0.0,0.0
1003,239,2020-03-16 22:47:00,0,2580.0,1880.0,0.729,12.247,844,523,443,80,321,246,75,37,0.0,0.0
1003,240,2020-03-16 22:50:00,0,2520.0,1857.0,0.737,11.987,385,242,189,53,143,99,44,23,0.0,0.0
1003,241,2020-03-16 22:53:00,0,2548.0,1892.0,0.743,12.133,365,220,162,58,145,102,43,16,0.0,0.0
1003,242,2020-03-16 22:56:00,0,2557.5,1897.5,0.742,12.1765,283,155,113,42,128,89,39,22,0.0,0.0
1003,243,2020-03-16 22:59:00,0,2567.0,1903.0,0.741,12.22,547,364,293,71,183,133,50,28,0.0,0.0
1003,244,2020-03-16 23:02:00,0,2495.0,1835.0,0.735,11.864,803,558,447,111,245,187,58,50,0.0,0.0
1003,245,2020-03-16 23:05:00,0,2538.0,1884.0,0.742,12.087,765,561,462,99,204,164,40,57,0.0,0.0
1003,246,2020-03-16 23:08:00,0,2503.0,1877.0,0.75,11.942,1392,1063,888,175,329,273,56,87,0.0,0.0
1003,247,2020-03-16 23:11:00,0,2705.0,2066.0,0.764,12.946,1271,962,812,150,309,254,55,84,0.0,0.0
1003,248,2020-03-16 23:14:00,0,2942.0,2090.0,0.71,13.903,1287,899,749,150,388,311,77,74,0.01,0.0
1003,249,2020-03-16 23:17:00,0,3135.0,2272.0,0.725,14.868,1254,905,744,161,349,274,75,75,0.0,0.0
1003,250,2020-03-16 23:20:00,0,2953.0,2208.0,0.748,14.081,905,624,513,111,281,220,61,54,0.0,0.0
1003,251,2020-03-16 23:23:00,0,2902.0,2130.0,0.734,13.793,521,372,296,76,149,105,44,28,0.0,0.0
1003,252,2020-03-16 23:26:00,0,2689.0,1981.0,0.736,12.79,449,355,289,66,94,57,37,50,0.0,0.0
1003,253,2020-03-16 23:29:00,0,2680.0,1997.0,0.745,12.77,550,475,380,95,75,37,38,50,0.0,0.0
1003,254,2020-03-16 23:32:00,0,2584.0,1955.0,0.757,12.347,282,188,126,62,94,55,39,24,0.0,0.0
1003,255,2020-03-16 23:35:00,0,2714.0,2075.0,0.764,12.992,734,589,455,134,145,96,49,81,0.0,0.0
1003,256,2020-03-16 23:38:00,0,2518.0,1803.0,0.716,11.917,107,72,56,16,35,17,18,2,0.0,0.0
1003,257,2020-03-16 23:41:00,0,2500.0,1793.0,0.717,11.836,47,11,0,11,36,5,31,0,0.0,0.0
1003,258,2020-03-16 23:44:00,0,2377.0,1726.0,0.726,11.277,313,170,131,39,143,95,48,24,0.01,0.0
1003,259,2020-03-16 23:47:00,0,2350.0,1776.0,0.756,11.225,406,177,135,42,229,164,65,35,0.0,0.0
1003,260,2020-03-16 23:50:00,0,2584.0,1891.0,0.732,12.275,622,402,327,75,220,162,58,57,0.0,0.0
1003,261,2020-03-16 23:53:00,0,2574.0,1984.0,0.771,12.339,956,777,636,141,179,132,47,74,0.0,0.0
1003,262,2020-03-16 23:56:00,0,2639.0,2041.0,0.773,12.659,1280,1011,828,183,269,203,66,87,0.0,0.0
1003,263,2020-03-16 23:59:00,0,2521.0,1902.0,0.755,12.038,704,533,428,105,171,117,54,61,0.0,0.0
1003,264,2020-03-17 00:02:00,0,2859.0,2180.0,0.763,13.679,690,495,394,101,195,138,57,51,0.0,0.0
1003,265,2020-03-17 00:05:00,0,2537.0,1833.0,0.722,12.024,447,208,163,45,239,169,70,50,0.0,0.0
1003,266,2020-03-17 00:08:00,0,2676.0,1993.0,0.745,12.75,573,401,313,88,172,119,53,42,0.0,0.0
1003,267,2020-03-17 00:11:00,0,2998.0,2219.0,0.74,14.267,772,552,434,118,220,152,68,52,0.0,0.0
1003,268,2020-03-17 00:14:00,0,2727.0,2074.0,0.76,13.042,851,457,365,92,394,308,86,52,0.0,0.0
1003,269,2020-03-17 00:17:00,0,2916.0,2183.0,0.748,13.907,1033,768,633,135,265,188,77,50,0.0,0.0
1003,270,2020-03-17 00:20:00,0,2878.0,2148.0,0.746,13.716,713,532,419,113,181,111,70,93,0.0,0.0
1003,271,2020-03-17 00:23:00,0,2932.0,2245.0,0.766,14.04,873,691,537,154,182,118,64,111,0.0,0.0
1003,272,2020-03-17 00:26:00,0,3119.0,2337.0,0.749,14.879,718,508,411,97,210,141,69,100,0.0,0.0
1003,273,2020-03-17 00:29:00,0,3076.0,2347.0,0.763,14.719,975,748,616,132,227,158,69,137,0.0,0.0
1003,274,2020-03-17 00:32:00,0,3219.0,2459.0,0.764,15.406,951,697,545,152,254,181,73,103,0.0,0.0
1003,275,2020-03-17 00:35:00,0,3426.0,2547.0,0.743,16.319,587,393,296,97,194,128,66,118,0.0,0.0
1003,276,2020-03-17 00:38:00,0,3393.0,2671.0,0.787,16.326,824,519,411,108,305,226,79,96,0.0,0.0
1003,277,2020-03-17 00:41:00,0,3204.0,2518.0,0.786,15.41,749,507,384,123,242,174,68,100,0.01,0.0
1003,278,2020-03-17 00:44:00,0,2500.0,1981.0,0.792,12.045,417,201,147,54,216,148,68,30,0.0,0.0
1003,279,2020-03-17 00:47:00,0,2477.0,1986.0,0.802,11.958,610,331,264,67,279,195,84,39,0.0,0.0
1003,280,2020-03-17 00:50:00,0,2806.0,2285.0,0.814,13.584,692,451,361,90,241,156,85,75,0.0,0.0
1003,281,2020-03-17 00:53:00,0,3127.0,2509.0,0.802,15.1,723,495,390,105,228,157,71,114,0.0,0.0
1003,282,2020-03-17 00:56:00,0,3199.0,2553.0,0.798,15.431,483,284,203,81,199,118,81,67,0.0,0.0
1003,283,2020-03-17 00:59:00,0,2980.0,2342.0,0.786,14.334,590,412,325,87,178,112,66,84,0.01,0.0
1003,284,2020-03-17 01:02:00,0,3215.0,2583.0,0.803,15.528,586,383,289,94,203,141,62,69,0.0,0.0
1003,285,2020-03-17 01:05:00,0,2609.0,2136.0,0.819,12.646,684,403,328,75,281,200,81,34,0.0,0.0
1003,286,2020-03-17 01:08:00,0,3021.0,2426.0,0.803,14.591,644,456,343,113,188,116,72,124,0.0,0.0
1003,287,2020-03-17 01:11:00,0,3400.0,2689.0,0.791,16.375,624,418,329,89,206,140,66,92,0.0,0.0
1003,288,2020-03-17 01:14:00,0,2976.0,2367.0,0.795,14.345,407,248,173,75,159,92,67,93,0.0,0.0
1003,289,2020-03-17 01:17:00,0,3460.0,2665.0,0.77,16.583,395,254,178,76,141,80,61,86,0.0,0.0
1003,290,2020-03-17 01:20:00,0,2944.0,2334.0,0.793,14.183,809,411,309,102,398,300,98,69,0.0,0.0
1003,291,2020-03-17 01:23:00,0,3005.0,2384.0,0.793,14.48,468,306,221,85,162,105,57,80,0.0,0.0
1003,292,2020-03-17 01:26:00,0,3256.0,2501.0,0.768,15.597,593,365,271,94,228,148,80,94,0.0,0.0
1003,293,2020-03-17 01:29:00,0,3157.0,2459.0,0.779,15.162,470,346,264,82,124,71,53,79,0.0,0.0
1003,294,2020-03-17 01:32:00,0,2577.0,1991.0,0.773,12.356,467,304,226,78,163,102,61,42,0.0,0.0
1003,295,2020-03-17 01:35:00,0,2644.0,2178.0,0.824,12.83,564,374,295,79,190,132,58,49,0.0,0.0
1003,296,2020-03-17 01:38:00,0,2949.0,2285.0,0.775,14.148,390,217,166,51,173,117,56,20,0.0,0.0
1003,297,2020-03-17 01:41:00,0,2290.0,1742.0,0.761,10.952,315,140,98,42,175,115,60,40,0.0,0.0
1003,298,2020-03-17 01:44:00,0,2747.0,2189.0,0.797,13.248,609,372,290,82,237,169,68,87,0.0,0.0
1003,299,2020-03-17 01:47:00,0,3083.0,2386.0,0.774,14.789,504,307,214,93,197,133,64,85,0.0,0.0
1003,300,2020-03-17 01:50:00,0,3089.0,2433.0,0.788,14.863,614,371,278,93,243,164,79,93,0.0,0.0
1003,301,2020-03-17 01:53:00,0,2693.0,2187.0,0.812,13.033,437,280,204,76,157,97,60,61,0.0,0.0
1003,302,2020-03-17 01:56:00,0,2566.0,2019.0,0.7855,12.3465,139,76,55,21,63,21,42,9,0.0,0.0
1003,303,2020-03-17 01:59:00,0,2439.0,1851.0,0.759,11.66,437,250,192,58,187,131,56,8,0.08,0.0
1003,304,2020-03-17 02:02:00,0,2678.0,2146.0,0.801,12.929,790,550,463,87,240,187,53,51,0.24,0.0
1003,305,2020-03-17 02:05:00,0,2531.0,2031.0,0.802,12.221,222,97,70,27,125,75,50,4,0.16,0.0
1003,306,2020-03-17 02:08:00,0,2666.0,2086.0,0.782,12.814,353,222,166,56,131,86,45,24,0.1,0.0
1003,307,2020-03-17 02:11:00,0,2552.0,2062.0,0.808,12.339,472,326,247,79,146,90,56,91,0.0,0.0
1003,308,2020-03-17 02:14:00,0,2686.0,2114.0,0.787,12.922,258,147,91,56,111,52,59,77,0.0,0.0
1003,309,2020-03-17 02:17:00,0,2652.0,2147.0,0.81,12.827,267,193,131,62,74,34,40,62,0.0,0.0
1003,310,2020-03-17 02:20:00,0,2712.0,2126.0,0.784,13.04,235,159,108,51,76,30,46,67,0.0,0.0
1003,311,2020-03-17 02:23:00,0,2425.0,1852.0,0.764,11.603,40,6,3,3,34,0,34,0,0.0,0.0
1003,312,2020-03-17 02:26:00,0,2376.0,1778.0,0.748,11.332,22,1,0,1,21,0,21,0,0.0,0.0
1003,313,2020-03-17 02:29:00,0,2381.0,1764.0,0.741,11.335,403,282,205,77,121,72,49,67,0.0,0.0
1003,314,2020-03-17 02:32:00,0,2528.0,1952.0,0.772,12.122,506,358,279,79,148,107,41,70,0.0,0.0
1003,315,2020-03-17 02:35:00,0,2297.0,1873.0,0.816,11.123,512,343,268,75,169,112,57,73,0.0,0.0
1003,316,2020-03-17 02:38:00,0,2003.0,1632.0,0.815,9.699,228,88,52,36,140,82,58,20,0.0,0.0
1003,317,2020-03-17 02:41:00,0,1904.0,1567.0,0.823,9.237,200,50,32,18,150,81,69,2,0.0,0.0
1003,318,2020-03-17 02:44:00,0,1627.0,1299.0,0.798,7.849,57,0,0,0,57,0,57,0,0.0,0.0
1003,319,2020-03-17 02:47:00,0,1932.0,1401.0,0.725,9.165,64,4,0,4,60,5,55,0,0.0,0.0
1003,320,2020-03-17 02:50:00,0,1945.0,1473.0,0.758,9.294,27,9,0,9,18,5,13,0,0.0,0.0
1003,321,2020-03-17 02:53:00,0,1847.0,1406.0,0.761,8.835,48,44,1,43,4,1,3,0,0.0,0.0
1003,322,2020-03-17 02:56:00,0,1649.0,1336.0,0.81,7.976,15,14,0,14,1,0,1,0,0.0,0.0
1003,323,2020-03-17 02:59:00,0,1662.0,1285.0,0.773,7.971,1,0,0,0,1,0,1,0,0.0,0.0
1003,324,2020-03-17 03:02:00,0,1658.0,1227.0,0.74,7.889,8,5,2,3,3,0,3,0,0.0,0.0
1003,325,2020-03-17 03:05:00,0,1478.0,1205.0,0.816,7.156,4,2,1,1,2,0,2,0,0.0,0.0
1003,326,2020-03-17 03:08:00,0,1452.0,1112.0,0.765,6.953,2,2,1,1,0,0,0,0,0.0,0.0
1003,327,2020-03-17 03:11:00,0,1357.0,1032.0,0.761,6.489,14,13,3,10,1,0,1,0,0.0,0.0
1003,328,2020-03-17 03:14:00,0,1470.0,1141.0,0.777,7.055,324,208,155,53,116,68,48,25,0.0,0.0
1003,329,2020-03-17 03:17:00,0,1639.0,1367.0,0.834,7.971,445,281,212,69,164,93,71,28,0.0,0.0
1003,330,2020-03-17 03:20:00,0,1937.0,1481.0,0.765,9.273,108,29,3,26,79,26,53,3,0.0,0.0
1003,331,2020-03-17 03:23:00,0,1959.0,1501.0,0.766,9.382,9,0,0,0,9,0,9,0,0.0,0.0
1003,332,2020-03-17 03:26:00,0,1722.0,1325.0,0.77,8.251,54,0,0,0,54,0,54,0,0.0,0.0
1003,333,2020-03-17 03:29:00,0,1640.0,1211.0,0.738,7.8,68,1,0,1,67,2,65,0,0.0,0.0
1003,334,2020-03-17 03:32:00,0,1484.0,1152.0,0.776,7.124,178,65,45,20,113,54,59,4,0.0,0.0
1003,335,2020-03-17 03:35:00,0,1682.0,1254.0,0.745,8.017,43,6,1,5,37,3,34,0,0.0,0.0
1003,336,2020-03-17 03:38:00,0,1656.0,1269.0,0.766,7.93,3,0,0,0,3,1,2,0,0.0,0.0
1003,337,2020-03-17 03:41:00,0,1550.0,1165.0,0.751,7.396,1,0,0,0,1,1,0,0,0.0,0.0
1003,338,2020-03-17 03:44:00,0,1458.0,1075.0,0.737,6.934,3,0,0,0,3,1,2,0,0.0,0.0
1003,339,2020-03-17 03:47:00,0,1413.0,1054.0,0.746,6.733,19,6,2,4,13,4,9,0,0.0,0.0
1003,340,2020-03-17 03:50:00,0,1299.0,1018.0,0.783,6.244,14,14,2,12,0,0,0,0,0.0,0.0
1003,341,2020-03-17 03:53:00,0,1297.0,979.0,0.755,6.193,12,9,2,7,3,1,2,0,0.0,0.0
1003,342,2020-03-17 03:56:00,0,1314.0,988.0,0.752,6.271,11,11,0,11,0,0,0,0,0.0,0.0
1003,343,2020-03-17 03:59:00,0,1331.0,1008.0,0.757,6.361,0,0,0,0,0,0,0,0,0.0,0.0
1003,344,2020-03-17 04:02:00,0,1303.0,991.0,0.76,6.232,6,0,0,0,6,0,6,0,0.0,0.0
1003,345,2020-03-17 04:05:00,0,1289.0,1001.0,0.777,6.187,1,0,0,0,1,0,1,0,0.0,0.0
1003,346,2020-03-17 04:08:00,0,1388.0,1020.0,0.735,6.596,11,0,0,0,11,3,8,0,0.0,0.0
1003,347,2020-03-17 04:11:00,0,1515.0,1057.0,0.698,7.138,78,5,3,2,73,21,52,0,0.0,0.0
1003,348,2020-03-17 04:14:00,0,1436.0,1031.0,0.718,6.798,90,0,0,0,90,19,71,0,0.0,0.0
1003,349,2020-03-17 04:17:00,0,1488.0,1031.0,0.693,7.005,84,0,0,0,84,15,69,0,0.0,0.0
1003,350,2020-03-17 04:20:00,0,1506.0,1043.0,0.693,7.091,20,1,0,1,19,2,17,0,0.0,0.0
1003,351,2020-03-17 04:23:00,0,1515.0,1042.0,0.687,7.123,0,0,0,0,0,0,0,0,0.0,0.0
1003,352,2020-03-17 04:26:00,0,1477.0,1053.0,0.713,6.985,1,1,0,1,0,0,0,0,0.0,0.0
1003,353,2020-03-17 04:29:00,0,1523.0,1072.0,0.704,7.187,7,6,0,6,1,0,1,0,0.0,0.0
1003,354,2020-03-17 04:32:00,0,1628.0,1265.0,0.777,7.817,284,209,149,60,75,42,33,15,0.0,0.0
1003,355,2020-03-17 04:35:00,0,1915.0,1519.0,0.793,9.225,433,240,163,77,193,118,75,59,0.0,0.0
1003,356,2020-03-17 04:38:00,0,2016.0,1566.0,0.777,9.677,102,18,5,13,84,23,61,0,0.0,0.0
1003,357,2020-03-17 04:41:00,0,2048.0,1521.0,0.742,9.754,204,72,52,20,132,69,63,1,0.0,0.0
1003,358,2020-03-17 04:44:00,0,1888.0,1472.0,0.779,9.07,61,0,0,0,61,0,61,0,0.0,0.0
1003,359,2020-03-17 04:47:00,0,1850.0,1350.0,0.73,8.782,71,16,0,16,55,0,55,0,0.0,0.0
1003,360,2020-03-17 04:50:00,0,1661.0,1244.0,0.749,7.922,46,0,0,0,46,0,46,0,0.0,0.0
1003,361,2020-03-17 04:53:00,0,1557.0,1131.0,0.726,7.385,59,4,0,4,55,0,55,0,0.0,0.0
1003,362,2020-03-17 04:56:00,0,1528.0,1106.0,0.7235,7.245,77,6,0,6,71,13,58,0,0.0,0.0
1003,363,2020-03-17 04:59:00,0,1499.0,1081.0,0.721,7.105,73,5,2,3,68,7,61,0,0.0,0.0
1003,364,2020-03-17 05:02:00,0,1464.0,1094.0,0.747,6.978,213,17,9,8,196,122,74,0,0.0,0.0
1003,365,2020-03-17 05:05:00,0,1692.0,1236.0,0.73,8.037,25,5,1,4,20,8,12,0,0.0,0.0
1003,366,2020-03-17 05:08:00,0,1624.0,1233.0,0.759,7.764,239,100,73,27,139,85,54,9,0.0,0.0
1003,367,2020-03-17 05:11:00,0,1936.0,1400.0,0.723,9.18,483,216,163,53,267,176,91,20,0.0,0.0
1003,368,2020-03-17 05:14:00,0,2072.0,1543.0,0.745,9.874,515,341,261,80,174,106,68,42,0.0,0.0
1003,369,2020-03-17 05:17:00,0,2039.0,1551.0,0.761,9.751,58,8,1,7,50,28,22,1,0.0,0.0
1003,370,2020-03-17 05:20:00,0,2010.0,1511.0,0.752,9.591,2,2,0,2,0,0,0,0,0.0,0.0
1003,371,2020-03-17 05:23:00,0,1931.0,1379.0,0.714,9.134,0,0,0,0,0,0,0,0,0.0,0.0
1003,372,2020-03-17 05:26:00,0,1654.0,1256.0,0.759,7.907,77,22,17,5,55,21,34,0,0.0,0.0
1003,373,2020-03-17 05:29:00,0,1663.0,1177.0,0.708,7.855,56,1,0,1,55,4,51,0,0.0,0.0
1003,374,2020-03-17 05:32:00,0,1478.0,1093.0,0.739,7.034,72,0,0,0,72,0,72,0,0.0,0.0
1003,375,2020-03-17 05:35:00,0,1510.0,1016.0,0.673,7.073,121,11,2,9,110,48,62,0,0.0,0.0
1003,376,2020-03-17 05:38:00,0,1408.0,1024.0,0.727,6.682,59,0,0,0,59,9,50,0,0.0,0.0
1003,377,2020-03-17 05:41:00,0,1313.0,981.0,0.747,6.261,90,3,0,3,87,31,56,0,0.0,0.0
1003,378,2020-03-17 05:44:00,0,1324.0,943.0,0.713,6.26,71,5,2,3,66,10,56,0,0.0,0.0
1003,379,2020-03-17 05:47:00,0,1222.0,914.0,0.748,5.826,86,7,2,5,79,20,59,0,0.0,0.0
1003,380,2020-03-17 05:50:00,0,1117.0,867.0,0.776,5.36,84,5,1,4,79,23,56,0,0.0,0.0
1003,381,2020-03-17 05:53:00,0,1136.0,910.0,0.801,5.482,72,2,1,1,70,18,52,0,0.0,0.0
1003,382,2020-03-17 05:56:00,0,1119.0,883.0,0.789,5.384,60,1,0,1,59,6,53,0,0.0,0.0
1003,383,2020-03-17 05:59:00,0,1128.0,903.0,0.8,5.444,61,2,0,2,59,2,57,0,0.0,0.0
1003,384,2020-03-17 06:02:00,1,1291.0,918.0,0.711,6.102,266,105,69,36,161,85,76,10,0.0,0.0
1003,385,2020-03-17 06:05:00,1,1466.0,1153.0,0.786,7.053,46,6,3,3,40,19,21,1,0.0,0.0
1003,386,2020-03-17 06:08:00,1,1606.0,1249.0,0.778,7.712,135,17,5,12,118,55,63,0,0.0,0.0
1003,387,2020-03-17 06:11:00,1,1926.0,1457.0,0.756,9.203,165,60,28,32,105,51,54,9,0.0,0.0
1003,388,2020-03-17 06:14:00,1,2075.0,1631.0,0.786,9.98,170,78,58,20,92,45,47,8,0.0,0.0
1003,389,2020-03-17 06:17:00,1,2296.0,1684.0,0.734,10.912,74,14,4,10,60,16,44,0,0.0,0.0
1003,390,2020-03-17 06:20:00,1,2247.0,1692.0,0.753,10.729,302,133,100,33,169,105,64,17,0.0,0.0
1003,391,2020-03-17 06:23:00,1,2345.0,1733.0,0.739,11.159,258,134,94,40,124,79,45,12,0.0,0.0
1003,392,2020-03-17 06:26:00,1,2285.0,1692.0,0.74,10.876,357,150,101,49,207,143,64,19,0.0,0.0
1003,393,2020-03-17 06:29:00,1,2188.0,1661.0,0.759,10.46,163,47,29,18,116,71,45,3,0.0,0.0
1003,394,2020-03-17 06:32:00,1,2174.0,1639.0,0.754,10.381,87,18,6,12,69,29,40,1,0.0,0.0
1003,395,2020-03-17 06:35:00,1,2044.0,1585.0,0.776,9.807,172,0,0,0,172,81,91,0,0.0,0.0
1003,396,2020-03-17 06:38:00,1,2025.0,1543.0,0.762,9.688,111,15,4,11,96,29,67,0,0.0,0.0
1003,397,2020-03-17 06:41:00,1,1914.0,1450.0,0.758,9.145,61,0,0,0,61,0,61,0,0.0,0.0
1003,398,2020-03-17 06:44:00,1,1738.0,1304.0,0.75,8.293,78,0,0,0,78,0,78,0,0.0,0.0
1003,399,2020-03-17 06:47:00,1,1677.0,1186.0,0.707,7.923,53,0,0,0,53,0,53,0,0.0,0.0
1003,400,2020-03-17 06:50:00,1,1501.0,1088.0,0.724,7.119,65,0,0,0,65,0,65,0,0.0,0.0
1003,401,2020-03-17 06:53:00,1,1533.0,1058.0,0.69,7.211,57,0,0,0,57,0,57,0,0.0,0.0
1003,402,2020-03-17 06:56:00,1,1333.0,996.0,0.747,6.356,68,1,1,0,67,2,65,0,0.0,0.0
1003,403,2020-03-17 06:59:00,1,1205.0,892.0,0.741,5.734,67,0,0,0,67,0,67,0,0.0,0.0
1003,404,2020-03-17 07:02:00,1,1019.0,820.0,0.805,4.922,75,1,0,1,74,0,74,0,0.0,0.0
1003,405,2020-03-17 07:05:00,1,1023.0,795.0,0.777,4.912,99,29,2,27,70,0,70,0,0.0,0.0
1003,406,2020-03-17 07:08:00,1,1034.0,790.0,0.764,4.949,75,4,3,1,71,0,71,0,0.0,0.0
1003,407,2020-03-17 07:11:00,1,1035.0,780.0,0.754,4.939,101,33,21,12,68,22,46,0,0.0,0.0
1003,408,2020-03-17 07:14:00,1,1039.0,849.0,0.817,5.032,0,0,0,0,0,0,0,0,0.0,0.0
1003,409,2020-03-17 07:17:00,1,1037.0,814.0,0.785,4.987,0,0,0,0,0,0,0,0,0.0,0.0
1003,410,2020-03-17 07:20:00,1,1050.0,777.0,0.741,4.997,1,1,0,1,0,0,0,0,0.0,0.0
1003,411,2020-03-17 07:23:00,1,933.0,743.0,0.796,4.498,0,0,0,0,0,0,0,0,0.0,0.0
1003,412,2020-03-17 07:26:00,1,961.0,755.0,0.786,4.621,10,10,0,10,0,0,0,0,0.0,0.0
1003,413,2020-03-17 07:29:00,1,874.0,685.0,0.784,4.202,32,9,3,6,23,10,13,0,0.0,0.0
1003,414,2020-03-17 07:32:00,1,852.0,714.0,0.837,4.148,0,0,0,0,0,0,0,0,0.0,0.0
1003,415,2020-03-17 07:35:00,1,950.0,743.0,0.783,4.564,6,5,0,5,1,1,0,0,0.0,0.0
1003,416,2020-03-17 07:38:00,1,942.0,746.0,0.792,4.539,4,3,1,2,1,1,0,0,0.0,0.0
1003,417,2020-03-17 07:41:00,1,1044.0,746.0,0.715,4.939,12,9,3,6,3,2,1,0,0.0,0.0
1003,418,2020-03-17 07:44:00,1,955.0,745.0,0.779,4.588,7,4,1,3,3,2,1,0,0.0,0.0
1003,419,2020-03-17 07:47:00,1,949.0,728.0,0.767,4.545,9,9,0,9,0,0,0,0,0.0,0.0
1003,420,2020-03-17 07:50:00,1,1067.0,774.0,0.725,5.062,9,9,2,7,0,0,0,0,0.0,0.0
1003,421,2020-03-17 07:53:00,1,865.0,663.0,0.766,4.142,4,2,1,1,2,2,0,0,0.0,0.0
1003,422,2020-03-17 07:56:00,1,918.0,706.5,0.769,4.398,0,0,0,0,0,0,0,0,0.0,0.0
1003,423,2020-03-17 07:59:00,1,971.0,750.0,0.772,4.654,3,0,0,0,3,0,3,0,0.0,0.0
1003,424,2020-03-17 08:02:00,1,1002.0,848.0,0.847,4.885,2,0,0,0,2,2,0,0,0.0,0.0
1003,425,2020-03-17 08:05:00,1,1312.0,995.0,0.758,6.27,2,0,0,0,2,0,2,0,0.0,0.0
1003,426,2020-03-17 08:08:00,1,1414.0,1043.0,0.737,6.726,3,0,0,0,3,2,1,0,0.0,0.0
1003,427,2020-03-17 08:11:00,1,1492.0,1039.0,0.696,7.027,1,0,0,0,1,0,1,0,0.0,0.0
1003,428,2020-03-17 08:14:00,1,1345.0,999.0,0.742,6.407,5,0,0,0,5,0,5,0,0.0,0.0
1003,429,2020-03-17 08:17:00,1,1508.0,1043.0,0.692,7.097,5,0,0,0,5,0,5,0,0.0,0.0
1003,430,2020-03-17 08:20:00,1,1496.0,1060.0,0.709,7.067,16,5,1,4,11,2,9,0,0.0,0.0
1003,431,2020-03-17 08:23:00,1,1521.0,1071.0,0.704,7.18,53,22,10,12,31,18,13,0,0.0,0.0
1003,432,2020-03-17 08:26:00,1,1568.0,1182.0,0.754,7.488,143,17,6,11,126,83,43,2,0.0,0.0
1003,433,2020-03-17 08:29:00,1,1966.0,1463.0,0.744,9.366,308,140,89,51,168,106,62,16,0.0,0.0
1003,434,2020-03-17 08:32:00,1,1895.0,1495.0,0.789,9.123,167,74,53,21,93,53,40,10,0.0,0.0
1003,435,2020-03-17 08:35:00,1,1989.0,1491.0,0.75,9.487,106,39,22,17,67,30,37,0,0.0,0.0
1003,436,2020-03-17 08:38:00,1,1884.0,1492.0,0.792,9.075,334,185,133,52,149,98,51,21,0.0,0.0
1003,437,2020-03-17 08:41:00,1,2111.0,1547.0,0.733,10.031,420,219,165,54,201,123,78,0,0.0,0.0
1003,438,2020-03-17 08:44:00,1,2007.0,1507.0,0.751,9.576,681,409,332,77,272,200,72,2,0.0,0.0
1003,439,2020-03-17 08:47:00,1,1918.0,1494.0,0.779,9.21,257,129,79,50,128,66,62,5,0.0,0.0
1003,440,2020-03-17 08:50:00,1,1933.0,1441.0,0.746,9.211,109,21,1,20,88,39,49,0,0.0,0.0
1003,441,2020-03-17 08:53:00,1,1900.0,1468.0,0.772,9.112,419,198,147,51,221,155,66,2,0.0,0.0
1003,442,2020-03-17 08:56:00,1,1934.0,1491.0,0.771,9.269,633,223,161,62,410,309,101,2,0.0,0.0
1003,443,2020-03-17 08:59:00,1,1895.0,1432.0,0.756,9.051,854,381,290,91,473,356,117,6,0.0,0.0
1003,444,2020-03-17 09:02:00,1,1882.0,1397.0,0.742,8.961,493,141,92,49,352,267,85,18,0.0,0.0
1003,445,2020-03-17 09:05:00,1,1907.0,1393.0,0.731,9.054,224,85,45,40,139,54,85,0,0.0,0.0
1003,446,2020-03-17 09:08:00,1,1933.0,1384.0,0.716,9.148,199,94,54,40,105,53,52,2,0.0,0.0
1003,447,2020-03-17 09:11:00,1,1957.0,1386.0,0.708,9.248,45,0,0,0,45,0,45,0,0.0,0.0
1003,448,2020-03-17 09:14:00,1,1662.0,1265.0,0.761,7.951,42,0,0,0,42,0,42,0,0.0,0.0
1003,449,2020-03-17 09:17:00,1,1587.0,1138.0,0.717,7.512,46,3,1,2,43,0,43,0,0.0,0.0
1003,450,2020-03-17 09:20:00,1,1503.0,1083.0,0.721,7.123,46,0,0,0,46,0,46,0,0.0,0.0
1003,451,2020-03-17 09:23:00,1,1429.0,1022.0,0.715,6.764,62,0,0,0,62,0,62,0,0.0,0.0
1003,452,2020-03-17 09:26:00,1,1315.0,950.0,0.722,6.234,74,2,1,1,72,2,70,0,0.0,0.0
1003,453,2020-03-17 09:29:00,1,1316.0,926.0,0.703,6.211,79,0,0,0,79,0,79,0,0.0,0.0
1003,454,2020-03-17 09:32:00,1,1222.0,907.0,0.742,5.82,266,96,71,25,170,106,64,52,0.24,0.0
1003,455,2020-03-17 09:35:00,1,851.0,721.0,0.848,4.15,280,170,103,67,110,73,37,23,0.2,0.0
1003,456,2020-03-17 09:38:00,1,1620.0,1303.0,0.804,7.827,236,146,99,47,90,63,27,13,0.0,0.0
1003,457,2020-03-17 09:41:00,1,1901.0,1498.0,0.788,9.147,228,156,110,46,72,51,21,10,0.0,0.0
1003,458,2020-03-17 09:44:00,1,1881.0,1402.0,0.746,8.964,31,28,13,15,3,2,1,6,0.0,0.0
1003,459,2020-03-17 09:47:00,1,1670.0,1226.0,0.734,7.938,14,14,0,14,0,0,0,0,0.0,0.0
1003,460,2020-03-17 09:50:00,1,1473.0,1140.0,0.774,7.067,29,29,10,19,0,0,0,0,0.0,0.0
1003,461,2020-03-17 09:53:00,1,1401.0,1021.0,0.729,6.65,11,9,4,5,2,0,2,0,0.0,0.0
1003,462,2020-03-17 09:56:00,1,1331.0,930.0,0.699,6.273,51,36,15,21,15,6,9,2,0.0,0.0
1003,463,2020-03-17 09:59:00,1,1245.0,903.0,0.725,5.905,23,14,8,6,9,6,3,0,0.0,0.0
1003,464,2020-03-17 10:02:00,1,1346.0,962.0,0.715,6.37,12,5,1,4,7,1,6,0,0.0,0.0
1003,465,2020-03-17 10:05:00,1,1023.0,850.0,0.831,4.973,4,3,0,3,1,0,1,0,0.0,0.0
1003,466,2020-03-17 10:08:00,1,1046.0,788.0,0.753,4.995,25,15,4,11,10,3,7,1,0.0,0.0
1003,467,2020-03-17 10:11:00,1,1019.0,808.0,0.793,4.91,26,25,0,25,1,1,0,0,0.0,0.0
1003,468,2020-03-17 10:14:00,1,1310.0,957.0,0.731,6.22,40,40,8,32,0,0,0,0,0.0,0.0
1003,469,2020-03-17 10:17:00,1,1281.0,982.0,0.766,6.134,1,1,0,1,0,0,0,0,0.0,0.0
1003,470,2020-03-17 10:20:00,1,1227.0,955.0,0.779,5.891,2,0,0,0,2,1,1,0,0.0,0.0
1003,471,2020-03-17 10:23:00,1,1227.0,914.0,0.746,5.845,8,0,0,0,8,0,8,0,0.0,0.0
1003,472,2020-03-17 10:26:00,1,1131.0,892.0,0.788,5.444,0,0,0,0,0,0,0,0,0.0,0.0
1003,473,2020-03-17 10:29:00,1,1226.0,914.0,0.746,5.842,0,0,0,0,0,0,0,0,0.0,0.0
1003,474,2020-03-17 10:32:00,1,1300.0,991.0,0.763,6.22,1,0,0,0,1,0,1,0,0.0,0.0
1003,475,2020-03-17 10:35:00,1,1309.0,1019.0,0.778,6.285,4,0,0,0,4,0,4,0,0.0,0.0
1003,476,2020-03-17 10:38:00,1,1316.0,989.0,0.752,6.281,1,1,1,0,0,0,0,0,0.0,0.0
1003,477,2020-03-17 10:41:00,1,1226.0,928.0,0.757,5.858,4,0,0,0,4,0,4,0,0.0,0.0
1003,478,2020-03-17 10:44:00,1,1119.0,895.0,0.8,5.399,8,0,0,0,8,0,8,0,0.0,0.0
1003,479,2020-03-17 10:47:00,1,1291.0,956.0,0.74,6.143,3,0,0,0,3,0,3,0,0.0,0.0
1003,480,2020-03-17 10:50:00,1,1420.0,1052.0,0.741,6.761,3,0,0,0,3,0,3,0,0.0,0.0
1003,481,2020-03-17 10:53:00,1,1329.0,976.0,0.735,6.316,68,48,15,33,20,1,19,5,0.0,0.0
1003,482,2020-03-17 10:56:00,1,1496.5,1100.5,0.7355,7.114,35,27,11,16,8,4,4,3,0.0,0.0
1003,483,2020-03-17 10:59:00,1,1664.0,1225.0,0.736,7.912,322,221,181,40,101,66,35,28,0.0,0.0
1003,484,2020-03-17 11:02:00,1,2063.0,1559.0,0.755,9.855,349,212,155,57,137,96,41,34,0.0,0.0
1003,485,2020-03-17 11:05:00,1,2105.0,1577.0,0.749,10.039,552,262,197,65,290,226,64,9,0.0,0.0
1003,486,2020-03-17 11:08:00,1,2100.0,1533.0,0.73,9.972,85,46,22,24,39,14,25,30,0.0,0.0
1003,487,2020-03-17 11:11:00,1,2076.0,1495.0,0.72,9.835,67,44,15,29,23,1,22,1,0.01,0.0
1003,488,2020-03-17 11:14:00,1,1887.0,1422.0,0.754,9.011,4,4,4,0,0,0,0,0,0.0,0.0
1003,489,2020-03-17 11:17:00,1,1716.0,1259.0,0.733,8.157,1,1,1,0,0,0,0,0,0.0,0.0
1003,490,2020-03-17 11:20:00,1,1490.0,1119.0,0.751,7.109,1,1,0,1,0,0,0,0,0.0,0.0
1003,491,2020-03-17 11:23:00,1,1298.0,934.0,0.72,6.147,0,0,0,0,0,0,0,0,0.0,0.0
1003,492,2020-03-17 11:26:00,1,1134.0,847.0,0.747,5.406,30,21,8,13,9,1,8,0,0.0,0.0
1003,493,2020-03-17 11:29:00,1,1326.0,944.0,0.712,6.27,5,4,0,4,1,0,1,0,0.0,0.0
1003,494,2020-03-17 11:32:00,1,1311.0,938.0,0.716,6.204,2,2,0,2,0,0,0,0,0.0,0.0
1003,495,2020-03-17 11:35:00,1,1128.0,890.0,0.789,5.428,3,0,0,0,3,0,3,0,0.0,0.0
1003,496,2020-03-17 11:38:00,1,1035.0,824.0,0.796,4.99,30,29,11,18,1,0,1,0,0.0,0.0
1003,497,2020-03-17 11:41:00,1,1017.0,785.0,0.772,4.877,15,15,4,11,0,0,0,0,0.0,0.0
1003,498,2020-03-17 11:44:00,1,1038.0,763.0,0.735,4.935,4,4,1,3,0,0,0,0,0.0,0.0
1003,499,2020-03-17 11:47:00,1,1038.0,790.0,0.761,4.964,13,13,1,12,0,0,0,0,0.0,0.0
1003,500,2020-03-17 11:50:00,1,1050.0,871.0,0.83,5.1,6,6,2,4,0,0,0,0,0.0,0.0
1003,501,2020-03-17 11:53:00,1,1047.0,850.0,0.811,5.066,3,3,0,3,0,0,0,0,0.0,0.0
1003,502,2020-03-17 11:56:00,1,1057.0,827.0,0.782,5.078,0,0,0,0,0,0,0,0,0.0,0.0
1003,503,2020-03-17 11:59:00,1,1017.0,774.0,0.761,4.865,0,0,0,0,0,0,0,0,0.0,0.0
1003,504,2020-03-17 12:02:00,1,1070.0,783.0,0.732,5.084,4,4,0,4,0,0,0,0,0.0,0.0
1003,505,2020-03-17 12:05:00,1,1040.0,763.0,0.733,4.945,11,11,4,7,0,0,0,0,0.0,0.0
1003,506,2020-03-17 12:08:00,1,1009.0,842.0,0.834,4.909,36,33,17,16,3,2,1,0,0.0,0.0
1003,507,2020-03-17 12:11:00,1,1236.0,883.0,0.714,5.849,4,2,0,2,2,1,1,0,0.0,0.0
1003,508,2020-03-17 12:14:00,1,1207.0,876.0,0.726,5.724,130,77,59,18,53,36,17,5,0.0,0.0
1003,509,2020-03-17 12:17:00,1,1293.0,932.0,0.721,6.126,0,0,0,0,0,0,0,0,0.01,0.0
1003,510,2020-03-17 12:20:00,1,1037.0,846.0,0.815,5.023,0,0,0,0,0,0,0,0,0.0,0.0
1003,511,2020-03-17 12:23:00,1,1054.0,815.0,0.773,5.055,0,0,0,0,0,0,0,0,0.0,0.0
1003,512,2020-03-17 12:26:00,1,1038.0,856.0,0.825,5.036,2,2,1,1,0,0,0,0,0.0,0.0
1003,513,2020-03-17 12:29:00,1,1037.0,852.0,0.821,5.029,3,3,0,3,0,0,0,0,0.0,0.0
1003,514,2020-03-17 12:32:00,1,1028.0,836.0,0.813,4.976,4,4,0,4,0,0,0,0,0.0,0.0
1003,515,2020-03-17 12:35:00,1,1068.0,802.0,0.751,5.097,8,8,0,8,0,0,0,0,0.0,0.0
1003,516,2020-03-17 12:38:00,1,1059.0,743.0,0.702,4.994,5,5,0,5,0,0,0,0,0.0,0.0
1003,517,2020-03-17 12:41:00,1,1053.0,719.0,0.683,4.944,13,12,7,5,1,0,1,0,0.0,0.0
1003,518,2020-03-17 12:44:00,1,1341.0,924.0,0.689,6.309,1,1,0,1,0,0,0,0,0.0,0.0
1003,519,2020-03-17 12:47:00,1,1214.0,915.0,0.753,5.798,0,0,0,0,0,0,0,0,0.0,0.0
1003,520,2020-03-17 12:50:00,1,1019.0,829.0,0.813,4.933,1,1,1,0,0,0,0,0,0.0,0.0
1003,521,2020-03-17 12:53:00,1,1048.0,771.0,0.736,4.984,8,8,0,8,0,0,0,0,0.0,0.0
1003,522,2020-03-17 12:56:00,1,958.0,719.0,0.751,4.57,24,16,8,8,8,4,4,2,0.0,0.0
1003,523,2020-03-17 12:59:00,1,1049.0,816.0,0.778,5.036,21,0,0,0,21,1,20,0,0.0,0.0
1003,524,2020-03-17 13:02:00,1,1038.0,842.0,0.811,5.02,1,0,0,0,1,0,1,0,0.0,0.0
1003,525,2020-03-17 13:05:00,1,1023.0,829.0,0.811,4.95,0,0,0,0,0,0,0,0,0.0,0.0
1003,526,2020-03-17 13:08:00,1,1108.0,850.0,0.768,5.305,0,0,0,0,0,0,0,0,0.0,0.0
1003,527,2020-03-17 13:11:00,1,1497.0,1081.0,0.722,7.097,2,0,0,0,2,0,2,0,0.0,0.0
1003,528,2020-03-17 13:14:00,1,1458.0,1094.0,0.75,6.954,0,0,0,0,0,0,0,0,0.0,0.0
1003,529,2020-03-17 13:17:00,1,1471.0,1079.0,0.733,6.99,16,0,0,0,16,0,16,0,0.0,0.0
1003,530,2020-03-17 13:20:00,1,1503.0,1046.0,0.696,7.079,14,4,3,1,10,0,10,0,0.0,0.0
1003,531,2020-03-17 13:23:00,1,1298.0,992.0,0.764,6.211,5,0,0,0,5,0,5,0,0.0,0.0
1003,532,2020-03-17 13:26:00,1,1316.0,937.0,0.712,6.224,0,0,0,0,0,0,0,0,0.0,0.0
1003,533,2020-03-17 13:29:00,1,1207.0,887.0,0.735,5.738,7,4,2,2,3,0,3,0,0.0,0.0
1003,534,2020-03-17 13:32:00,1,1293.0,889.0,0.688,6.078,97,63,26,37,34,11,23,31,0.0,0.0
1003,535,2020-03-17 13:35:00,1,1710.0,1215.0,0.71,8.085,92,77,24,53,15,2,13,20,0.0,0.0
1003,536,2020-03-17 13:38:00,1,1703.0,1340.0,0.787,8.193,123,90,66,24,33,21,12,6,0.0,0.0
1003,537,2020-03-17 13:41:00,1,1700.0,1331.0,0.783,8.172,45,21,6,15,24,4,20,18,0.01,0.0
1003,538,2020-03-17 13:44:00,1,1993.0,1407.0,0.706,9.41,112,67,44,23,45,25,20,35,0.0,0.0
1003,539,2020-03-17 13:47:00,1,1932.0,1550.0,0.802,9.327,354,240,187,53,114,82,32,32,0.0,0.0
1003,540,2020-03-17 13:50:00,1,2098.0,1551.0,0.739,9.983,311,197,145,52,114,89,25,42,0.0,0.0
1003,541,2020-03-17 13:53:00,1,1937.0,1347.0,0.695,9.125,435,273,215,58,162,119,43,31,0.0,0.0
1003,542,2020-03-17 13:56:00,1,1987.5,1438.0,0.7225,9.4245,182,132,91,41,50,29,21,17,0.0,0.0
1003,543,2020-03-17 13:59:00,1,2038.0,1529.0,0.75,9.724,232,157,106,51,75,46,29,8,0.0,0.0
1003,544,2020-03-17 14:02:00,1,1917.0,1384.0,0.722,9.087,2,0,0,0,2,1,1,0,0.0,0.0
1003,545,2020-03-17 14:05:00,1,1951.0,1382.0,0.708,9.218,33,20,8,12,13,3,10,4,0.0,0.0
1003,546,2020-03-17 14:08:00,1,1936.0,1458.0,0.753,9.242,345,212,156,56,133,85,48,16,0.0,0.0
1003,547,2020-03-17 14:11:00,1,1665.0,1198.0,0.719,7.885,8,8,0,8,0,0,0,1,0.0,0.0
1003,548,2020-03-17 14:14:00,1,1672.0,1250.0,0.748,7.974,12,12,1,11,0,0,0,0,0.0,0.0
1003,549,2020-03-17 14:17:00,1,1487.0,1109.0,0.746,7.088,23,23,1,22,0,0,0,0,0.0,0.0
1003,550,2020-03-17 14:20:00,1,1413.0,983.0,0.696,6.656,25,20,11,9,5,2,3,0,0.0,0.0
1003,551,2020-03-17 14:23:00,1,1307.0,938.0,0.718,6.189,2,2,2,0,0,0,0,0,0.0,0.0
1003,552,2020-03-17 14:26:00,1,1219.0,884.0,0.725,5.782,0,0,0,0,0,0,0,0,0.0,0.0
1003,553,2020-03-17 14:29:00,1,1031.0,838.0,0.812,4.99,0,0,0,0,0,0,0,0,0.0,0.0
1003,554,2020-03-17 14:32:00,1,1040.0,795.0,0.765,4.979,1,1,1,0,0,0,0,0,0.0,0.0
1003,555,2020-03-17 14:35:00,1,1047.0,763.0,0.729,4.97,0,0,0,0,0,0,0,0,0.0,0.0
1003,556,2020-03-17 14:38:00,1,1048.0,740.0,0.706,4.947,0,0,0,0,0,0,0,0,0.0,0.0
1003,557,2020-03-17 14:41:00,1,1051.0,828.0,0.788,5.06,158,127,94,33,31,20,11,16,0.0,0.0
1003,558,2020-03-17 14:44:00,1,1300.0,950.0,0.731,6.174,147,87,56,31,60,27,33,2,0.0,0.0
1003,559,2020-03-17 14:47:00,1,1342.0,976.0,0.727,6.37,0,0,0,0,0,0,0,0,0.0,0.0
1003,560,2020-03-17 14:50:00,1,1033.0,884.0,0.855,5.05,0,0,0,0,0,0,0,0,0.0,0.0
1003,561,2020-03-17 14:53:00,1,1042.0,808.0,0.775,5.001,16,16,1,15,0,0,0,0,0.0,0.0
1003,562,2020-03-17 14:56:00,1,1039.0,779.0,0.75,4.955,6,6,0,6,0,0,0,0,0.0,0.0
1003,563,2020-03-17 14:59:00,1,1045.0,764.0,0.732,4.962,4,1,0,1,3,1,2,0,0.01,0.0
1003,564,2020-03-17 15:02:00,1,1039.0,770.0,0.742,4.945,5,0,0,0,5,0,5,0,0.0,0.0
1003,565,2020-03-17 15:05:00,1,1040.0,796.0,0.766,4.98,2,0,0,0,2,0,2,0,0.0,0.0
1003,566,2020-03-17 15:08:00,1,1029.0,815.0,0.792,4.958,0,0,0,0,0,0,0,0,0.0,0.0
1003,567,2020-03-17 15:11:00,1,1234.0,889.0,0.72,5.844,0,0,0,0,0,0,0,0,0.0,0.0
1003,568,2020-03-17 15:14:00,1,1135.0,874.0,0.77,5.438,1,0,0,0,1,0,1,0,0.0,0.0
1003,569,2020-03-17 15:17:00,1,1007.0,833.0,0.828,4.888,10,9,2,7,1,0,1,0,0.0,0.0
1003,570,2020-03-17 15:20:00,1,1138.0,912.0,0.801,5.492,15,15,3,12,0,0,0,0,0.0,0.0
1003,571,2020-03-17 15:23:00,1,1122.0,888.0,0.791,5.405,47,44,15,29,3,2,1,0,0.0,0.0
1003,572,2020-03-17 15:26:00,1,1109.0,857.0,0.773,5.318,4,4,1,3,0,0,0,0,0.0,0.0
1003,573,2020-03-17 15:29:00,1,1105.0,855.0,0.774,5.299,0,0,0,0,0,0,0,0,0.0,0.0
1003,574,2020-03-17 15:32:00,1,1118.0,870.0,0.778,5.37,3,2,2,0,1,0,1,0,0.0,0.0
1003,575,2020-03-17 15:35:00,1,1303.0,917.0,0.703,6.151,2,2,0,2,0,0,0,0,0.0,0.0
1003,576,2020-03-17 15:38:00,1,1312.0,958.0,0.73,6.228,12,12,0,12,0,0,0,0,0.01,0.0
1003,577,2020-03-17 15:41:00,1,1311.0,951.0,0.725,6.219,9,9,2,7,0,0,0,0,0.0,0.0
1003,578,2020-03-17 15:44:00,1,1331.0,937.0,0.704,6.28,6,6,1,5,0,0,0,0,0.0,0.0
1003,579,2020-03-17 15:47:00,1,1214.0,908.0,0.748,5.79,19,18,0,18,1,0,1,0,0.0,0.0
1003,580,2020-03-17 15:50:00,1,1213.0,908.0,0.748,5.786,32,14,7,7,18,2,16,1,0.0,0.0
1003,581,2020-03-17 15:53:00,1,1332.0,933.0,0.7,6.282,7,0,0,0,7,0,7,0,0.0,0.0
1003,582,2020-03-17 15:56:00,1,1155.0,897.0,0.777,5.544,35,24,11,13,11,3,8,4,0.0,0.0
1003,583,2020-03-17 15:59:00,1,1498.0,1084.0,0.724,7.102,160,117,85,32,43,30,13,20,0.0,0.0
1003,584,2020-03-17 16:02:00,1,1464.0,1147.0,0.784,7.038,114,57,20,37,57,16,41,4,0.0,0.0
1003,585,2020-03-17 16:05:00,1,1650.0,1254.0,0.76,7.887,47,26,12,14,21,7,14,4,0.0,0.0
1003,586,2020-03-17 16:08:00,1,1567.0,1203.0,0.767,7.507,8,4,0,4,4,1,3,0,0.0,0.0
1003,587,2020-03-17 16:11:00,1,1485.0,1129.0,0.76,7.1,15,7,4,3,8,5,3,0,0.0,0.0
1003,588,2020-03-17 16:14:00,1,1508.0,1077.0,0.714,7.134,47,37,11,26,10,6,4,0,0.0,0.0
1003,589,2020-03-17 16:17:00,1,1583.0,1191.0,0.753,7.554,89,61,24,37,28,8,20,14,0.0,0.0
1003,590,2020-03-17 16:20:00,1,1940.0,1386.0,0.715,9.177,259,167,126,41,92,59,33,23,0.0,0.0
1003,591,2020-03-17 16:23:00,1,1910.0,1450.0,0.759,9.132,42,11,3,8,31,8,23,1,0.0,0.0
1003,592,2020-03-17 16:26:00,1,1896.0,1408.0,0.743,9.03,252,169,140,29,83,63,20,19,0.0,0.0
1003,593,2020-03-17 16:29:00,1,1639.0,1295.0,0.79,7.892,0,0,0,0,0,0,0,0,0.0,0.0
1003,594,2020-03-17 16:32:00,1,1561.0,1141.0,0.731,7.414,0,0,0,0,0,0,0,0,0.0,0.0
1003,595,2020-03-17 16:35:00,1,1462.0,1040.0,0.712,6.912,0,0,0,0,0,0,0,0,0.0,0.0
1003,596,2020-03-17 16:38:00,1,1308.0,1004.0,0.767,6.266,6,0,0,0,6,1,5,0,0.0,0.0
1003,597,2020-03-17 16:41:00,1,1323.0,944.0,0.713,6.26,3,2,1,1,1,0,1,0,0.0,0.0
1003,598,2020-03-17 16:44:00,1,1144.0,869.0,0.76,5.47,0,0,0,0,0,0,0,0,0.0,0.0
1003,599,2020-03-17 16:47:00,1,1061.0,789.0,0.744,5.053,3,3,0,3,0,0,0,0,0.0,0.0
1003,600,2020-03-17 16:50:00,1,1049.0,818.0,0.78,5.039,18,8,5,3,10,5,5,0,0.0,0.0
1003,601,2020-03-17 16:53:00,1,1037.0,836.0,0.807,5.011,12,0,0,0,12,0,12,0,0.0,0.0
1003,602,2020-03-17 16:56:00,1,1016.5,845.5,0.8325,4.9415,19,0,0,0,19,0,19,0,0.0,0.0
1003,603,2020-03-17 16:59:00,1,996.0,855.0,0.858,4.872,13,0,0,0,13,0,13,0,0.0,0.0
1003,604,2020-03-17 17:02:00,1,1108.0,882.0,0.796,5.341,17,0,0,0,17,0,17,0,0.0,0.0
1003,605,2020-03-17 17:05:00,1,1113.0,885.0,0.795,5.363,14,0,0,0,14,0,14,0,0.0,0.0
1003,606,2020-03-17 17:08:00,1,1124.0,894.0,0.795,5.418,7,0,0,0,7,0,7,0,0.01,0.0
1003,607,2020-03-17 17:11:00,1,1130.0,905.0,0.8,5.455,26,11,6,5,15,4,11,0,0.0,0.0
1003,608,2020-03-17 17:14:00,1,1312.0,999.0,0.761,6.275,0,0,0,0,0,0,0,0,0.0,0.0
1003,609,2020-03-17 17:17:00,1,1308.0,969.0,0.74,6.226,0,0,0,0,0,0,0,0,0.0,0.0
1003,610,2020-03-17 17:20:00,1,1272.0,921.0,0.724,6.033,26,7,5,2,19,7,12,1,0.0,0.0
1003,611,2020-03-17 17:23:00,1,1221.0,934.0,0.765,5.843,5,1,1,0,4,0,4,0,0.0,0.0
1003,612,2020-03-17 17:26:00,1,1129.0,891.0,0.789,5.435,5,5,0,5,0,0,0,0,0.0,0.0
1003,613,2020-03-17 17:29:00,1,1023.0,878.0,0.858,5.004,0,0,0,0,0,0,0,0,0.0,0.0
1003,614,2020-03-17 17:32:00,1,1020.0,862.0,0.845,4.974,7,7,0,7,0,0,0,0,0.0,0.0
1003,615,2020-03-17 17:35:00,1,1287.0,969.0,0.753,6.142,162,109,55,54,53,25,28,14,0.0,0.0
1003,616,2020-03-17 17:38:00,1,1666.0,1298.0,0.779,8.002,154,90,67,23,64,34,30,25,0.0,0.0
1003,617,2020-03-17 17:41:00,1,1910.0,1496.0,0.783,9.182,203,103,65,38,100,55,45,18,0.0,0.0
1003,618,2020-03-17 17:44:00,1,2130.0,1678.0,0.788,10.251,499,353,294,59,146,111,35,55,0.0,0.0
1003,619,2020-03-17 17:47:00,1,2368.0,1808.0,0.764,11.334,547,342,275,67,205,156,49,62,0.0,0.0
1003,620,2020-03-17 17:50:00,1,2080.0,1565.0,0.753,9.928,591,364,290,74,227,171,56,60,0.0,0.0
1003,621,2020-03-17 17:53:00,1,2094.0,1678.0,0.801,10.109,292,130,85,45,162,100,62,54,0.0,0.0
1003,622,2020-03-17 17:56:00,1,2392.0,1690.0,0.707,11.296,125,26,8,18,99,42,57,15,0.0,0.0
1003,623,2020-03-17 17:59:00,1,2210.0,1662.0,0.752,10.547,125,64,25,39,61,28,33,0,0.0,0.0
1003,624,2020-03-17 18:02:00,0,1903.0,1445.0,0.76,9.097,32,17,1,16,15,0,15,0,0.0,0.0
1003,625,2020-03-17 18:05:00,0,1647.0,1287.0,0.781,7.915,23,9,0,9,14,0,14,0,0.0,0.0
1003,626,2020-03-17 18:08:00,0,1587.0,1177.0,0.742,7.557,53,5,1,4,48,8,40,0,0.0,0.0
1003,627,2020-03-17 18:11:00,0,1498.0,1115.0,0.744,7.136,126,0,0,0,126,86,40,0,0.0,0.0
1003,628,2020-03-17 18:14:00,0,1311.0,1022.0,0.78,6.299,67,4,1,3,63,31,32,0,0.0,0.0
1003,629,2020-03-17 18:17:00,0,1309.0,944.0,0.721,6.204,46,9,0,9,37,2,35,0,0.01,0.0
1003,630,2020-03-17 18:20:00,0,1285.0,940.0,0.731,6.105,43,4,0,4,39,0,39,0,0.0,0.0
1003,631,2020-03-17 18:23:00,0,1302.0,1024.0,0.786,6.263,366,144,92,52,222,141,81,27,0.0,0.0
1003,632,2020-03-17 18:26:00,0,1642.0,1279.0,0.779,7.885,187,134,85,49,53,24,29,55,0.0,0.0
1003,633,2020-03-17 18:29:00,0,2118.0,1586.0,0.749,10.1,341,193,119,74,148,87,61,93,0.0,0.0
1003,634,2020-03-17 18:32:00,0,2346.0,1806.0,0.77,11.242,315,194,129,65,121,70,51,80,0.01,0.0
1003,635,2020-03-17 18:35:00,0,2717.0,2027.0,0.746,12.949,352,177,113,64,175,100,75,84,0.0,0.0
1003,636,2020-03-17 18:38:00,0,2629.0,2064.0,0.785,12.645,258,120,58,62,138,72,66,71,0.0,0.0
1003,637,2020-03-17 18:41:00,0,2463.0,1924.0,0.781,11.833,334,169,106,63,165,99,66,78,0.0,0.0
1003,638,2020-03-17 18:44:00,0,2063.0,1648.0,0.799,9.954,283,158,104,54,125,88,37,27,0.39,0.0
1003,639,2020-03-17 18:47:00,0,1971.0,1550.0,0.786,9.481,512,283,202,81,229,143,86,85,0.0,0.0
1003,640,2020-03-17 18:50:00,0,2707.0,2180.0,0.806,13.079,402,128,70,58,274,210,64,58,0.0,0.0
1003,641,2020-03-17 18:53:00,0,2711.0,2094.0,0.773,12.999,261,147,90,57,114,51,63,78,0.0,0.0
1003,642,2020-03-17 18:56:00,0,2634.0,2149.0,0.816,12.759,446,249,169,80,197,123,74,86,0.04,0.0
1003,643,2020-03-17 18:59:00,0,2646.0,2085.0,0.788,12.732,377,216,146,70,161,101,60,72,0.0,0.0
1003,644,2020-03-17 19:02:00,0,2911.0,2364.0,0.812,14.086,353,227,153,74,126,74,52,96,0.0,0.0
1003,645,2020-03-17 19:05:00,0,3091.0,2603.0,0.842,15.059,551,291,233,58,260,193,67,43,0.1,0.0
1003,646,2020-03-17 19:08:00,0,2843.0,2303.0,0.81,13.752,283,145,84,61,138,74,64,96,0.0,0.0
1003,647,2020-03-17 19:11:00,0,3084.0,2630.0,0.853,15.063,436,219,151,68,217,140,77,88,0.0,0.0
1003,648,2020-03-17 19:14:00,0,3383.0,2727.0,0.806,16.348,415,221,160,61,194,112,82,91,0.0,0.0
1003,649,2020-03-17 19:17:00,0,3221.0,2725.0,0.846,15.708,318,157,95,62,161,97,64,87,0.0,0.0
1003,650,2020-03-17 19:20:00,0,3060.0,2568.0,0.839,14.902,662,405,322,83,257,179,78,77,0.21,0.0
1003,651,2020-03-17 19:23:00,0,3173.0,2706.0,0.853,15.498,344,160,112,48,184,118,66,61,0.0,0.0
1003,652,2020-03-17 19:26:00,0,3284.0,2750.0,0.837,15.982,307,122,73,49,185,127,58,74,0.0,0.0
1003,653,2020-03-17 19:29:00,0,3376.0,2886.0,0.855,16.497,280,139,80,59,141,82,59,65,0.0,0.0
1003,654,2020-03-17 19:32:00,0,3123.0,2752.0,0.881,15.351,346,115,84,31,231,184,47,15,0.3,0.0
1003,655,2020-03-17 19:35:00,0,2617.0,2340.0,0.894,12.9,353,163,107,56,190,131,59,65,0.0,0.0
1003,656,2020-03-17 19:38:00,0,3255.0,2829.0,0.869,15.956,306,84,35,49,222,145,77,46,0.0,0.0
1003,657,2020-03-17 19:41:00,0,3327.0,2906.0,0.873,16.324,137,58,23,35,79,53,26,23,0.0,0.0
1003,658,2020-03-17 19:44:00,0,3199.0,2870.0,0.897,15.781,322,112,71,41,210,138,72,39,0.14,0.0
1003,659,2020-03-17 19:47:00,0,3412.0,3015.0,0.884,16.783,97,35,5,30,62,41,21,16,0.0,0.0
1003,660,2020-03-17 19:50:00,0,2833.0,2619.0,0.924,14.062,343,125,91,34,218,165,53,23,0.14,0.0
1003,661,2020-03-17 19:53:00,0,3278.0,2938.0,0.896,16.166,273,124,64,60,149,94,55,29,0.0,0.0
1003,662,2020-03-17 19:56:00,0,2667.0,2401.0,0.9015,13.165,301,137,90,47,164,106,58,21,0.13,0.0
1003,663,2020-03-17 19:59:00,0,2056.0,1864.0,0.907,10.164,229,87,45,42,142,84,58,2,0.0,0.0
1003,664,2020-03-17 20:02:00,0,1799.0,1572.0,0.874,8.828,353,180,116,64,173,96,77,38,0.0,0.0
1003,665,2020-03-17 20:05:00,0,3336.0,2870.0,0.86,16.323,209,57,12,45,152,82,70,34,0.0,0.0
1003,666,2020-03-17 20:08:00,0,3126.0,2813.0,0.9,15.433,356,135,90,45,221,153,68,45,0.0,0.0
1003,667,2020-03-17 20:11:00,0,3247.0,2894.0,0.891,15.996,314,87,42,45,227,159,68,52,0.0,0.0
1003,668,2020-03-17 20:14:00,0,3001.0,2774.0,0.924,14.894,267,120,71,49,147,98,49,59,0.0,0.0
1003,669,2020-03-17 20:17:00,0,3271.0,2919.0,0.892,16.121,196,89,40,49,107,67,40,38,0.0,0.0
1003,670,2020-03-17 20:20:00,0,3280.0,2848.0,0.868,16.076,313,116,57,59,197,137,60,55,0.0,0.0
1003,671,2020-03-17 20:23:00,0,3110.0,2838.0,0.913,15.394,934,579,470,109,355,282,73,40,0.0,0.0
1003,672,2020-03-17 20:26:00,0,2839.0,2605.0,0.918,14.067,874,452,360,92,422,324,98,40,0.03,0.0
1003,673,2020-03-17 20:29:00,0,3050.0,2747.0,0.901,15.06,296,94,50,44,202,145,57,50,0.08,0.0
1003,674,2020-03-17 20:32:00,0,3012.0,2711.0,0.9,14.87,250,73,19,54,177,118,59,44,0.0,0.0
1003,675,2020-03-17 20:35:00,0,3244.0,3021.0,0.931,16.127,166,34,18,16,132,87,45,36,0.0,0.0
1003,676,2020-03-17 20:38:00,0,3281.0,2899.0,0.884,16.136,88,37,16,21,51,31,20,15,0.0,0.0
1003,677,2020-03-17 20:41:00,0,2982.0,2722.0,0.913,14.764,355,215,156,59,140,95,45,66,0.0,0.0
1003,678,2020-03-17 20:44:00,0,2801.0,2554.0,0.912,13.862,291,133,81,52,158,108,50,20,0.17,0.0
1003,679,2020-03-17 20:47:00,0,3112.0,2842.0,0.913,15.409,292,102,54,48,190,130,60,55,0.0,0.0
1003,680,2020-03-17 20:50:00,0,3285.0,2900.0,0.883,16.155,265,64,33,31,201,120,81,58,0.01,0.0
1003,681,2020-03-17 20:53:00,0,3028.0,2868.0,0.947,15.104,237,85,44,41,152,97,55,55,0.13,0.0
1003,682,2020-03-17 20:56:00,0,2977.0,2752.0,0.924,14.778,308,104,58,46,204,140,64,81,0.01,0.0
1003,683,2020-03-17 20:59:00,0,2439.0,2315.0,0.949,12.173,284,133,79,54,151,96,55,26,0.0,0.0
1003,684,2020-03-17 21:02:00,0,2321.0,2063.0,0.889,11.429,286,153,110,43,133,83,50,14,0.23,0.0
1003,685,2020-03-17 21:05:00,0,2038.0,1987.0,0.975,10.228,75,50,37,13,25,16,9,4,0.0,0.0
1003,686,2020-03-17 21:08:00,0,1842.0,1704.0,0.925,9.142,2,2,1,1,0,0,0,0,0.0,0.0
1003,687,2020-03-17 21:11:00,0,1660.0,1550.0,0.934,8.257,21,6,2,4,15,2,13,0,0.0,0.0
1003,688,2020-03-17 21:14:00,0,1597.0,1517.0,0.95,7.973,18,4,0,4,14,0,14,0,0.0,0.0
1003,689,2020-03-17 21:17:00,0,1526.0,1410.0,0.924,7.573,94,60,28,32,34,15,19,4,0.0,0.0
1003,690,2020-03-17 21:20:00,0,1537.0,1342.0,0.873,7.541,569,350,267,83,219,163,56,60,0.0,0.0
1003,691,2020-03-17 21:23:00,0,2729.0,2591.0,0.949,13.622,554,340,272,68,214,158,56,113,0.0,0.0
1003,692,2020-03-17 21:26:00,0,2837.0,2713.0,0.956,14.18,249,90,46,44,159,92,67,78,0.0,0.0
1003,693,2020-03-17 21:29:00,0,2858.0,2647.0,0.926,14.191,340,158,102,56,182,125,57,96,0.0,0.0
1003,694,2020-03-17 21:32:00,0,2693.0,2580.0,0.958,13.465,276,153,96,57,123,72,51,99,0.0,0.0
1003,695,2020-03-17 21:35:00,0,2686.0,2602.0,0.969,13.464,219,144,87,57,75,42,33,108,0.0,0.0
1003,696,2020-03-17 21:38:00,0,2781.0,2616.0,0.941,13.851,275,184,115,69,91,52,39,85,0.05,0.0
1003,697,2020-03-17 21:41:00,0,3062.0,2772.0,0.906,15.132,336,218,136,82,118,72,46,102,0.0,0.0
1003,698,2020-03-17 21:44:00,0,1919.0,1887.0,0.983,9.648,193,83,52,31,110,58,52,44,0.0,0.0
1003,699,2020-03-17 21:47:00,0,1856.0,1670.0,0.9,9.161,420,257,200,57,163,119,44,37,0.0,0.04
1003,700,2020-03-17 21:50:00,0,2569.0,2505.0,0.975,12.895,466,283,228,55,183,137,46,83,0.46,0.0
1003,701,2020-03-17 21:53:00,0,2662.0,2517.0,0.946,13.276,258,173,115,58,85,46,39,81,0.0,0.0
1003,702,2020-03-17 21:56:00,0,3209.0,2870.0,0.894,15.821,280,78,36,42,202,127,75,52,0.0,0.0
1003,703,2020-03-17 21:59:00,0,3042.0,2779.0,0.913,15.062,302,166,97,69,136,78,58,93,0.0,0.02
1003,704,2020-03-17 22:02:00,0,2816.0,2659.0,0.944,14.04,218,129,76,53,89,51,38,62,0.0,0.03
1003,705,2020-03-17 22:05:00,0,2465.0,2365.0,0.959,12.332,232,124,81,43,108,67,41,7,0.0,0.01
1003,706,2020-03-17 22:08:00,0,1668.0,1549.0,0.929,8.285,93,46,16,30,47,18,29,0,0.0,0.0
1003,707,2020-03-17 22:11:00,0,1795.0,1590.0,0.886,8.834,0,0,0,0,0,0,0,0,0.0,0.0
1003,708,2020-03-17 22:14:00,0,1696.0,1534.0,0.904,8.382,8,3,2,1,5,3,2,0,0.0,0.01
1003,709,2020-03-17 22:17:00,0,1541.0,1460.0,0.947,7.686,1,1,1,0,0,0,0,0,0.0,0.0
1003,710,2020-03-17 22:20:00,0,1613.0,1415.0,0.877,7.92,8,4,2,2,4,2,2,0,0.0,0.0
1003,711,2020-03-17 22:23:00,0,1475.0,1279.0,0.867,7.226,9,6,0,6,3,0,3,0,0.0,0.0
1003,712,2020-03-17 22:26:00,0,1446.0,1213.0,0.839,7.041,14,9,0,9,5,3,2,0,0.0,0.0
1003,713,2020-03-17 22:29:00,0,1418.0,1243.0,0.876,6.964,140,79,56,23,61,39,22,13,0.0,0.0
1003,714,2020-03-17 22:32:00,0,2521.0,2419.0,0.959,12.611,335,204,149,55,131,91,40,79,0.0,0.01
1003,715,2020-03-17 22:35:00,0,2594.0,2586.0,0.997,13.084,173,114,66,48,59,31,28,26,0.0,0.05
1003,716,2020-03-17 22:38:00,0,1849.0,1762.0,0.953,9.234,2,2,0,2,0,0,0,0,0.0,0.0
1003,717,2020-03-17 22:41:00,0,2035.0,1894.0,0.931,10.115,3,0,0,0,3,2,1,0,0.0,0.0
1003,718,2020-03-17 22:44:00,0,2453.0,2281.0,0.93,12.189,177,87,71,16,90,53,37,11,0.0,0.0
1003,719,2020-03-17 22:47:00,0,2222.0,2080.0,0.936,11.058,6,1,0,1,5,0,5,0,0.0,0.0
1003,720,2020-03-17 22:50:00,0,2166.0,2045.0,0.944,10.798,0,0,0,0,0,0,0,0,0.0,0.0
1003,721,2020-03-17 22:53:00,0,1977.0,1963.0,0.993,9.961,28,11,7,4,17,7,10,2,0.0,0.0
1003,722,2020-03-17 22:56:00,0,1953.5,1986.0,1.017,9.8955,164,36,15,21,128,71,57,7,0.0,0.0
1003,723,2020-03-17 22:59:00,0,1930.0,2009.0,1.041,9.83,238,98,72,26,140,90,50,14,0.0,0.0
1003,724,2020-03-17 23:02:00,0,2181.0,2084.0,0.955,10.9,372,223,156,67,149,95,54,101,0.0,0.0
1003,725,2020-03-17 23:05:00,0,2574.0,2511.0,0.976,12.922,289,103,65,38,186,108,78,76,0.0,0.0
1003,726,2020-03-17 23:08:00,0,2582.0,2445.0,0.947,12.878,276,107,56,51,169,106,63,98,0.0,0.0
1003,727,2020-03-17 23:11:00,0,2842.0,2733.0,0.961,14.224,249,68,41,27,181,118,63,41,0.0,0.0
1003,728,2020-03-17 23:14:00,0,2563.0,2448.0,0.955,12.808,272,133,72,61,139,65,74,109,0.0,0.0
1003,729,2020-03-17 23:17:00,0,2730.0,2569.0,0.941,13.598,286,108,68,40,178,109,69,55,0.25,0.07
1003,730,2020-03-17 23:20:00,0,3033.0,2806.0,0.925,15.057,286,156,96,60,130,70,60,87,0.0,0.0
1003,731,2020-03-17 23:23:00,0,2600.0,2514.0,0.967,13.026,294,115,80,35,179,108,71,25,0.0,0.0
1003,732,2020-03-17 23:26:00,0,1665.0,1555.0,0.934,8.281,143,37,15,22,106,45,61,5,0.0,0.0
1003,733,2020-03-17 23:29:00,0,1601.0,1392.0,0.869,7.85,66,15,8,7,51,22,29,3,0.0,0.0
1003,734,2020-03-17 23:32:00,0,1601.0,1364.0,0.852,7.818,230,81,43,38,149,88,61,0,0.0,0.0
1003,735,2020-03-17 23:35:00,0,2540.0,2466.0,0.971,12.739,342,247,173,74,95,49,46,113,0.0,0.0
1003,736,2020-03-17 23:38:00,0,3215.0,2973.0,0.925,15.96,257,139,77,62,118,64,54,77,0.0,0.0
1003,737,2020-03-17 23:41:00,0,3251.0,3019.0,0.929,16.15,299,157,93,64,142,69,73,88,0.0,0.04
1003,738,2020-03-17 23:44:00,0,3474.0,3176.0,0.914,17.205,191,66,23,43,125,79,46,20,0.0,0.06
1003,739,2020-03-17 23:47:00,0,3268.0,3088.0,0.945,16.294,266,144,91,53,122,68,54,64,0.0,0.04
1003,740,2020-03-17 23:50:00,0,3266.0,2991.0,0.916,16.18,322,122,72,50,200,131,69,48,0.01,0.1
1003,741,2020-03-17 23:53:00,0,3316.0,3060.0,0.923,16.453,341,143,91,52,198,131,67,68,0.21,0.0
1003,742,2020-03-17 23:56:00,0,2300.0,2106.0,0.916,11.392,377,180,138,42,197,134,63,28,0.0,0.0
1003,743,2020-03-17 23:59:00,0,3255.0,2943.0,0.904,16.084,302,175,106,69,127,76,51,93,0.0,0.0
1003,744,2020-03-18 00:02:00,0,3404.0,3070.0,0.902,16.811,230,155,92,63,75,26,49,97,0.0,0.06
1003,745,2020-03-18 00:05:00,0,3260.0,3099.0,0.951,16.276,349,163,99,64,186,127,59,39,0.11,0.1
1003,746,2020-03-18 00:08:00,0,2479.0,2363.0,0.953,12.382,553,320,251,69,233,156,77,30,0.0,0.01
1003,747,2020-03-18 00:11:00,0,2297.0,2075.0,0.903,11.348,675,317,233,84,358,265,93,27,0.0,0.0
1003,748,2020-03-18 00:14:00,0,3172.0,2964.0,0.935,15.777,665,367,280,87,298,219,79,71,0.0,0.0
1003,749,2020-03-18 00:17:00,0,3262.0,3035.0,0.93,16.213,392,225,165,60,167,108,59,93,0.0,0.0
1003,750,2020-03-18 00:20:00,0,3606.0,3377.0,0.937,17.946,206,54,21,33,152,109,43,18,0.3,0.01
1003,751,2020-03-18 00:23:00,0,3708.0,3536.0,0.954,18.522,157,85,48,37,72,50,22,13,0.0,0.07
1003,752,2020-03-18 00:26:00,0,3187.0,2950.0,0.926,15.824,275,163,126,37,112,75,37,49,0.0,0.02
1003,753,2020-03-18 00:29:00,0,2247.0,2062.0,0.918,11.134,246,74,46,28,172,110,62,2,0.0,0.0
1003,754,2020-03-18 00:32:00,0,2468.0,2415.0,0.979,12.396,431,254,198,56,177,136,41,47,0.0,0.0
1003,755,2020-03-18 00:35:00,0,3335.0,3138.0,0.941,16.614,212,63,36,27,149,99,50,37,0.0,0.03
1003,756,2020-03-18 00:38:00,0,3276.0,3049.0,0.931,16.282,275,168,135,33,107,73,34,16,0.12,0.0
1003,757,2020-03-18 00:41:00,0,2368.0,2320.0,0.98,11.897,822,367,253,114,455,345,110,9,0.0,0.0
1003,758,2020-03-18 00:44:00,0,2453.0,2184.0,0.89,12.083,1134,624,512,112,510,406,104,5,0.0,0.02
1003,759,2020-03-18 00:47:00,0,2877.0,2775.0,0.965,14.409,845,590,485,105,255,194,61,10,0.07,0.0
1003,760,2020-03-18 00:50:00,0,2594.0,2531.0,0.976,13.021,1191,775,638,137,416,323,93,7,0.0,0.0
1003,761,2020-03-18 00:53:00,0,3083.0,2885.0,0.936,15.341,270,139,98,41,131,90,41,49,0.0,0.04
1003,762,2020-03-18 00:56:00,0,3212.0,3092.0,0.963,16.077,112,51,31,20,61,33,28,31,0.0,0.04
1003,763,2020-03-18 00:59:00,0,3104.0,2969.0,0.957,15.517,83,36,23,13,47,19,28,4,0.0,0.39
1003,764,2020-03-18 01:02:00,0,2009.0,1916.0,0.953,10.037,42,9,3,6,33,11,22,0,0.0,0.02
1003,765,2020-03-18 01:05:00,0,2613.0,2408.0,0.922,12.96,735,481,388,93,254,190,64,28,0.11,0.04
1003,766,2020-03-18 01:08:00,0,2837.0,2653.0,0.935,14.113,910,560,456,104,350,261,89,20,0.13,0.0
1003,767,2020-03-18 01:11:00,0,3064.0,2876.0,0.939,15.256,521,290,228,62,231,182,49,5,0.0,0.0
1003,768,2020-03-18 01:14:00,0,2798.0,2606.0,0.931,13.908,544,307,229,78,237,171,66,13,0.0,0.0
1003,769,2020-03-18 01:17:00,0,3054.0,2992.0,0.98,15.345,837,508,404,104,329,230,99,23,0.0,0.0
1003,770,2020-03-18 01:20:00,0,2964.0,2744.0,0.926,14.718,1081,587,486,101,494,372,122,39,0.0,0.02
1003,771,2020-03-18 01:23:00,0,3010.0,2799.0,0.93,14.959,835,436,331,105,399,284,115,28,0.0,0.0
1003,772,2020-03-18 01:26:00,0,2986.0,2779.0,0.931,14.841,1276,793,651,142,483,368,115,46,0.0,0.0
1003,773,2020-03-18 01:29:00,0,2874.0,2711.0,0.943,14.325,918,481,401,80,437,333,104,34,0.1,0.0
1003,774,2020-03-18 01:32:00,0,2807.0,2601.0,0.927,13.94,858,384,280,104,474,360,114,17,0.0,0.0
1003,775,2020-03-18 01:35:00,0,2830.0,2610.0,0.922,14.04,1566,924,746,178,642,526,116,91,0.0,0.0
1003,776,2020-03-18 01:38:00,0,2726.0,2562.0,0.94,13.576,1143,773,637,136,370,282,88,84,0.0,0.0
1003,777,2020-03-18 01:41:00,0,2804.0,2645.0,0.943,13.974,1468,947,790,157,521,405,116,63,0.0,0.0
1003,778,2020-03-18 01:44:00,0,2516.0,2462.0,0.978,12.64,1443,921,762,159,522,416,106,25,0.0,0.0
1003,779,2020-03-18 01:47:00,0,2597.0,2552.0,0.983,13.058,1427,1070,878,192,357,251,106,40,0.0,0.0
1003,780,2020-03-18 01:50:00,0,2605.0,2524.0,0.969,13.058,866,665,541,124,201,144,57,22,0.05,0.0
1003,781,2020-03-18 01:53:00,0,2593.0,2526.0,0.974,13.014,770,625,508,117,145,90,55,20,0.0,0.0
1003,782,2020-03-18 01:56:00,0,2547.5,2474.0,0.971,12.776,755,522,422,100,233,172,61,49,0.0,0.0
1003,783,2020-03-18 01:59:00,0,2502.0,2422.0,0.968,12.538,369,207,153,54,162,106,56,61,0.0,0.0
1003,784,2020-03-18 02:02:00,0,2574.0,2412.0,0.937,12.813,719,307,230,77,412,305,107,27,0.0,0.0
1003,785,2020-03-18 02:05:00,0,2515.0,2415.0,0.96,12.582,201,65,34,31,136,91,45,10,0.0,0.0
1003,786,2020-03-18 02:08:00,0,2514.0,2414.0,0.96,12.577,194,130,88,42,64,37,27,44,0.0,0.0
1003,787,2020-03-18 02:11:00,0,2398.0,2387.0,0.995,12.091,1134,749,627,122,385,288,97,47,0.0,0.0
1003,788,2020-03-18 02:14:00,0,2369.0,2322.0,0.98,11.903,1467,988,828,160,479,372,107,77,0.0,0.0
1003,789,2020-03-18 02:17:00,0,2434.0,2382.0,0.979,12.226,1218,772,629,143,446,338,108,73,0.0,0.0
1003,790,2020-03-18 02:20:00,0,2496.0,2378.0,0.953,12.466,806,550,434,116,256,173,83,53,0.0,0.0
1003,791,2020-03-18 02:23:00,0,2402.0,2371.0,0.987,12.088,1181,633,501,132,548,415,133,69,0.0,0.0
1003,792,2020-03-18 02:26:00,0,2388.0,2349.0,0.983,12.009,988,528,417,111,460,352,108,45,0.0,0.0
1003,793,2020-03-18 02:29:00,0,2381.0,2223.0,0.933,11.844,1120,731,598,133,389,291,98,67,0.0,0.0
1003,794,2020-03-18 02:32:00,0,2425.0,2369.0,0.977,12.176,1172,799,652,147,373,281,92,52,0.0,0.0
1003,795,2020-03-18 02:35:00,0,2444.0,2286.0,0.935,12.161,298,188,129,59,110,75,35,98,0.0,0.0
1003,796,2020-03-18 02:38:00,0,2434.0,2391.0,0.982,12.236,187,92,32,60,95,54,41,47,0.0,0.0
1003,797,2020-03-18 02:41:00,0,2585.0,2417.0,0.935,12.861,90,57,25,32,33,6,27,3,0.0,0.0
1003,798,2020-03-18 02:44:00,0,2435.0,2316.0,0.951,12.156,18,8,3,5,10,1,9,0,0.0,0.0
1003,799,2020-03-18 02:47:00,0,2280.0,2081.0,0.913,11.287,9,3,0,3,6,2,4,0,0.0,0.0
1003,800,2020-03-18 02:50:00,0,2011.0,1953.0,0.971,10.087,1,0,0,0,1,0,1,0,0.0,0.0
1003,801,2020-03-18 02:53:00,0,1830.0,1827.0,0.998,9.232,2,1,0,1,1,0,1,0,0.0,0.0
1003,802,2020-03-18 02:56:00,0,1835.0,1685.0,0.918,9.097,41,19,10,9,22,6,16,2,0.0,0.0
1003,803,2020-03-18 02:59:00,0,1857.0,1701.0,0.916,9.201,0,0,0,0,0,0,0,0,0.0,0.0
1003,804,2020-03-18 03:02:00,0,1661.0,1608.0,0.968,8.325,0,0,0,0,0,0,0,0,0.0,0.0
1003,805,2020-03-18 03:05:00,0,1614.0,1535.0,0.951,8.06,8,5,2,3,3,0,3,0,0.0,0.0
1003,806,2020-03-18 03:08:00,0,1626.0,1518.0,0.933,8.088,1,1,0,1,0,0,0,0,0.0,0.0
1003,807,2020-03-18 03:11:00,0,1511.0,1474.0,0.975,7.585,1,1,0,1,0,0,0,0,0.0,0.0
1003,808,2020-03-18 03:14:00,0,1561.0,1438.0,0.921,7.744,274,195,144,51,79,52,27,20,0.0,0.0
1003,809,2020-03-18 03:17:00,0,1839.0,1812.0,0.985,9.25,352,241,168,73,111,60,51,102,0.0,0.0
1003,810,2020-03-18 03:20:00,0,1770.0,1853.0,1.047,9.024,450,324,252,72,126,83,43,108,0.0,0.0
1003,811,2020-03-18 03:23:00,0,2237.0,2102.0,0.94,11.139,108,74,41,33,34,7,27,29,0.0,0.0
1003,812,2020-03-18 03:26:00,0,2334.0,2233.0,0.957,11.666,136,37,18,19,99,40,59,22,0.0,0.0
1003,813,2020-03-18 03:29:00,0,2228.0,2166.0,0.972,11.175,58,0,0,0,58,0,58,0,0.0,0.0
1003,814,2020-03-18 03:32:00,0,1982.0,1970.0,0.994,9.991,54,2,2,0,52,0,52,0,0.0,0.0
1003,815,2020-03-18 03:35:00,0,1790.0,1766.0,0.986,9.007,421,236,185,51,185,117,68,58,0.0,0.0
1003,816,2020-03-18 03:38:00,0,2169.0,2042.0,0.941,10.808,325,100,58,42,225,145,80,75,0.0,0.0
1003,817,2020-03-18 03:41:00,0,2469.0,2263.0,0.917,12.233,426,215,138,77,211,145,66,80,0.0,0.0
1003,818,2020-03-18 03:44:00,0,2448.0,2275.0,0.929,12.162,238,99,54,45,139,96,43,38,0.0,0.0
1003,819,2020-03-18 03:47:00,0,2737.0,2593.0,0.948,13.654,131,62,36,26,69,49,20,2,0.0,0.04
1003,820,2020-03-18 03:50:00,0,1766.0,1663.0,0.942,8.797,74,34,13,21,40,4,36,7,0.0,0.02
1003,821,2020-03-18 03:53:00,0,1433.0,1338.0,0.934,7.127,90,51,13,38,39,5,34,7,0.0,0.0
1003,822,2020-03-18 03:56:00,0,1558.0,1477.0,0.948,7.775,1,0,0,0,1,0,1,0,0.0,0.01
1003,823,2020-03-18 03:59:00,0,1834.0,1704.0,0.929,9.111,13,10,5,5,3,0,3,0,0.0,0.0
1003,824,2020-03-18 04:02:00,0,1994.0,1808.0,0.907,9.86,0,0,0,0,0,0,0,0,0.0,0.0
1003,825,2020-03-18 04:05:00,0,2184.0,2001.0,0.916,10.818,0,0,0,0,0,0,0,0,0.0,0.01
1003,826,2020-03-18 04:08:00,0,2288.0,2173.0,0.95,11.421,5,0,0,0,5,1,4,0,0.0,0.0
1003,827,2020-03-18 04:11:00,0,2265.0,2083.0,0.919,11.231,81,34,22,12,47,20,27,7,0.0,0.0
1003,828,2020-03-18 04:14:00,0,2194.0,2082.0,0.949,10.95,33,0,0,0,33,4,29,0,0.0,0.0
1003,829,2020-03-18 04:17:00,0,2013.0,1926.0,0.957,10.062,32,0,0,0,32,4,28,0,0.0,0.0
1003,830,2020-03-18 04:20:00,0,1844.0,1818.0,0.986,9.28,41,6,2,4,35,10,25,0,0.0,0.0
1003,831,2020-03-18 04:23:00,0,1838.0,1708.0,0.929,9.133,64,21,7,14,43,15,28,0,0.0,0.0
1003,832,2020-03-18 04:26:00,0,1755.0,1646.0,0.938,8.736,21,0,0,0,21,1,20,0,0.0,0.0
1003,833,2020-03-18 04:29:00,0,1675.0,1582.0,0.945,8.352,30,0,0,0,30,4,26,0,0.0,0.0
1003,834,2020-03-18 04:32:00,0,1564.0,1497.0,0.957,7.819,296,112,66,46,184,130,54,13,0.0,0.0
1003,835,2020-03-18 04:35:00,0,1758.0,1671.0,0.95,8.777,604,361,259,102,243,158,85,13,0.0,0.0
1003,836,2020-03-18 04:38:00,0,1925.0,1873.0,0.973,9.659,800,346,240,106,454,342,112,8,0.0,0.0
1003,837,2020-03-18 04:41:00,0,2263.0,2108.0,0.931,11.249,654,269,207,62,385,274,111,5,0.0,0.0
1003,838,2020-03-18 04:44:00,0,2160.0,2116.0,0.98,10.853,759,440,354,86,319,249,70,13,0.42,0.0
1003,839,2020-03-18 04:47:00,0,2379.0,2342.0,0.985,11.965,1064,767,658,109,297,222,75,78,0.0,0.0
1003,840,2020-03-18 04:50:00,0,2431.0,2363.0,0.972,12.194,557,326,269,57,231,162,69,92,0.0,0.0
1003,841,2020-03-18 04:53:00,0,2784.0,2668.0,0.959,13.921,295,78,40,38,217,138,79,52,0.0,0.0
1003,842,2020-03-18 04:56:00,0,2841.0,2700.0,0.951,14.1815,277,52,21,31,225,152,73,45,0.0,0.02
1003,843,2020-03-18 04:59:00,0,2898.0,2732.0,0.943,14.442,267,91,59,32,176,121,55,49,0.0,0.04
1003,844,2020-03-18 05:02:00,0,2187.0,2028.0,0.927,10.862,263,142,81,61,121,76,45,74,0.0,0.0
1003,845,2020-03-18 05:05:00,0,3253.0,2968.0,0.912,16.102,270,81,31,50,189,126,63,44,0.0,0.05
1003,846,2020-03-18 05:08:00,0,2579.0,2445.0,0.948,12.868,465,239,191,48,226,160,66,12,0.0,0.02
1003,847,2020-03-18 05:11:00,0,2999.0,2743.0,0.915,14.853,1322,879,745,134,443,352,91,24,0.0,0.08
1003,848,2020-03-18 05:14:00,0,3077.0,2818.0,0.916,15.242,462,306,245,61,156,111,45,80,0.0,0.0
1003,849,2020-03-18 05:17:00,0,2765.0,2632.0,0.952,13.808,871,593,494,99,278,217,61,170,0.0,0.0
1003,850,2020-03-18 05:20:00,0,2530.0,2508.0,0.991,12.746,519,366,289,77,153,107,46,87,0.0,0.0
1003,851,2020-03-18 05:23:00,0,3350.0,3147.0,0.94,16.682,110,46,18,28,64,49,15,17,0.0,0.0
1003,852,2020-03-18 05:26:00,0,2387.0,2337.0,0.979,11.991,297,146,90,56,151,93,58,31,0.0,0.0
1003,853,2020-03-18 05:29:00,0,2043.0,1920.0,0.939,10.176,1082,676,560,116,406,305,101,9,0.21,0.0
1003,854,2020-03-18 05:32:00,0,2457.0,2327.0,0.947,12.256,872,528,428,100,344,269,75,5,0.0,0.02
1003,855,2020-03-18 05:35:00,0,2826.0,2697.0,0.955,14.119,579,390,327,63,189,153,36,13,0.0,0.0
1003,856,2020-03-18 05:38:00,0,3236.0,2948.0,0.911,16.013,75,19,7,12,56,32,24,6,0.0,0.0
1003,857,2020-03-18 05:41:00,0,3161.0,2961.0,0.937,15.734,91,52,40,12,39,31,8,8,0.0,0.03
1003,858,2020-03-18 05:44:00,0,2424.0,2265.0,0.935,12.057,130,36,15,21,94,54,40,1,0.0,0.01
1003,859,2020-03-18 05:47:00,0,2022.0,1842.0,0.911,10.007,50,11,7,4,39,21,18,0,0.0,0.01
1003,860,2020-03-18 05:50:00,0,1555.0,1516.0,0.975,7.807,58,14,8,6,44,16,28,0,0.0,0.0
1003,861,2020-03-18 05:53:00,0,1584.0,1381.0,0.872,7.771,32,2,0,2,30,2,28,0,0.0,0.0
1003,862,2020-03-18 05:56:00,0,1440.0,1327.0,0.922,7.143,143,41,23,18,102,60,42,0,0.0,0.0
1003,863,2020-03-18 05:59:00,0,1546.0,1348.0,0.872,7.582,370,198,128,70,172,115,57,11,0.0,0.01
1003,864,2020-03-18 06:02:00,1,2514.0,2475.0,0.984,12.646,501,237,183,54,264,193,71,37,0.0,0.01
1003,865,2020-03-18 06:05:00,1,2897.0,2792.0,0.964,14.505,409,223,164,59,186,128,58,69,0.0,0.0
1003,866,2020-03-18 06:08:00,1,2852.0,2711.0,0.95,14.24,114,40,13,27,74,43,31,21,0.0,0.0
1003,867,2020-03-18 06:11:00,1,2977.0,2869.0,0.964,14.907,94,23,6,17,71,45,26,15,0.0,0.0
1003,868,2020-03-18 06:14:00,1,3221.0,3035.0,0.942,16.052,79,44,37,7,35,22,13,0,0.0,0.14
1003,869,2020-03-18 06:17:00,1,2259.0,2148.0,0.951,11.279,749,319,244,75,430,332,98,9,0.05,0.0
1003,870,2020-03-18 06:20:00,1,2249.0,2036.0,0.905,11.113,1052,632,531,101,420,314,106,10,0.0,0.05
1003,871,2020-03-18 06:23:00,1,2552.0,2516.0,0.986,12.838,439,171,121,50,268,190,78,7,0.0,0.0
1003,872,2020-03-18 06:26:00,1,1985.0,1904.0,0.959,9.928,861,462,363,99,399,291,108,20,0.0,0.0
1003,873,2020-03-18 06:29:00,1,2642.0,2469.0,0.935,13.142,590,309,241,68,281,202,79,6,0.0,0.0
1003,874,2020-03-18 06:32:00,1,2581.0,2427.0,0.94,12.856,205,65,16,49,140,72,68,11,0.0,0.0
1003,875,2020-03-18 06:35:00,1,2519.0,2480.0,0.985,12.668,41,12,1,11,29,14,15,0,0.0,0.0
1003,876,2020-03-18 06:38:00,1,2409.0,2254.0,0.935,11.988,2,1,0,1,1,1,0,0,0.0,0.0
1003,877,2020-03-18 06:41:00,1,2372.0,2214.0,0.934,11.797,17,14,0,14,3,1,2,0,0.0,0.0
1003,878,2020-03-18 06:44:00,1,2289.0,2083.0,0.91,11.323,6,2,0,2,4,0,4,0,0.0,0.0
1003,879,2020-03-18 06:47:00,1,1987.0,1880.0,0.946,9.91,23,17,0,17,6,3,3,0,0.0,0.0
1003,880,2020-03-18 06:50:00,1,1845.0,1796.0,0.974,9.257,0,0,0,0,0,0,0,0,0.0,0.0
1003,881,2020-03-18 06:53:00,1,1880.0,1691.0,0.9,9.28,1,1,0,1,0,0,0,0,0.0,0.0
1003,882,2020-03-18 06:56:00,1,1552.0,1532.0,0.987,7.81,35,20,11,9,15,5,10,0,0.0,0.0
1003,883,2020-03-18 06:59:00,1,1562.0,1567.0,1.003,7.887,9,5,0,5,4,1,3,0,0.0,0.0
1003,884,2020-03-18 07:02:00,1,1569.0,1565.0,0.998,7.914,0,0,0,0,0,0,0,0,0.0,0.0
1003,885,2020-03-18 07:05:00,1,1594.0,1539.0,0.966,7.984,40,24,1,23,16,2,14,0,0.0,0.0
1003,886,2020-03-18 07:08:00,1,1573.0,1492.0,0.949,7.847,6,3,0,3,3,1,2,0,0.0,0.0
1003,887,2020-03-18 07:11:00,1,1614.0,1451.0,0.899,7.966,7,5,1,4,2,1,1,0,0.0,0.0
1003,888,2020-03-18 07:14:00,1,1419.0,1416.0,0.998,7.158,5,0,0,0,5,1,4,0,0.0,0.0
1003,889,2020-03-18 07:17:00,1,1493.0,1431.0,0.958,7.468,132,96,54,42,36,5,31,0,0.0,0.0
1003,890,2020-03-18 07:20:00,1,1373.0,1380.0,1.005,6.939,56,18,5,13,38,5,33,0,0.0,0.0
1003,891,2020-03-18 07:23:00,1,1514.0,1421.0,0.939,7.537,42,1,0,1,41,8,33,0,0.0,0.0
1003,892,2020-03-18 07:26:00,1,1584.0,1416.0,0.894,7.808,29,6,2,4,23,0,23,0,0.0,0.0
1003,893,2020-03-18 07:29:00,1,1505.0,1435.0,0.954,7.519,24,0,0,0,24,0,24,0,0.0,0.0
1003,894,2020-03-18 07:32:00,1,1506.0,1438.0,0.955,7.525,71,25,8,17,46,24,22,0,0.0,0.0
1003,895,2020-03-18 07:35:00,1,1589.0,1517.0,0.954,7.942,12,8,0,8,4,1,3,0,0.0,0.0
1003,896,2020-03-18 07:38:00,1,1598.0,1503.0,0.94,7.958,14,14,0,14,0,0,0,0,0.0,0.0
1003,897,2020-03-18 07:41:00,1,1571.0,1462.0,0.93,7.808,30,27,0,27,3,0,3,0,0.0,0.0
1003,898,2020-03-18 07:44:00,1,1596.0,1433.0,0.898,7.873,43,43,0,43,0,0,0,0,0.0,0.0
1003,899,2020-03-18 07:47:00,1,1428.0,1406.0,0.984,7.182,31,31,0,31,0,0,0,0,0.0,0.0
1003,900,2020-03-18 07:50:00,1,1442.0,1414.0,0.981,7.249,30,27,0,27,3,1,2,0,0.0,0.0
1003,901,2020-03-18 07:53:00,1,1418.0,1420.0,1.001,7.16,39,30,1,29,9,5,4,0,0.0,0.0
1003,902,2020-03-18 07:56:00,1,1624.0,1602.5,0.988,8.172,141,32,12,20,109,34,75,1,0.0,0.0
1003,903,2020-03-18 07:59:00,1,1830.0,1785.0,0.975,9.184,104,16,6,10,88,19,69,0,0.0,0.0
1003,904,2020-03-18 08:02:00,1,2016.0,1963.0,0.974,10.115,82,5,3,2,77,35,42,1,0.0,0.0
1003,905,2020-03-18 08:05:00,1,1803.0,1836.0,1.018,9.138,10,4,2,2,6,1,5,0,0.0,0.0
1003,906,2020-03-18 08:08:00,1,1853.0,1745.0,0.942,9.233,2,0,0,0,2,0,2,0,0.0,0.0
1003,907,2020-03-18 08:11:00,1,1669.0,1629.0,0.976,8.378,9,1,0,1,8,2,6,0,0.0,0.0
1003,908,2020-03-18 08:14:00,1,1592.0,1543.0,0.969,7.982,49,0,0,0,49,8,41,0,0.0,0.0
1003,909,2020-03-18 08:17:00,1,1594.0,1452.0,0.911,7.89,104,13,8,5,91,26,65,0,0.0,0.0
1003,910,2020-03-18 08:20:00,1,1534.0,1551.0,1.011,7.761,56,18,0,18,38,8,30,0,0.0,0.05
1003,911,2020-03-18 08:23:00,1,1843.0,1722.0,0.934,9.169,174,59,41,18,115,60,55,0,0.0,0.0
1003,912,2020-03-18 08:26:00,1,2457.0,2257.0,0.919,12.181,305,150,98,52,155,80,75,53,0.0,0.0
1003,913,2020-03-18 08:29:00,1,2601.0,2420.0,0.931,12.925,420,145,106,39,275,191,84,38,0.0,0.0
1003,914,2020-03-18 08:32:00,1,2413.0,2322.0,0.962,12.078,465,257,198,59,208,157,51,83,0.0,0.0
1003,915,2020-03-18 08:35:00,1,2592.0,2352.0,0.908,12.815,183,157,90,67,26,6,20,23,0.0,0.0
1003,916,2020-03-18 08:38:00,1,2644.0,2385.0,0.902,13.056,23,13,5,8,10,1,9,0,0.0,0.0
1003,917,2020-03-18 08:41:00,1,2490.0,2336.0,0.938,12.396,12,11,5,6,1,0,1,0,0.0,0.0
1003,918,2020-03-18 08:44:00,1,2339.0,2132.0,0.911,11.575,18,11,5,6,7,1,6,0,0.0,0.0
1003,919,2020-03-18 08:47:00,1,2309.0,2077.0,0.9,11.397,14,6,3,3,8,1,7,0,0.0,0.0
1003,920,2020-03-18 08:50:00,1,2028.0,1930.0,0.951,10.126,2,0,0,0,2,0,2,0,0.0,0.0
1003,921,2020-03-18 08:53:00,1,1856.0,1787.0,0.963,9.291,4,0,0,0,4,1,3,0,0.0,0.0
1003,922,2020-03-18 08:56:00,1,1861.0,1682.0,0.904,9.195,21,17,4,13,4,1,3,0,0.0,0.0
1003,923,2020-03-18 08:59:00,1,1768.0,1575.0,0.891,8.712,2,1,0,1,1,0,1,0,0.0,0.0
1003,924,2020-03-18 09:02:00,1,1568.0,1522.0,0.971,7.861,0,0,0,0,0,0,0,0,0.0,0.0
1003,925,2020-03-18 09:05:00,1,1606.0,1503.0,0.936,7.99,3,0,0,0,3,1,2,0,0.0,0.0
1003,926,2020-03-18 09:08:00,1,1620.0,1484.0,0.917,8.025,2,0,0,0,2,1,1,0,0.0,0.0
1003,927,2020-03-18 09:11:00,1,1551.0,1441.0,0.929,7.708,18,7,2,5,11,4,7,0,0.0,0.0
1003,928,2020-03-18 09:14:00,1,1882.0,1725.0,0.917,9.323,0,0,0,0,0,0,0,0,0.0,0.0
1003,929,2020-03-18 09:17:00,1,1848.0,1694.0,0.917,9.157,18,4,0,4,14,0,14,0,0.0,0.0
1003,930,2020-03-18 09:20:00,1,1822.0,1696.0,0.931,9.057,0,0,0,0,0,0,0,0,0.0,0.0
1003,931,2020-03-18 09:23:00,1,1904.0,1667.0,0.876,9.349,12,8,0,8,4,0,4,0,0.0,0.0
1003,932,2020-03-18 09:26:00,1,1644.0,1555.0,0.946,8.197,3,2,0,2,1,1,0,0,0.0,0.0
1003,933,2020-03-18 09:29:00,1,1839.0,1585.0,0.862,9.001,12,6,2,4,6,1,5,0,0.0,0.0
1003,934,2020-03-18 09:32:00,1,1860.0,1651.0,0.888,9.157,12,12,0,12,0,0,0,0,0.0,0.0
1003,935,2020-03-18 09:35:00,1,1874.0,1645.0,0.878,9.207,2,2,0,2,0,0,0,0,0.0,0.0
1003,936,2020-03-18 09:38:00,1,1832.0,1627.0,0.888,9.018,130,72,36,36,58,32,26,11,0.0,0.0
1003,937,2020-03-18 09:41:00,1,2038.0,1835.0,0.9,10.063,137,82,39,43,55,24,31,53,0.0,0.0
1003,938,2020-03-18 09:44:00,1,2261.0,1985.0,0.878,11.108,241,139,91,48,102,75,27,68,0.0,0.0
1003,939,2020-03-18 09:47:00,1,2318.0,2052.0,0.885,11.406,198,114,66,48,84,45,39,58,0.0,0.0
1003,940,2020-03-18 09:50:00,1,2333.0,2092.0,0.897,11.51,767,436,358,78,331,260,71,38,0.0,0.0
1003,941,2020-03-18 09:53:00,1,2283.0,2050.0,0.898,11.266,280,136,90,46,144,90,54,67,0.0,0.0
1003,942,2020-03-18 09:56:00,1,2397.0,2131.0,0.889,11.803,110,71,29,42,39,16,23,44,0.0,0.0
1003,943,2020-03-18 09:59:00,1,2474.0,2180.0,0.881,12.163,27,8,4,4,19,2,17,0,0.0,0.0
1003,944,2020-03-18 10:02:00,1,2182.0,1947.0,0.893,10.751,2,2,1,1,0,0,0,0,0.0,0.0
1003,945,2020-03-18 10:05:00,1,1905.0,1741.0,0.914,9.433,0,0,0,0,0,0,0,0,0.0,0.0
1003,946,2020-03-18 10:08:00,1,1891.0,1594.0,0.843,9.215,10,8,5,3,2,0,2,0,0.0,0.0
1003,947,2020-03-18 10:11:00,1,1621.0,1485.0,0.916,8.031,14,0,0,0,14,0,14,0,0.0,0.0
1003,948,2020-03-18 10:14:00,1,1503.0,1325.0,0.882,7.387,40,21,13,8,19,9,10,3,0.0,0.0
1003,949,2020-03-18 10:17:00,1,1445.0,1342.0,0.929,7.178,2,2,0,2,0,0,0,0,0.0,0.0
1003,950,2020-03-18 10:20:00,1,1438.0,1357.0,0.944,7.166,21,21,4,17,0,0,0,0,0.0,0.0
1003,951,2020-03-18 10:23:00,1,1459.0,1341.0,0.919,7.231,0,0,0,0,0,0,0,0,0.0,0.0
1003,952,2020-03-18 10:26:00,1,1445.0,1314.0,0.909,7.15,12,12,4,8,0,0,0,0,0.0,0.0
1003,953,2020-03-18 10:29:00,1,1438.0,1275.0,0.887,7.076,0,0,0,0,0,0,0,0,0.0,0.0
1003,954,2020-03-18 10:32:00,1,1421.0,1189.0,0.837,6.916,6,6,2,4,0,0,0,0,0.0,0.0
1003,955,2020-03-18 10:35:00,1,1468.0,1193.0,0.812,7.105,0,0,0,0,0,0,0,0,0.0,0.0
1003,956,2020-03-18 10:38:00,1,1428.0,1147.0,0.804,6.895,15,12,2,10,3,1,2,0,0.0,0.0
1003,957,2020-03-18 10:41:00,1,1464.0,1298.0,0.886,7.205,0,0,0,0,0,0,0,0,0.0,0.0
1003,958,2020-03-18 10:44:00,1,1427.0,1227.0,0.86,6.979,46,25,13,12,21,8,13,0,0.0,0.0
1003,959,2020-03-18 10:47:00,1,1604.0,1437.0,0.896,7.912,5,2,1,1,3,0,3,0,0.0,0.0
1003,960,2020-03-18 10:50:00,1,1572.0,1459.0,0.928,7.811,4,3,0,3,1,0,1,0,0.0,0.0
1003,961,2020-03-18 10:53:00,1,1707.0,1478.0,0.866,8.362,0,0,0,0,0,0,0,0,0.0,0.0
1003,962,2020-03-18 10:56:00,1,1655.0,1421.0,0.8585,8.0935,0,0,0,0,0,0,0,0,0.0,0.0
1003,963,2020-03-18 10:59:00,1,1603.0,1364.0,0.851,7.825,0,0,0,0,0,0,0,0,0.0,0.0
1003,964,2020-03-18 11:02:00,1,1635.0,1356.0,0.829,7.945,9,9,1,8,0,0,0,0,0.0,0.0
1003,965,2020-03-18 11:05:00,1,1623.0,1432.0,0.882,7.982,27,14,11,3,13,10,3,0,0.0,0.0
1003,966,2020-03-18 11:08:00,1,1610.0,1374.0,0.854,7.865,13,10,4,6,3,1,2,0,0.0,0.0
1003,967,2020-03-18 11:11:00,1,1663.0,1322.0,0.795,8.016,14,1,0,1,13,4,9,0,0.0,0.0
1003,968,2020-03-18 11:14:00,1,1444.0,1227.0,0.85,7.048,0,0,0,0,0,0,0,0,0.0,0.0
1003,969,2020-03-18 11:17:00,1,1475.0,1178.0,0.798,7.116,7,0,0,0,7,0,7,0,0.0,0.0
1003,970,2020-03-18 11:20:00,1,1428.0,1120.0,0.784,6.865,2,0,0,0,2,0,2,0,0.0,0.0
1003,971,2020-03-18 11:23:00,1,1460.0,1217.0,0.834,7.098,77,30,14,16,47,20,27,2,0.0,0.0
1003,972,2020-03-18 11:26:00,1,1623.0,1424.0,0.877,7.969,3,1,1,0,2,0,2,0,0.0,0.0
1003,973,2020-03-18 11:29:00,1,1636.0,1467.0,0.897,8.068,1,1,0,1,0,0,0,0,0.0,0.0
1003,974,2020-03-18 11:32:00,1,1590.0,1405.0,0.884,7.818,13,9,0,9,4,0,4,0,0.0,0.0
1003,975,2020-03-18 11:35:00,1,1726.0,1442.0,0.835,8.395,59,45,9,36,14,3,11,2,0.0,0.0
1003,976,2020-03-18 11:38:00,1,1898.0,1555.0,0.82,9.199,235,112,76,36,123,72,51,66,0.0,0.0
1003,977,2020-03-18 11:41:00,1,2217.0,1850.0,0.835,10.781,221,121,63,58,100,53,47,67,0.0,0.0
1003,978,2020-03-18 11:44:00,1,1973.0,1680.0,0.851,9.635,443,162,106,56,281,200,81,85,0.0,0.0
1003,979,2020-03-18 11:47:00,1,2292.0,1866.0,0.814,11.098,369,157,117,40,212,147,65,92,0.0,0.0
1003,980,2020-03-18 11:50:00,1,2880.0,2430.0,0.844,14.037,134,32,6,26,102,62,40,17,0.0,0.0
1003,981,2020-03-18 11:53:00,1,2818.0,2413.0,0.856,13.774,38,14,6,8,24,18,6,1,0.0,0.04
1003,982,2020-03-18 11:56:00,1,2944.0,2620.0,0.89,14.498,12,5,2,3,7,5,2,2,0.0,0.07
1003,983,2020-03-18 11:59:00,1,2807.0,2432.0,0.867,13.751,454,199,164,35,255,185,70,24,0.0,0.03
1003,984,2020-03-18 12:02:00,1,2032.0,1817.0,0.894,10.019,1333,793,649,144,540,420,120,85,0.45,0.02
1003,985,2020-03-18 12:05:00,1,1804.0,1633.0,0.906,8.914,1564,1037,877,160,527,413,114,44,0.0,0.01
1003,986,2020-03-18 12:08:00,1,2584.0,2443.0,0.945,12.887,522,246,188,58,276,194,82,17,0.0,0.01
1003,987,2020-03-18 12:11:00,1,3009.0,2707.0,0.9,14.854,70,20,3,17,50,33,17,15,0.0,0.01
1003,988,2020-03-18 12:14:00,1,3316.0,2908.0,0.877,16.286,320,159,129,30,161,124,37,13,0.0,0.07
1003,989,2020-03-18 12:17:00,1,2438.0,2156.0,0.884,11.993,1177,722,570,152,455,351,104,39,0.0,0.02
1003,990,2020-03-18 12:20:00,1,2448.0,2140.0,0.874,12.014,1608,1068,879,189,540,426,114,33,0.0,0.0
1003,991,2020-03-18 12:23:00,1,2563.0,2327.0,0.908,12.672,1219,645,540,105,574,445,129,51,0.0,0.0
1003,992,2020-03-18 12:26:00,1,2273.0,1964.0,0.864,11.13,1400,753,628,125,647,510,137,67,0.0,0.0
1003,993,2020-03-18 12:29:00,1,2198.0,1985.0,0.903,10.856,1062,499,385,114,563,463,100,35,0.0,0.0
1003,994,2020-03-18 12:32:00,1,2894.0,2584.0,0.893,14.262,568,175,142,33,393,350,43,21,0.0,0.0
1003,995,2020-03-18 12:35:00,1,2992.0,2682.0,0.896,14.758,630,31,17,14,599,508,91,24,0.0,0.32
1003,996,2020-03-18 12:38:00,1,3187.0,2871.0,0.901,15.734,671,0,0,0,671,548,123,0,0.0,0.01
1003,997,2020-03-18 12:41:00,1,3062.0,2750.0,0.898,15.108,671,0,0,0,671,557,114,0,0.0,0.01
1003,998,2020-03-18 12:44:00,1,2670.0,2545.0,0.953,13.339,718,234,176,58,484,391,93,31,0.0,0.0
1003,999,2020-03-18 12:47:00,1,2325.0,2133.0,0.918,11.521,645,312,235,77,333,248,85,54,0.0,0.0
1003,1000,2020-03-18 12:50:00,1,1800.0,1582.0,0.879,8.845,208,101,59,42,107,62,45,36,0.0,0.0
1003,1001,2020-03-18 12:53:00,1,1594.0,1426.0,0.895,7.86,119,37,6,31,82,23,59,5,0.0,0.0
1003,1002,2020-03-18 12:56:00,1,1629.0,1331.0,0.817,7.894,62,0,0,0,62,0,62,0,0.0,0.0
1003,1003,2020-03-18 12:59:00,1,1458.0,1162.0,0.797,7.031,56,0,0,0,56,0,56,0,0.0,0.0
1003,1004,2020-03-18 13:02:00,1,1289.0,1073.0,0.833,6.269,48,0,0,0,48,0,48,0,0.0,0.0
1003,1005,2020-03-18 13:05:00,1,1469.0,1140.0,0.776,7.052,95,11,7,4,84,14,70,1,0.0,0.0
1003,1006,2020-03-18 13:08:00,1,1443.0,1199.0,0.831,7.012,66,1,0,1,65,3,62,0,0.0,0.0
1003,1007,2020-03-18 13:11:00,1,1430.0,1275.0,0.891,7.046,64,4,4,0,60,2,58,0,0.0,0.0
1003,1008,2020-03-18 13:14:00,1,1416.0,1328.0,0.938,7.049,75,11,4,7,64,9,55,0,0.0,0.0
1003,1009,2020-03-18 13:17:00,1,1951.0,1917.0,0.982,9.81,89,14,7,7,75,4,71,0,0.0,0.0
1003,1010,2020-03-18 13:20:00,1,2169.0,2064.0,0.951,10.832,63,4,0,4,59,2,57,0,0.0,0.0
1003,1011,2020-03-18 13:23:00,1,1784.0,1781.0,0.999,8.999,80,5,1,4,75,21,54,0,0.0,0.0
1003,1012,2020-03-18 13:26:00,1,1555.0,1478.0,0.951,7.764,51,0,0,0,51,4,47,0,0.0,0.0
1003,1013,2020-03-18 13:29:00,1,1411.0,1311.0,0.929,7.011,120,1,0,1,119,70,49,2,0.0,0.0
1003,1014,2020-03-18 13:32:00,1,1445.0,1265.0,0.875,7.094,111,0,0,0,111,43,68,0,0.0,0.0
1003,1015,2020-03-18 13:35:00,1,1425.0,1220.0,0.856,6.965,206,20,7,13,186,123,63,3,0.0,0.0
1003,1016,2020-03-18 13:38:00,1,1451.0,1251.0,0.862,7.101,83,21,5,16,62,8,54,0,0.0,0.0
1003,1017,2020-03-18 13:41:00,1,1463.0,1254.0,0.857,7.154,80,18,2,16,62,4,58,0,0.0,0.0
1003,1018,2020-03-18 13:44:00,1,1810.0,1723.0,0.952,9.038,170,40,21,19,130,58,72,3,0.0,0.0
1003,1019,2020-03-18 13:47:00,1,1997.0,1962.0,0.982,10.042,364,19,2,17,345,234,111,44,0.0,0.0
1003,1020,2020-03-18 13:50:00,1,2016.0,1945.0,0.965,10.095,142,29,4,25,113,53,60,12,0.0,0.0
1003,1021,2020-03-18 13:53:00,1,1971.0,1970.0,0.999,9.947,366,122,83,39,244,168,76,37,0.0,0.0
1003,1022,2020-03-18 13:56:00,1,2074.5,2043.0,0.9855,10.4345,349,124,80,44,225,149,76,40,0.0,0.0
1003,1023,2020-03-18 13:59:00,1,2178.0,2116.0,0.972,10.922,206,48,19,29,158,88,70,53,0.0,0.0
1003,1024,2020-03-18 14:02:00,1,2229.0,2086.0,0.936,11.092,167,54,24,30,113,56,57,23,0.0,0.0
1003,1025,2020-03-18 14:05:00,1,2017.0,1915.0,0.949,10.065,56,0,0,0,56,2,54,0,0.0,0.0
1003,1026,2020-03-18 14:08:00,1,1868.0,1654.0,0.886,9.191,52,1,0,1,51,2,49,0,0.0,0.01
1003,1027,2020-03-18 14:11:00,1,1863.0,1750.0,0.94,9.276,70,3,0,3,67,10,57,0,0.0,0.0
1003,1028,2020-03-18 14:14:00,1,1760.0,1640.0,0.932,8.75,42,0,0,0,42,0,42,0,0.0,0.0
1003,1029,2020-03-18 14:17:00,1,1608.0,1492.0,0.928,7.985,69,6,2,4,63,12,51,1,0.0,0.0
1003,1030,2020-03-18 14:20:00,1,1422.0,1368.0,0.962,7.116,49,0,0,0,49,0,49,0,0.0,0.0
1003,1031,2020-03-18 14:23:00,1,1347.0,1281.0,0.95,6.727,50,0,0,0,50,0,50,0,0.0,0.0
1003,1032,2020-03-18 14:26:00,1,1219.0,1185.0,0.972,6.114,55,3,1,2,52,5,47,0,0.0,0.0
1003,1033,2020-03-18 14:29:00,1,1268.0,1209.0,0.953,6.333,45,3,1,2,42,0,42,0,0.0,0.0
1003,1034,2020-03-18 14:32:00,1,1266.0,1218.0,0.962,6.335,51,0,0,0,51,0,51,0,0.0,0.0
1003,1035,2020-03-18 14:35:00,1,1434.0,1365.0,0.952,7.161,84,26,11,15,58,32,26,2,0.0,0.0
1003,1036,2020-03-18 14:38:00,1,1612.0,1577.0,0.978,8.098,5,0,0,0,5,4,1,0,0.0,0.0
1003,1037,2020-03-18 14:41:00,1,1407.0,1463.0,1.04,7.163,0,0,0,0,0,0,0,0,0.0,0.0
1003,1038,2020-03-18 14:44:00,1,1405.0,1400.0,0.997,7.086,49,18,10,8,31,19,12,6,0.0,0.0
1003,1039,2020-03-18 14:47:00,1,1603.0,1510.0,0.942,7.988,0,0,0,0,0,0,0,0,0.0,0.0
1003,1040,2020-03-18 14:50:00,1,1497.0,1438.0,0.961,7.49,31,10,4,6,21,15,6,1,0.0,0.0
1003,1041,2020-03-18 14:53:00,1,1545.0,1531.0,0.991,7.781,1,1,1,0,0,0,0,0,0.0,0.01
1003,1042,2020-03-18 14:56:00,1,1581.0,1639.0,1.036,8.043,0,0,0,0,0,0,0,0,0.0,0.0
1003,1043,2020-03-18 14:59:00,1,1578.0,1559.0,0.988,7.944,2,2,0,2,0,0,0,0,0.0,0.0
1003,1044,2020-03-18 15:02:00,1,1474.0,1417.0,0.961,7.378,0,0,0,0,0,0,0,0,0.0,0.0
1003,1045,2020-03-18 15:05:00,1,1432.0,1366.0,0.954,7.153,19,2,0,2,17,11,6,2,0.0,0.0
1003,1046,2020-03-18 15:08:00,1,1426.0,1348.0,0.945,7.111,8,1,0,1,7,2,5,0,0.0,0.0
1003,1047,2020-03-18 15:11:00,1,1447.0,1370.0,0.947,7.218,200,70,14,56,130,76,54,49,0.0,0.0
1003,1048,2020-03-18 15:14:00,1,1822.0,1727.0,0.948,9.088,252,76,35,41,176,108,68,33,0.0,0.0
1003,1049,2020-03-18 15:17:00,1,1796.0,1839.0,1.023,9.113,234,90,55,35,144,88,56,48,0.0,0.0
1003,1050,2020-03-18 15:20:00,1,1933.0,1966.0,1.017,9.791,192,91,51,40,101,53,48,16,0.0,0.0
1003,1051,2020-03-18 15:23:00,1,2012.0,1935.0,0.962,10.069,105,17,2,15,88,36,52,0,0.0,0.0
1003,1052,2020-03-18 15:26:00,1,1841.0,1859.0,1.009,9.312,27,5,2,3,22,3,19,0,0.0,0.0
1003,1053,2020-03-18 15:29:00,1,1862.0,1686.0,0.906,9.203,188,70,45,25,118,54,64,25,0.0,0.0
1003,1054,2020-03-18 15:32:00,1,1978.0,1920.0,0.971,9.918,233,65,33,32,168,102,66,63,0.0,0.03
1003,1055,2020-03-18 15:35:00,1,2373.0,2264.0,0.954,11.854,354,134,95,39,220,145,75,66,0.0,0.0
1003,1056,2020-03-18 15:38:00,1,2253.0,2154.0,0.956,11.26,414,234,172,62,180,114,66,83,0.0,0.08
1003,1057,2020-03-18 15:41:00,1,2266.0,2153.0,0.95,11.312,1265,773,661,112,492,396,96,85,0.01,0.0
1003,1058,2020-03-18 15:44:00,1,2402.0,2182.0,0.908,11.878,892,476,389,87,416,310,106,64,0.0,0.03
1003,1059,2020-03-18 15:47:00,1,2369.0,2255.0,0.952,11.831,846,518,400,118,328,240,88,49,0.04,0.0
1003,1060,2020-03-18 15:50:00,1,2291.0,2202.0,0.961,11.465,1125,731,600,131,394,278,116,74,0.0,0.0
1003,1061,2020-03-18 15:53:00,1,2588.0,2444.0,0.944,12.901,561,299,231,68,262,177,85,55,0.0,0.01
1003,1062,2020-03-18 15:56:00,1,2185.0,2087.0,0.955,10.919,1147,564,439,125,583,468,115,48,0.0,0.0
1003,1063,2020-03-18 15:59:00,1,2410.0,2149.0,0.892,11.873,930,563,465,98,367,271,96,68,0.0,0.0
1003,1064,2020-03-18 16:02:00,1,1969.0,1904.0,0.967,9.867,137,36,14,22,101,69,32,6,0.0,0.0
1003,1065,2020-03-18 16:05:00,1,2625.0,2499.0,0.952,13.11,131,31,10,21,100,47,53,0,0.0,0.0
1003,1066,2020-03-18 16:08:00,1,2378.0,2245.0,0.944,11.854,42,2,0,2,40,0,40,0,0.0,0.0
1003,1067,2020-03-18 16:11:00,1,2239.0,2090.0,0.934,11.136,50,1,1,0,49,2,47,0,0.0,0.0
1003,1068,2020-03-18 16:14:00,1,2008.0,1890.0,0.941,10.003,133,1,0,1,132,95,37,0,0.0,0.0
1003,1069,2020-03-18 16:17:00,1,1860.0,1736.0,0.934,9.25,192,0,0,0,192,131,61,0,0.0,0.0
1003,1070,2020-03-18 16:20:00,1,1633.0,1551.0,0.95,8.153,112,0,0,0,112,48,64,0,0.0,0.0
1003,1071,2020-03-18 16:23:00,1,1580.0,1469.0,0.93,7.85,57,0,0,0,57,2,55,0,0.0,0.0
1003,1072,2020-03-18 16:26:00,1,1427.0,1336.0,0.937,7.101,66,3,0,3,63,19,44,0,0.0,0.0
1003,1073,2020-03-18 16:29:00,1,1456.0,1287.0,0.884,7.161,148,0,0,0,148,89,59,0,0.0,0.0
1003,1074,2020-03-18 16:32:00,1,1210.0,1204.0,0.995,6.1,158,0,0,0,158,122,36,0,0.0,0.0
1003,1075,2020-03-18 16:35:00,1,1250.0,1200.0,0.961,6.253,177,11,7,4,166,118,48,0,0.0,0.0
1003,1076,2020-03-18 16:38:00,1,1405.0,1299.0,0.925,6.973,3,0,0,0,3,0,3,0,0.0,0.0
1003,1077,2020-03-18 16:41:00,1,1504.0,1438.0,0.956,7.518,10,0,0,0,10,8,2,0,0.0,0.0
1003,1078,2020-03-18 16:44:00,1,1380.0,1372.0,0.994,6.954,93,8,0,8,85,36,49,0,0.0,0.0
1003,1079,2020-03-18 16:47:00,1,1424.0,1373.0,0.964,7.13,51,0,0,0,51,0,51,0,0.0,0.0
1003,1080,2020-03-18 16:50:00,1,1411.0,1298.0,0.92,6.995,41,0,0,0,41,0,41,0,0.0,0.0
1003,1081,2020-03-18 16:53:00,1,1450.0,1297.0,0.895,7.149,59,4,0,4,55,1,54,0,0.0,0.0
1003,1082,2020-03-18 16:56:00,1,1452.5,1312.5,0.904,7.176,55,1,0,1,54,12,42,0,0.0,0.0
1003,1083,2020-03-18 16:59:00,1,1455.0,1328.0,0.913,7.203,58,7,0,7,51,7,44,2,0.0,0.0
1003,1084,2020-03-18 17:02:00,1,1606.0,1464.0,0.912,7.951,68,19,0,19,49,4,45,7,0.0,0.0
1003,1085,2020-03-18 17:05:00,1,1404.0,1392.0,0.991,7.073,53,2,0,2,51,0,51,0,0.0,0.0
1003,1086,2020-03-18 17:08:00,1,1405.0,1401.0,0.997,7.086,46,1,0,1,45,0,45,0,0.0,0.0
1003,1087,2020-03-18 17:11:00,1,1585.0,1428.0,0.901,7.825,50,1,0,1,49,0,49,0,0.0,0.0
1003,1088,2020-03-18 17:14:00,1,1491.0,1418.0,0.952,7.443,46,13,0,13,33,0,33,0,0.0,0.0
1003,1089,2020-03-18 17:17:00,1,1483.0,1411.0,0.952,7.403,46,15,11,4,31,9,22,1,0.0,0.0
1003,1090,2020-03-18 17:20:00,1,1595.0,1443.0,0.905,7.88,22,0,0,0,22,0,22,0,0.0,0.0
1003,1091,2020-03-18 17:23:00,1,1599.0,1431.0,0.895,7.883,75,13,5,8,62,13,49,0,0.0,0.0
1003,1092,2020-03-18 17:26:00,1,1582.0,1409.0,0.891,7.793,61,5,1,4,56,6,50,0,0.0,0.0
1003,1093,2020-03-18 17:29:00,1,1573.0,1520.0,0.966,7.88,217,103,82,21,114,73,41,25,0.0,0.0
1003,1094,2020-03-18 17:32:00,1,1861.0,1718.0,0.923,9.234,210,99,46,53,111,58,53,41,0.0,0.0
1003,1095,2020-03-18 17:35:00,1,1842.0,1843.0,1.0,9.296,133,53,17,36,80,49,31,1,0.0,0.0
1003,1096,2020-03-18 17:38:00,1,1993.0,1837.0,0.922,9.885,148,54,11,43,94,49,45,10,0.0,0.0
1003,1097,2020-03-18 17:41:00,1,2052.0,2004.0,0.977,10.302,230,120,64,56,110,64,46,23,0.0,0.0
1003,1098,2020-03-18 17:44:00,1,2279.0,2149.0,0.943,11.359,271,95,59,36,176,122,54,17,0.0,0.0
1003,1099,2020-03-18 17:47:00,1,2238.0,2179.0,0.973,11.23,798,488,399,89,310,230,80,139,0.0,0.0
1003,1100,2020-03-18 17:50:00,1,2498.0,2271.0,0.909,12.356,380,125,79,46,255,179,76,83,0.0,0.0
1003,1101,2020-03-18 17:53:00,1,2366.0,2291.0,0.968,11.857,347,152,84,68,195,130,65,81,0.0,0.0
1003,1102,2020-03-18 17:56:00,1,2702.0,2573.0,0.952,13.494,438,128,64,64,310,224,86,91,0.0,0.0
1003,1103,2020-03-18 17:59:00,1,1867.0,1701.0,0.911,9.239,112,51,18,33,61,16,45,12,0.0,0.0
1003,1104,2020-03-18 18:02:00,0,1599.0,1416.0,0.885,7.87,42,1,0,1,41,8,33,0,0.0,0.0
1003,1105,2020-03-18 18:05:00,0,1403.0,1325.0,0.944,6.994,48,4,1,3,44,19,25,0,0.0,0.0
1003,1106,2020-03-18 18:08:00,0,1279.0,1166.0,0.911,6.332,145,46,37,9,99,58,41,12,0.0,0.0
1003,1107,2020-03-18 18:11:00,0,2315.0,2152.0,0.93,11.505,468,260,202,58,208,150,58,89,0.0,0.0
1003,1108,2020-03-18 18:14:00,0,2816.0,2596.0,0.922,13.967,462,208,149,59,254,179,75,101,0.0,0.0
1003,1109,2020-03-18 18:17:00,0,2405.0,2227.0,0.926,11.94,579,390,297,93,189,137,52,211,0.0,0.0
1003,1110,2020-03-18 18:20:00,0,2727.0,2628.0,0.964,13.653,592,378,300,78,214,163,51,193,0.0,0.0
1003,1111,2020-03-18 18:23:00,0,2876.0,2733.0,0.95,14.357,367,200,140,60,167,103,64,83,0.0,0.01
1003,1112,2020-03-18 18:26:00,0,3276.0,2970.0,0.907,16.195,307,113,64,49,194,125,69,82,0.0,0.0
1003,1113,2020-03-18 18:29:00,0,2869.0,2725.0,0.95,14.321,263,96,56,40,167,117,50,57,0.27,0.07
1003,1114,2020-03-18 18:32:00,0,2467.0,2299.0,0.932,12.264,436,226,177,49,210,148,62,98,0.0,0.01
1003,1115,2020-03-18 18:35:00,0,2421.0,2357.0,0.974,12.148,528,324,248,76,204,143,61,90,0.0,0.0
1003,1116,2020-03-18 18:38:00,0,2027.0,1827.0,0.901,10.011,205,49,9,40,156,112,44,51,0.0,0.0
1003,1117,2020-03-18 18:41:00,0,2428.0,2182.0,0.899,11.981,321,165,119,46,156,104,52,105,0.0,0.0
1003,1118,2020-03-18 18:44:00,0,3060.0,2869.0,0.937,15.234,239,48,14,34,191,131,60,45,0.0,0.0
1003,1119,2020-03-18 18:47:00,0,3288.0,3142.0,0.956,16.433,226,78,40,38,148,98,50,36,0.0,0.06
1003,1120,2020-03-18 18:50:00,0,3407.0,3243.0,0.952,17.014,195,36,8,28,159,113,46,26,0.0,0.1
1003,1121,2020-03-18 18:53:00,0,2866.0,2679.0,0.935,14.258,213,91,51,40,122,85,37,35,0.0,0.01
1003,1122,2020-03-18 18:56:00,0,2175.0,2037.0,0.936,10.826,14,13,0,13,1,0,1,0,0.0,0.0
1003,1123,2020-03-18 18:59:00,0,1829.0,1778.0,0.973,9.173,16,5,1,4,11,6,5,0,0.0,0.01
1003,1124,2020-03-18 19:02:00,0,1856.0,1679.0,0.904,9.173,177,94,64,30,83,43,40,33,0.0,0.0
1003,1125,2020-03-18 19:05:00,0,2963.0,2888.0,0.975,14.872,315,69,28,41,246,161,85,55,0.0,0.0
1003,1126,2020-03-18 19:08:00,0,3034.0,2901.0,0.956,15.165,172,58,30,28,114,77,37,26,0.1,0.02
1003,1127,2020-03-18 19:11:00,0,3007.0,2831.0,0.941,14.982,358,151,103,48,207,129,78,107,0.03,0.05
1003,1128,2020-03-18 19:14:00,0,2276.0,2087.0,0.917,11.279,556,312,233,79,244,166,78,149,0.01,0.01
1003,1129,2020-03-18 19:17:00,0,3226.0,2996.0,0.929,16.027,468,173,109,64,295,196,99,74,0.0,0.0
1003,1130,2020-03-18 19:20:00,0,3360.0,3112.0,0.926,16.685,414,200,138,62,214,138,76,69,0.11,0.07
1003,1131,2020-03-18 19:23:00,0,2257.0,2126.0,0.942,11.244,183,69,42,27,114,73,41,14,0.0,0.02
1003,1132,2020-03-18 19:26:00,0,2044.0,1943.0,0.95,10.204,453,198,130,68,255,173,82,92,0.0,0.0
1003,1133,2020-03-18 19:29:00,0,3401.0,3343.0,0.983,17.102,346,151,91,60,195,135,60,70,0.05,0.03
1003,1134,2020-03-18 19:32:00,0,3331.0,3093.0,0.928,16.547,834,548,446,102,286,206,80,145,0.06,0.03
1003,1135,2020-03-18 19:35:00,0,3262.0,3137.0,0.962,16.323,220,134,75,59,86,46,40,84,0.0,0.0
1003,1136,2020-03-18 19:38:00,0,3399.0,3359.0,0.988,17.11,435,249,178,71,186,129,57,80,0.0,0.1
1003,1137,2020-03-18 19:41:00,0,3383.0,3218.0,0.951,16.893,252,144,83,61,108,64,44,59,0.07,0.1
1003,1138,2020-03-18 19:44:00,0,2440.0,2259.0,0.926,12.115,457,221,160,61,236,151,85,75,0.01,0.01
1003,1139,2020-03-18 19:47:00,0,2767.0,2712.0,0.98,13.906,453,243,186,57,210,158,52,30,0.0,0.0
1003,1140,2020-03-18 19:50:00,0,3027.0,2871.0,0.949,15.105,245,126,91,35,119,84,35,15,0.06,0.0
1003,1141,2020-03-18 19:53:00,0,2486.0,2460.0,0.989,12.517,44,2,1,1,42,7,35,0,0.0,0.0
1003,1142,2020-03-18 19:56:00,0,2197.5,2162.5,0.983,11.0505,53,2,0,2,51,14,37,0,0.0,0.0
1003,1143,2020-03-18 19:59:00,0,1909.0,1865.0,0.977,9.584,76,4,2,2,72,23,49,0,0.0,0.0
1003,1144,2020-03-18 20:02:00,0,1650.0,1621.0,0.982,8.296,71,15,6,9,56,15,41,0,0.0,0.0
1003,1145,2020-03-18 20:05:00,0,1499.0,1437.0,0.958,7.497,5,2,0,2,3,1,2,0,0.0,0.0
1003,1146,2020-03-18 20:08:00,0,1440.0,1238.0,0.86,7.043,105,21,6,15,84,52,32,10,0.0,0.0
1003,1147,2020-03-18 20:11:00,0,1446.0,1340.0,0.927,7.179,491,226,159,67,265,184,81,69,0.0,0.0
1003,1148,2020-03-18 20:14:00,0,3000.0,2858.0,0.953,14.983,337,187,118,69,150,81,69,99,0.0,0.0
1003,1149,2020-03-18 20:17:00,0,3285.0,3118.0,0.949,16.396,314,141,83,58,173,111,62,65,0.0,0.0
1003,1150,2020-03-18 20:20:00,0,3271.0,3164.0,0.967,16.391,211,75,38,37,136,80,56,48,0.01,0.14
1003,1151,2020-03-18 20:23:00,0,2945.0,2904.0,0.986,14.818,244,144,86,58,100,46,54,83,0.13,0.07
1003,1152,2020-03-18 20:26:00,0,3261.0,3156.0,0.968,16.341,731,411,325,86,320,233,87,88,0.05,0.04
1003,1153,2020-03-18 20:29:00,0,3432.0,3473.0,1.012,17.367,724,434,339,95,290,214,76,93,0.01,0.01
1003,1154,2020-03-18 20:32:00,0,3232.0,3152.0,0.975,16.225,293,169,104,65,124,56,68,99,0.0,0.0
1003,1155,2020-03-18 20:35:00,0,3511.0,3422.0,0.975,17.623,332,200,134,66,132,67,65,78,0.09,0.04
1003,1156,2020-03-18 20:38:00,0,2393.0,2268.0,0.948,11.94,477,269,200,69,208,133,75,85,0.09,0.03
1003,1157,2020-03-18 20:41:00,0,3414.0,3373.0,0.988,17.186,468,253,188,65,215,156,59,67,0.0,0.02
1003,1158,2020-03-18 20:44:00,0,3371.0,3173.0,0.941,16.793,455,245,190,55,210,130,80,70,0.08,0.01
1003,1159,2020-03-18 20:47:00,0,2180.0,2081.0,0.955,10.895,597,304,237,67,293,208,85,110,0.0,0.01
1003,1160,2020-03-18 20:50:00,0,3141.0,2916.0,0.928,15.603,368,122,80,42,246,170,76,65,0.0,0.0
1003,1161,2020-03-18 20:53:00,0,3451.0,3299.0,0.956,17.249,310,81,37,44,229,158,71,50,0.0,0.07
1003,1162,2020-03-18 20:56:00,0,3258.0,3083.0,0.946,16.248,358,113,66,47,245,175,70,69,0.07,0.09
1003,1163,2020-03-18 20:59:00,0,2570.0,2571.0,1.0,12.971,348,188,139,49,160,110,50,32,0.01,0.0
1003,1164,2020-03-18 21:02:00,0,2256.0,2186.0,0.969,11.308,261,103,51,52,158,97,61,9,0.0,0.0
1003,1165,2020-03-18 21:05:00,0,1927.0,1891.0,0.981,9.684,417,210,158,52,207,140,67,21,0.0,0.0
1003,1166,2020-03-18 21:08:00,0,2536.0,2507.0,0.989,12.767,55,14,11,3,41,18,23,0,0.0,0.0
1003,1167,2020-03-18 21:11:00,0,2472.0,2355.0,0.953,12.347,21,7,4,3,14,8,6,0,0.0,0.0
1003,1168,2020-03-18 21:14:00,0,1932.0,1948.0,1.008,9.768,11,0,0,0,11,0,11,0,0.0,0.0
1003,1169,2020-03-18 21:17:00,0,1829.0,1690.0,0.924,9.076,177,67,35,32,110,48,62,18,0.0,0.0
1003,1170,2020-03-18 21:20:00,0,2529.0,2449.0,0.968,12.675,263,197,132,65,66,31,35,109,0.0,0.06
1003,1171,2020-03-18 21:23:00,0,2938.0,2861.0,0.974,14.744,255,172,109,63,83,38,45,100,0.0,0.05
1003,1172,2020-03-18 21:26:00,0,3250.0,3092.0,0.951,16.228,278,186,110,76,92,38,54,111,0.0,0.04
1003,1173,2020-03-18 21:29:00,0,3205.0,3032.0,0.946,15.985,285,185,117,68,100,59,41,89,0.28,0.1
1003,1174,2020-03-18 21:32:00,0,2007.0,1991.0,0.992,10.11,236,107,63,44,129,88,41,16,0.0,0.01
1003,1175,2020-03-18 21:35:00,0,2595.0,2544.0,0.98,13.041,839,514,408,106,325,261,64,153,0.0,0.02
1003,1176,2020-03-18 21:38:00,0,3230.0,3022.0,0.936,16.071,340,209,130,79,131,87,44,107,0.0,0.05
1003,1177,2020-03-18 21:41:00,0,3304.0,3184.0,0.963,16.544,252,179,107,72,73,32,41,107,0.0,0.11
1003,1178,2020-03-18 21:44:00,0,3193.0,3108.0,0.973,16.021,527,241,188,53,286,206,80,37,0.03,0.0
1003,1179,2020-03-18 21:47:00,0,2388.0,2333.0,0.977,11.992,116,18,5,13,98,54,44,2,0.0,0.0
1003,1180,2020-03-18 21:50:00,0,2279.0,2218.0,0.973,11.433,165,92,69,23,73,43,30,0,0.0,0.0
1003,1181,2020-03-18 21:53:00,0,1880.0,1813.0,0.964,9.415,25,1,0,1,24,1,23,0,0.0,0.0
1003,1182,2020-03-18 21:56:00,0,1856.0,1646.0,0.887,9.135,24,1,0,1,23,0,23,0,0.0,0.0
1003,1183,2020-03-18 21:59:00,0,2484.0,2381.0,0.959,12.421,48,3,1,2,45,18,27,0,0.0,0.01
1003,1184,2020-03-18 22:02:00,0,2728.0,2692.0,0.987,13.729,27,0,0,0,27,0,27,0,0.0,0.0
1003,1185,2020-03-18 22:05:00,0,2644.0,2689.0,1.017,13.395,60,17,11,6,43,16,27,0,0.0,0.0
1003,1186,2020-03-18 22:08:00,0,2605.0,2633.0,1.011,13.178,34,4,2,2,30,6,24,0,0.0,0.0
1003,1187,2020-03-18 22:11:00,0,2224.0,2278.0,1.024,11.286,35,0,0,0,35,4,31,0,0.0,0.0
1003,1188,2020-03-18 22:14:00,0,2099.0,2132.0,1.016,10.629,240,75,56,19,165,104,61,8,0.0,0.0
1003,1189,2020-03-18 22:17:00,0,2394.0,2399.0,1.002,12.086,263,150,97,53,113,57,56,96,0.0,0.02
1003,1190,2020-03-18 22:20:00,0,2500.0,2603.0,1.041,12.733,187,86,56,30,101,49,52,123,0.0,0.11
1003,1191,2020-03-18 22:23:00,0,2805.0,2741.0,0.977,14.088,378,174,125,49,204,136,68,103,0.18,0.17
1003,1192,2020-03-18 22:26:00,0,2417.0,2322.0,0.961,12.093,584,286,220,66,298,221,77,37,0.0,0.0
1003,1193,2020-03-18 22:29:00,0,2219.0,2194.0,0.989,11.171,1170,586,443,143,584,455,129,8,0.0,0.0
1003,1194,2020-03-18 22:32:00,0,3000.0,2952.0,0.984,15.087,839,515,413,102,324,237,87,71,0.0,0.0
1003,1195,2020-03-18 22:35:00,0,2996.0,2901.0,0.968,15.014,1150,735,614,121,415,326,89,31,0.16,0.0
1003,1196,2020-03-18 22:38:00,0,2847.0,2785.0,0.978,14.301,329,197,147,50,132,92,40,73,0.0,0.18
1003,1197,2020-03-18 22:41:00,0,2764.0,2773.0,1.003,13.961,23,0,0,0,23,0,23,0,0.0,0.0
1003,1198,2020-03-18 22:44:00,0,2740.0,2749.0,1.003,13.84,144,49,36,13,95,57,38,0,0.0,0.01
1003,1199,2020-03-18 22:47:00,0,2597.0,2482.0,0.956,12.979,670,359,280,79,311,230,81,13,0.0,0.0
1003,1200,2020-03-18 22:50:00,0,2956.0,2918.0,0.987,14.876,864,527,439,88,337,267,70,56,0.0,0.01
1003,1201,2020-03-18 22:53:00,0,3211.0,3097.0,0.965,16.078,497,319,253,66,178,117,61,105,0.68,0.0
1003,1202,2020-03-18 22:56:00,0,3209.5,3061.5,0.954,16.034,221,128,107,21,93,66,27,13,0.0,0.0
1003,1203,2020-03-18 22:59:00,0,3208.0,3026.0,0.943,15.99,613,367,306,61,246,179,67,14,0.0,0.02
1003,1204,2020-03-18 23:02:00,0,2832.0,2800.0,0.989,14.256,908,545,458,87,363,278,85,7,0.0,0.0
1003,1205,2020-03-18 23:05:00,0,2989.0,2935.0,0.982,15.027,714,446,367,79,268,200,68,16,0.0,0.0
1003,1206,2020-03-18 23:08:00,0,2768.0,2685.0,0.97,13.878,904,590,497,93,314,250,64,50,0.0,0.01
1003,1207,2020-03-18 23:11:00,0,2565.0,2524.0,0.984,12.9,346,177,127,50,169,113,56,68,0.0,0.0
1003,1208,2020-03-18 23:14:00,0,2805.0,2752.0,0.981,14.097,420,237,176,61,183,133,50,54,0.0,0.0
1003,1209,2020-03-18 23:17:00,0,2885.0,2854.0,0.989,14.524,365,185,130,55,180,128,52,37,0.0,0.0
1003,1210,2020-03-18 23:20:00,0,2864.0,2776.0,0.969,14.359,498,337,270,67,161,115,46,19,0.0,0.0
1003,1211,2020-03-18 23:23:00,0,2737.0,2661.0,0.972,13.731,229,59,23,36,170,106,64,3,0.0,0.0
1003,1212,2020-03-18 23:26:00,0,2808.0,2761.0,0.983,14.118,130,48,13,35,82,49,33,0,0.0,0.0
1003,1213,2020-03-18 23:29:00,0,2794.0,2697.0,0.965,13.993,597,349,276,73,248,186,62,8,0.0,0.0
1003,1214,2020-03-18 23:32:00,0,2642.0,2646.0,1.001,13.338,1466,1056,872,184,410,316,94,7,0.0,0.05
1003,1215,2020-03-18 23:35:00,0,2556.0,2542.0,0.995,12.886,1593,1228,1045,183,365,277,88,18,0.0,0.0
1003,1216,2020-03-18 23:38:00,0,2460.0,2499.0,1.016,12.46,775,531,430,101,244,187,57,59,0.0,0.0
1003,1217,2020-03-18 23:41:00,0,2854.0,2746.0,0.962,14.284,262,168,95,73,94,41,53,106,0.0,0.0
1003,1218,2020-03-18 23:44:00,0,2526.0,2557.0,1.013,12.783,830,410,327,83,420,317,103,70,0.0,0.0
1003,1219,2020-03-18 23:47:00,0,2586.0,2514.0,0.972,12.969,1076,705,585,120,371,271,100,14,0.0,0.01
1003,1220,2020-03-18 23:50:00,0,2397.0,2349.0,0.98,12.046,586,353,264,89,233,151,82,15,0.0,0.0
1003,1221,2020-03-18 23:53:00,0,2603.0,2529.0,0.972,13.054,1127,592,475,117,535,446,89,18,0.0,0.0
1003,1222,2020-03-18 23:56:00,0,2584.0,2601.0,1.006,13.062,621,361,275,86,260,195,65,16,0.0,0.0
1003,1223,2020-03-18 23:59:00,0,2656.0,2688.0,1.012,13.441,574,364,281,83,210,140,70,73,0.0,0.0
1003,1224,2020-03-19 00:02:00,0,2778.0,2722.0,0.98,13.96,249,206,128,78,43,0,43,97,0.0,0.0
1003,1225,2020-03-19 00:05:00,0,2422.0,2459.0,1.015,12.263,429,177,115,62,252,187,65,11,0.0,0.01
1003,1226,2020-03-19 00:08:00,0,1960.0,1947.0,0.993,9.878,159,68,33,35,91,40,51,3,0.0,0.0
1003,1227,2020-03-19 00:11:00,0,2300.0,2192.0,0.953,11.489,106,28,7,21,78,28,50,1,0.0,0.0
1003,1228,2020-03-19 00:14:00,0,2433.0,2405.0,0.989,12.246,63,3,2,1,60,3,57,0,0.0,0.0
1003,1229,2020-03-19 00:17:00,0,2418.0,2422.0,1.002,12.206,62,0,0,0,62,0,62,0,0.0,0.0
1003,1230,2020-03-19 00:20:00,0,2352.0,2327.0,0.989,11.842,60,0,0,0,60,2,58,0,0.0,0.0
1003,1231,2020-03-19 00:23:00,0,1972.0,2080.0,1.055,10.073,89,13,12,1,76,19,57,0,0.0,0.0
1003,1232,2020-03-19 00:26:00,0,1954.0,2084.0,1.067,10.004,71,0,0,0,71,0,71,0,0.0,0.0
1003,1233,2020-03-19 00:29:00,0,1957.0,2024.0,1.034,9.952,97,6,1,5,91,24,67,0,0.0,0.0
1003,1234,2020-03-19 00:32:00,0,1786.0,1910.0,1.069,9.151,141,10,3,7,131,54,77,0,0.0,0.0
1003,1235,2020-03-19 00:35:00,0,1851.0,1852.0,1.001,9.342,209,21,11,10,188,105,83,0,0.0,0.0
1003,1236,2020-03-19 00:38:00,0,1841.0,1767.0,0.959,9.211,86,12,6,6,74,2,72,0,0.0,0.0
1003,1237,2020-03-19 00:41:00,0,1604.0,1661.0,1.035,8.158,110,27,6,21,83,26,57,0,0.0,0.0
1003,1238,2020-03-19 00:44:00,0,1568.0,1660.0,1.059,8.014,101,15,7,8,86,15,71,0,0.0,0.0
1003,1239,2020-03-19 00:47:00,0,1614.0,1644.0,1.019,8.181,64,1,0,1,63,6,57,0,0.0,0.0
1003,1240,2020-03-19 00:50:00,0,1827.0,1782.0,0.975,9.169,511,281,213,68,230,145,85,6,0.0,0.0
1003,1241,2020-03-19 00:53:00,0,1955.0,1937.0,0.991,9.845,911,512,385,127,399,288,111,15,0.0,0.0
1003,1242,2020-03-19 00:56:00,0,2171.0,2192.0,1.009,10.982,1036,507,382,125,529,390,139,14,0.0,0.0
1003,1243,2020-03-19 00:59:00,0,2343.0,2323.0,0.991,11.801,1236,712,541,171,524,395,129,27,0.0,0.0
1003,1244,2020-03-19 01:02:00,0,2392.0,2453.0,1.026,12.139,1171,695,551,144,476,375,101,52,0.0,0.0
1003,1245,2020-03-19 01:05:00,0,2523.0,2573.0,1.02,12.79,854,591,458,133,263,193,70,52,0.0,0.0
1003,1246,2020-03-19 01:08:00,0,2570.0,2542.0,0.989,12.938,507,398,297,101,109,72,37,21,0.0,0.48
1003,1247,2020-03-19 01:11:00,0,2560.0,2553.0,0.997,12.913,206,167,106,61,39,20,19,35,0.0,0.0
1003,1248,2020-03-19 01:14:00,0,2575.0,2509.0,0.975,12.923,227,156,89,67,71,25,46,128,0.0,0.0
1003,1249,2020-03-19 01:17:00,0,2751.0,2731.0,0.993,13.862,140,82,33,49,58,0,58,123,0.0,0.0
1003,1250,2020-03-19 01:20:00,0,2861.0,2819.0,0.985,14.393,120,72,33,39,48,4,44,116,0.0,0.0
1003,1251,2020-03-19 01:23:00,0,2971.0,2898.0,0.976,14.914,421,250,189,61,171,114,57,79,0.0,0.0
1003,1252,2020-03-19 01:26:00,0,3319.0,3233.0,0.974,16.656,597,391,309,82,206,158,48,67,0.0,0.0
1003,1253,2020-03-19 01:29:00,0,2557.0,2467.0,0.965,12.805,901,536,438,98,365,277,88,102,0.07,0.0
1003,1254,2020-03-19 01:32:00,0,2995.0,2911.0,0.972,15.024,939,581,472,109,358,260,98,14,0.0,0.0
1003,1255,2020-03-19 01:35:00,0,3244.0,3129.0,0.965,16.246,918,486,396,90,432,329,103,139,0.0,0.0
1003,1256,2020-03-19 01:38:00,0,3009.0,3002.0,0.998,15.179,627,382,300,82,245,183,62,137,0.0,0.0
1003,1257,2020-03-19 01:41:00,0,3308.0,3210.0,0.97,16.589,511,217,152,65,294,224,70,42,0.0,0.0
1003,1258,2020-03-19 01:44:00,0,2939.0,2906.0,0.989,14.798,572,399,318,81,173,126,47,27,0.0,0.0
1003,1259,2020-03-19 01:47:00,0,2598.0,2553.0,0.983,13.061,226,70,32,38,156,104,52,2,0.0,0.0
1003,1260,2020-03-19 01:50:00,0,2937.0,2809.0,0.956,14.682,152,42,5,37,110,63,47,1,0.0,0.0
1003,1261,2020-03-19 01:53:00,0,2956.0,2960.0,1.001,14.925,223,54,19,35,169,106,63,0,0.0,0.0
1003,1262,2020-03-19 01:56:00,0,2889.5,2847.0,0.9845,14.5375,822,479,393,86,343,257,86,22,0.0,0.0
1003,1263,2020-03-19 01:59:00,0,2823.0,2734.0,0.968,14.15,1380,898,740,158,482,373,109,12,0.0,0.0
1003,1264,2020-03-19 02:02:00,0,2855.0,2728.0,0.956,14.269,522,368,292,76,154,95,59,114,0.0,0.0
1003,1265,2020-03-19 02:05:00,0,2901.0,2839.0,0.979,14.575,235,161,101,60,74,37,37,138,0.0,0.0
1003,1266,2020-03-19 02:08:00,0,2964.0,2917.0,0.984,14.909,665,433,353,80,232,186,46,111,0.0,0.0
1003,1267,2020-03-19 02:11:00,0,3010.0,2901.0,0.964,15.073,291,154,108,46,137,89,48,58,0.0,0.0
1003,1268,2020-03-19 02:14:00,0,2421.0,2282.0,0.943,12.064,585,287,229,58,298,229,69,15,0.0,0.0
1003,1269,2020-03-19 02:17:00,0,2789.0,2725.0,0.977,14.007,1284,818,690,128,466,357,109,13,0.0,0.01
1003,1270,2020-03-19 02:20:00,0,2702.0,2652.0,0.981,13.582,1750,1084,922,162,666,533,133,16,0.12,0.0
1003,1271,2020-03-19 02:23:00,0,2775.0,2701.0,0.973,13.924,1216,698,588,110,518,410,108,13,0.02,0.0
1003,1272,2020-03-19 02:26:00,0,3048.0,2911.0,0.955,15.233,729,471,385,86,258,192,66,25,0.0,0.0
1003,1273,2020-03-19 02:29:00,0,2803.0,2791.0,0.996,14.132,880,654,551,103,226,162,64,8,0.0,0.0
1003,1274,2020-03-19 02:32:00,0,2916.0,2861.0,0.981,14.656,704,425,357,68,279,200,79,24,0.0,0.0
1003,1275,2020-03-19 02:35:00,0,2405.0,2426.0,1.008,12.162,623,308,243,65,315,241,74,3,0.0,0.0
1003,1276,2020-03-19 02:38:00,0,2832.0,2710.0,0.957,14.16,506,227,170,57,279,200,79,1,0.0,0.0
1003,1277,2020-03-19 02:41:00,0,2837.0,2696.0,0.95,14.162,180,48,19,29,132,87,45,1,0.0,0.0
1003,1278,2020-03-19 02:44:00,0,2613.0,2595.0,0.993,13.167,237,117,71,46,120,58,62,0,0.0,0.0
1003,1279,2020-03-19 02:47:00,0,2769.0,2691.0,0.972,13.887,163,24,8,16,139,89,50,0,0.0,0.0
1003,1280,2020-03-19 02:50:00,0,2409.0,2449.0,1.017,12.205,151,3,1,2,148,90,58,0,0.0,0.0
1003,1281,2020-03-19 02:53:00,0,2160.0,2106.0,0.975,10.842,108,5,0,5,103,85,18,0,0.0,0.0
1003,1282,2020-03-19 02:56:00,0,1969.0,2012.0,1.022,9.983,1189,702,569,133,487,371,116,10,0.0,0.0
1003,1283,2020-03-19 02:59:00,0,2272.0,2141.0,0.942,11.322,1130,569,427,142,561,425,136,13,0.0,0.0
1003,1284,2020-03-19 03:02:00,0,2262.0,2166.0,0.958,11.31,996,608,467,141,388,291,97,5,0.0,0.0
1003,1285,2020-03-19 03:05:00,0,2335.0,2261.0,0.968,11.704,982,588,477,111,394,302,92,3,0.0,0.0
1003,1286,2020-03-19 03:08:00,0,2363.0,2354.0,0.996,11.917,1275,805,687,118,470,362,108,83,0.0,0.0
1003,1287,2020-03-19 03:11:00,0,2599.0,2537.0,0.976,13.049,236,127,87,40,109,62,47,92,0.0,0.0
1003,1288,2020-03-19 03:14:00,0,2795.0,2711.0,0.97,14.012,170,35,10,25,135,78,57,19,0.0,0.0
1003,1289,2020-03-19 03:17:00,0,2476.0,2489.0,1.005,12.511,1079,591,500,91,488,383,105,22,0.0,0.05
1003,1290,2020-03-19 03:20:00,0,2376.0,2298.0,0.967,11.905,1075,571,473,98,504,386,118,178,0.0,0.0
1003,1291,2020-03-19 03:23:00,0,2570.0,2592.0,1.009,12.993,735,444,352,92,291,226,65,23,0.0,0.0
1003,1292,2020-03-19 03:26:00,0,2713.0,2650.0,0.977,13.624,1565,907,781,126,658,516,142,16,0.22,0.01
1003,1293,2020-03-19 03:29:00,0,2791.0,2814.0,1.008,14.113,930,578,469,109,352,282,70,90,0.0,0.01
1003,1294,2020-03-19 03:32:00,0,2586.0,2571.0,0.994,13.036,592,294,226,68,298,218,80,4,0.0,0.0
1003,1295,2020-03-19 03:35:00,0,2966.0,2846.0,0.96,14.835,759,479,386,93,280,196,84,3,0.0,0.0
1003,1296,2020-03-19 03:38:00,0,2808.0,2731.0,0.972,14.088,357,191,141,50,166,120,46,24,0.0,0.04
1003,1297,2020-03-19 03:41:00,0,2899.0,2842.0,0.98,14.567,97,24,2,22,73,50,23,16,0.0,0.06
1003,1298,2020-03-19 03:44:00,0,2989.0,2895.0,0.968,14.982,127,33,4,29,94,55,39,31,0.0,0.11
1003,1299,2020-03-19 03:47:00,0,2761.0,2846.0,1.031,14.027,431,165,106,59,266,196,70,19,0.0,0.03
1003,1300,2020-03-19 03:50:00,0,2571.0,2474.0,0.962,12.868,1556,851,709,142,705,573,132,3,0.0,0.01
1003,1301,2020-03-19 03:53:00,0,2621.0,2580.0,0.984,13.181,942,555,442,113,387,288,99,4,0.0,0.0
1003,1302,2020-03-19 03:56:00,0,2823.0,2701.0,0.957,14.113,1099,755,627,128,344,260,84,11,0.24,0.0
1003,1303,2020-03-19 03:59:00,0,3092.0,3032.0,0.981,15.539,801,501,417,84,300,221,79,25,0.0,0.02
1003,1304,2020-03-19 04:02:00,0,2835.0,2872.0,1.013,14.35,1123,669,550,119,454,355,99,23,0.0,0.0
1003,1305,2020-03-19 04:05:00,0,2858.0,2840.0,0.994,14.404,1559,945,794,151,614,498,116,9,0.0,0.01
1003,1306,2020-03-19 04:08:00,0,2787.0,2783.0,0.999,14.062,166,84,36,48,82,38,44,35,0.0,0.0
1003,1307,2020-03-19 04:11:00,0,2788.0,2808.0,1.007,14.093,188,101,37,64,87,42,45,7,0.0,0.0
1003,1308,2020-03-19 04:14:00,0,2809.0,2717.0,0.967,14.075,46,17,7,10,29,13,16,1,0.0,0.0
1003,1309,2020-03-19 04:17:00,0,2379.0,2387.0,1.003,12.014,4,2,1,1,2,0,2,0,0.0,0.0
1003,1310,2020-03-19 04:20:00,0,2247.0,2195.0,0.977,11.281,7,3,0,3,4,1,3,0,0.0,0.0
1003,1311,2020-03-19 04:23:00,0,1951.0,2010.0,1.03,9.912,8,4,0,4,4,3,1,0,0.0,0.0
1003,1312,2020-03-19 04:26:00,0,1826.0,1896.0,1.038,9.292,0,0,0,0,0,0,0,0,0.0,0.0
1003,1313,2020-03-19 04:29:00,0,1838.0,1717.0,0.934,9.143,7,2,0,2,5,1,4,0,0.0,0.0
1003,1314,2020-03-19 04:32:00,0,1533.0,1590.0,1.037,7.8,6,2,0,2,4,2,2,0,0.0,0.0
1003,1315,2020-03-19 04:35:00,0,1579.0,1597.0,1.012,7.987,11,11,0,11,0,0,0,0,0.0,0.0
1003,1316,2020-03-19 04:38:00,0,1565.0,1671.0,1.068,8.016,6,5,0,5,1,0,1,0,0.0,0.0
1003,1317,2020-03-19 04:41:00,0,1555.0,1607.0,1.033,7.907,1,1,0,1,0,0,0,0,0.0,0.0
1003,1318,2020-03-19 04:44:00,0,1600.0,1591.0,0.994,8.065,57,24,15,9,33,12,21,0,0.0,0.0
1003,1319,2020-03-19 04:47:00,0,1560.0,1565.0,1.003,7.881,61,8,2,6,53,14,39,0,0.0,0.0
1003,1320,2020-03-19 04:50:00,0,1560.0,1612.0,1.034,7.929,12,3,1,2,9,4,5,0,0.0,0.0
1003,1321,2020-03-19 04:53:00,0,1645.0,1609.0,0.978,8.264,2,0,0,0,2,0,2,0,0.0,0.0
1003,1322,2020-03-19 04:56:00,0,1723.0,1756.5,1.0175,8.735,138,63,28,35,75,36,39,19,0.0,0.0
1003,1323,2020-03-19 04:59:00,0,1801.0,1904.0,1.057,9.206,175,64,34,30,111,62,49,6,0.0,0.0
1003,1324,2020-03-19 05:02:00,0,1766.0,1844.0,1.044,8.997,14,0,0,0,14,0,14,0,0.0,0.0
1003,1325,2020-03-19 05:05:00,0,1791.0,1706.0,0.952,8.946,17,2,0,2,15,0,15,0,0.0,0.0
1003,1326,2020-03-19 05:08:00,0,1663.0,1673.0,1.006,8.403,41,6,0,6,35,20,15,0,0.0,0.0
1003,1327,2020-03-19 05:11:00,0,1579.0,1679.0,1.063,8.081,19,1,0,1,18,5,13,0,0.0,0.0
1003,1328,2020-03-19 05:14:00,0,1644.0,1666.0,1.013,8.323,14,2,0,2,12,4,8,0,0.0,0.0
1003,1329,2020-03-19 05:17:00,0,1744.0,1704.0,0.978,8.756,53,30,4,26,23,6,17,0,0.0,0.0
1003,1330,2020-03-19 05:20:00,0,1767.0,1735.0,0.982,8.881,39,14,0,14,25,10,15,0,0.0,0.0
1003,1331,2020-03-19 05:23:00,0,1818.0,1879.0,1.034,9.241,305,102,68,34,203,143,60,0,0.0,0.0
1003,1332,2020-03-19 05:26:00,0,1993.0,1994.0,1.0,10.061,838,355,264,91,483,360,123,1,0.0,0.0
1003,1333,2020-03-19 05:29:00,0,2202.0,2179.0,0.99,11.088,536,218,156,62,318,223,95,28,0.0,0.06
1003,1334,2020-03-19 05:32:00,0,2336.0,2307.0,0.988,11.757,776,530,403,127,246,175,71,8,0.0,0.0
1003,1335,2020-03-19 05:35:00,0,2398.0,2359.0,0.984,12.058,718,374,284,90,344,256,88,24,0.0,0.0
1003,1336,2020-03-19 05:38:00,0,2398.0,2411.0,1.005,12.117,553,367,285,82,186,122,64,48,0.0,0.0
1003,1337,2020-03-19 05:41:00,0,2390.0,2511.0,1.051,12.198,1192,967,810,157,225,158,67,83,0.0,0.0
1003,1338,2020-03-19 05:44:00,0,2577.0,2560.0,0.993,12.987,180,95,56,39,85,44,41,4,0.0,0.0
1003,1339,2020-03-19 05:47:00,0,2638.0,2674.0,1.014,13.353,223,89,48,41,134,77,57,30,0.0,0.0
1003,1340,2020-03-19 05:50:00,0,2934.0,2900.0,0.988,14.77,13,7,0,7,6,5,1,0,0.0,0.02
1003,1341,2020-03-19 05:53:00,0,3231.0,3066.0,0.949,16.123,18,2,0,2,16,7,9,1,0.0,0.31
1003,1342,2020-03-19 05:56:00,0,3049.0,3008.0,0.987,15.343,18,0,0,0,18,0,18,0,0.0,0.0
1003,1343,2020-03-19 05:59:00,0,2588.0,2565.0,0.991,13.038,635,378,296,82,257,200,57,113,0.0,0.02
1003,1344,2020-03-19 06:02:00,1,2530.0,2646.0,1.046,12.898,720,403,328,75,317,246,71,85,0.03,0.0
1003,1345,2020-03-19 06:05:00,1,3110.0,3049.0,0.981,15.628,447,187,145,42,260,186,74,29,0.04,0.0
1003,1346,2020-03-19 06:08:00,1,2536.0,2515.0,0.992,12.774,686,419,347,72,267,210,57,25,0.03,0.0
1003,1347,2020-03-19 06:11:00,1,2471.0,2467.0,0.998,12.468,937,750,636,114,187,135,52,0,0.0,0.0
1003,1348,2020-03-19 06:14:00,1,2991.0,2901.0,0.97,14.998,678,468,375,93,210,151,59,31,0.08,0.0
1003,1349,2020-03-19 06:17:00,1,2978.0,2941.0,0.987,14.989,433,256,197,59,177,124,53,18,0.07,0.0
1003,1350,2020-03-19 06:20:00,1,3055.0,3014.0,0.986,15.375,740,487,397,90,253,192,61,3,0.0,0.0
1003,1351,2020-03-19 06:23:00,1,2827.0,2764.0,0.978,14.199,749,444,355,89,305,242,63,4,0.04,0.0
1003,1352,2020-03-19 06:26:00,1,2700.0,2708.0,1.003,13.637,595,333,255,78,262,191,71,12,0.04,0.0
1003,1353,2020-03-19 06:29:00,1,2725.0,2684.0,0.985,13.707,198,92,28,64,106,61,45,1,0.0,0.0
1003,1354,2020-03-19 06:32:00,1,2642.0,2668.0,1.01,13.364,168,49,19,30,119,74,45,0,0.0,0.0
1003,1355,2020-03-19 06:35:00,1,2396.0,2372.0,0.99,12.065,16,0,0,0,16,2,14,0,0.0,0.0
1003,1356,2020-03-19 06:38:00,1,2245.0,2177.0,0.97,11.255,46,9,4,5,37,15,22,0,0.0,0.0
1003,1357,2020-03-19 06:41:00,1,2244.0,2141.0,0.954,11.212,30,0,0,0,30,10,20,0,0.0,0.0
1003,1358,2020-03-19 06:44:00,1,2006.0,1919.0,0.956,10.029,27,0,0,0,27,17,10,0,0.0,0.0
1003,1359,2020-03-19 06:47:00,1,1796.0,1756.0,0.978,9.021,18,1,0,1,17,7,10,0,0.0,0.0
1003,1360,2020-03-19 06:50:00,1,1813.0,1676.0,0.924,8.997,13,0,0,0,13,3,10,0,0.0,0.0
1003,1361,2020-03-19 06:53:00,1,1774.0,1705.0,0.961,8.878,17,1,0,1,16,4,12,0,0.0,0.0
1003,1362,2020-03-19 06:56:00,1,1553.0,1581.0,1.018,7.868,17,1,0,1,16,0,16,0,0.0,0.0
1003,1363,2020-03-19 06:59:00,1,1574.0,1610.0,1.023,7.983,35,7,2,5,28,9,19,0,0.0,0.0
1003,1364,2020-03-19 07:02:00,1,1545.0,1615.0,1.046,7.875,22,2,0,2,20,8,12,0,0.0,0.0
1003,1365,2020-03-19 07:05:00,1,1532.0,1588.0,1.036,7.792,50,0,0,0,50,16,34,0,0.0,0.0
1003,1366,2020-03-19 07:08:00,1,1558.0,1636.0,1.05,7.95,12,0,0,0,12,2,10,0,0.0,0.0
1003,1367,2020-03-19 07:11:00,1,1567.0,1618.0,1.033,7.964,14,0,0,0,14,2,12,0,0.0,0.0
1003,1368,2020-03-19 07:14:00,1,1617.0,1602.0,0.991,8.144,23,0,0,0,23,2,21,0,0.0,0.0
1003,1369,2020-03-19 07:17:00,1,1552.0,1567.0,1.01,7.851,320,117,81,36,203,137,66,26,0.0,0.0
1003,1370,2020-03-19 07:20:00,1,1994.0,2014.0,1.01,10.085,27,0,0,0,27,6,21,0,0.0,0.0
1003,1371,2020-03-19 07:23:00,1,1753.0,1794.0,1.023,8.893,32,0,0,0,32,4,28,0,0.0,0.0
1003,1372,2020-03-19 07:26:00,1,1743.0,1685.0,0.967,8.734,28,0,0,0,28,0,28,0,0.0,0.0
1003,1373,2020-03-19 07:29:00,1,1568.0,1538.0,0.981,7.879,45,3,1,2,42,4,38,0,0.0,0.0
1003,1374,2020-03-19 07:32:00,1,1587.0,1559.0,0.982,7.98,35,0,0,0,35,0,35,0,0.0,0.0
1003,1375,2020-03-19 07:35:00,1,1481.0,1462.0,0.987,7.455,38,3,1,2,35,0,35,0,0.0,0.0
1003,1376,2020-03-19 07:38:00,1,1412.0,1479.0,1.048,7.201,51,14,5,9,37,6,31,0,0.0,0.0
1003,1377,2020-03-19 07:41:00,1,1444.0,1478.0,1.023,7.326,22,1,0,1,21,0,21,0,0.0,0.0
1003,1378,2020-03-19 07:44:00,1,1581.0,1637.0,1.036,8.041,128,42,17,25,86,43,43,3,0.0,0.0
1003,1379,2020-03-19 07:47:00,1,1818.0,1819.0,1.0,9.177,158,30,13,17,128,65,63,6,0.0,0.0
1003,1380,2020-03-19 07:50:00,1,1933.0,2031.0,1.051,9.864,162,30,6,24,132,73,59,0,0.0,0.0
1003,1381,2020-03-19 07:53:00,1,2167.0,2156.0,0.995,10.926,241,110,64,46,131,85,46,5,0.0,0.0
1003,1382,2020-03-19 07:56:00,1,2298.5,2274.5,0.99,11.5755,656,428,341,87,228,156,72,62,0.0,0.01
1003,1383,2020-03-19 07:59:00,1,2430.0,2393.0,0.985,12.225,784,502,425,77,282,211,71,54,0.0,0.04
1003,1384,2020-03-19 08:02:00,1,2352.0,2279.0,0.969,11.791,1279,943,798,145,336,251,85,19,0.0,0.0
1003,1385,2020-03-19 08:05:00,1,2428.0,2264.0,0.933,12.073,1305,1011,857,154,294,229,65,31,0.0,0.06
1003,1386,2020-03-19 08:08:00,1,2374.0,2375.0,1.0,11.985,1083,670,552,118,413,306,107,33,0.0,0.0
1003,1387,2020-03-19 08:11:00,1,2398.0,2397.0,1.0,12.101,520,264,198,66,256,169,87,49,0.0,0.0
1003,1388,2020-03-19 08:14:00,1,2418.0,2352.0,0.973,12.131,863,397,313,84,466,368,98,29,0.0,0.0
1003,1389,2020-03-19 08:17:00,1,2375.0,2420.0,1.019,12.036,1000,557,457,100,443,346,97,50,0.0,0.0
1003,1390,2020-03-19 08:20:00,1,2404.0,2421.0,1.007,12.152,1135,605,498,107,530,422,108,62,0.0,0.0
1003,1391,2020-03-19 08:23:00,1,2386.0,2393.0,1.003,12.048,92,42,7,35,50,23,27,3,0.0,0.0
1003,1392,2020-03-19 08:26:00,1,2394.0,2334.0,0.975,12.016,33,9,0,9,24,8,16,0,0.0,0.0
1003,1393,2020-03-19 08:29:00,1,2244.0,2140.0,0.954,11.211,15,1,0,1,14,0,14,0,0.0,0.0
1003,1394,2020-03-19 08:32:00,1,1986.0,1925.0,0.97,9.955,27,4,2,2,23,9,14,0,0.0,0.0
1003,1395,2020-03-19 08:35:00,1,1841.0,1733.0,0.941,9.174,16,0,0,0,16,5,11,0,0.0,0.0
1003,1396,2020-03-19 08:38:00,1,1533.0,1587.0,1.035,7.798,22,0,0,0,22,5,17,0,0.0,0.0
1003,1397,2020-03-19 08:41:00,1,1532.0,1554.0,1.015,7.755,34,5,2,3,29,7,22,0,0.0,0.0
1003,1398,2020-03-19 08:44:00,1,1568.0,1515.0,0.966,7.855,14,0,0,0,14,0,14,0,0.0,0.0
1003,1399,2020-03-19 08:47:00,1,1393.0,1421.0,1.02,7.061,78,22,13,9,56,31,25,0,0.0,0.0
1003,1400,2020-03-19 08:50:00,1,1502.0,1527.0,1.017,7.608,16,1,0,1,15,5,10,0,0.0,0.0
1003,1401,2020-03-19 08:53:00,1,1537.0,1531.0,0.996,7.751,24,1,0,1,23,2,21,0,0.0,0.0
1003,1402,2020-03-19 08:56:00,1,1407.0,1428.0,1.015,7.123,34,0,0,0,34,0,34,0,0.0,0.0
1003,1403,2020-03-19 08:59:00,1,1431.0,1348.0,0.942,7.132,31,0,0,0,31,0,31,0,0.0,0.0
1003,1404,2020-03-19 09:02:00,1,1420.0,1325.0,0.933,7.063,78,2,1,1,76,33,43,0,0.0,0.0
1003,1405,2020-03-19 09:05:00,1,1425.0,1337.0,0.938,7.095,74,1,0,1,73,33,40,0,0.0,0.0
1003,1406,2020-03-19 09:08:00,1,1416.0,1315.0,0.928,7.036,59,2,0,2,57,28,29,0,0.0,0.0
1003,1407,2020-03-19 09:11:00,1,1393.0,1388.0,0.997,7.025,53,1,0,1,52,24,28,0,0.0,0.0
1003,1408,2020-03-19 09:14:00,1,1478.0,1436.0,0.972,7.413,25,1,0,1,24,3,21,0,0.0,0.0
1003,1409,2020-03-19 09:17:00,1,1397.0,1420.0,1.016,7.076,39,18,14,4,21,7,14,0,0.0,0.0
1003,1410,2020-03-19 09:20:00,1,1491.0,1443.0,0.968,7.471,14,0,0,0,14,0,14,0,0.0,0.0
1003,1411,2020-03-19 09:23:00,1,1393.0,1397.0,1.003,7.034,8,0,0,0,8,0,8,0,0.0,0.0
1003,1412,2020-03-19 09:26:00,1,1599.0,1526.0,0.954,7.992,12,0,0,0,12,0,12,0,0.0,0.0
1003,1413,2020-03-19 09:29:00,1,1577.0,1500.0,0.951,7.872,18,1,0,1,17,4,13,0,0.0,0.0
1003,1414,2020-03-19 09:32:00,1,1591.0,1498.0,0.942,7.926,36,17,12,5,19,10,9,0,0.0,0.0
1003,1415,2020-03-19 09:35:00,1,1583.0,1468.0,0.928,7.861,26,8,4,4,18,6,12,0,0.0,0.0
1003,1416,2020-03-19 09:38:00,1,1601.0,1489.0,0.93,7.957,26,5,0,5,21,5,16,0,0.0,0.0
1003,1417,2020-03-19 09:41:00,1,1401.0,1383.0,0.987,7.049,12,0,0,0,12,0,12,0,0.0,0.0
1003,1418,2020-03-19 09:44:00,1,1424.0,1336.0,0.938,7.09,8,0,0,0,8,0,8,0,0.0,0.0
1003,1419,2020-03-19 09:47:00,1,1434.0,1293.0,0.902,7.079,12,0,0,0,12,0,12,0,0.0,0.0
1003,1420,2020-03-19 09:50:00,1,1436.0,1325.0,0.923,7.126,27,6,3,3,21,5,16,2,0.0,0.0
1003,1421,2020-03-19 09:53:00,1,1381.0,1371.0,0.993,6.959,14,2,0,2,12,1,11,0,0.0,0.0
1003,1422,2020-03-19 09:56:00,1,1590.0,1499.0,0.943,7.922,37,18,10,8,19,7,12,0,0.0,0.0
1003,1423,2020-03-19 09:59:00,1,1671.0,1569.0,0.939,8.321,120,49,24,25,71,31,40,41,0.0,0.0
1003,1424,2020-03-19 10:02:00,1,1830.0,1688.0,0.923,9.078,131,25,4,21,106,55,51,24,0.0,0.0
1003,1425,2020-03-19 10:05:00,1,1941.0,1855.0,0.956,9.701,216,94,60,34,122,75,47,31,0.0,0.0
1003,1426,2020-03-19 10:08:00,1,1960.0,1893.0,0.966,9.818,637,278,206,72,359,270,89,28,0.0,0.0
1003,1427,2020-03-19 10:11:00,1,1967.0,1966.0,1.0,9.925,965,610,510,100,355,270,85,79,0.0,0.0
1003,1428,2020-03-19 10:14:00,1,2279.0,2043.0,0.896,11.241,310,172,118,54,138,100,38,85,0.0,0.0
1003,1429,2020-03-19 10:17:00,1,2026.0,1919.0,0.947,10.105,229,95,61,34,134,87,47,34,0.0,0.0
1003,1430,2020-03-19 10:20:00,1,2260.0,2144.0,0.949,11.276,1050,660,524,136,390,307,83,95,0.0,0.0
1003,1431,2020-03-19 10:23:00,1,2304.0,2121.0,0.921,11.425,1319,741,592,149,578,449,129,78,0.0,0.0
1003,1432,2020-03-19 10:26:00,1,2253.0,2190.0,0.972,11.299,1333,868,708,160,465,367,98,97,0.0,0.01
1003,1433,2020-03-19 10:29:00,1,2439.0,2235.0,0.917,12.084,1240,724,598,126,516,397,119,90,0.0,0.0
1003,1434,2020-03-19 10:32:00,1,2438.0,2265.0,0.929,12.113,1378,874,730,144,504,386,118,80,0.0,0.02
1003,1435,2020-03-19 10:35:00,1,2234.0,2190.0,0.98,11.226,1196,673,545,128,523,402,121,74,0.0,0.0
1003,1436,2020-03-19 10:38:00,1,2241.0,2183.0,0.974,11.246,571,253,186,67,318,236,82,58,0.0,0.0
1003,1437,2020-03-19 10:41:00,1,2261.0,2192.0,0.969,11.334,265,167,97,70,98,56,42,103,0.0,0.04
1003,1438,2020-03-19 10:44:00,1,2412.0,2250.0,0.933,11.994,180,102,53,49,78,41,37,103,0.0,0.02
1003,1439,2020-03-19 10:47:00,1,1965.0,1853.0,0.943,9.794,253,91,63,28,162,124,38,21,0.0,0.01
1003,1440,2020-03-19 10:50:00,1,1811.0,1785.0,0.986,9.11,97,92,54,38,5,0,5,30,0.0,0.0
1003,1441,2020-03-19 10:53:00,1,2211.0,2096.0,0.948,11.034,89,72,16,56,17,5,12,0,0.0,0.0
1003,1442,2020-03-19 10:56:00,1,2206.5,2143.5,0.9715,11.067,75,34,6,28,41,1,40,3,0.0,0.0
1003,1443,2020-03-19 10:59:00,1,2202.0,2191.0,0.995,11.1,0,0,0,0,0,0,0,0,0.0,0.0
1003,1444,2020-03-19 11:02:00,1,1575.0,1646.0,1.045,8.027,0,0,0,0,0,0,0,0,0.0,0.0
1003,1445,2020-03-19 11:05:00,1,1403.0,1366.0,0.974,7.042,14,13,0,13,1,0,1,0,0.0,0.0
1003,1446,2020-03-19 11:08:00,1,1383.0,1323.0,0.956,6.915,8,8,0,8,0,0,0,0,0.0,0.0
1003,1447,2020-03-19 11:11:00,1,1430.0,1342.0,0.939,7.118,22,7,0,7,15,0,15,0,0.0,0.0
1003,1448,2020-03-19 11:14:00,1,1549.0,1579.0,1.019,7.851,2,0,0,0,2,0,2,0,0.0,0.0
1003,1449,2020-03-19 11:17:00,1,1817.0,1784.0,0.982,9.134,5,1,0,1,4,0,4,0,0.0,0.0
1003,1450,2020-03-19 11:20:00,1,1554.0,1613.0,1.038,7.907,33,31,0,31,2,0,2,0,0.0,0.0
1003,1451,2020-03-19 11:23:00,1,1392.0,1412.0,1.014,7.048,0,0,0,0,0,0,0,0,0.0,0.0
1003,1452,2020-03-19 11:26:00,1,1219.0,1301.0,1.067,6.242,11,8,2,6,3,0,3,0,0.0,0.0
1003,1453,2020-03-19 11:29:00,1,1227.0,1290.0,1.051,6.263,12,10,0,10,2,1,1,2,0.0,0.0
1003,1454,2020-03-19 11:32:00,1,1309.0,1290.0,0.985,6.585,21,20,0,20,1,1,0,0,0.0,0.0
1003,1455,2020-03-19 11:35:00,1,1428.0,1336.0,0.935,7.106,0,0,0,0,0,0,0,0,0.0,0.0
1003,1456,2020-03-19 11:38:00,1,1421.0,1326.0,0.933,7.065,8,7,0,7,1,0,1,0,0.0,0.0
1003,1457,2020-03-19 11:41:00,1,1670.0,1667.0,0.998,8.423,0,0,0,0,0,0,0,0,0.0,0.0
1003,1458,2020-03-19 11:44:00,1,1561.0,1541.0,0.987,7.855,2,2,0,2,0,0,0,0,0.0,0.0
1003,1459,2020-03-19 11:47:00,1,1391.0,1404.0,1.009,7.037,12,12,0,12,0,0,0,0,0.0,0.01
1003,1460,2020-03-19 11:50:00,1,1590.0,1458.0,0.917,7.877,0,0,0,0,0,0,0,0,0.0,0.0
1003,1461,2020-03-19 11:53:00,1,1575.0,1508.0,0.958,7.877,2,2,0,2,0,0,0,0,0.0,0.0
1003,1462,2020-03-19 11:56:00,1,1567.0,1472.0,0.939,7.804,0,0,0,0,0,0,0,0,0.0,0.0
1003,1463,2020-03-19 11:59:00,1,1598.0,1430.0,0.895,7.879,2,2,0,2,0,0,0,0,0.0,0.0
1003,1464,2020-03-19 12:02:00,1,1571.0,1507.0,0.959,7.857,52,32,5,27,20,0,20,13,0.0,0.0
1003,1465,2020-03-19 12:05:00,1,1845.0,1691.0,0.917,9.14,78,40,18,22,38,14,24,47,0.0,0.0
1003,1466,2020-03-19 12:08:00,1,1820.0,1826.0,1.003,9.192,133,89,57,32,44,29,15,31,0.0,0.0
1003,1467,2020-03-19 12:11:00,1,1895.0,1796.0,0.948,9.453,234,168,109,59,66,25,41,110,0.0,0.0
1003,1468,2020-03-19 12:14:00,1,2308.0,2110.0,0.914,11.427,189,121,64,57,68,19,49,118,0.0,0.03
1003,1469,2020-03-19 12:17:00,1,2479.0,2186.0,0.882,12.188,432,277,207,70,155,93,62,124,0.0,0.05
1003,1470,2020-03-19 12:20:00,1,2389.0,2277.0,0.953,11.934,225,132,77,55,93,49,44,89,0.0,0.0
1003,1471,2020-03-19 12:23:00,1,2278.0,2165.0,0.951,11.372,564,294,223,71,270,199,71,102,0.03,0.01
1003,1472,2020-03-19 12:26:00,1,2490.0,2401.0,0.964,12.467,186,114,52,62,72,29,43,95,0.0,0.0
1003,1473,2020-03-19 12:29:00,1,2546.0,2479.0,0.974,12.776,1527,926,766,160,601,473,128,101,0.24,0.08
1003,1474,2020-03-19 12:32:00,1,2190.0,2164.0,0.988,11.026,642,368,276,92,274,206,68,51,0.0,0.0
1003,1475,2020-03-19 12:35:00,1,1968.0,1928.0,0.98,9.886,1454,863,719,144,591,479,112,61,0.06,0.0
1003,1476,2020-03-19 12:38:00,1,2423.0,2415.0,0.997,12.219,1290,706,582,124,584,477,107,47,0.0,0.0
1003,1477,2020-03-19 12:41:00,1,2563.0,2550.0,0.995,12.922,1056,631,510,121,425,313,112,64,0.0,0.04
1003,1478,2020-03-19 12:44:00,1,2356.0,2474.0,1.05,12.02,332,175,124,51,157,97,60,34,0.0,0.0
1003,1479,2020-03-19 12:47:00,1,1947.0,1972.0,1.013,9.854,67,20,3,17,47,27,20,12,0.0,0.0
1003,1480,2020-03-19 12:50:00,1,1926.0,1928.0,1.001,9.723,0,0,0,0,0,0,0,0,0.0,0.0
1003,1481,2020-03-19 12:53:00,1,1987.0,1998.0,1.006,10.04,8,6,2,4,2,0,2,3,0.0,0.0
1003,1482,2020-03-19 12:56:00,1,1716.0,1731.0,1.008,8.677,2,2,1,1,0,0,0,2,0.0,0.0
1003,1483,2020-03-19 12:59:00,1,1584.0,1553.0,0.981,7.959,3,3,0,3,0,0,0,4,0.0,0.0
1003,1484,2020-03-19 13:02:00,1,1486.0,1517.0,1.02,7.535,1,1,0,1,0,0,0,0,0.0,0.0
1003,1485,2020-03-19 13:05:00,1,1566.0,1607.0,1.026,7.948,0,0,0,0,0,0,0,0,0.0,0.0
1003,1486,2020-03-19 13:08:00,1,1696.0,1701.0,1.003,8.566,0,0,0,0,0,0,0,0,0.0,0.0
1003,1487,2020-03-19 13:11:00,1,1550.0,1613.0,1.041,7.892,5,5,2,3,0,0,0,3,0.0,0.0
1003,1488,2020-03-19 13:14:00,1,1366.0,1444.0,1.057,6.98,0,0,0,0,0,0,0,0,0.0,0.0
1003,1489,2020-03-19 13:17:00,1,1423.0,1392.0,0.979,7.146,0,0,0,0,0,0,0,0,0.0,0.0
1003,1490,2020-03-19 13:20:00,1,1282.0,1300.0,1.014,6.491,37,32,20,12,5,0,5,2,0.0,0.0
1003,1491,2020-03-19 13:23:00,1,1547.0,1606.0,1.038,7.873,5,5,1,4,0,0,0,0,0.0,0.0
1003,1492,2020-03-19 13:26:00,1,1528.0,1580.0,1.034,7.77,17,17,4,13,0,0,0,0,0.0,0.0
1003,1493,2020-03-19 13:29:00,1,1458.0,1483.0,1.018,7.386,23,23,0,23,0,0,0,0,0.0,0.0
1003,1494,2020-03-19 13:32:00,1,1440.0,1458.0,1.013,7.289,21,18,8,10,3,0,3,0,0.0,0.0
1003,1495,2020-03-19 13:35:00,1,1393.0,1413.0,1.014,7.053,1,1,0,1,0,0,0,0,0.0,0.0
1003,1496,2020-03-19 13:38:00,1,1399.0,1438.0,1.028,7.102,15,13,7,6,2,0,2,2,0.0,0.0
1003,1497,2020-03-19 13:41:00,1,1590.0,1510.0,0.949,7.937,20,4,2,2,16,0,16,0,0.0,0.0
1003,1498,2020-03-19 13:44:00,1,1603.0,1518.0,0.947,7.998,5,4,2,2,1,0,1,0,0.0,0.0
1003,1499,2020-03-19 13:47:00,1,1524.0,1410.0,0.925,7.566,19,15,7,8,4,0,4,2,0.0,0.0
1003,1500,2020-03-19 13:50:00,1,1520.0,1441.0,0.948,7.584,0,0,0,0,0,0,0,0,0.0,0.0
1003,1501,2020-03-19 13:53:00,1,1462.0,1376.0,0.941,7.286,0,0,0,0,0,0,0,0,0.0,0.0
1003,1502,2020-03-19 13:56:00,1,1443.0,1365.0,0.946,7.197,0,0,0,0,0,0,0,0,0.0,0.0
1003,1503,2020-03-19 13:59:00,1,1424.0,1354.0,0.951,7.108,0,0,0,0,0,0,0,0,0.0,0.0
1003,1504,2020-03-19 14:02:00,1,1523.0,1418.0,0.931,7.57,1,1,0,1,0,0,0,0,0.0,0.0
1003,1505,2020-03-19 14:05:00,1,1637.0,1442.0,0.881,8.046,0,0,0,0,0,0,0,0,0.0,0.0
1003,1506,2020-03-19 14:08:00,1,1426.0,1340.0,0.94,7.102,92,75,35,40,17,7,10,12,0.0,0.0
1003,1507,2020-03-19 14:11:00,1,1570.0,1493.0,0.951,7.84,144,87,33,54,57,8,49,86,0.0,0.0
1003,1508,2020-03-19 14:14:00,1,1829.0,1650.0,0.902,9.032,120,25,13,12,95,58,37,29,0.0,0.0
1003,1509,2020-03-19 14:17:00,1,1914.0,1830.0,0.956,9.567,212,119,89,30,93,58,35,14,0.0,0.0
1003,1510,2020-03-19 14:20:00,1,2565.0,2357.0,0.919,12.715,227,140,91,49,87,45,42,84,0.0,0.0
1003,1511,2020-03-19 14:23:00,1,2593.0,2361.0,0.911,12.83,184,74,33,41,110,54,56,68,0.0,0.0
1003,1512,2020-03-19 14:26:00,1,2883.0,2584.0,0.896,14.219,140,89,40,49,51,21,30,78,0.0,0.0
1003,1513,2020-03-19 14:29:00,1,3031.0,2696.0,0.889,14.929,131,56,26,30,75,33,42,88,0.0,0.08
1003,1514,2020-03-19 14:32:00,1,2883.0,2616.0,0.907,14.256,158,93,46,47,65,28,37,90,0.0,0.12
1003,1515,2020-03-19 14:35:00,1,3047.0,2825.0,0.927,15.133,170,106,51,55,64,22,42,101,0.0,0.13
1003,1516,2020-03-19 14:38:00,1,3041.0,2843.0,0.935,15.131,325,184,127,57,141,85,56,87,0.1,0.04
1003,1517,2020-03-19 14:41:00,1,2569.0,2551.0,0.993,12.947,1097,596,482,114,501,391,110,123,0.29,0.0
1003,1518,2020-03-19 14:44:00,1,1916.0,1948.0,1.017,9.707,936,522,410,112,414,306,108,66,0.0,0.0
1003,1519,2020-03-19 14:47:00,1,2545.0,2530.0,0.994,12.828,1040,557,445,112,483,374,109,54,0.0,0.05
1003,1520,2020-03-19 14:50:00,1,2434.0,2378.0,0.977,12.224,838,502,393,109,336,249,87,69,0.0,0.0
1003,1521,2020-03-19 14:53:00,1,1860.0,1781.0,0.958,9.301,16,11,6,5,5,3,2,7,0.0,0.0
1003,1522,2020-03-19 14:56:00,1,1577.0,1432.0,0.908,7.798,0,0,0,0,0,0,0,0,0.0,0.0
1003,1523,2020-03-19 14:59:00,1,1603.0,1483.0,0.925,7.956,11,7,2,5,4,3,1,0,0.0,0.0
1003,1524,2020-03-19 15:02:00,1,1435.0,1372.0,0.956,7.171,9,7,3,4,2,0,2,0,0.0,0.0
1003,1525,2020-03-19 15:05:00,1,1237.0,1223.0,0.988,6.228,0,0,0,0,0,0,0,0,0.0,0.0
1003,1526,2020-03-19 15:08:00,1,1246.0,1199.0,0.962,6.235,11,11,0,11,0,0,0,0,0.0,0.0
1003,1527,2020-03-19 15:11:00,1,2378.0,2412.0,1.014,12.04,10,10,2,8,0,0,0,1,0.0,0.0
1003,1528,2020-03-19 15:14:00,1,2553.0,2639.0,1.034,12.981,3,3,0,3,0,0,0,0,0.0,0.0
1003,1529,2020-03-19 15:17:00,1,2376.0,2387.0,1.005,12.005,2,2,0,2,0,0,0,0,0.0,0.0
1003,1530,2020-03-19 15:20:00,1,2101.0,2178.0,1.037,10.689,5,5,2,3,0,0,0,0,0.0,0.0
1003,1531,2020-03-19 15:23:00,1,1948.0,2105.0,1.081,10.004,17,17,3,14,0,0,0,0,0.0,0.0
1003,1532,2020-03-19 15:26:00,1,1804.0,2017.0,1.118,9.34,58,54,3,51,4,0,4,0,0.0,0.0
1003,1533,2020-03-19 15:29:00,1,1810.0,1841.0,1.017,9.168,22,21,0,21,1,0,1,0,0.0,0.0
1003,1534,2020-03-19 15:32:00,1,1614.0,1766.0,1.094,8.313,4,4,1,3,0,0,0,0,0.0,0.0
1003,1535,2020-03-19 15:35:00,1,1565.0,1692.0,1.082,8.038,18,10,2,8,8,3,5,1,0.0,0.0
1003,1536,2020-03-19 15:38:00,1,1565.0,1666.0,1.065,8.009,35,35,2,33,0,0,0,0,0.0,0.0
1003,1537,2020-03-19 15:41:00,1,1540.0,1698.0,1.102,7.946,23,23,0,23,0,0,0,0,0.0,0.0
1003,1538,2020-03-19 15:44:00,1,1534.0,1617.0,1.054,7.834,34,34,0,34,0,0,0,0,0.0,0.0
1003,1539,2020-03-19 15:47:00,1,1468.0,1600.0,1.09,7.557,39,38,4,34,1,0,1,0,0.0,0.0
1003,1540,2020-03-19 15:50:00,1,1483.0,1583.0,1.068,7.596,159,95,69,26,64,43,21,4,0.0,0.0
1003,1541,2020-03-19 15:53:00,1,1524.0,1705.0,1.119,7.894,42,34,22,12,8,6,2,2,0.0,0.0
1003,1542,2020-03-19 15:56:00,1,1514.0,1713.0,1.131,7.862,58,41,29,12,17,11,6,2,0.0,0.0
1003,1543,2020-03-19 15:59:00,1,1359.0,1577.0,1.16,7.102,93,50,37,13,43,12,31,12,0.0,0.0
1003,1544,2020-03-19 16:02:00,1,1205.0,1370.0,1.136,6.266,27,27,0,27,0,0,0,0,0.0,0.0
1003,1545,2020-03-19 16:05:00,1,1378.0,1351.0,0.98,6.925,20,17,0,17,3,1,2,0,0.0,0.0
1003,1546,2020-03-19 16:08:00,1,1319.0,1378.0,1.044,6.723,1,0,0,0,1,0,1,0,0.0,0.0
1003,1547,2020-03-19 16:11:00,1,1197.0,1358.0,1.135,6.218,0,0,0,0,0,0,0,0,0.0,0.0
1003,1548,2020-03-19 16:14:00,1,1539.0,1651.0,1.072,7.892,20,9,5,4,11,7,4,0,0.0,0.0
1003,1549,2020-03-19 16:17:00,1,1495.0,1661.0,1.111,7.73,0,0,0,0,0,0,0,0,0.0,0.0
1003,1550,2020-03-19 16:20:00,1,1557.0,1710.0,1.098,8.027,139,67,35,32,72,41,31,44,0.0,0.0
1003,1551,2020-03-19 16:23:00,1,1844.0,1989.0,1.079,9.466,163,92,34,58,71,46,25,25,0.0,0.0
1003,1552,2020-03-19 16:26:00,1,1944.0,2125.0,1.093,10.012,325,163,111,52,162,105,57,42,0.0,0.0
1003,1553,2020-03-19 16:29:00,1,1951.0,2193.0,1.124,10.114,0,0,0,0,0,0,0,0,0.0,0.0
1003,1554,2020-03-19 16:32:00,1,1766.0,1951.0,1.104,9.118,103,62,46,16,41,23,18,11,0.0,0.0
1003,1555,2020-03-19 16:35:00,1,2024.0,2034.0,1.005,10.227,191,108,47,61,83,39,44,102,0.0,0.0
1003,1556,2020-03-19 16:38:00,1,2329.0,2351.0,1.01,11.779,111,68,39,29,43,16,27,94,0.0,0.08
1003,1557,2020-03-19 16:41:00,1,2368.0,2509.0,1.059,12.108,100,61,32,29,39,13,26,105,0.0,0.08
1003,1558,2020-03-19 16:44:00,1,2377.0,2571.0,1.082,12.21,219,117,90,27,102,67,35,98,0.0,0.08
1003,1559,2020-03-19 16:47:00,1,2460.0,2553.0,1.038,12.518,419,270,200,70,149,119,30,80,0.01,0.04
1003,1560,2020-03-19 16:50:00,1,1832.0,1949.0,1.064,9.376,40,23,6,17,17,9,8,0,0.0,0.0
1003,1561,2020-03-19 16:53:00,1,1363.0,1475.0,1.083,7.002,8,2,0,2,6,4,2,0,0.0,0.0
1003,1562,2020-03-19 16:56:00,1,1168.0,1237.5,1.0555,5.972,21,3,2,1,18,1,17,0,0.0,0.0
1003,1563,2020-03-19 16:59:00,1,973.0,1000.0,1.028,4.942,41,41,2,39,0,0,0,0,0.0,0.0
1003,1564,2020-03-19 17:02:00,1,1382.0,1413.0,1.023,7.008,11,11,0,11,0,0,0,0,0.0,0.0
1003,1565,2020-03-19 17:05:00,1,2317.0,2390.0,1.032,11.773,24,24,7,17,0,0,0,0,0.0,0.0
1003,1566,2020-03-19 17:08:00,1,2362.0,2443.0,1.034,12.009,33,19,8,11,14,1,13,0,0.0,0.0
1003,1567,2020-03-19 17:11:00,1,2196.0,2281.0,1.039,11.179,73,0,0,0,73,0,73,0,0.0,0.0
1003,1568,2020-03-19 17:14:00,1,1950.0,2140.0,1.098,10.05,1,0,0,0,1,0,1,0,0.0,0.0
1003,1569,2020-03-19 17:17:00,1,1768.0,1867.0,1.056,9.031,3,3,2,1,0,0,0,0,0.0,0.0
1003,1570,2020-03-19 17:20:00,1,1729.0,1780.0,1.029,8.783,7,6,3,3,1,1,0,0,0.0,0.0
1003,1571,2020-03-19 17:23:00,1,1802.0,1877.0,1.042,9.178,10,5,2,3,5,0,5,2,0.0,0.0
1003,1572,2020-03-19 17:26:00,1,1790.0,1847.0,1.031,9.098,25,16,2,14,9,0,9,9,0.0,0.0
1003,1573,2020-03-19 17:29:00,1,1718.0,1802.0,1.049,8.762,5,2,2,0,3,1,2,3,0.0,0.0
1003,1574,2020-03-19 17:32:00,1,1824.0,1876.0,1.028,9.265,211,110,87,23,101,58,43,0,0.0,0.0
1003,1575,2020-03-19 17:35:00,1,1801.0,1846.0,1.025,9.138,11,2,0,2,9,3,6,0,0.0,0.0
1003,1576,2020-03-19 17:38:00,1,1757.0,1829.0,1.041,8.947,4,1,0,1,3,1,2,0,0.0,0.0
1003,1577,2020-03-19 17:41:00,1,1737.0,1786.0,1.028,8.821,1,1,0,1,0,0,0,0,0.0,0.0
1003,1578,2020-03-19 17:44:00,1,1518.0,1648.0,1.086,7.804,11,1,0,1,10,3,7,0,0.0,0.0
1003,1579,2020-03-19 17:47:00,1,1577.0,1600.0,1.015,7.983,149,67,34,33,82,46,36,19,0.0,0.0
1003,1580,2020-03-19 17:50:00,1,1815.0,1904.0,1.049,9.261,63,22,0,22,41,8,33,10,0.0,0.0
1003,1581,2020-03-19 17:53:00,1,1944.0,2059.0,1.059,9.94,119,47,15,32,72,32,40,10,0.0,0.0
1003,1582,2020-03-19 17:56:00,1,2210.0,2242.0,1.014,11.188,162,76,37,39,86,34,52,31,0.0,0.0
1003,1583,2020-03-19 17:59:00,1,2337.0,2384.0,1.02,11.846,138,89,42,47,49,20,29,21,0.0,0.0
1003,1584,2020-03-19 18:02:00,0,2388.0,2476.0,1.037,12.152,592,337,255,82,255,171,84,75,0.01,0.0
1003,1585,2020-03-19 18:05:00,0,2656.0,2776.0,1.045,13.537,959,590,494,96,369,286,83,220,0.0,0.0
1003,1586,2020-03-19 18:08:00,0,2787.0,2853.0,1.024,14.14,855,535,432,103,320,231,89,107,0.0,0.0
1003,1587,2020-03-19 18:11:00,0,2831.0,2798.0,0.988,14.253,471,344,260,84,127,76,51,107,0.0,0.0
1003,1588,2020-03-19 18:14:00,0,3031.0,3022.0,0.997,15.287,637,474,375,99,163,114,49,23,0.0,0.07
1003,1589,2020-03-19 18:17:00,0,2799.0,2735.0,0.977,14.058,596,426,319,107,170,120,50,13,0.0,0.03
1003,1590,2020-03-19 18:20:00,0,2673.0,2657.0,0.994,13.474,240,76,33,43,164,110,54,26,0.0,0.0
1003,1591,2020-03-19 18:23:00,0,2991.0,2958.0,0.989,15.059,91,30,0,30,61,23,38,0,0.01,0.0
1003,1592,2020-03-19 18:26:00,0,2767.0,2798.0,1.011,13.998,471,301,221,80,170,127,43,39,0.0,0.0
1003,1593,2020-03-19 18:29:00,0,3006.0,2975.0,0.99,15.137,138,45,19,26,93,51,42,5,0.0,0.0
1003,1594,2020-03-19 18:32:00,0,2958.0,2903.0,0.981,14.868,407,288,221,67,119,81,38,48,0.0,0.0
1003,1595,2020-03-19 18:35:00,0,2889.0,2852.0,0.987,14.538,676,501,410,91,175,121,54,38,0.0,0.0
1003,1596,2020-03-19 18:38:00,0,2997.0,2871.0,0.958,14.988,919,709,559,150,210,154,56,58,0.0,0.0
1003,1597,2020-03-19 18:41:00,0,3089.0,2912.0,0.943,15.395,378,260,199,61,118,80,38,30,0.0,0.0
1003,1598,2020-03-19 18:44:00,0,2833.0,2774.0,0.979,14.233,453,349,267,82,104,67,37,33,0.0,0.0
1003,1599,2020-03-19 18:47:00,0,2972.0,2777.0,0.935,14.783,407,311,233,78,96,58,38,14,0.06,0.0
1003,1600,2020-03-19 18:50:00,0,2569.0,2453.0,0.955,12.838,214,134,91,43,80,43,37,12,0.0,0.0
1003,1601,2020-03-19 18:53:00,0,2541.0,2429.0,0.956,12.7,356,230,159,71,126,80,46,89,0.0,0.0
1003,1602,2020-03-19 18:56:00,0,2928.0,2685.0,0.917,14.509,508,346,267,79,162,106,56,16,0.0,0.0
1003,1603,2020-03-19 18:59:00,0,2914.0,2658.0,0.912,14.425,624,478,378,100,146,102,44,37,0.0,0.0
1003,1604,2020-03-19 19:02:00,0,2447.0,2254.0,0.921,12.138,197,154,95,59,43,23,20,3,0.0,0.0
1003,1605,2020-03-19 19:05:00,0,2639.0,2380.0,0.902,13.031,28,15,11,4,13,7,6,0,0.0,0.0
1003,1606,2020-03-19 19:08:00,0,1687.0,1551.0,0.919,8.365,12,5,1,4,7,4,3,0,0.0,0.0
1003,1607,2020-03-19 19:11:00,0,1933.0,1733.0,0.896,9.537,605,362,278,84,243,184,59,59,0.06,0.0
1003,1608,2020-03-19 19:14:00,0,3053.0,2714.0,0.889,15.033,118,50,27,23,68,30,38,58,0.0,0.0
1003,1609,2020-03-19 19:17:00,0,3203.0,2732.0,0.853,15.646,263,162,111,51,101,50,51,85,0.0,0.0
1003,1610,2020-03-19 19:20:00,0,3012.0,2621.0,0.87,14.768,113,20,8,12,93,38,55,16,0.0,0.0
1003,1611,2020-03-19 19:23:00,0,2856.0,2555.0,0.895,14.082,285,113,55,58,172,98,74,90,0.0,0.0
1003,1612,2020-03-19 19:26:00,0,3003.0,2596.0,0.864,14.707,83,29,18,11,54,11,43,7,0.0,0.0
1003,1613,2020-03-19 19:29:00,0,2617.0,2339.0,0.894,12.903,49,28,16,12,21,10,11,4,0.0,0.0
1003,1614,2020-03-19 19:32:00,0,2644.0,2262.0,0.856,12.921,860,447,359,88,413,310,103,107,0.0,0.0
1003,1615,2020-03-19 19:35:00,0,2580.0,2308.0,0.895,12.721,123,58,44,14,65,29,36,1,0.0,0.0
1003,1616,2020-03-19 19:38:00,0,2461.0,2111.0,0.857,12.034,80,27,8,19,53,26,27,21,0.0,0.0
1003,1617,2020-03-19 19:41:00,0,2494.0,2047.0,0.821,12.093,311,113,66,47,198,109,89,34,0.0,0.0
1003,1618,2020-03-19 19:44:00,0,2678.0,2198.0,0.821,12.987,357,185,130,55,172,101,71,32,0.0,0.0
1003,1619,2020-03-19 19:47:00,0,2672.0,2231.0,0.835,12.997,464,332,269,63,132,98,34,38,0.0,0.0
1003,1620,2020-03-19 19:50:00,0,2658.0,2251.0,0.847,12.964,34,6,2,4,28,23,5,0,0.0,0.0
1003,1621,2020-03-19 19:53:00,0,2487.0,2099.0,0.844,12.121,40,7,1,6,33,11,22,0,0.0,0.0
1003,1622,2020-03-19 19:56:00,0,2290.5,1941.5,0.848,11.174,60,8,3,5,52,0,52,0,0.0,0.0
1003,1623,2020-03-19 19:59:00,0,2094.0,1784.0,0.852,10.227,671,481,395,86,190,140,50,57,0.0,0.0
1003,1624,2020-03-19 20:02:00,0,2328.0,1914.0,0.822,11.292,555,392,292,100,163,121,42,72,0.09,0.0
1003,1625,2020-03-19 20:05:00,0,2316.0,1926.0,0.832,11.257,228,120,61,59,108,69,39,10,0.0,0.0
1003,1626,2020-03-19 20:08:00,0,2480.0,2150.0,0.867,12.15,638,393,315,78,245,177,68,88,0.0,0.0
1003,1627,2020-03-19 20:11:00,0,2500.0,2114.0,0.846,12.189,365,158,91,67,207,146,61,11,0.0,0.0
1003,1628,2020-03-19 20:14:00,0,2450.0,2057.0,0.84,11.932,726,557,427,130,169,119,50,26,0.0,0.0
1003,1629,2020-03-19 20:17:00,0,2917.0,2417.0,0.828,14.169,784,551,421,130,233,180,53,35,0.0,0.0
1003,1630,2020-03-19 20:20:00,0,2669.0,2298.0,0.861,13.062,453,290,216,74,163,125,38,7,0.03,0.0
1003,1631,2020-03-19 20:23:00,0,2508.0,2019.0,0.805,12.116,307,148,102,46,159,104,55,81,0.0,0.0
1003,1632,2020-03-19 20:26:00,0,2656.0,2263.0,0.852,12.971,417,304,229,75,113,74,39,27,0.0,0.0
1003,1633,2020-03-19 20:29:00,0,2875.0,2341.0,0.814,13.92,421,342,245,97,79,49,30,5,0.0,0.0
1003,1634,2020-03-19 20:32:00,0,2505.0,2026.0,0.809,12.113,274,125,70,55,149,82,67,4,0.0,0.0
1003,1635,2020-03-19 20:35:00,0,2923.0,2318.0,0.793,14.084,568,368,294,74,200,144,56,66,0.0,0.0
1003,1636,2020-03-19 20:38:00,0,2880.0,2307.0,0.801,13.9,531,389,294,95,142,93,49,14,0.0,0.0
1003,1637,2020-03-19 20:41:00,0,2384.0,1900.0,0.797,11.497,404,201,122,79,203,116,87,6,0.0,0.0
1003,1638,2020-03-19 20:44:00,0,2715.0,2213.0,0.815,13.147,182,95,61,34,87,46,41,20,0.0,0.0
1003,1639,2020-03-19 20:47:00,0,2802.0,2274.0,0.811,13.558,361,226,157,69,135,86,49,7,0.0,0.0
1003,1640,2020-03-19 20:50:00,0,2631.0,2155.0,0.819,12.75,392,183,120,63,209,138,71,18,0.0,0.0
1003,1641,2020-03-19 20:53:00,0,2676.0,2258.0,0.844,13.044,746,524,402,122,222,154,68,22,0.0,0.0
1003,1642,2020-03-19 20:56:00,0,2689.0,2231.0,0.829,13.066,648,435,356,79,213,169,44,98,0.03,0.0
1003,1643,2020-03-19 20:59:00,0,2573.0,2111.0,0.82,12.474,224,99,67,32,125,73,52,26,0.0,0.0
1003,1644,2020-03-19 21:02:00,0,2077.0,1776.0,0.855,10.149,721,310,251,59,411,324,87,83,0.0,0.0
1003,1645,2020-03-19 21:05:00,0,3094.0,2612.0,0.844,15.081,53,5,3,2,48,23,25,10,0.0,0.0
1003,1646,2020-03-19 21:08:00,0,3054.0,2468.0,0.808,14.766,276,83,38,45,193,129,64,48,0.0,0.0
1003,1647,2020-03-19 21:11:00,0,2889.0,2400.0,0.831,14.041,28,18,9,9,10,2,8,4,0.0,0.0
1003,1648,2020-03-19 21:14:00,0,2696.0,2267.0,0.841,13.132,18,7,0,7,11,0,11,0,0.0,0.0
1003,1649,2020-03-19 21:17:00,0,2560.0,2110.0,0.824,12.421,130,71,47,24,59,31,28,12,0.0,0.0
1003,1650,2020-03-19 21:20:00,0,1860.0,1649.0,0.886,9.154,85,25,7,18,60,10,50,0,0.0,0.0
1003,1651,2020-03-19 21:23:00,0,1478.0,1159.0,0.784,7.105,400,221,131,90,179,100,79,27,0.0,0.0
1003,1652,2020-03-19 21:26:00,0,2378.0,1896.0,0.798,11.468,344,127,64,63,217,165,52,21,0.0,0.0
1003,1653,2020-03-19 21:29:00,0,2679.0,2200.0,0.821,12.993,212,151,93,58,61,31,30,34,0.0,0.0
1003,1654,2020-03-19 21:32:00,0,3371.0,2685.0,0.796,16.256,860,377,303,74,483,407,76,50,0.0,0.0
1003,1655,2020-03-19 21:35:00,0,3366.0,2619.0,0.778,16.163,62,19,16,3,43,34,9,0,0.0,0.0
1003,1656,2020-03-19 21:38:00,0,2896.0,2317.0,0.8,13.975,111,61,35,26,50,23,27,26,0.0,0.0
1003,1657,2020-03-19 21:41:00,0,3176.0,2545.0,0.801,15.332,729,410,328,82,319,238,81,101,0.0,0.0
1003,1658,2020-03-19 21:44:00,0,3182.0,2531.0,0.795,15.338,700,398,321,77,302,239,63,99,0.0,0.0
1003,1659,2020-03-19 21:47:00,0,2740.0,2224.0,0.811,13.259,169,103,51,52,66,20,46,0,0.0,0.0
1003,1660,2020-03-19 21:50:00,0,2958.0,2350.0,0.794,14.258,296,146,87,59,150,87,63,3,0.0,0.0
1003,1661,2020-03-19 21:53:00,0,2695.0,2194.0,0.814,13.048,222,121,102,19,101,71,30,16,0.0,0.0
1003,1662,2020-03-19 21:56:00,0,2514.0,2046.0,0.814,12.17,29,6,3,3,23,3,20,0,0.0,0.0
1003,1663,2020-03-19 21:59:00,0,2611.0,2073.0,0.794,12.582,437,238,177,61,199,140,59,30,0.0,0.0
1003,1664,2020-03-19 22:02:00,0,2460.0,1938.0,0.788,11.837,677,405,333,72,272,202,70,173,0.0,0.0
1003,1665,2020-03-19 22:05:00,0,2521.0,1990.0,0.789,12.137,349,173,121,52,176,116,60,48,0.0,0.0
1003,1666,2020-03-19 22:08:00,0,2551.0,1927.0,0.755,12.186,46,19,9,10,27,12,15,4,0.0,0.0
1003,1667,2020-03-19 22:11:00,0,2327.0,1798.0,0.773,11.159,17,0,0,0,17,0,17,0,0.0,0.0
1003,1668,2020-03-19 22:14:00,0,2072.0,1705.0,0.823,10.049,64,4,3,1,60,19,41,0,0.0,0.0
1003,1669,2020-03-19 22:17:00,0,2081.0,1613.0,0.775,9.985,67,31,17,14,36,19,17,2,0.0,0.0
1003,1670,2020-03-19 22:20:00,0,1978.0,1557.0,0.787,9.517,254,122,83,39,132,91,41,25,0.0,0.0
1003,1671,2020-03-19 22:23:00,0,2212.0,1783.0,0.806,10.689,702,473,372,101,229,178,51,157,0.0,0.0
1003,1672,2020-03-19 22:26:00,0,2407.0,1873.0,0.778,11.557,645,391,322,69,254,197,57,284,0.0,0.0
1003,1673,2020-03-19 22:29:00,0,2722.0,2145.0,0.788,13.102,303,201,162,39,102,85,17,170,0.0,0.0
1003,1674,2020-03-19 22:32:00,0,2324.0,1769.0,0.761,11.116,323,218,162,56,105,77,28,14,0.0,0.0
1003,1675,2020-03-19 22:35:00,0,2470.0,1992.0,0.806,11.937,409,243,186,57,166,110,56,59,0.0,0.0
1003,1676,2020-03-19 22:38:00,0,2516.0,1976.0,0.785,12.1,283,188,140,48,95,58,37,17,0.0,0.0
1003,1677,2020-03-19 22:41:00,0,2514.0,2027.0,0.806,12.15,184,126,74,52,58,34,24,18,0.0,0.0
1003,1678,2020-03-19 22:44:00,0,2421.0,1831.0,0.756,11.567,283,141,83,58,142,100,42,16,0.0,0.0
1003,1679,2020-03-19 22:47:00,0,2540.0,1934.0,0.761,12.149,503,258,197,61,245,186,59,72,0.0,0.0
1003,1680,2020-03-19 22:50:00,0,2873.0,2199.0,0.766,13.754,635,444,362,82,191,148,43,92,0.02,0.0
1003,1681,2020-03-19 22:53:00,0,2700.0,2058.0,0.762,12.917,44,35,26,9,9,5,4,0,0.0,0.0
1003,1682,2020-03-19 22:56:00,0,2488.0,1899.5,0.7635,11.9055,3,3,1,2,0,0,0,0,0.0,0.0
1003,1683,2020-03-19 22:59:00,0,2276.0,1741.0,0.765,10.894,362,198,153,45,164,129,35,29,0.02,0.0
1003,1684,2020-03-19 23:02:00,0,2126.0,1696.0,0.798,10.254,189,115,91,24,74,51,23,4,0.0,0.0
1003,1685,2020-03-19 23:05:00,0,1628.0,1325.0,0.814,7.883,4,4,0,4,0,0,0,0,0.0,0.0
1003,1686,2020-03-19 23:08:00,0,1660.0,1298.0,0.782,7.977,41,30,14,16,11,10,1,2,0.0,0.0
1003,1687,2020-03-19 23:11:00,0,1624.0,1311.0,0.807,7.851,3,3,0,3,0,0,0,0,0.0,0.0
1003,1688,2020-03-19 23:14:00,0,1643.0,1341.0,0.816,7.958,0,0,0,0,0,0,0,0,0.0,0.0
1003,1689,2020-03-19 23:17:00,0,1620.0,1324.0,0.817,7.85,2,2,1,1,0,0,0,0,0.0,0.0
1003,1690,2020-03-19 23:20:00,0,1726.0,1340.0,0.777,8.283,155,43,18,25,112,65,47,21,0.0,0.0
1003,1691,2020-03-19 23:23:00,0,2068.0,1632.0,0.789,9.954,358,188,150,38,170,118,52,38,0.0,0.0
1003,1692,2020-03-19 23:26:00,0,2063.0,1696.0,0.822,10.006,369,199,158,41,170,132,38,130,0.0,0.0
1003,1693,2020-03-19 23:29:00,0,2372.0,1840.0,0.776,11.382,787,513,421,92,274,210,64,70,0.0,0.0
1003,1694,2020-03-19 23:32:00,0,2702.0,2036.0,0.754,12.899,89,57,29,28,32,15,17,0,0.0,0.0
1003,1695,2020-03-19 23:35:00,0,2325.0,1852.0,0.796,11.213,416,259,195,64,157,108,49,49,0.17,0.0
1003,1696,2020-03-19 23:38:00,0,1945.0,1511.0,0.777,9.335,213,99,58,41,114,73,41,24,0.0,0.0
1003,1697,2020-03-19 23:41:00,0,2365.0,1773.0,0.75,11.281,543,325,263,62,218,159,59,51,0.23,0.0
1003,1698,2020-03-19 23:44:00,0,2237.0,1721.0,0.769,10.718,247,100,52,48,147,88,59,0,0.0,0.0
1003,1699,2020-03-19 23:47:00,0,2055.0,1597.0,0.777,9.864,294,171,118,53,123,88,35,7,0.0,0.0
1003,1700,2020-03-19 23:50:00,0,2356.0,1779.0,0.755,11.252,266,167,131,36,99,78,21,35,0.0,0.0
1003,1701,2020-03-19 23:53:00,0,2349.0,1746.0,0.743,11.189,24,23,1,22,1,1,0,0,0.0,0.0
1003,1702,2020-03-19 23:56:00,0,2348.0,1755.0,0.748,11.195,2,2,1,1,0,0,0,0,0.0,0.0
1003,1703,2020-03-19 23:59:00,0,2077.0,1607.0,0.774,9.961,2,2,0,2,0,0,0,0,0.0,0.0
1003,1704,2020-03-20 00:02:00,0,1914.0,1484.0,0.775,9.184,0,0,0,0,0,0,0,0,0.0,0.0
1003,1705,2020-03-20 00:05:00,0,1861.0,1437.0,0.772,8.923,0,0,0,0,0,0,0,0,0.0,0.0
1003,1706,2020-03-20 00:08:00,0,1618.0,1338.0,0.827,7.858,2,2,0,2,0,0,0,0,0.0,0.0
1003,1707,2020-03-20 00:11:00,0,1651.0,1268.0,0.768,7.907,3,3,0,3,0,0,0,0,0.0,0.0
1003,1708,2020-03-20 00:14:00,0,1696.0,1395.0,0.823,8.225,259,167,128,39,92,66,26,7,0.0,0.0
1003,1709,2020-03-20 00:17:00,0,1909.0,1541.0,0.807,9.23,57,35,20,15,22,16,6,0,0.0,0.0
1003,1710,2020-03-20 00:20:00,0,1868.0,1503.0,0.805,9.025,263,166,131,35,97,72,25,45,0.0,0.0
1003,1711,2020-03-20 00:23:00,0,1822.0,1473.0,0.808,8.81,276,208,153,55,68,49,19,26,0.0,0.0
1003,1712,2020-03-20 00:26:00,0,1877.0,1535.0,0.818,9.093,131,70,44,26,61,37,24,7,0.0,0.0
1003,1713,2020-03-20 00:29:00,0,1440.0,1179.0,0.819,6.979,242,148,96,52,94,68,26,120,0.0,0.0
1003,1714,2020-03-20 00:32:00,0,1866.0,1526.0,0.818,9.043,473,281,220,61,192,135,57,118,0.11,0.0
1003,1715,2020-03-20 00:35:00,0,2107.0,1645.0,0.781,10.122,170,82,37,45,88,49,39,0,0.0,0.0
1003,1716,2020-03-20 00:38:00,0,1929.0,1474.0,0.764,9.231,116,72,25,47,44,21,23,0,0.0,0.0
1003,1717,2020-03-20 00:41:00,0,2218.0,1760.0,0.794,10.69,207,132,93,39,75,56,19,2,0.0,0.0
1003,1718,2020-03-20 00:44:00,0,2159.0,1736.0,0.804,10.429,306,179,111,68,127,84,43,8,0.0,0.0
1003,1719,2020-03-20 00:47:00,0,2350.0,1800.0,0.766,11.252,75,45,35,10,30,19,11,22,0.0,0.0
1003,1720,2020-03-20 00:50:00,0,1889.0,1522.0,0.806,9.128,9,0,0,0,9,3,6,0,0.0,0.0
1003,1721,2020-03-20 00:53:00,0,1818.0,1379.0,0.759,8.689,32,3,1,2,29,10,19,0,0.0,0.0
1003,1722,2020-03-20 00:56:00,0,1608.0,1316.0,0.818,7.794,23,2,1,1,21,6,15,0,0.0,0.0
1003,1723,2020-03-20 00:59:00,0,1644.0,1281.0,0.779,7.898,26,4,0,4,22,7,15,0,0.0,0.0
1003,1724,2020-03-20 01:02:00,0,1449.0,1169.0,0.807,7.004,52,21,7,14,31,14,17,0,0.0,0.0
1003,1725,2020-03-20 01:05:00,0,1486.0,1200.0,0.808,7.183,42,0,0,0,42,7,35,0,0.0,0.0
1003,1726,2020-03-20 01:08:00,0,1456.0,1134.0,0.779,6.991,19,2,0,2,17,13,4,0,0.0,0.0
1003,1727,2020-03-20 01:11:00,0,1448.0,1137.0,0.785,6.965,26,3,0,3,23,4,19,0,0.0,0.0
1003,1728,2020-03-20 01:14:00,0,1469.0,1169.0,0.796,7.083,76,0,0,0,76,10,66,0,0.0,0.0
1003,1729,2020-03-20 01:17:00,0,1485.0,1141.0,0.769,7.113,18,0,0,0,18,5,13,0,0.0,0.0
1003,1730,2020-03-20 01:20:00,0,1531.0,1125.0,0.735,7.278,69,2,1,1,67,17,50,0,0.0,0.0
1003,1731,2020-03-20 01:23:00,0,1280.0,1054.0,0.823,6.21,45,2,1,1,43,13,30,0,0.0,0.0
1003,1732,2020-03-20 01:26:00,0,1483.0,1092.0,0.736,7.053,104,41,24,17,63,38,25,2,0.0,0.0
1003,1733,2020-03-20 01:29:00,0,1467.0,1157.0,0.789,7.061,205,118,72,46,87,54,33,6,0.0,0.0
1003,1734,2020-03-20 01:32:00,0,1796.0,1439.0,0.801,8.668,367,228,181,47,139,103,36,21,0.0,0.0
1003,1735,2020-03-20 01:35:00,0,1699.0,1376.0,0.81,8.219,80,36,29,7,44,23,21,2,0.0,0.0
1003,1736,2020-03-20 01:38:00,0,1653.0,1348.0,0.816,8.004,42,0,0,0,42,9,33,0,0.0,0.0
1003,1737,2020-03-20 01:41:00,0,1644.0,1296.0,0.788,7.914,2,0,0,0,2,1,1,0,0.0,0.0
1003,1738,2020-03-20 01:44:00,0,1458.0,1202.0,0.824,7.075,26,13,8,5,13,7,6,0,0.0,0.0
1003,1739,2020-03-20 01:47:00,0,1503.0,1154.0,0.768,7.2,15,3,1,2,12,4,8,0,0.0,0.0
1003,1740,2020-03-20 01:50:00,0,1365.0,1056.0,0.774,6.546,17,0,0,0,17,4,13,0,0.0,0.0
1003,1741,2020-03-20 01:53:00,0,1275.0,1004.0,0.788,6.135,11,2,1,1,9,0,9,0,0.0,0.0
1003,1742,2020-03-20 01:56:00,0,1271.0,994.5,0.7825,6.1095,66,17,9,8,49,26,23,0,0.0,0.0
1003,1743,2020-03-20 01:59:00,0,1267.0,985.0,0.777,6.084,21,5,2,3,16,2,14,0,0.0,0.0
1003,1744,2020-03-20 02:02:00,0,1284.0,1039.0,0.809,6.211,13,0,0,0,13,0,13,0,0.0,0.0
1003,1745,2020-03-20 02:05:00,0,1297.0,1008.0,0.777,6.225,16,0,0,0,16,5,11,0,0.0,0.0
1003,1746,2020-03-20 02:08:00,0,1203.0,981.0,0.815,5.825,9,0,0,0,9,4,5,0,0.0,0.0
1003,1747,2020-03-20 02:11:00,0,1211.0,978.0,0.807,5.855,20,1,0,1,19,3,16,0,0.0,0.0
1003,1748,2020-03-20 02:14:00,0,1300.0,1002.0,0.771,6.232,30,3,2,1,27,10,17,0,0.0,0.0
1003,1749,2020-03-20 02:17:00,0,1202.0,978.0,0.814,5.818,6,2,1,1,4,0,4,0,0.0,0.0
1003,1750,2020-03-20 02:20:00,0,1216.0,981.0,0.807,5.876,11,0,0,0,11,0,11,0,0.0,0.0
1003,1751,2020-03-20 02:23:00,0,1306.0,1009.0,0.772,6.263,43,12,3,9,31,17,14,1,0.0,0.0
1003,1752,2020-03-20 02:26:00,0,1468.0,1145.0,0.78,7.051,195,96,41,55,99,54,45,15,0.0,0.0
1003,1753,2020-03-20 02:29:00,0,1597.0,1339.0,0.838,7.774,318,178,125,53,140,94,46,12,0.0,0.0
1003,1754,2020-03-20 02:32:00,0,2053.0,1766.0,0.86,10.045,410,258,208,50,152,118,34,45,0.0,0.0
1003,1755,2020-03-20 02:35:00,0,2339.0,1796.0,0.768,11.203,348,211,172,39,137,91,46,115,0.0,0.0
1003,1756,2020-03-20 02:38:00,0,2590.0,1934.0,0.747,12.348,365,262,195,67,103,82,21,75,0.0,0.0
1003,1757,2020-03-20 02:41:00,0,2552.0,1896.0,0.743,12.155,187,122,90,32,65,44,21,2,0.0,0.0
1003,1758,2020-03-20 02:44:00,0,2449.0,1898.0,0.775,11.75,265,186,146,40,79,50,29,32,0.0,0.0
1003,1759,2020-03-20 02:47:00,0,2536.0,1919.0,0.757,12.115,78,52,27,25,26,10,16,1,0.0,0.0
1003,1760,2020-03-20 02:50:00,0,2515.0,1993.0,0.792,12.118,151,54,28,26,97,54,43,18,0.0,0.0
1003,1761,2020-03-20 02:53:00,0,2523.0,1903.0,0.754,12.05,8,6,3,3,2,2,0,1,0.0,0.0
1003,1762,2020-03-20 02:56:00,0,2184.0,1683.0,0.771,10.469,5,0,0,0,5,2,3,0,0.0,0.0
1003,1763,2020-03-20 02:59:00,0,2076.0,1581.0,0.761,9.929,1,0,0,0,1,0,1,0,0.0,0.0
1003,1764,2020-03-20 03:02:00,0,1882.0,1443.0,0.767,9.012,1,0,0,0,1,0,1,0,0.0,0.0
1003,1765,2020-03-20 03:05:00,0,1714.0,1351.0,0.788,8.248,2,2,1,1,0,0,0,0,0.0,0.0
1003,1766,2020-03-20 03:08:00,0,1697.0,1343.0,0.791,8.174,1,0,0,0,1,0,1,0,0.0,0.0
1003,1767,2020-03-20 03:11:00,0,1641.0,1288.0,0.785,7.891,48,24,12,12,24,11,13,1,0.0,0.0
1003,1768,2020-03-20 03:14:00,0,1567.0,1261.0,0.804,7.571,14,4,1,3,10,0,10,0,0.0,0.0
1003,1769,2020-03-20 03:17:00,0,1473.0,1198.0,0.813,7.13,6,0,0,0,6,0,6,0,0.0,0.0
1003,1770,2020-03-20 03:20:00,0,1493.0,1128.0,0.756,7.134,12,1,0,1,11,0,11,0,0.0,0.0
1003,1771,2020-03-20 03:23:00,0,1292.0,1082.0,0.838,6.288,10,0,0,0,10,0,10,0,0.0,0.0
1003,1772,2020-03-20 03:26:00,0,1241.0,1002.0,0.808,6.001,2,0,0,0,2,0,2,0,0.0,0.0
1003,1773,2020-03-20 03:29:00,0,1276.0,997.0,0.781,6.129,3,0,0,0,3,3,0,0,0.0,0.0
1003,1774,2020-03-20 03:32:00,0,1195.0,972.0,0.814,5.785,0,0,0,0,0,0,0,0,0.0,0.0
1003,1775,2020-03-20 03:35:00,0,1122.0,969.0,0.864,5.493,7,0,0,0,7,5,2,0,0.0,0.0
1003,1776,2020-03-20 03:38:00,0,1114.0,970.0,0.871,5.463,252,119,84,35,133,90,43,15,0.0,0.0
1003,1777,2020-03-20 03:41:00,0,1608.0,1395.0,0.868,7.88,331,178,130,48,153,111,42,21,0.0,0.0
1003,1778,2020-03-20 03:44:00,0,1771.0,1383.0,0.781,8.511,140,71,31,40,69,42,27,26,0.0,0.0
1003,1779,2020-03-20 03:47:00,0,1853.0,1571.0,0.848,9.041,320,214,171,43,106,74,32,109,0.0,0.0
1003,1780,2020-03-20 03:50:00,0,1910.0,1523.0,0.797,9.211,330,190,144,46,140,99,41,17,0.03,0.0
1003,1781,2020-03-20 03:53:00,0,2077.0,1705.0,0.821,10.071,512,276,207,69,236,178,58,10,0.0,0.0
1003,1782,2020-03-20 03:56:00,0,1890.0,1462.0,0.773,9.066,427,255,190,65,172,116,56,12,0.0,0.0
1003,1783,2020-03-20 03:59:00,0,2074.0,1714.0,0.827,10.069,514,268,209,59,246,162,84,17,0.0,0.0
1003,1784,2020-03-20 04:02:00,0,2095.0,1713.0,0.818,10.149,957,597,485,112,360,273,87,33,0.0,0.0
1003,1785,2020-03-20 04:05:00,0,1890.0,1580.0,0.836,9.194,103,28,15,13,75,50,25,0,0.0,0.0
1003,1786,2020-03-20 04:08:00,0,1889.0,1545.0,0.818,9.154,7,5,2,3,2,1,1,0,0.0,0.0
1003,1787,2020-03-20 04:11:00,0,2022.0,1604.0,0.793,9.744,4,0,0,0,4,1,3,0,0.0,0.0
1003,1788,2020-03-20 04:14:00,0,1893.0,1412.0,0.746,9.023,2,0,0,0,2,1,1,0,0.0,0.0
1003,1789,2020-03-20 04:17:00,0,1609.0,1298.0,0.807,7.776,3,1,0,1,2,2,0,0,0.0,0.0
1003,1790,2020-03-20 04:20:00,0,1697.0,1283.0,0.756,8.106,12,0,0,0,12,4,8,0,0.0,0.0
1003,1791,2020-03-20 04:23:00,0,1489.0,1200.0,0.806,7.194,9,3,0,3,6,2,4,0,0.0,0.0
1003,1792,2020-03-20 04:26:00,0,1492.0,1178.0,0.79,7.182,29,3,2,1,26,20,6,0,0.0,0.0
1003,1793,2020-03-20 04:29:00,0,1381.0,1111.0,0.804,6.672,58,0,0,0,58,27,31,0,0.0,0.0
1003,1794,2020-03-20 04:32:00,0,1303.0,1074.0,0.824,6.324,36,0,0,0,36,8,28,0,0.0,0.0
1003,1795,2020-03-20 04:35:00,0,1311.0,1012.0,0.772,6.287,45,12,6,6,33,7,26,0,0.0,0.0
1003,1796,2020-03-20 04:38:00,0,1219.0,983.0,0.806,5.893,29,11,3,8,18,8,10,0,0.0,0.0
1003,1797,2020-03-20 04:41:00,0,1123.0,966.0,0.86,5.493,15,11,6,5,4,0,4,0,0.0,0.0
1003,1798,2020-03-20 04:44:00,0,1216.0,999.0,0.822,5.898,20,9,4,5,11,4,7,0,0.0,0.0
1003,1799,2020-03-20 04:47:00,0,1180.0,979.0,0.83,5.732,18,14,0,14,4,2,2,0,0.0,0.0
1003,1800,2020-03-20 04:50:00,0,1003.0,938.0,0.935,4.991,7,4,1,3,3,2,1,0,0.0,0.0
1003,1801,2020-03-20 04:53:00,0,1017.0,927.0,0.912,5.032,7,0,0,0,7,2,5,0,0.0,0.0
1003,1802,2020-03-20 04:56:00,0,1016.5,897.5,0.883,4.998,6,2,0,2,4,0,4,0,0.0,0.0
1003,1803,2020-03-20 04:59:00,0,1016.0,868.0,0.854,4.964,56,29,11,18,27,14,13,0,0.0,0.0
1003,1804,2020-03-20 05:02:00,0,988.0,878.0,0.888,4.866,18,0,0,0,18,2,16,0,0.0,0.0
1003,1805,2020-03-20 05:05:00,0,1014.0,889.0,0.877,4.98,6,1,0,1,5,3,2,0,0.0,0.0
1003,1806,2020-03-20 05:08:00,0,1017.0,870.0,0.855,4.97,5,3,3,0,2,0,2,0,0.0,0.0
1003,1807,2020-03-20 05:11:00,0,1047.0,893.0,0.853,5.116,121,55,19,36,66,39,27,0,0.0,0.0
1003,1808,2020-03-20 05:14:00,0,1377.0,1105.0,0.802,6.65,157,57,15,42,100,56,44,4,0.0,0.0
1003,1809,2020-03-20 05:17:00,0,2082.0,1687.0,0.811,10.071,261,160,118,42,101,73,28,49,0.0,0.0
1003,1810,2020-03-20 05:20:00,0,1715.0,1425.0,0.831,8.334,121,36,30,6,85,60,25,1,0.0,0.0
1003,1811,2020-03-20 05:23:00,0,1664.0,1268.0,0.762,7.96,128,4,2,2,124,82,42,0,0.0,0.0
1003,1812,2020-03-20 05:26:00,0,1454.0,1179.0,0.811,7.036,12,5,1,4,7,4,3,0,0.0,0.0
1003,1813,2020-03-20 05:29:00,0,1485.0,1138.0,0.766,7.113,9,3,1,2,6,1,5,0,0.0,0.0
1003,1814,2020-03-20 05:32:00,0,1496.0,1143.0,0.764,7.16,16,3,1,2,13,7,6,0,0.0,0.0
1003,1815,2020-03-20 05:35:00,0,1461.0,1141.0,0.781,7.019,33,5,2,3,28,6,22,0,0.0,0.0
1003,1816,2020-03-20 05:38:00,0,1457.0,1131.0,0.776,6.995,30,10,6,4,20,10,10,0,0.0,0.0
1003,1817,2020-03-20 05:41:00,0,1489.0,1163.0,0.781,7.153,13,3,0,3,10,0,10,0,0.0,0.0
1003,1818,2020-03-20 05:44:00,0,1302.0,1096.0,0.842,6.345,32,15,0,15,17,0,17,0,0.0,0.0
1003,1819,2020-03-20 05:47:00,0,1175.0,1000.0,0.851,5.738,28,9,2,7,19,0,19,0,0.0,0.0
1003,1820,2020-03-20 05:50:00,0,1202.0,1013.0,0.843,5.855,142,81,59,22,61,42,19,4,0.0,0.0
1003,1821,2020-03-20 05:53:00,0,2025.0,1683.0,0.831,9.841,23,13,2,11,10,7,3,0,0.0,0.0
1003,1822,2020-03-20 05:56:00,0,1629.0,1405.0,0.862,7.975,288,150,91,59,138,102,36,47,0.0,0.0
1003,1823,2020-03-20 05:59:00,0,1448.0,1155.0,0.798,6.985,675,428,347,81,247,179,68,27,0.0,0.0
1003,1824,2020-03-20 06:02:00,1,1603.0,1307.0,0.816,7.762,270,152,106,46,118,80,38,39,0.0,0.0
1003,1825,2020-03-20 06:05:00,1,2069.0,1662.0,0.803,9.991,336,221,173,48,115,73,42,106,0.0,0.0
1003,1826,2020-03-20 06:08:00,1,2591.0,2043.0,0.789,12.471,92,55,27,28,37,15,22,97,0.0,0.1
1003,1827,2020-03-20 06:11:00,1,2706.0,2121.0,0.784,13.011,60,32,13,19,28,15,13,95,0.0,0.08
1003,1828,2020-03-20 06:14:00,1,2596.0,2183.0,0.841,12.647,84,48,25,23,36,15,21,102,0.0,0.09
1003,1829,2020-03-20 06:17:00,1,2606.0,2226.0,0.854,12.733,140,91,70,21,49,31,18,97,0.0,0.3
1003,1830,2020-03-20 06:20:00,1,2858.0,2501.0,0.875,14.031,36,6,0,6,30,10,20,0,0.0,0.01
1003,1831,2020-03-20 06:23:00,1,2551.0,2335.0,0.915,12.637,194,96,64,32,98,59,39,13,0.49,0.0
1003,1832,2020-03-20 06:26:00,1,2630.0,2361.0,0.898,12.977,180,114,85,29,66,44,22,21,0.07,0.03
1003,1833,2020-03-20 06:29:00,1,2557.0,2352.0,0.92,12.678,277,148,104,44,129,87,42,58,0.0,0.0
1003,1834,2020-03-20 06:32:00,1,2821.0,2582.0,0.915,13.972,232,92,55,37,140,72,68,46,0.15,0.01
1003,1835,2020-03-20 06:35:00,1,2651.0,2537.0,0.957,13.252,198,123,68,55,75,20,55,101,0.0,0.02
1003,1836,2020-03-20 06:38:00,1,2853.0,2706.0,0.949,14.237,169,102,64,38,67,21,46,53,0.02,0.07
1003,1837,2020-03-20 06:41:00,1,2873.0,2698.0,0.939,14.306,223,145,82,63,78,36,42,98,0.23,0.06
1003,1838,2020-03-20 06:44:00,1,2987.0,2829.0,0.947,14.901,207,118,65,53,89,35,54,98,0.0,0.0
1003,1839,2020-03-20 06:47:00,1,3144.0,2940.0,0.935,15.643,394,211,154,57,183,125,58,54,0.25,0.08
1003,1840,2020-03-20 06:50:00,1,2864.0,2789.0,0.974,14.371,367,230,161,69,137,83,54,75,0.0,0.03
1003,1841,2020-03-20 06:53:00,1,2969.0,2895.0,0.975,14.904,222,134,78,56,88,44,44,92,0.08,0.05
1003,1842,2020-03-20 06:56:00,1,3028.0,2871.0,0.948,15.107,186,105,60,45,81,39,42,72,0.09,0.02
1003,1843,2020-03-20 06:59:00,1,3219.0,3015.0,0.937,16.021,274,143,81,62,131,75,56,73,0.09,0.04
1003,1844,2020-03-20 07:02:00,1,2404.0,2353.0,0.979,12.077,301,195,139,56,106,55,51,67,0.02,0.04
1003,1845,2020-03-20 07:05:00,1,3217.0,3103.0,0.965,16.112,252,141,79,62,111,47,64,78,0.04,0.06
1003,1846,2020-03-20 07:08:00,1,3013.0,2887.0,0.958,15.067,259,131,88,43,128,62,66,83,0.09,0.0
1003,1847,2020-03-20 07:11:00,1,3255.0,3056.0,0.939,16.208,239,98,56,42,141,74,67,42,0.0,0.0
1003,1848,2020-03-20 07:14:00,1,3044.0,2916.0,0.958,15.222,196,82,40,42,114,45,69,60,0.0,0.0
1003,1849,2020-03-20 07:17:00,1,3103.0,3061.0,0.987,15.616,190,67,34,33,123,63,60,33,0.1,0.0
1003,1850,2020-03-20 07:20:00,1,2685.0,2654.0,0.989,13.515,140,66,31,35,74,33,41,47,0.05,0.04
1003,1851,2020-03-20 07:23:00,1,3014.0,3001.0,0.996,15.197,180,50,20,30,130,81,49,25,0.03,0.05
1003,1852,2020-03-20 07:26:00,1,2968.0,3013.0,1.015,15.028,215,86,48,38,129,74,55,32,0.01,0.01
1003,1853,2020-03-20 07:29:00,1,2927.0,2912.0,0.995,14.754,313,153,116,37,160,109,51,35,0.11,0.14
1003,1854,2020-03-20 07:32:00,1,2406.0,2425.0,1.008,12.164,828,465,377,88,363,276,87,51,0.0,0.0
1003,1855,2020-03-20 07:35:00,1,2409.0,2327.0,0.966,12.069,139,69,23,46,70,15,55,1,0.0,0.0
1003,1856,2020-03-20 07:38:00,1,2404.0,2416.0,1.005,12.147,61,6,3,3,55,27,28,0,0.0,0.0
1003,1857,2020-03-20 07:41:00,1,2395.0,2355.0,0.983,12.043,38,8,4,4,30,7,23,0,0.01,0.0
1003,1858,2020-03-20 07:44:00,1,1948.0,2011.0,1.032,9.9,49,7,3,4,42,15,27,0,0.0,0.0
1003,1859,2020-03-20 07:47:00,1,1623.0,1704.0,1.05,8.28,69,4,2,2,65,16,49,0,0.0,0.0
1003,1860,2020-03-20 07:50:00,1,1635.0,1734.0,1.061,8.362,14,1,1,0,13,0,13,0,0.0,0.0
1003,1861,2020-03-20 07:53:00,1,1787.0,1746.0,0.977,8.976,3,0,0,0,3,0,3,0,0.0,0.0
1003,1862,2020-03-20 07:56:00,1,1794.0,1827.0,1.018,9.0915,10,0,0,0,10,2,8,0,0.0,0.0
1003,1863,2020-03-20 07:59:00,1,1801.0,1908.0,1.059,9.207,8,0,0,0,8,2,6,0,0.0,0.0
1003,1864,2020-03-20 08:02:00,1,1752.0,1808.0,1.032,8.904,2,0,0,0,2,0,2,0,0.0,0.0
1003,1865,2020-03-20 08:05:00,1,1565.0,1704.0,1.089,8.053,52,22,14,8,30,18,12,0,0.0,0.0
1003,1866,2020-03-20 08:08:00,1,1822.0,1876.0,1.03,9.256,20,14,11,3,6,1,5,0,0.0,0.0
1003,1867,2020-03-20 08:11:00,1,1808.0,1877.0,1.038,9.2,145,66,46,20,79,54,25,7,0.0,0.0
1003,1868,2020-03-20 08:14:00,1,1707.0,1812.0,1.061,8.732,15,3,1,2,12,4,8,0,0.0,0.0
1003,1869,2020-03-20 08:17:00,1,1796.0,1807.0,1.006,9.078,252,125,72,53,127,76,51,17,0.0,0.0
1003,1870,2020-03-20 08:20:00,1,1969.0,2076.0,1.055,10.055,181,83,43,40,98,42,56,44,0.0,0.0
1003,1871,2020-03-20 08:23:00,1,2199.0,2207.0,1.003,11.109,273,166,104,62,107,40,67,93,0.0,0.0
1003,1872,2020-03-20 08:26:00,1,2390.0,2416.0,1.011,12.092,253,184,111,73,69,22,47,81,0.0,0.0
1003,1873,2020-03-20 08:29:00,1,2468.0,2563.0,1.039,12.561,262,169,110,59,93,22,71,95,0.0,0.0
1003,1874,2020-03-20 08:32:00,1,2558.0,2708.0,1.058,13.076,202,79,42,37,123,63,60,36,0.0,0.04
1003,1875,2020-03-20 08:35:00,1,2792.0,2900.0,1.038,14.212,70,20,3,17,50,33,17,3,0.18,0.06
1003,1876,2020-03-20 08:38:00,1,2773.0,2942.0,1.061,14.181,154,87,70,17,67,51,16,18,0.02,0.02
1003,1877,2020-03-20 08:41:00,1,2594.0,2713.0,1.046,13.224,549,322,260,62,227,171,56,34,0.18,0.06
1003,1878,2020-03-20 08:44:00,1,2875.0,2971.0,1.034,14.617,30,10,2,8,20,14,6,0,0.0,0.0
1003,1879,2020-03-20 08:47:00,1,2991.0,2994.0,1.001,15.098,6,4,1,3,2,2,0,2,0.0,0.07
1003,1880,2020-03-20 08:50:00,1,2922.0,2984.0,1.021,14.817,228,120,93,27,108,81,27,2,0.02,0.04
1003,1881,2020-03-20 08:53:00,1,2340.0,2478.0,1.059,11.963,812,483,382,101,329,239,90,11,0.01,0.02
1003,1882,2020-03-20 08:56:00,1,2411.0,2419.0,1.003,12.175,835,557,440,117,278,193,85,27,0.1,0.0
1003,1883,2020-03-20 08:59:00,1,2240.0,2166.0,0.967,11.222,1006,548,439,109,458,360,98,11,0.0,0.0
1003,1884,2020-03-20 09:02:00,1,2710.0,2797.0,1.032,13.773,503,240,149,91,263,187,76,12,0.0,0.0
1003,1885,2020-03-20 09:05:00,1,2894.0,3015.0,1.042,14.738,412,159,91,68,253,179,74,13,0.09,0.03
1003,1886,2020-03-20 09:08:00,1,2194.0,2276.0,1.037,11.165,78,23,9,14,55,24,31,5,0.0,0.01
1003,1887,2020-03-20 09:11:00,1,1535.0,1698.0,1.106,7.927,42,0,0,0,42,0,42,0,0.0,0.0
1003,1888,2020-03-20 09:14:00,1,1380.0,1368.0,0.991,6.953,59,0,0,0,59,16,43,0,0.0,0.02
1003,1889,2020-03-20 09:17:00,1,1593.0,1606.0,1.008,8.055,64,5,2,3,59,4,55,0,0.0,0.0
1003,1890,2020-03-20 09:20:00,1,1943.0,1991.0,1.024,9.859,68,0,0,0,68,0,68,0,0.0,0.0
1003,1891,2020-03-20 09:23:00,1,2198.0,2353.0,1.07,11.267,67,0,0,0,67,0,67,0,0.0,0.0
1003,1892,2020-03-20 09:26:00,1,2244.0,2347.0,1.046,11.439,93,2,0,2,91,8,83,0,0.0,0.0
1003,1893,2020-03-20 09:29:00,1,1916.0,2180.0,1.137,9.963,67,0,0,0,67,4,63,0,0.0,0.0
1003,1894,2020-03-20 09:32:00,1,1862.0,2060.0,1.106,9.618,66,0,0,0,66,0,66,0,0.0,0.0
1003,1895,2020-03-20 09:35:00,1,1830.0,1943.0,1.062,9.362,16,0,0,0,16,0,16,0,0.0,0.0
1003,1896,2020-03-20 09:38:00,1,1607.0,1810.0,1.126,8.336,92,0,0,0,92,37,55,0,0.0,0.0
1003,1897,2020-03-20 09:41:00,1,1548.0,1794.0,1.159,8.084,118,16,11,5,102,71,31,0,0.0,0.0
1003,1898,2020-03-20 09:44:00,1,1473.0,1657.0,1.125,7.638,33,3,0,3,30,7,23,0,0.0,0.0
1003,1899,2020-03-20 09:47:00,1,1371.0,1549.0,1.13,7.117,33,4,0,4,29,6,23,0,0.0,0.0
1003,1900,2020-03-20 09:50:00,1,1346.0,1514.0,1.125,6.978,41,2,0,2,39,13,26,0,0.0,0.02
1003,1901,2020-03-20 09:53:00,1,1439.0,1609.0,1.118,7.452,52,6,0,6,46,27,19,0,0.0,0.0
1003,1902,2020-03-20 09:56:00,1,1356.0,1557.0,1.148,7.067,51,1,0,1,50,19,31,0,0.0,0.0
1003,1903,2020-03-20 09:59:00,1,1371.0,1614.0,1.177,7.187,91,25,13,12,66,39,27,6,0.0,0.0
1003,1904,2020-03-20 10:02:00,1,1519.0,1684.0,1.109,7.848,20,1,0,1,19,2,17,0,0.0,0.0
1003,1905,2020-03-20 10:05:00,1,1550.0,1640.0,1.058,7.923,35,3,0,3,32,11,21,0,0.0,0.0
1003,1906,2020-03-20 10:08:00,1,1571.0,1670.0,1.063,8.037,30,2,2,0,28,7,21,0,0.0,0.0
1003,1907,2020-03-20 10:11:00,1,1373.0,1604.0,1.168,7.186,42,6,4,2,36,18,18,0,0.0,0.0
1003,1908,2020-03-20 10:14:00,1,1361.0,1580.0,1.161,7.112,89,6,1,5,83,62,21,0,0.0,0.0
1003,1909,2020-03-20 10:17:00,1,1359.0,1611.0,1.185,7.14,31,6,4,2,25,12,13,0,0.0,0.0
1003,1910,2020-03-20 10:20:00,1,1329.0,1599.0,1.203,7.007,361,1,1,0,360,329,31,0,0.0,0.0
1003,1911,2020-03-20 10:23:00,1,1392.0,1571.0,1.129,7.224,64,2,0,2,62,25,37,0,0.0,0.0
1003,1912,2020-03-20 10:26:00,1,1352.0,1503.0,1.112,6.99,30,0,0,0,30,15,15,0,0.0,0.0
1003,1913,2020-03-20 10:29:00,1,1381.0,1598.0,1.157,7.21,45,10,6,4,35,17,18,0,0.0,0.0
1003,1914,2020-03-20 10:32:00,1,1363.0,1567.0,1.15,7.105,14,0,0,0,14,5,9,0,0.0,0.0
1003,1915,2020-03-20 10:35:00,1,1351.0,1598.0,1.183,7.094,37,2,2,0,35,17,18,0,0.0,0.0
1003,1916,2020-03-20 10:38:00,1,1320.0,1580.0,1.197,6.949,24,0,0,0,24,11,13,0,0.0,0.0
1003,1917,2020-03-20 10:41:00,1,1374.0,1577.0,1.148,7.16,17,0,0,0,17,4,13,0,0.0,0.01
1003,1918,2020-03-20 10:44:00,1,1604.0,1828.0,1.14,8.342,260,76,47,29,184,123,61,22,0.0,0.0
1003,1919,2020-03-20 10:47:00,1,2229.0,2417.0,1.084,11.459,227,10,5,5,217,141,76,1,0.0,0.0
1003,1920,2020-03-20 10:50:00,1,2376.0,2663.0,1.12,12.31,240,15,6,9,225,153,72,0,0.0,0.04
1003,1921,2020-03-20 10:53:00,1,2199.0,2392.0,1.087,11.313,194,100,57,43,94,59,35,8,0.0,0.03
1003,1922,2020-03-20 10:56:00,1,2373.0,2629.0,1.106,12.261,93,3,1,2,90,55,35,1,0.0,0.33
1003,1923,2020-03-20 10:59:00,1,2547.0,2866.0,1.125,13.209,46,21,1,20,25,12,13,0,0.0,0.02
1003,1924,2020-03-20 11:02:00,1,2694.0,2925.0,1.086,13.853,199,89,61,28,110,77,33,14,0.14,0.0
1003,1925,2020-03-20 11:05:00,1,1959.0,2111.0,1.077,10.055,888,508,397,111,380,285,95,49,0.04,0.02
1003,1926,2020-03-20 11:08:00,1,1717.0,1813.0,1.056,8.771,798,481,366,115,317,214,103,19,0.0,0.0
1003,1927,2020-03-20 11:11:00,1,2361.0,2527.0,1.07,12.101,665,325,243,82,340,238,102,17,0.0,0.0
1003,1928,2020-03-20 11:14:00,1,2691.0,2863.0,1.064,13.77,112,61,24,37,51,29,22,0,0.22,0.0
1003,1929,2020-03-20 11:17:00,1,2100.0,2306.0,1.098,10.827,199,120,74,46,79,47,32,30,0.01,0.0
1003,1930,2020-03-20 11:20:00,1,2359.0,2472.0,1.048,12.032,135,70,17,53,65,31,34,2,0.0,0.0
1003,1931,2020-03-20 11:23:00,1,2502.0,2688.0,1.074,12.834,169,60,13,47,109,54,55,3,0.0,0.0
1003,1932,2020-03-20 11:26:00,1,2440.0,2649.0,1.086,12.545,43,30,1,29,13,2,11,0,0.0,0.0
1003,1933,2020-03-20 11:29:00,1,2266.0,2400.0,1.059,11.587,61,46,0,46,15,0,15,0,0.0,0.0
1003,1934,2020-03-20 11:32:00,1,2131.0,2275.0,1.067,10.915,18,7,3,4,11,7,4,0,0.0,0.0
1003,1935,2020-03-20 11:35:00,1,1914.0,2097.0,1.096,9.862,16,13,2,11,3,1,2,0,0.0,0.0
1003,1936,2020-03-20 11:38:00,1,1958.0,2095.0,1.07,10.033,1,1,0,1,0,0,0,0,0.0,0.0
1003,1937,2020-03-20 11:41:00,1,1767.0,1973.0,1.116,9.146,18,10,4,6,8,6,2,0,0.0,0.0
1003,1938,2020-03-20 11:44:00,1,1592.0,1825.0,1.146,8.294,0,0,0,0,0,0,0,0,0.0,0.0
1003,1939,2020-03-20 11:47:00,1,1514.0,1778.0,1.174,7.934,8,3,0,3,5,2,3,0,0.0,0.0
1003,1940,2020-03-20 11:50:00,1,1489.0,1706.0,1.146,7.755,20,19,0,19,1,1,0,0,0.0,0.0
1003,1941,2020-03-20 11:53:00,1,1557.0,1691.0,1.086,8.007,270,196,134,62,74,58,16,66,0.0,0.0
1003,1942,2020-03-20 11:56:00,1,1739.0,1966.0,1.131,9.026,218,114,68,46,104,53,51,59,0.0,0.0
1003,1943,2020-03-20 11:59:00,1,2338.0,2583.0,1.104,12.072,266,158,124,34,108,80,28,129,0.0,0.0
1003,1944,2020-03-20 12:02:00,1,2295.0,2579.0,1.124,11.895,159,81,43,38,78,38,40,67,0.01,0.0
1003,1945,2020-03-20 12:05:00,1,2334.0,2597.0,1.113,12.069,103,61,45,16,42,24,18,4,0.11,0.0
1003,1946,2020-03-20 12:08:00,1,2172.0,2398.0,1.104,11.212,2,0,0,0,2,1,1,0,0.0,0.0
1004,1,2020-03-16 10:53:00,1,4114.0,3304.0,0.803,19.868,608,257,191,66,351,266,85,29,0.04,0.04
1004,2,2020-03-16 10:56:00,1,4146.0,3281.0,0.791,19.97,373,174,118,56,199,138,61,21,0.0,0.0
1004,3,2020-03-16 10:59:00,1,4018.0,3183.5,0.792,19.3575,160,68,47,21,92,60,32,10,0.0,0.0
1004,4,2020-03-16 11:02:00,1,3890.0,3086.0,0.793,18.745,239,108,76,32,131,91,40,36,0.01,0.01
1004,5,2020-03-16 11:05:00,1,3894.0,3113.0,0.8,18.79,365,171,120,51,194,140,54,21,0.0,0.0
1004,6,2020-03-16 11:08:00,1,3901.0,3046.0,0.781,18.741,334,206,138,68,128,72,56,6,0.05,0.02
1004,7,2020-03-16 11:11:00,1,3821.0,2971.0,0.777,18.344,85,29,7,22,56,23,33,1,0.0,0.0
1004,8,2020-03-16 11:14:00,1,3740.0,2900.0,0.776,17.946,210,101,54,47,109,59,50,0,0.0,0.0
1004,9,2020-03-16 11:17:00,1,3658.0,2839.0,0.776,17.556,147,70,28,42,77,43,34,2,0.01,0.02
1004,10,2020-03-16 11:20:00,1,3555.0,2809.0,0.79,17.115,218,86,44,42,132,90,42,2,0.0,0.0
1004,11,2020-03-16 11:23:00,1,3581.0,2793.0,0.78,17.201,42,20,6,14,22,10,12,0,0.0,0.0
1004,12,2020-03-16 11:26:00,1,3570.0,2762.0,0.774,17.126,254,161,105,56,93,47,46,0,0.05,0.0
1004,13,2020-03-16 11:29:00,1,3665.0,2862.0,0.781,17.609,450,220,156,64,230,173,57,6,0.01,0.0
1004,14,2020-03-16 11:32:00,1,3570.0,2791.0,0.782,17.154,398,132,91,41,266,193,73,8,0.0,0.0
1004,15,2020-03-16 11:35:00,1,3595.0,2707.0,0.753,17.162,118,46,27,19,72,46,26,0,0.01,0.0
1004,16,2020-03-16 11:38:00,1,3503.0,2615.0,0.746,16.697,60,20,3,17,40,1,39,0,0.0,0.0
1004,17,2020-03-16 11:41:00,1,3327.0,2590.0,0.778,15.977,98,69,33,36,29,13,16,0,0.0,0.0
1004,18,2020-03-16 11:44:00,1,3339.0,2512.0,0.752,15.937,11,7,4,3,4,1,3,0,0.0,0.0
1004,19,2020-03-16 11:47:00,1,3184.0,2333.0,0.733,15.131,0,0,0,0,0,0,0,0,0.05,0.0
1004,20,2020-03-16 11:50:00,1,3006.0,2256.0,0.75,14.343,11,0,0,0,11,1,10,0,0.0,0.0
1004,21,2020-03-16 11:53:00,1,2927.0,2184.0,0.746,13.951,25,17,6,11,8,0,8,0,0.0,0.0
1004,22,2020-03-16 11:56:00,1,2769.0,2043.0,0.738,13.173,29,26,5,21,3,0,3,0,0.01,0.0
1004,23,2020-03-16 11:59:00,1,2781.0,1972.0,0.709,13.142,16,15,0,15,1,0,1,0,0.0,0.0
1004,24,2020-03-16 12:02:00,1,2695.0,1917.0,0.711,12.743,9,7,3,4,2,0,2,0,0.0,0.0
1004,25,2020-03-16 12:05:00,1,2776.0,1957.0,0.705,13.104,1,0,0,0,1,0,1,0,0.01,0.0
1004,26,2020-03-16 12:08:00,1,2786.0,1969.0,0.707,13.16,32,12,10,2,20,9,11,3,0.02,0.0
1004,27,2020-03-16 12:11:00,1,2759.0,2075.0,0.752,13.17,16,15,0,15,1,1,0,0,0.0,0.0
1004,28,2020-03-16 12:14:00,1,2766.0,1999.0,0.723,13.11,17,2,0,2,15,1,14,0,0.0,0.0
1004,29,2020-03-16 12:17:00,1,2591.0,1913.0,0.738,12.328,11,2,0,2,9,1,8,0,0.0,0.0
1004,30,2020-03-16 12:20:00,1,2621.0,1845.0,0.704,12.37,32,0,0,0,32,2,30,0,0.0,0.0
1004,31,2020-03-16 12:23:00,1,2630.0,1832.0,0.696,12.392,20,4,0,4,16,3,13,0,0.04,0.0
1004,32,2020-03-16 12:26:00,1,2631.0,1807.0,0.687,12.365,33,25,2,23,8,1,7,0,0.0,0.0
1004,33,2020-03-16 12:29:00,1,2624.0,1845.0,0.703,12.382,58,58,0,58,0,0,0,0,0.01,0.0
1004,34,2020-03-16 12:32:00,1,2608.0,1839.0,0.705,12.314,31,23,6,17,8,0,8,0,0.03,0.0
1004,35,2020-03-16 12:35:00,1,2612.0,1874.0,0.717,12.368,0,0,0,0,0,0,0,0,0.0,0.0
1004,36,2020-03-16 12:38:00,1,2602.0,1894.0,0.728,12.351,0,0,0,0,0,0,0,0,0.0,0.0
1004,37,2020-03-16 12:41:00,1,2603.0,1907.0,0.733,12.37,27,6,3,3,21,0,21,0,0.0,0.0
1004,38,2020-03-16 12:44:00,1,2608.0,1886.0,0.723,12.364,15,12,8,4,3,0,3,0,0.0,0.0
1004,39,2020-03-16 12:47:00,1,2688.0,1933.0,0.719,12.73,6,6,3,3,0,0,0,0,0.0,0.0
1004,40,2020-03-16 12:50:00,1,2602.0,1912.0,0.735,12.371,8,7,4,3,1,0,1,0,0.0,0.0
1004,41,2020-03-16 12:53:00,1,2620.0,1834.0,0.7,12.352,47,38,23,15,9,6,3,0,0.0,0.0
1004,42,2020-03-16 12:56:00,1,2600.0,1907.0,0.734,12.355,42,21,15,6,21,11,10,0,0.0,0.0
1004,43,2020-03-16 12:59:00,1,2589.0,1949.0,0.753,12.361,37,31,0,31,6,0,6,0,0.0,0.0
1004,44,2020-03-16 13:02:00,1,2764.0,2035.0,0.736,13.141,68,56,9,47,12,1,11,3,0.0,0.0
1004,45,2020-03-16 13:05:00,1,2913.0,2218.0,0.761,13.933,81,50,24,26,31,6,25,2,0.0,0.0
1004,46,2020-03-16 13:08:00,1,2911.0,2279.0,0.783,13.993,33,8,3,5,25,7,18,5,0.0,0.0
1004,47,2020-03-16 13:11:00,1,3103.0,2332.0,0.751,14.808,187,110,59,51,77,45,32,16,0.0,0.0
1004,48,2020-03-16 13:14:00,1,3184.0,2345.0,0.737,15.142,432,173,111,62,259,188,71,7,0.0,0.0
1004,49,2020-03-16 13:17:00,1,3249.0,2460.0,0.757,15.525,280,134,88,46,146,102,44,11,0.0,0.0
1004,50,2020-03-16 13:20:00,1,3173.0,2353.0,0.741,15.108,134,79,43,36,55,19,36,0,0.0,0.0
1004,51,2020-03-16 13:23:00,1,3171.0,2363.0,0.745,15.111,27,13,1,12,14,5,9,0,0.05,0.0
1004,52,2020-03-16 13:26:00,1,2904.0,2224.0,0.766,13.903,3,0,0,0,3,1,2,0,0.0,0.0
1004,53,2020-03-16 13:29:00,1,2755.0,2071.0,0.752,13.148,12,0,0,0,12,1,11,0,0.0,0.0
1004,54,2020-03-16 13:32:00,1,2688.0,1939.0,0.721,12.739,50,36,16,20,14,8,6,0,0.0,0.0
1004,55,2020-03-16 13:35:00,1,2777.0,2006.0,0.722,13.164,21,2,1,1,19,0,19,0,0.01,0.0
1004,56,2020-03-16 13:38:00,1,2783.0,2000.0,0.719,13.178,15,14,0,14,1,0,1,0,0.0,0.0
1004,57,2020-03-16 13:41:00,1,2767.0,1971.0,0.713,13.083,16,16,0,16,0,0,0,0,0.0,0.0
1004,58,2020-03-16 13:44:00,1,2692.0,1922.0,0.714,12.733,8,8,0,8,0,0,0,0,0.01,0.0
1004,59,2020-03-16 13:47:00,1,2585.0,1916.0,0.741,12.306,76,75,46,29,1,0,1,0,0.0,0.0
1004,60,2020-03-16 13:50:00,1,2607.0,1855.0,0.711,12.325,373,373,309,64,0,0,0,0,0.01,0.0
1004,61,2020-03-16 13:53:00,1,2608.0,1831.0,0.702,12.301,29,27,4,23,2,0,2,0,0.0,0.0
1004,62,2020-03-16 13:56:00,1,2616.0,1851.0,0.707,12.357,10,4,2,2,6,1,5,0,0.0,0.0
1004,63,2020-03-16 13:59:00,1,2570.0,1826.5,0.7105,12.1485,8,7,2,5,1,0,1,0,0.0,0.0
1004,64,2020-03-16 14:02:00,1,2524.0,1802.0,0.714,11.94,5,1,0,1,4,0,4,0,0.0,0.0
1004,65,2020-03-16 14:05:00,1,2424.0,1779.0,0.734,11.521,17,0,0,0,17,1,16,0,0.0,0.0
1004,66,2020-03-16 14:08:00,1,2346.0,1701.0,0.725,11.126,22,0,0,0,22,1,21,0,0.0,0.0
1004,67,2020-03-16 14:11:00,1,2337.0,1741.0,0.745,11.136,9,2,0,2,7,0,7,0,0.0,0.0
1004,68,2020-03-16 14:14:00,1,2421.0,1779.0,0.735,11.51,4,1,0,1,3,2,1,0,0.02,0.0
1004,69,2020-03-16 14:17:00,1,2518.0,1802.0,0.716,11.916,0,0,0,0,0,0,0,0,0.0,0.0
1004,70,2020-03-16 14:20:00,1,2521.0,1805.0,0.716,11.932,0,0,0,0,0,0,0,0,0.0,0.0
1004,71,2020-03-16 14:23:00,1,2519.0,1791.0,0.711,11.909,1,0,0,0,1,1,0,0,0.0,0.0
1004,72,2020-03-16 14:26:00,1,2337.0,1748.0,0.748,11.142,24,0,0,0,24,0,24,0,0.0,0.0
1004,73,2020-03-16 14:29:00,1,2346.0,1752.0,0.747,11.183,3,0,0,0,3,0,3,0,0.0,0.0
1004,74,2020-03-16 14:32:00,1,2342.0,1739.0,0.743,11.151,2,0,0,0,2,0,2,0,0.0,0.0
1004,75,2020-03-16 14:35:00,1,2351.0,1706.0,0.726,11.152,0,0,0,0,0,0,0,0,0.0,0.0
1004,76,2020-03-16 14:38:00,1,2341.0,1759.0,0.752,11.17,3,0,0,0,3,0,3,0,0.0,0.0
1004,77,2020-03-16 14:41:00,1,2514.0,1804.0,0.718,11.902,2,2,1,1,0,0,0,0,0.0,0.0
1004,78,2020-03-16 14:44:00,1,2530.0,1819.0,0.719,11.982,2,0,0,0,2,0,2,0,0.0,0.0
1004,79,2020-03-16 14:47:00,1,2519.0,1819.0,0.722,11.94,0,0,0,0,0,0,0,0,0.0,0.0
1004,80,2020-03-16 14:50:00,1,2607.0,1819.0,0.698,12.288,106,48,28,20,58,25,33,2,0.0,0.0
1004,81,2020-03-16 14:53:00,1,2598.0,1941.0,0.747,12.384,130,26,4,22,104,56,48,0,0.0,0.0
1004,82,2020-03-16 14:56:00,1,2762.0,2068.0,0.749,13.173,128,29,11,18,99,64,35,0,0.0,0.0
1004,83,2020-03-16 14:59:00,1,2764.0,2039.0,0.738,13.148,69,43,8,35,26,3,23,0,0.0,0.0
1004,84,2020-03-16 15:02:00,1,2751.0,2083.0,0.757,13.144,154,112,57,55,42,9,33,0,0.0,0.0
1004,85,2020-03-16 15:05:00,1,2732.0,2167.0,0.793,13.164,184,109,65,44,75,42,33,2,0.0,0.0
1004,86,2020-03-16 15:08:00,1,2973.0,2327.0,0.783,14.291,278,161,112,49,117,79,38,17,0.02,0.02
1004,87,2020-03-16 15:11:00,1,2832.0,2159.0,0.762,13.548,305,209,158,51,96,52,44,15,0.0,0.33
1004,88,2020-03-16 15:14:00,1,3265.0,2459.0,0.753,15.587,467,242,170,72,225,165,60,13,0.0,0.0
1004,89,2020-03-16 15:17:00,1,3326.0,2551.0,0.767,15.929,449,255,186,69,194,134,60,20,0.0,0.0
1004,90,2020-03-16 15:20:00,1,3342.0,2491.0,0.746,15.925,499,247,166,81,252,177,75,4,0.0,0.0
1004,91,2020-03-16 15:23:00,1,3340.0,2444.0,0.732,15.866,606,322,244,78,284,208,76,25,0.0,0.0
1004,92,2020-03-16 15:26:00,1,3179.0,2317.0,0.729,15.093,110,99,60,39,11,4,7,2,0.0,0.0
1004,93,2020-03-16 15:29:00,1,3167.0,2375.0,0.75,15.107,37,6,2,4,31,2,29,0,0.0,0.0
1004,94,2020-03-16 15:32:00,1,3182.0,2333.0,0.733,15.121,63,36,4,32,27,1,26,0,0.0,0.0
1004,95,2020-03-16 15:35:00,1,3175.0,2342.0,0.737,15.102,65,39,3,36,26,12,14,0,0.0,0.0
1004,96,2020-03-16 15:38:00,1,2929.0,2197.0,0.75,13.974,26,22,0,22,4,1,3,0,0.0,0.0
1004,97,2020-03-16 15:41:00,1,2748.0,2050.0,0.746,13.097,35,7,0,7,28,0,28,0,0.0,0.0
1004,98,2020-03-16 15:44:00,1,2684.0,1962.0,0.731,12.749,37,23,10,13,14,2,12,0,0.01,0.0
1004,99,2020-03-16 15:47:00,1,2690.0,1948.0,0.724,12.754,0,0,0,0,0,0,0,0,0.0,0.0
1004,100,2020-03-16 15:50:00,1,2606.0,1877.0,0.72,12.346,1,1,0,1,0,0,0,0,0.0,0.0
1004,101,2020-03-16 15:53:00,1,2608.0,1825.0,0.7,12.295,0,0,0,0,0,0,0,0,0.01,0.0
1004,102,2020-03-16 15:56:00,1,2539.0,1810.0,0.713,12.007,0,0,0,0,0,0,0,0,0.0,0.0
1004,103,2020-03-16 15:59:00,1,2533.0,1807.0,0.713,11.982,0,0,0,0,0,0,0,0,0.0,0.0
1004,104,2020-03-16 16:02:00,1,2346.0,1725.0,0.735,11.152,13,11,8,3,2,1,1,0,0.0,0.0
1004,105,2020-03-16 16:05:00,1,2355.0,1713.0,0.727,11.176,13,13,2,11,0,0,0,0,0.0,0.0
1004,106,2020-03-16 16:08:00,1,2343.0,1757.0,0.75,11.178,8,1,1,0,7,3,4,0,0.0,0.0
1004,107,2020-03-16 16:11:00,1,2338.0,1753.0,0.75,11.153,18,18,1,17,0,0,0,0,0.0,0.0
1004,108,2020-03-16 16:14:00,1,2352.0,1718.0,0.73,11.171,24,22,3,19,2,2,0,0,0.0,0.0
1004,109,2020-03-16 16:17:00,1,2343.0,1738.0,0.742,11.155,3,3,0,3,0,0,0,0,0.01,0.0
1004,110,2020-03-16 16:20:00,1,2435.0,1784.0,0.733,11.569,2,0,0,0,2,0,2,0,0.0,0.0
1004,111,2020-03-16 16:23:00,1,2352.0,1736.0,0.738,11.19,5,0,0,0,5,1,4,0,0.0,0.0
1004,112,2020-03-16 16:26:00,1,2342.0,1726.0,0.737,11.137,18,9,1,8,9,4,5,0,0.0,0.0
1004,113,2020-03-16 16:29:00,1,2343.0,1730.0,0.739,11.146,24,16,6,10,8,3,5,0,0.0,0.0
1004,114,2020-03-16 16:32:00,1,2345.0,1716.0,0.732,11.139,36,32,13,19,4,2,2,0,0.0,0.0
1004,115,2020-03-16 16:35:00,1,2347.0,1721.0,0.733,11.153,20,20,6,14,0,0,0,0,0.0,0.0
1004,116,2020-03-16 16:38:00,1,2363.0,1670.0,0.707,11.161,0,0,0,0,0,0,0,0,0.0,0.0
1004,117,2020-03-16 16:41:00,1,2190.0,1599.0,0.73,10.401,21,1,0,1,20,0,20,0,0.0,0.0
1004,118,2020-03-16 16:44:00,1,2160.0,1603.0,0.742,10.286,6,6,1,5,0,0,0,0,0.0,0.0
1004,119,2020-03-16 16:47:00,1,2355.0,1673.0,0.71,11.133,8,8,1,7,0,0,0,0,0.01,0.0
1004,120,2020-03-16 16:50:00,1,2348.0,1712.0,0.729,11.148,5,5,0,5,0,0,0,0,0.01,0.0
1004,121,2020-03-16 16:53:00,1,2346.0,1718.0,0.732,11.146,8,7,2,5,1,0,1,0,0.01,0.0
1004,122,2020-03-16 16:56:00,1,2355.0,1671.0,0.71,11.128,1,1,0,1,0,0,0,0,0.0,0.0
1004,123,2020-03-16 16:59:00,1,2260.5,1651.0,0.7315,10.733,14,13,2,11,1,0,1,0,0.0,0.0
1004,124,2020-03-16 17:02:00,1,2166.0,1631.0,0.753,10.338,10,9,6,3,1,0,1,0,0.0,0.0
1004,125,2020-03-16 17:05:00,1,2177.0,1633.0,0.75,10.386,121,82,47,35,39,14,25,0,0.0,0.0
1004,126,2020-03-16 17:08:00,1,2600.0,1899.0,0.73,12.349,82,61,38,23,21,12,9,4,0.0,0.0
1004,127,2020-03-16 17:11:00,1,2608.0,1868.0,0.716,12.344,69,35,28,7,34,25,9,0,0.0,0.0
1004,128,2020-03-16 17:14:00,1,2595.0,1909.0,0.736,12.336,84,44,24,20,40,26,14,5,0.0,0.0
1004,129,2020-03-16 17:17:00,1,2771.0,2023.0,0.73,13.159,92,19,3,16,73,31,42,0,0.0,0.0
1004,130,2020-03-16 17:20:00,1,2750.0,2105.0,0.765,13.165,169,29,9,20,140,86,54,0,0.0,0.0
1004,131,2020-03-16 17:23:00,1,2817.0,2190.0,0.777,13.524,220,93,45,48,127,74,53,0,0.0,0.0
1004,132,2020-03-16 17:26:00,1,2833.0,2199.0,0.776,13.596,303,94,52,42,209,142,67,5,0.0,0.0
1004,133,2020-03-16 17:29:00,1,2730.0,2155.0,0.79,13.141,219,116,88,28,103,63,40,15,0.0,0.0
1004,134,2020-03-16 17:32:00,1,3151.0,2407.0,0.764,15.081,531,248,187,61,283,206,77,12,0.0,0.0
1004,135,2020-03-16 17:35:00,1,3173.0,2409.0,0.759,15.171,501,264,197,67,237,176,61,1,0.0,0.0
1004,136,2020-03-16 17:38:00,1,3166.0,2374.0,0.75,15.104,522,251,197,54,271,201,70,11,0.0,0.0
1004,137,2020-03-16 17:41:00,1,2903.0,2257.0,0.777,13.936,86,53,35,18,33,19,14,13,0.0,0.0
1004,138,2020-03-16 17:44:00,1,2924.0,2231.0,0.763,13.989,59,38,10,28,21,0,21,0,0.02,0.0
1004,139,2020-03-16 17:47:00,1,2749.0,2064.0,0.751,13.118,18,18,6,12,0,0,0,0,0.0,0.0
1004,140,2020-03-16 17:50:00,1,2764.0,2018.0,0.73,13.126,8,8,0,8,0,0,0,0,0.0,0.0
1004,141,2020-03-16 17:53:00,1,2608.0,1885.0,0.723,12.361,13,13,1,12,0,0,0,0,0.0,0.0
1004,142,2020-03-16 17:56:00,1,2343.0,1765.0,0.753,11.185,1,1,0,1,0,0,0,0,0.0,0.0
1004,143,2020-03-16 17:59:00,1,2342.0,1740.0,0.743,11.154,0,0,0,0,0,0,0,0,0.0,0.0
1004,144,2020-03-16 18:02:00,0,2343.0,1698.0,0.725,11.113,0,0,0,0,0,0,0,0,0.0,0.0
1004,145,2020-03-16 18:05:00,0,2354.0,1673.0,0.711,11.128,0,0,0,0,0,0,0,0,0.0,0.0
1004,146,2020-03-16 18:08:00,0,2176.0,1578.0,0.725,10.321,0,0,0,0,0,0,0,0,0.0,0.0
1004,147,2020-03-16 18:11:00,0,2173.0,1613.0,0.742,10.349,0,0,0,0,0,0,0,0,0.0,0.0
1004,148,2020-03-16 18:14:00,0,2341.0,1716.0,0.733,11.123,60,20,3,17,40,17,23,0,0.0,0.0
1004,149,2020-03-16 18:17:00,0,2596.0,1973.0,0.76,12.413,217,108,61,47,109,63,46,5,0.0,0.0
1004,150,2020-03-16 18:20:00,0,2755.0,2112.0,0.766,13.194,208,64,22,42,144,96,48,5,0.0,0.0
1004,151,2020-03-16 18:23:00,0,2910.0,2247.0,0.772,13.954,319,143,90,53,176,111,65,8,0.0,0.0
1004,152,2020-03-16 18:26:00,0,3166.0,2378.0,0.751,15.106,229,108,74,34,121,86,35,22,0.0,0.0
1004,153,2020-03-16 18:29:00,0,3180.0,2313.0,0.727,15.092,12,1,0,1,11,0,11,0,0.0,0.0
1004,154,2020-03-16 18:32:00,0,2932.0,2189.0,0.747,13.975,23,5,2,3,18,4,14,0,0.0,0.0
1004,155,2020-03-16 18:35:00,0,2760.0,2089.0,0.757,13.189,23,11,1,10,12,4,8,0,0.0,0.0
1004,156,2020-03-16 18:38:00,0,2931.0,2151.0,0.734,13.929,116,54,16,38,62,27,35,1,0.0,0.0
1004,157,2020-03-16 18:41:00,0,3103.0,2305.0,0.743,14.777,57,13,5,8,44,8,36,1,0.0,0.0
1004,158,2020-03-16 18:44:00,0,3262.0,2459.0,0.754,15.573,422,172,131,41,250,172,78,46,0.0,0.0
1004,159,2020-03-16 18:47:00,0,3315.0,2604.0,0.786,15.943,408,235,184,51,173,123,50,83,0.0,0.0
1004,160,2020-03-16 18:50:00,0,3591.0,2682.0,0.747,17.117,241,124,79,45,117,71,46,35,0.0,0.0
1004,161,2020-03-16 18:53:00,0,3603.0,2686.0,0.745,17.171,314,99,54,45,215,146,69,9,0.0,0.0
1004,162,2020-03-16 18:56:00,0,3586.0,2689.0,0.75,17.105,308,148,110,38,160,101,59,29,0.01,0.0
1004,163,2020-03-16 18:59:00,0,3412.0,2623.0,0.769,16.346,55,26,9,17,29,4,25,0,0.0,0.0
1004,164,2020-03-16 19:02:00,0,3151.0,2418.0,0.767,15.093,46,36,13,23,10,2,8,0,0.0,0.0
1004,165,2020-03-16 19:05:00,0,2997.0,2285.0,0.762,14.341,44,18,6,12,26,14,12,0,0.0,0.0
1004,166,2020-03-16 19:08:00,0,2916.0,2172.0,0.745,13.895,70,33,16,17,37,23,14,3,0.0,0.0
1004,167,2020-03-16 19:11:00,0,2837.0,2140.0,0.754,13.547,241,107,63,44,134,78,56,11,0.0,0.0
1004,168,2020-03-16 19:14:00,0,3204.0,2359.0,0.736,15.236,46,14,3,11,32,14,18,1,0.0,0.0
1004,169,2020-03-16 19:17:00,0,3352.0,2463.0,0.735,15.935,265,107,65,42,158,111,47,14,0.0,0.0
1004,170,2020-03-16 19:20:00,0,3405.0,2629.0,0.772,16.327,574,289,222,67,285,223,62,83,0.0,0.0
1004,171,2020-03-16 19:23:00,0,3333.0,2515.0,0.755,15.917,343,153,95,58,190,131,59,58,0.01,0.0
1004,172,2020-03-16 19:26:00,0,3323.0,2545.0,0.766,15.909,316,162,120,42,154,99,55,60,0.0,0.0
1004,173,2020-03-16 19:29:00,0,3167.0,2302.0,0.727,15.028,301,122,85,37,179,125,54,29,0.0,0.0
1004,174,2020-03-16 19:32:00,0,3335.0,2527.0,0.758,15.939,402,194,139,55,208,149,59,40,0.0,0.0
1004,175,2020-03-16 19:35:00,0,2929.0,2147.0,0.733,13.918,229,99,60,39,130,92,38,59,0.0,0.0
1004,176,2020-03-16 19:38:00,0,3336.0,2484.0,0.744,15.895,396,217,153,64,179,108,71,62,0.0,0.0
1004,177,2020-03-16 19:41:00,0,3608.0,2652.0,0.735,17.152,467,249,187,62,218,157,61,51,0.0,0.0
1004,178,2020-03-16 19:44:00,0,3167.0,2396.0,0.756,15.133,325,151,109,42,174,125,49,90,0.0,0.0
1004,179,2020-03-16 19:47:00,0,3191.0,2365.0,0.741,15.19,251,149,95,54,102,71,31,50,0.0,0.0
1004,180,2020-03-16 19:50:00,0,3612.0,2654.0,0.735,17.172,201,106,60,46,95,61,34,89,0.0,0.0
1004,181,2020-03-16 19:53:00,0,3577.0,2741.0,0.766,17.127,264,130,82,48,134,96,38,39,0.0,0.0
1004,182,2020-03-16 19:56:00,0,2275.0,1634.0,0.719,10.772,67,31,10,21,36,19,17,2,0.0,0.0
1004,183,2020-03-16 19:59:00,0,2588.0,1932.5,0.744,12.3355,5,5,1,4,0,0,0,0,0.0,0.0
1004,184,2020-03-16 20:02:00,0,2901.0,2231.0,0.769,13.899,182,93,54,39,89,52,37,14,0.0,0.0
1004,185,2020-03-16 20:05:00,0,3596.0,2750.0,0.765,17.213,286,155,108,47,131,79,52,88,0.01,0.0
1004,186,2020-03-16 20:08:00,0,3731.0,2931.0,0.786,17.946,174,113,59,54,61,2,59,90,0.0,0.0
1004,187,2020-03-16 20:11:00,0,3805.0,3026.0,0.795,18.343,340,226,157,69,114,35,79,139,0.0,0.0
1004,188,2020-03-16 20:14:00,0,3561.0,2800.0,0.786,17.131,381,205,137,68,176,115,61,101,0.0,0.0
1004,189,2020-03-16 20:17:00,0,3560.0,2839.0,0.798,17.172,453,188,129,59,265,205,60,41,0.0,0.0
1004,190,2020-03-16 20:20:00,0,3151.0,2484.0,0.788,15.166,385,156,125,31,229,176,53,58,0.0,0.0
1004,191,2020-03-16 20:23:00,0,3765.0,2847.0,0.756,17.986,357,203,130,73,154,78,76,117,0.01,0.0
1004,192,2020-03-16 20:26:00,0,3916.0,3003.0,0.767,18.755,230,139,73,66,91,34,57,82,0.0,0.0
1004,193,2020-03-16 20:29:00,0,3698.0,2961.0,0.801,17.85,244,115,60,55,129,68,61,71,0.0,0.0
1004,194,2020-03-16 20:32:00,0,3812.0,3004.0,0.788,18.344,261,71,31,40,190,112,78,76,0.01,0.0
1004,195,2020-03-16 20:35:00,0,3901.0,3081.0,0.79,18.783,282,124,75,49,158,102,56,55,0.0,0.0
1004,196,2020-03-16 20:38:00,0,3225.0,2579.0,0.8,15.56,432,198,144,54,234,163,71,68,0.0,0.0
1004,197,2020-03-16 20:41:00,0,3961.0,3192.0,0.806,19.142,216,110,58,52,106,44,62,66,0.0,0.0
1004,198,2020-03-16 20:44:00,0,4053.0,3238.0,0.799,19.553,184,68,32,36,116,72,44,55,0.0,0.0
1004,199,2020-03-16 20:47:00,0,4024.0,3286.0,0.817,19.492,132,64,24,40,68,26,42,36,0.0,0.0
1004,200,2020-03-16 20:50:00,0,3450.0,2866.0,0.831,16.766,405,172,135,37,233,170,63,77,0.0,0.0
1004,201,2020-03-16 20:53:00,0,2857.0,2442.0,0.855,13.96,109,33,12,21,76,33,43,2,0.0,0.0
1004,202,2020-03-16 20:56:00,0,2557.0,2098.0,0.821,12.398,88,36,5,31,52,22,30,1,0.0,0.0
1004,203,2020-03-16 20:59:00,0,2696.0,2259.0,0.838,13.123,2,2,1,1,0,0,0,0,0.0,0.0
1004,204,2020-03-16 21:02:00,0,2545.0,2072.0,0.814,12.321,35,12,4,8,23,4,19,0,0.0,0.0
1004,205,2020-03-16 21:05:00,0,2580.0,2050.0,0.795,12.434,85,39,20,19,46,24,22,0,0.0,0.0
1004,206,2020-03-16 21:08:00,0,2480.0,1990.0,0.802,11.974,22,15,5,10,7,1,6,0,0.0,0.0
1004,207,2020-03-16 21:11:00,0,2321.0,1836.0,0.791,11.177,7,5,1,4,2,0,2,0,0.0,0.0
1004,208,2020-03-16 21:14:00,0,2325.0,1777.0,0.764,11.128,67,32,18,14,35,25,10,0,0.0,0.0
1004,209,2020-03-16 21:17:00,0,2380.0,1937.0,0.814,11.52,4,2,0,2,2,0,2,0,0.0,0.0
1004,210,2020-03-16 21:20:00,0,2711.0,2250.0,0.83,13.172,23,21,5,16,2,0,2,0,0.0,0.0
1004,211,2020-03-16 21:23:00,0,2710.0,2235.0,0.825,13.151,9,2,0,2,7,2,5,0,0.0,0.0
1004,212,2020-03-16 21:26:00,0,2881.0,2388.0,0.829,13.995,12,3,1,2,9,0,9,0,0.0,0.0
1004,213,2020-03-16 21:29:00,0,3115.0,2660.0,0.854,15.216,376,141,99,42,235,174,61,31,0.0,0.0
1004,214,2020-03-16 21:32:00,0,3254.0,2806.0,0.862,15.93,312,115,82,33,197,139,58,63,0.0,0.0
1004,215,2020-03-16 21:35:00,0,3525.0,2891.0,0.82,17.09,106,53,24,29,53,28,25,28,0.0,0.0
1004,216,2020-03-16 21:38:00,0,3526.0,2886.0,0.819,17.087,117,54,18,36,63,33,30,29,0.0,0.0
1004,217,2020-03-16 21:41:00,0,3684.0,3093.0,0.84,17.938,114,65,17,48,49,23,26,15,0.01,0.0
1004,218,2020-03-16 21:44:00,0,3657.0,3178.0,0.869,17.925,407,148,118,30,259,195,64,29,0.0,0.0
1004,219,2020-03-16 21:47:00,0,3102.0,2658.0,0.857,15.162,447,186,143,43,261,203,58,64,0.0,0.0
1004,220,2020-03-16 21:50:00,0,3260.0,2771.0,0.85,15.912,445,173,120,53,272,197,75,26,0.0,0.0
1004,221,2020-03-16 21:53:00,0,3807.0,3376.0,0.887,18.737,122,58,18,40,64,35,29,29,0.0,0.0
1004,222,2020-03-16 21:56:00,0,3981.0,3462.0,0.87,19.519,208,107,60,47,101,53,48,69,0.0,0.0
1004,223,2020-03-16 21:59:00,0,3790.0,3432.0,0.906,18.733,357,111,78,33,246,183,63,51,0.0,0.0
1004,224,2020-03-16 22:02:00,0,3656.0,3214.0,0.879,17.964,390,128,96,32,262,195,67,41,0.38,0.0
1004,225,2020-03-16 22:05:00,0,3775.0,3469.0,0.919,18.714,330,98,52,46,232,149,83,4,0.13,0.0
1004,226,2020-03-16 22:08:00,0,3197.0,3006.0,0.94,15.926,353,106,63,43,247,173,74,37,0.0,0.0
1004,227,2020-03-16 22:11:00,0,3644.0,3160.0,0.867,17.855,299,166,112,54,133,73,60,76,0.0,0.0
1004,228,2020-03-16 22:14:00,0,4042.0,3610.0,0.893,19.924,202,119,73,46,83,41,42,51,0.0,0.0
1004,229,2020-03-16 22:17:00,0,4016.0,3688.0,0.918,19.905,182,92,44,48,90,51,39,50,0.29,0.0
1004,230,2020-03-16 22:20:00,0,3981.0,3599.0,0.904,19.672,284,83,55,28,201,139,62,27,0.21,0.0
1004,231,2020-03-16 22:23:00,0,4025.0,3704.0,0.92,19.961,405,189,127,62,216,148,68,69,0.0,0.0
1004,232,2020-03-16 22:26:00,0,4203.0,3781.0,0.9,20.746,209,132,73,59,77,21,56,92,0.0,0.0
1004,233,2020-03-16 22:29:00,0,4200.0,3809.0,0.907,20.764,260,127,73,54,133,70,63,71,0.12,0.0
1004,234,2020-03-16 22:32:00,0,3783.0,3503.0,0.926,18.782,296,144,83,61,152,86,66,70,0.0,0.0
1004,235,2020-03-16 22:35:00,0,3453.0,3228.0,0.935,17.178,551,252,179,73,299,227,72,58,0.0,0.0
1004,236,2020-03-16 22:38:00,0,4167.0,3880.0,0.931,20.714,571,211,152,59,360,278,82,36,0.02,0.0
1004,237,2020-03-16 22:41:00,0,3776.0,3521.0,0.932,18.776,227,136,84,52,91,46,45,111,0.0,0.0
1004,238,2020-03-16 22:44:00,0,4104.0,3804.0,0.927,20.38,204,114,65,49,90,29,61,63,0.0,0.0
1004,239,2020-03-16 22:47:00,0,3990.0,3824.0,0.958,19.953,211,108,58,50,103,40,63,68,0.0,0.0
1004,240,2020-03-16 22:50:00,0,4155.0,4005.0,0.964,20.806,159,94,49,45,65,18,47,84,0.0,0.0
1004,241,2020-03-16 22:53:00,0,4169.0,3892.0,0.934,20.734,288,113,58,55,175,118,57,38,0.0,0.0
1004,242,2020-03-16 22:56:00,0,3200.0,3085.0,0.964,16.022,383,156,107,49,227,166,61,39,0.05,0.0
1004,243,2020-03-16 22:59:00,0,3391.5,3300.5,0.9725,17.016,504,215,164,51,289,217,72,25,0.0,0.0
1004,244,2020-03-16 23:02:00,0,3583.0,3516.0,0.981,18.01,373,142,102,40,231,174,57,77,0.0,0.0
1004,245,2020-03-16 23:05:00,0,3758.0,3570.0,0.95,18.759,552,220,162,58,332,253,79,48,0.0,0.0
1004,246,2020-03-16 23:08:00,0,3749.0,3590.0,0.958,18.747,197,117,65,52,80,17,63,75,0.0,0.0
1004,247,2020-03-16 23:11:00,0,3754.0,3579.0,0.954,18.753,191,110,60,50,81,30,51,57,0.0,0.0
1004,248,2020-03-16 23:14:00,0,3996.0,3845.0,0.962,19.999,179,69,34,35,110,61,49,30,0.56,0.03
1004,249,2020-03-16 23:17:00,0,3406.0,3368.0,0.989,17.147,333,113,66,47,220,158,62,16,0.0,0.0
1004,250,2020-03-16 23:20:00,0,2720.0,2572.0,0.945,13.566,271,55,32,23,216,136,80,7,0.0,0.0
1004,251,2020-03-16 23:23:00,0,3042.0,2840.0,0.934,15.128,697,280,206,74,417,325,92,26,0.0,0.02
1004,252,2020-03-16 23:26:00,0,3749.0,3649.0,0.973,18.809,643,297,249,48,346,268,78,37,0.0,0.0
1004,253,2020-03-16 23:29:00,0,3577.0,3464.0,0.968,17.928,545,201,156,45,344,264,80,47,0.0,0.03
1004,254,2020-03-16 23:32:00,0,3069.0,2825.0,0.921,15.219,841,389,293,96,452,342,110,3,0.0,0.0
1004,255,2020-03-16 23:35:00,0,3177.0,3100.0,0.976,15.949,718,337,247,90,381,280,101,26,0.0,0.0
1004,256,2020-03-16 23:38:00,0,4035.0,3788.0,0.939,20.09,132,78,40,38,54,28,26,57,0.0,0.0
1004,257,2020-03-16 23:41:00,0,3995.0,3855.0,0.965,20.007,128,64,36,28,64,29,35,34,0.0,0.0
1004,258,2020-03-16 23:44:00,0,3985.0,3819.0,0.958,19.93,168,87,48,39,81,50,31,49,0.13,0.08
1004,259,2020-03-16 23:47:00,0,3258.0,3190.0,0.979,16.366,354,152,111,41,202,141,61,85,0.17,0.01
1004,260,2020-03-16 23:50:00,0,3750.0,3656.0,0.975,18.823,404,146,107,39,258,182,76,62,0.0,0.0
1004,261,2020-03-16 23:53:00,0,3852.0,3642.0,0.945,19.21,358,137,100,37,221,156,65,31,0.0,0.03
1004,262,2020-03-16 23:56:00,0,3178.0,3140.0,0.988,15.999,51,23,4,19,28,7,21,3,0.0,0.0
1004,263,2020-03-16 23:59:00,0,3199.0,3074.0,0.961,16.009,264,127,74,53,137,79,58,26,0.0,0.0
1004,264,2020-03-17 00:02:00,0,2783.0,2706.0,0.972,13.959,205,49,11,38,156,104,52,10,0.0,0.0
1004,265,2020-03-17 00:05:00,0,2653.0,2442.0,0.92,13.158,105,29,2,27,76,32,44,0,0.0,0.0
1004,266,2020-03-17 00:08:00,0,2724.0,2544.0,0.934,13.55,35,0,0,0,35,1,34,0,0.0,0.0
1004,267,2020-03-17 00:11:00,0,3114.0,2942.0,0.945,15.526,27,0,0,0,27,4,23,0,0.0,0.0
1004,268,2020-03-17 00:14:00,0,3064.0,2833.0,0.924,15.21,5,2,0,2,3,1,2,0,0.0,0.0
1004,269,2020-03-17 00:17:00,0,2645.0,2484.0,0.939,13.17,13,5,0,5,8,3,5,0,0.0,0.0
1004,270,2020-03-17 00:20:00,0,2524.0,2199.0,0.871,12.38,2,2,0,2,0,0,0,0,0.0,0.0
1004,271,2020-03-17 00:23:00,0,2496.0,2257.0,0.904,12.333,2,2,0,2,0,0,0,0,0.0,0.0
1004,272,2020-03-17 00:26:00,0,2805.0,2646.0,0.943,13.979,254,113,80,33,141,112,29,15,0.0,0.0
1004,273,2020-03-17 00:29:00,0,3209.0,3016.0,0.94,15.982,323,147,101,46,176,124,52,75,0.0,0.0
1004,274,2020-03-17 00:32:00,0,3041.0,2900.0,0.954,15.193,297,166,108,58,131,82,49,81,0.0,0.0
1004,275,2020-03-17 00:35:00,0,3275.0,3151.0,0.962,16.391,257,68,21,47,189,125,64,49,0.0,0.0
1004,276,2020-03-17 00:38:00,0,3435.0,3351.0,0.976,17.241,106,53,22,31,53,30,23,40,0.0,0.01
1004,277,2020-03-17 00:41:00,0,2799.0,2655.0,0.949,13.965,679,274,204,70,405,313,92,13,0.0,0.0
1004,278,2020-03-17 00:44:00,0,3343.0,3296.0,0.986,16.819,395,144,98,46,251,192,59,22,0.0,0.06
1004,279,2020-03-17 00:47:00,0,3135.0,2903.0,0.926,15.566,331,125,82,43,206,140,66,62,0.0,0.0
1004,280,2020-03-17 00:50:00,0,2807.0,2635.0,0.939,13.976,840,339,254,85,501,379,122,0,0.0,0.0
1004,281,2020-03-17 00:53:00,0,2528.0,2179.0,0.862,12.371,968,404,308,96,564,446,118,2,0.0,0.0
1004,282,2020-03-17 00:56:00,0,3582.0,3487.0,0.974,17.971,727,272,208,64,455,338,117,32,0.0,0.0
1004,283,2020-03-17 00:59:00,0,3596.0,3445.0,0.958,17.982,377,142,91,51,235,173,62,51,0.0,0.0
1004,284,2020-03-17 01:02:00,0,3745.0,3628.0,0.969,18.773,191,75,32,43,116,66,50,54,0.0,0.0
1004,285,2020-03-17 01:05:00,0,4002.0,3810.0,0.952,19.985,95,34,8,26,61,24,37,19,0.0,0.0
1004,286,2020-03-17 01:08:00,0,4009.0,3778.0,0.942,19.979,86,31,15,16,55,30,25,20,0.0,0.18
1004,287,2020-03-17 01:11:00,0,3603.0,3429.0,0.951,17.993,317,165,114,51,152,101,51,44,0.0,0.0
1004,288,2020-03-17 01:14:00,0,3021.0,2927.0,0.969,15.144,377,154,110,44,223,155,68,50,0.15,0.0
1004,289,2020-03-17 01:17:00,0,3704.0,3678.0,0.993,18.664,652,225,159,66,427,342,85,11,0.0,0.0
1004,290,2020-03-17 01:20:00,0,3504.0,3425.0,0.978,17.597,332,137,101,36,195,145,50,47,0.0,0.0
1004,291,2020-03-17 01:23:00,0,4006.0,3737.0,0.933,19.922,73,14,0,14,59,18,41,22,0.0,0.0
1004,292,2020-03-17 01:26:00,0,3934.0,3733.0,0.949,19.634,97,32,9,23,65,27,38,37,0.0,0.08
1004,293,2020-03-17 01:29:00,0,3578.0,3515.0,0.983,17.987,415,134,87,47,281,202,79,38,0.17,0.01
1004,294,2020-03-17 01:32:00,0,3205.0,3083.0,0.962,16.041,749,309,232,77,440,344,96,16,0.0,0.0
1004,295,2020-03-17 01:35:00,0,2788.0,2734.0,0.981,14.01,564,234,181,53,330,252,78,25,0.0,0.01
1004,296,2020-03-17 01:38:00,0,2633.0,2441.0,0.927,13.077,756,340,253,87,416,310,106,0,0.0,0.0
1004,297,2020-03-17 01:41:00,0,3222.0,2934.0,0.911,15.944,789,331,258,73,458,355,103,26,0.0,0.0
1004,298,2020-03-17 01:44:00,0,3474.0,3457.0,0.995,17.516,287,102,59,43,185,126,59,27,0.0,0.0
1004,299,2020-03-17 01:47:00,0,2723.0,2586.0,0.95,13.593,114,90,27,63,24,10,14,5,0.0,0.0
1004,300,2020-03-17 01:50:00,0,2890.0,2714.0,0.939,14.391,148,70,33,37,78,28,50,2,0.0,0.0
1004,301,2020-03-17 01:53:00,0,2493.0,2327.0,0.933,12.4,0,0,0,0,0,0,0,0,0.0,0.0
1004,302,2020-03-17 01:56:00,0,2285.0,1963.0,0.859,11.176,4,4,1,3,0,0,0,0,0.0,0.0
1004,303,2020-03-17 01:59:00,0,2658.5,2435.0,0.909,13.1705,0,0,0,0,0,0,0,0,0.0,0.0
1004,304,2020-03-17 02:02:00,0,3032.0,2907.0,0.959,15.165,22,16,2,14,6,3,3,0,0.0,0.0
1004,305,2020-03-17 02:05:00,0,3193.0,3098.0,0.97,16.011,558,240,166,74,318,236,82,14,0.0,0.0
1004,306,2020-03-17 02:08:00,0,3159.0,3213.0,1.017,16.003,646,280,213,67,366,267,99,63,0.0,0.01
1004,307,2020-03-17 02:11:00,0,3193.0,3106.0,0.973,16.019,185,99,67,32,86,60,26,79,0.0,0.0
1004,308,2020-03-17 02:14:00,0,2777.0,2758.0,0.993,13.993,344,137,88,49,207,149,58,102,0.0,0.0
1004,309,2020-03-17 02:17:00,0,2602.0,2586.0,0.994,13.116,444,186,138,48,258,199,59,83,0.0,0.0
1004,310,2020-03-17 02:20:00,0,3448.0,3310.0,0.96,17.25,159,86,45,41,73,37,36,23,0.0,0.01
1004,311,2020-03-17 02:23:00,0,2106.0,1883.0,0.894,10.381,237,156,89,67,81,42,39,3,0.0,0.0
1004,312,2020-03-17 02:26:00,0,2231.0,2141.0,0.96,11.161,96,77,43,34,19,4,15,7,0.0,0.0
1004,313,2020-03-17 02:29:00,0,3229.0,2959.0,0.916,16.0,48,45,3,42,3,0,3,0,0.0,0.01
1004,314,2020-03-17 02:32:00,0,3216.0,3018.0,0.938,16.011,22,18,1,17,4,2,2,0,0.0,0.0
1004,315,2020-03-17 02:35:00,0,3206.0,3056.0,0.953,16.015,0,0,0,0,0,0,0,0,0.0,0.0
1004,316,2020-03-17 02:38:00,0,3041.0,2883.0,0.948,15.171,0,0,0,0,0,0,0,0,0.0,0.0
1004,317,2020-03-17 02:41:00,0,2795.0,2674.0,0.956,13.974,14,4,0,4,10,3,7,0,0.0,0.0
1004,318,2020-03-17 02:44:00,0,2637.0,2545.0,0.965,13.206,10,0,0,0,10,6,4,0,0.0,0.0
1004,319,2020-03-17 02:47:00,0,2646.0,2420.0,0.915,13.104,40,4,3,1,36,9,27,0,0.0,0.0
1004,320,2020-03-17 02:50:00,0,2513.0,2300.0,0.915,12.446,45,0,0,0,45,2,43,0,0.0,0.0
1004,321,2020-03-17 02:53:00,0,2518.0,2273.0,0.903,12.436,154,0,0,0,154,98,56,0,0.0,0.0
1004,322,2020-03-17 02:56:00,0,2506.0,2264.0,0.904,12.381,62,0,0,0,62,59,3,0,0.0,0.0
1004,323,2020-03-17 02:59:00,0,2505.0,2237.0,0.893,12.347,15,0,0,0,15,13,2,0,0.0,0.0
1004,324,2020-03-17 03:02:00,0,2321.0,2195.0,0.946,11.574,45,8,4,4,37,25,12,0,0.0,0.0
1004,325,2020-03-17 03:05:00,0,2228.0,2168.0,0.973,11.179,0,0,0,0,0,0,0,0,0.0,0.0
1004,326,2020-03-17 03:08:00,0,2253.0,2062.0,0.915,11.159,6,3,2,1,3,0,3,0,0.0,0.02
1004,327,2020-03-17 03:11:00,0,2260.0,2104.0,0.931,11.235,28,3,0,3,25,10,15,0,0.0,0.0
1004,328,2020-03-17 03:14:00,0,2222.0,2162.0,0.973,11.148,222,71,35,36,151,97,54,10,0.0,0.0
1004,329,2020-03-17 03:17:00,0,2462.0,2416.0,0.981,12.374,258,125,78,47,133,97,36,36,0.0,0.0
1004,330,2020-03-17 03:20:00,0,2625.0,2565.0,0.977,13.181,307,138,87,51,169,120,49,64,0.0,0.0
1004,331,2020-03-17 03:23:00,0,2793.0,2685.0,0.961,13.977,299,163,113,50,136,88,48,129,0.0,0.0
1004,332,2020-03-17 03:26:00,0,3062.0,2821.0,0.921,15.187,205,125,78,47,80,8,72,98,0.0,0.0
1004,333,2020-03-17 03:29:00,0,3128.0,2927.0,0.936,15.566,137,59,20,39,78,35,43,34,0.0,0.0
1004,334,2020-03-17 03:32:00,0,3456.0,3213.0,0.93,17.175,140,58,23,35,82,48,34,35,0.0,0.0
1004,335,2020-03-17 03:35:00,0,3277.0,3206.0,0.978,16.461,349,134,87,47,215,157,58,68,0.0,0.03
1004,336,2020-03-17 03:38:00,0,3263.0,3158.0,0.968,16.352,213,104,71,33,109,68,41,56,0.0,0.02
1004,337,2020-03-17 03:41:00,0,3609.0,3402.0,0.943,17.984,153,64,37,27,89,49,40,20,0.25,0.0
1004,338,2020-03-17 03:44:00,0,2812.0,2655.0,0.944,14.018,147,53,15,38,94,49,45,6,0.0,0.0
1004,339,2020-03-17 03:47:00,0,2490.0,2304.0,0.925,12.363,132,43,16,27,89,34,55,0,0.0,0.0
1004,340,2020-03-17 03:50:00,0,2645.0,2440.0,0.922,13.123,94,1,0,1,93,56,37,0,0.0,0.0
1004,341,2020-03-17 03:53:00,0,2657.0,2506.0,0.943,13.244,32,2,0,2,30,25,5,0,0.0,0.0
1004,342,2020-03-17 03:56:00,0,2342.0,2181.0,0.931,11.643,9,1,0,1,8,3,5,0,0.0,0.02
1004,343,2020-03-17 03:59:00,0,2102.0,1866.0,0.888,10.348,14,1,1,0,13,3,10,0,0.0,0.0
1004,344,2020-03-17 04:02:00,0,2123.0,1806.0,0.85,10.366,80,56,22,34,24,15,9,0,0.0,0.0
1004,345,2020-03-17 04:05:00,0,2296.0,1943.0,0.846,11.197,37,6,4,2,31,6,25,0,0.0,0.0
1004,346,2020-03-17 04:08:00,0,2815.0,2685.0,0.954,14.065,37,10,6,4,27,22,5,0,0.0,0.0
1004,347,2020-03-17 04:11:00,0,2957.0,2826.0,0.956,14.778,88,21,4,17,67,57,10,0,0.0,0.0
1004,348,2020-03-17 04:14:00,0,2879.0,2790.0,0.969,14.432,5,4,1,3,1,0,1,0,0.0,0.0
1004,349,2020-03-17 04:17:00,0,2797.0,2633.0,0.942,13.934,38,17,6,11,21,12,9,0,0.0,0.0
1004,350,2020-03-17 04:20:00,0,2643.0,2520.0,0.953,13.204,141,0,0,0,141,119,22,0,0.0,0.0
1004,351,2020-03-17 04:23:00,0,2578.0,2335.0,0.906,12.743,1,0,0,0,1,0,1,0,0.0,0.0
1004,352,2020-03-17 04:26:00,0,2497.0,2290.0,0.917,12.372,56,5,0,5,51,11,40,0,0.0,0.0
1004,353,2020-03-17 04:29:00,0,2509.0,2244.0,0.894,12.37,13,7,0,7,6,2,4,0,0.0,0.0
1004,354,2020-03-17 04:32:00,0,2524.0,2189.0,0.867,12.368,12,12,0,12,0,0,0,0,0.0,0.0
1004,355,2020-03-17 04:35:00,0,2513.0,2257.0,0.898,12.399,223,114,57,57,109,64,45,60,0.0,0.0
1004,356,2020-03-17 04:38:00,0,2504.0,2223.0,0.888,12.327,131,70,35,35,61,6,55,74,0.0,0.0
1004,357,2020-03-17 04:41:00,0,2910.0,2607.0,0.896,14.352,76,43,5,38,33,15,18,24,0.0,0.03
1004,358,2020-03-17 04:44:00,0,3090.0,2705.0,0.876,15.168,251,83,51,32,168,117,51,37,0.0,0.01
1004,359,2020-03-17 04:47:00,0,2097.0,1878.0,0.895,10.342,109,42,8,34,67,29,38,39,0.0,0.0
1004,360,2020-03-17 04:50:00,0,2124.0,1821.0,0.858,10.383,319,86,49,37,233,171,62,52,0.0,0.0
1004,361,2020-03-17 04:53:00,0,2676.0,2405.0,0.899,13.205,297,86,48,38,211,154,57,18,0.0,0.0
1004,362,2020-03-17 04:56:00,0,2715.0,2262.0,0.833,13.2,86,50,20,30,36,10,26,3,0.0,0.0
1004,363,2020-03-17 04:59:00,0,3183.0,2770.5,0.8655,15.6075,150,94,53,41,56,30,26,58,0.0,0.0
1004,364,2020-03-17 05:02:00,0,3651.0,3279.0,0.898,18.015,162,70,38,32,92,44,48,67,0.0,0.01
1004,365,2020-03-17 05:05:00,0,3794.0,3455.0,0.911,18.775,47,28,1,27,19,6,13,24,0.0,0.08
1004,366,2020-03-17 05:08:00,0,3856.0,3598.0,0.933,19.174,38,7,0,7,31,15,16,29,0.0,0.09
1004,367,2020-03-17 05:11:00,0,4010.0,3741.0,0.933,19.941,206,96,46,50,110,64,46,10,0.23,0.04
1004,368,2020-03-17 05:14:00,0,3371.0,3149.0,0.934,16.767,429,188,135,53,241,177,64,69,0.0,0.01
1004,369,2020-03-17 05:17:00,0,3377.0,3140.0,0.93,16.783,312,109,78,31,203,142,61,30,0.05,0.02
1004,370,2020-03-17 05:20:00,0,3246.0,2922.0,0.9,16.025,730,328,256,72,402,306,96,37,0.0,0.0
1004,371,2020-03-17 05:23:00,0,2808.0,2595.0,0.924,13.938,683,310,231,79,373,275,98,23,0.0,0.0
1004,372,2020-03-17 05:26:00,0,2670.0,2346.0,0.879,13.116,229,109,61,48,120,82,38,1,0.0,0.0
1004,373,2020-03-17 05:29:00,0,3471.0,3204.0,0.923,17.222,92,35,19,16,57,11,46,0,0.0,0.0
1004,374,2020-03-17 05:32:00,0,3598.0,3382.0,0.94,17.919,64,39,21,18,25,11,14,0,0.0,0.0
1004,375,2020-03-17 05:35:00,0,3274.0,3104.0,0.948,16.337,7,4,0,4,3,1,2,0,0.0,0.0
1004,376,2020-03-17 05:38:00,0,3138.0,2902.0,0.925,15.575,0,0,0,0,0,0,0,0,0.0,0.0
1004,377,2020-03-17 05:41:00,0,2979.0,2728.0,0.915,14.759,29,14,11,3,15,5,10,0,0.0,0.0
1004,378,2020-03-17 05:44:00,0,2828.0,2567.0,0.908,13.985,1,0,0,0,1,0,1,0,0.0,0.0
1004,379,2020-03-17 05:47:00,0,2675.0,2397.0,0.896,13.194,20,8,4,4,12,6,6,0,0.0,0.0
1004,380,2020-03-17 05:50:00,0,2487.0,2307.0,0.928,12.351,1,1,0,1,0,0,0,0,0.0,0.0
1004,381,2020-03-17 05:53:00,0,2506.0,2231.0,0.891,12.343,13,7,2,5,6,0,6,0,0.0,0.0
1004,382,2020-03-17 05:56:00,0,2513.0,2199.0,0.875,12.334,0,0,0,0,0,0,0,0,0.0,0.0
1004,383,2020-03-17 05:59:00,0,2425.0,2146.0,0.885,11.93,152,75,52,23,77,49,28,12,0.0,0.0
1004,384,2020-03-17 06:02:00,1,2590.0,2352.0,0.908,12.81,580,215,157,58,365,278,87,52,0.0,0.0
1004,385,2020-03-17 06:05:00,1,3099.0,2717.0,0.877,15.219,467,214,153,61,253,198,55,66,0.0,0.0
1004,386,2020-03-17 06:08:00,1,3076.0,2774.0,0.902,15.192,317,93,63,30,224,175,49,9,0.0,0.03
1004,387,2020-03-17 06:11:00,1,3085.0,2800.0,0.908,15.254,369,119,74,45,250,189,61,39,0.09,0.0
1004,388,2020-03-17 06:14:00,1,3078.0,2738.0,0.889,15.159,475,207,143,64,268,184,84,14,0.0,0.0
1004,389,2020-03-17 06:17:00,1,3075.0,2766.0,0.9,15.176,741,307,245,62,434,330,104,14,0.0,0.0
1004,390,2020-03-17 06:20:00,1,3011.0,2664.0,0.885,14.813,374,158,104,54,216,141,75,7,0.0,0.0
1004,391,2020-03-17 06:23:00,1,3103.0,2696.0,0.869,15.209,756,300,234,66,456,341,115,6,0.0,0.0
1004,392,2020-03-17 06:26:00,1,3009.0,2645.0,0.879,14.783,371,132,93,39,239,181,58,7,0.0,0.0
1004,393,2020-03-17 06:29:00,1,3005.0,2638.0,0.878,14.761,710,288,201,87,422,319,103,12,0.0,0.0
1004,394,2020-03-17 06:32:00,1,2829.0,2576.0,0.911,13.998,367,164,117,47,203,143,60,0,0.0,0.0
1004,395,2020-03-17 06:35:00,1,2844.0,2546.0,0.895,14.025,99,36,14,22,63,18,45,0,0.0,0.0
1004,396,2020-03-17 06:38:00,1,2935.0,2596.0,0.885,14.437,68,24,8,16,44,18,26,0,0.0,0.0
1004,397,2020-03-17 06:41:00,1,2845.0,2453.0,0.862,13.927,7,2,1,1,5,2,3,0,0.0,0.0
1004,398,2020-03-17 06:44:00,1,2613.0,2231.0,0.854,12.765,0,0,0,0,0,0,0,0,0.0,0.0
1004,399,2020-03-17 06:47:00,1,2284.0,1972.0,0.864,11.181,17,16,1,15,1,1,0,0,0.0,0.0
1004,400,2020-03-17 06:50:00,1,2302.0,1890.0,0.821,11.164,4,2,0,2,2,0,2,0,0.0,0.0
1004,401,2020-03-17 06:53:00,1,2120.0,1841.0,0.868,10.391,8,2,0,2,6,0,6,0,0.0,0.0
1004,402,2020-03-17 06:56:00,1,2120.0,1803.0,0.85,10.349,2,0,0,0,2,0,2,0,0.0,0.0
1004,403,2020-03-17 06:59:00,1,2121.0,1813.0,0.855,10.364,5,2,0,2,3,1,2,0,0.0,0.0
1004,404,2020-03-17 07:02:00,1,2120.0,1789.0,0.844,10.335,22,19,3,16,3,0,3,0,0.0,0.0
1004,405,2020-03-17 07:05:00,1,2133.0,1775.0,0.832,10.37,4,1,0,1,3,1,2,0,0.0,0.0
1004,406,2020-03-17 07:08:00,1,2152.0,1748.0,0.812,10.413,8,0,0,0,8,0,8,0,0.0,0.0
1004,407,2020-03-17 07:11:00,1,2141.0,1745.0,0.815,10.367,4,0,0,0,4,1,3,0,0.0,0.0
1004,408,2020-03-17 07:14:00,1,2149.0,1737.0,0.808,10.392,19,6,4,2,13,5,8,0,0.0,0.0
1004,409,2020-03-17 07:17:00,1,2147.0,1702.0,0.793,10.343,11,8,3,5,3,0,3,0,0.0,0.0
1004,410,2020-03-17 07:20:00,1,2160.0,1683.0,0.779,10.375,38,15,10,5,23,12,11,0,0.0,0.0
1004,411,2020-03-17 07:23:00,1,2147.0,1698.0,0.791,10.341,2,0,0,0,2,0,2,0,0.0,0.0
1004,412,2020-03-17 07:26:00,1,2235.0,1759.0,0.787,10.753,8,0,0,0,8,0,8,0,0.0,0.0
1004,413,2020-03-17 07:29:00,1,2228.0,1759.0,0.79,10.725,1,0,0,0,1,0,1,0,0.0,0.0
1004,414,2020-03-17 07:32:00,1,2230.0,1754.0,0.786,10.726,1,0,0,0,1,0,1,0,0.0,0.0
1004,415,2020-03-17 07:35:00,1,2151.0,1711.0,0.795,10.371,40,26,4,22,14,2,12,0,0.0,0.0
1004,416,2020-03-17 07:38:00,1,2163.0,1697.0,0.784,10.403,16,16,0,16,0,0,0,0,0.0,0.0
1004,417,2020-03-17 07:41:00,1,2081.0,1638.0,0.787,10.012,47,35,15,20,12,2,10,0,0.0,0.0
1004,418,2020-03-17 07:44:00,1,2159.0,1687.0,0.781,10.374,134,77,42,35,57,26,31,20,0.0,0.0
1004,419,2020-03-17 07:47:00,1,2563.0,2036.0,0.794,12.354,350,148,107,41,202,155,47,63,0.0,0.0
1004,420,2020-03-17 07:50:00,1,2910.0,2286.0,0.785,13.998,130,48,11,37,82,51,31,58,0.0,0.0
1004,421,2020-03-17 07:53:00,1,3027.0,2452.0,0.81,14.64,132,39,17,22,93,46,47,61,0.0,0.0
1004,422,2020-03-17 07:56:00,1,2723.0,2216.0,0.814,13.183,237,114,67,47,123,78,45,25,0.0,0.01
1004,423,2020-03-17 07:59:00,1,2713.0,2238.0,0.825,13.1675,279,115,77,38,164,119,45,36,0.0,0.0
1004,424,2020-03-17 08:02:00,1,2703.0,2260.0,0.836,13.152,723,306,223,83,417,323,94,8,0.0,0.0
1004,425,2020-03-17 08:05:00,1,3238.0,2867.0,0.886,15.93,774,280,213,67,494,394,100,7,0.0,0.06
1004,426,2020-03-17 08:08:00,1,3087.0,2683.0,0.869,15.133,348,165,102,63,183,123,60,8,0.0,0.0
1004,427,2020-03-17 08:11:00,1,3170.0,2783.0,0.878,15.57,537,223,167,56,314,234,80,14,0.0,0.0
1004,428,2020-03-17 08:14:00,1,3184.0,2757.0,0.866,15.595,84,24,9,15,60,24,36,1,0.0,0.0
1004,429,2020-03-17 08:17:00,1,3075.0,2685.0,0.873,15.089,31,14,2,12,17,4,13,0,0.0,0.01
1004,430,2020-03-17 08:20:00,1,2847.0,2503.0,0.879,13.99,58,2,0,2,56,2,54,0,0.0,0.0
1004,431,2020-03-17 08:23:00,1,2706.0,2288.0,0.845,13.195,68,0,0,0,68,0,68,0,0.0,0.0
1004,432,2020-03-17 08:26:00,1,2539.0,2089.0,0.822,12.318,66,12,7,5,54,19,35,0,0.0,0.0
1004,433,2020-03-17 08:29:00,1,2279.0,2005.0,0.88,11.199,4,3,1,2,1,0,1,0,0.0,0.0
1004,434,2020-03-17 08:32:00,1,2309.0,1869.0,0.809,11.168,4,2,2,0,2,0,2,0,0.0,0.0
1004,435,2020-03-17 08:35:00,1,2147.0,1770.0,0.825,10.419,28,24,0,24,4,0,4,0,0.0,0.0
1004,436,2020-03-17 08:38:00,1,1955.0,1701.0,0.87,9.587,0,0,0,0,0,0,0,0,0.0,0.0
1004,437,2020-03-17 08:41:00,1,2049.0,1738.0,0.848,9.996,5,3,1,2,2,1,1,0,0.0,0.0
1004,438,2020-03-17 08:44:00,1,2145.0,1756.0,0.819,10.393,36,10,8,2,26,11,15,0,0.0,0.0
1004,439,2020-03-17 08:47:00,1,2116.0,1856.0,0.877,10.392,0,0,0,0,0,0,0,0,0.0,0.0
1004,440,2020-03-17 08:50:00,1,2303.0,1860.0,0.808,11.132,14,7,0,7,7,1,6,0,0.0,0.0
1004,441,2020-03-17 08:53:00,1,2128.0,1805.0,0.848,10.381,18,0,0,0,18,0,18,0,0.0,0.0
1004,442,2020-03-17 08:56:00,1,2145.0,1739.0,0.811,10.378,16,8,0,8,8,0,8,0,0.0,0.0
1004,443,2020-03-17 08:59:00,1,2144.0,1740.0,0.811,10.374,50,24,0,24,26,13,13,0,0.0,0.0
1004,444,2020-03-17 09:02:00,1,2131.0,1738.0,0.816,10.319,8,0,0,0,8,0,8,0,0.0,0.0
1004,445,2020-03-17 09:05:00,1,2153.0,1697.0,0.788,10.361,3,0,0,0,3,0,3,0,0.0,0.0
1004,446,2020-03-17 09:08:00,1,2150.0,1701.0,0.791,10.356,46,11,6,5,35,9,26,0,0.0,0.0
1004,447,2020-03-17 09:11:00,1,2053.0,1671.0,0.814,9.939,10,3,0,3,7,2,5,0,0.0,0.0
1004,448,2020-03-17 09:14:00,1,1974.0,1642.0,0.832,9.597,311,22,5,17,289,261,28,0,0.0,0.0
1004,449,2020-03-17 09:17:00,1,1969.0,1658.0,0.842,9.594,62,13,0,13,49,9,40,0,0.0,0.0
1004,450,2020-03-17 09:20:00,1,1975.0,1632.0,0.826,9.59,65,56,0,56,9,0,9,0,0.0,0.0
1004,451,2020-03-17 09:23:00,1,2149.0,1715.0,0.798,10.365,5,5,0,5,0,0,0,0,0.0,0.0
1004,452,2020-03-17 09:26:00,1,2157.0,1683.0,0.78,10.362,38,34,0,34,4,0,4,0,0.0,0.0
1004,453,2020-03-17 09:29:00,1,1976.0,1635.0,0.827,9.597,50,26,10,16,24,9,15,0,0.0,0.0
1004,454,2020-03-17 09:32:00,1,2165.0,1672.0,0.772,10.381,8,1,0,1,7,3,4,0,0.0,0.0
1004,455,2020-03-17 09:35:00,1,2549.0,2097.0,0.823,12.365,194,83,51,32,111,68,43,5,0.0,0.04
1004,456,2020-03-17 09:38:00,1,3037.0,2515.0,0.828,14.749,232,79,38,41,153,95,58,6,0.0,0.0
1004,457,2020-03-17 09:41:00,1,3127.0,2518.0,0.805,15.107,73,36,11,25,37,4,33,1,0.0,0.0
1004,458,2020-03-17 09:44:00,1,3139.0,2539.0,0.809,15.179,226,90,52,38,136,89,47,21,0.0,0.0
1004,459,2020-03-17 09:47:00,1,2837.0,2484.0,0.876,13.926,212,81,57,24,131,90,41,16,0.0,0.0
1004,460,2020-03-17 09:50:00,1,2943.0,2460.0,0.836,14.317,514,221,159,62,293,205,88,0,0.0,0.0
1004,461,2020-03-17 09:53:00,1,2860.0,2405.0,0.841,13.932,733,275,201,74,458,359,99,24,0.0,0.0
1004,462,2020-03-17 09:56:00,1,2851.0,2388.0,0.838,13.879,443,233,164,69,210,152,58,18,0.0,0.0
1004,463,2020-03-17 09:59:00,1,2899.0,2327.0,0.802,14.0,22,13,1,12,9,1,8,0,0.0,0.0
1004,464,2020-03-17 10:02:00,1,2732.0,2172.0,0.795,13.17,0,0,0,0,0,0,0,0,0.0,0.0
1004,465,2020-03-17 10:05:00,1,2575.0,2032.0,0.789,12.397,18,5,1,4,13,2,11,0,0.0,0.0
1004,466,2020-03-17 10:08:00,1,2396.0,1951.0,0.814,11.6,13,7,0,7,6,0,6,0,0.0,0.0
1004,467,2020-03-17 10:11:00,1,2321.0,1837.0,0.792,11.179,0,0,0,0,0,0,0,0,0.0,0.0
1004,468,2020-03-17 10:14:00,1,2236.0,1762.0,0.788,10.761,44,1,0,1,43,2,41,0,0.0,0.0
1004,469,2020-03-17 10:17:00,1,2140.0,1736.0,0.811,10.354,53,1,1,0,52,0,52,0,0.0,0.0
1004,470,2020-03-17 10:20:00,1,2143.0,1698.0,0.792,10.324,57,4,0,4,53,0,53,0,0.0,0.0
1004,471,2020-03-17 10:23:00,1,2153.0,1705.0,0.792,10.369,4,1,0,1,3,0,3,0,0.0,0.0
1004,472,2020-03-17 10:26:00,1,2159.0,1702.0,0.789,10.391,1,0,0,0,1,0,1,0,0.0,0.0
1004,473,2020-03-17 10:29:00,1,2147.0,1675.0,0.78,10.313,84,38,10,28,46,11,35,0,0.0,0.0
1004,474,2020-03-17 10:32:00,1,2160.0,1674.0,0.775,10.363,81,18,2,16,63,0,63,0,0.0,0.0
1004,475,2020-03-17 10:35:00,1,1979.0,1580.0,0.798,9.548,110,62,8,54,48,20,28,2,0.0,0.0
1004,476,2020-03-17 10:38:00,1,2317.0,1833.0,0.791,11.159,150,68,28,40,82,37,45,15,0.0,0.0
1004,477,2020-03-17 10:41:00,1,2556.0,2067.0,0.809,12.359,203,110,72,38,93,56,37,43,0.0,0.0
1004,478,2020-03-17 10:44:00,1,2731.0,2185.0,0.8,13.181,109,43,17,26,66,28,38,48,0.0,0.0
1004,479,2020-03-17 10:47:00,1,2899.0,2326.0,0.802,13.999,180,87,57,30,93,57,36,47,0.0,0.0
1004,480,2020-03-17 10:50:00,1,2154.0,1737.0,0.807,10.409,52,35,5,30,17,1,16,0,0.0,0.0
1004,481,2020-03-17 10:53:00,1,2573.0,1967.0,0.764,12.316,14,6,0,6,8,0,8,0,0.0,0.0
1004,482,2020-03-17 10:56:00,1,2732.0,2150.0,0.787,13.144,12,5,1,4,7,1,6,0,0.0,0.0
1004,483,2020-03-17 10:59:00,1,2646.5,2088.0,0.789,12.738,2,1,1,0,1,1,0,0,0.0,0.0
1004,484,2020-03-17 11:02:00,1,2561.0,2026.0,0.791,12.332,0,0,0,0,0,0,0,0,0.0,0.0
1004,485,2020-03-17 11:05:00,1,2285.0,1913.0,0.837,11.123,10,4,0,4,6,0,6,0,0.0,0.0
1004,486,2020-03-17 11:08:00,1,2228.0,1804.0,0.81,10.776,19,9,5,4,10,3,7,0,0.0,0.0
1004,487,2020-03-17 11:11:00,1,2302.0,1884.0,0.819,11.156,4,1,0,1,3,0,3,0,0.0,0.0
1004,488,2020-03-17 11:14:00,1,2278.0,1990.0,0.874,11.177,0,0,0,0,0,0,0,0,0.0,0.0
1004,489,2020-03-17 11:17:00,1,2278.0,1948.0,0.855,11.13,14,10,1,9,4,1,3,0,0.0,0.0
1004,490,2020-03-17 11:20:00,1,2274.0,1983.0,0.872,11.154,8,2,0,2,6,0,6,0,0.0,0.0
1004,491,2020-03-17 11:23:00,1,2294.0,1951.0,0.85,11.198,0,0,0,0,0,0,0,0,0.0,0.0
1004,492,2020-03-17 11:26:00,1,2306.0,1906.0,0.827,11.194,9,2,1,1,7,0,7,0,0.0,0.0
1004,493,2020-03-17 11:29:00,1,2305.0,1881.0,0.816,11.166,4,2,1,1,2,1,1,0,0.0,0.0
1004,494,2020-03-17 11:32:00,1,2217.0,1860.0,0.839,10.794,7,1,0,1,6,2,4,0,0.0,0.0
1004,495,2020-03-17 11:35:00,1,2120.0,1824.0,0.86,10.372,5,0,0,0,5,2,3,0,0.0,0.0
1004,496,2020-03-17 11:38:00,1,2128.0,1810.0,0.851,10.389,11,0,0,0,11,6,5,0,0.0,0.0
1004,497,2020-03-17 11:41:00,1,2142.0,1755.0,0.819,10.383,13,0,0,0,13,2,11,0,0.0,0.0
1004,498,2020-03-17 11:44:00,1,2156.0,1737.0,0.806,10.419,27,0,0,0,27,6,21,0,0.0,0.0
1004,499,2020-03-17 11:47:00,1,2140.0,1744.0,0.815,10.362,85,46,31,15,39,13,26,3,0.0,0.0
1004,500,2020-03-17 11:50:00,1,2281.0,1987.0,0.871,11.185,96,44,25,19,52,19,33,3,0.0,0.0
1004,501,2020-03-17 11:53:00,1,2523.0,2167.0,0.859,12.34,204,112,66,46,92,48,44,32,0.0,0.0
1004,502,2020-03-17 11:56:00,1,2709.0,2279.0,0.841,13.196,265,118,77,41,147,101,46,63,0.0,0.0
1004,503,2020-03-17 11:59:00,1,2699.0,2283.0,0.846,13.162,418,191,136,55,227,161,66,15,0.0,0.0
1004,504,2020-03-17 12:02:00,1,2702.0,2281.0,0.844,13.171,575,225,161,64,350,263,87,28,0.0,0.0
1004,505,2020-03-17 12:05:00,1,2701.0,2258.0,0.836,13.14,547,268,200,68,279,194,85,8,0.0,0.0
1004,506,2020-03-17 12:08:00,1,2697.0,2269.0,0.841,13.138,491,245,173,72,246,182,64,69,0.0,0.0
1004,507,2020-03-17 12:11:00,1,2557.0,2058.0,0.805,12.353,198,100,69,31,98,60,38,3,0.0,0.0
1004,508,2020-03-17 12:14:00,1,2717.0,2230.0,0.821,13.174,30,13,1,12,17,0,17,0,0.0,0.0
1004,509,2020-03-17 12:17:00,1,2734.0,2149.0,0.786,13.149,6,0,0,0,6,0,6,0,0.0,0.0
1004,510,2020-03-17 12:20:00,1,2589.0,2021.0,0.78,12.44,15,0,0,0,15,0,15,0,0.0,0.0
1004,511,2020-03-17 12:23:00,1,2304.0,1863.0,0.808,11.14,11,0,0,0,11,0,11,0,0.0,0.0
1004,512,2020-03-17 12:26:00,1,2322.0,1779.0,0.766,11.12,0,0,0,0,0,0,0,0,0.0,0.0
1004,513,2020-03-17 12:29:00,1,2246.0,1731.0,0.771,10.767,9,3,1,2,6,1,5,0,0.0,0.0
1004,514,2020-03-17 12:32:00,1,2254.0,1741.0,0.772,10.81,25,0,0,0,25,0,25,0,0.0,0.0
1004,515,2020-03-17 12:35:00,1,2246.0,1720.0,0.766,10.754,8,2,0,2,6,0,6,0,0.0,0.0
1004,516,2020-03-17 12:38:00,1,2333.0,1755.0,0.752,11.137,6,2,0,2,4,1,3,0,0.0,0.0
1004,517,2020-03-17 12:41:00,1,2350.0,1735.0,0.738,11.182,0,0,0,0,0,0,0,0,0.0,0.0
1004,518,2020-03-17 12:44:00,1,2327.0,1759.0,0.756,11.117,40,11,6,5,29,9,20,0,0.0,0.0
1004,519,2020-03-17 12:47:00,1,2335.0,1767.0,0.757,11.155,8,2,0,2,6,1,5,0,0.0,0.0
1004,520,2020-03-17 12:50:00,1,2154.0,1700.0,0.789,10.368,23,23,0,23,0,0,0,0,0.0,0.0
1004,521,2020-03-17 12:53:00,1,2165.0,1620.0,0.749,10.323,34,7,2,5,27,5,22,0,0.0,0.0
1004,522,2020-03-17 12:56:00,1,1983.0,1589.0,0.801,9.573,24,21,0,21,3,1,2,0,0.0,0.0
1004,523,2020-03-17 12:59:00,1,2079.0,1587.0,0.763,9.947,28,28,0,28,0,0,0,0,0.0,0.0
1004,524,2020-03-17 13:02:00,1,2000.0,1539.0,0.769,9.586,41,7,2,5,34,12,22,0,0.0,0.0
1004,525,2020-03-17 13:05:00,1,2341.0,1777.0,0.759,11.193,127,49,12,37,78,32,46,10,0.0,0.0
1004,526,2020-03-17 13:08:00,1,2576.0,1983.0,0.77,12.344,198,89,47,42,109,54,55,19,0.0,0.0
1004,527,2020-03-17 13:11:00,1,2543.0,2115.0,0.832,12.361,127,58,32,26,69,42,27,55,0.0,0.0
1004,528,2020-03-17 13:14:00,1,2721.0,2222.0,0.817,13.181,112,38,14,24,74,31,43,31,0.0,0.0
1004,529,2020-03-17 13:17:00,1,2891.0,2373.0,0.821,14.016,82,34,3,31,48,22,26,31,0.0,0.04
1004,530,2020-03-17 13:20:00,1,2527.0,2137.0,0.845,12.323,558,219,154,65,339,261,78,33,0.07,0.09
1004,531,2020-03-17 13:23:00,1,2370.0,2005.0,0.846,11.558,547,212,148,64,335,237,98,5,0.0,0.01
1004,532,2020-03-17 13:26:00,1,2230.0,1790.0,0.803,10.768,745,362,288,74,383,292,91,14,0.0,0.0
1004,533,2020-03-17 13:29:00,1,3269.0,2815.0,0.861,15.995,614,236,190,46,378,282,96,12,0.33,0.0
1004,534,2020-03-17 13:32:00,1,2832.0,2484.0,0.877,13.908,106,40,29,11,66,33,33,5,0.0,0.0
1004,535,2020-03-17 13:35:00,1,3094.0,2692.0,0.87,15.169,0,0,0,0,0,0,0,0,0.0,0.0
1004,536,2020-03-17 13:38:00,1,2847.0,2499.0,0.878,13.983,0,0,0,0,0,0,0,0,0.0,0.0
1004,537,2020-03-17 13:41:00,1,2703.0,2316.0,0.857,13.213,0,0,0,0,0,0,0,0,0.0,0.02
1004,538,2020-03-17 13:44:00,1,2533.0,2101.0,0.829,12.307,13,9,5,4,4,0,4,0,0.0,0.01
1004,539,2020-03-17 13:47:00,1,2269.0,2030.0,0.895,11.188,0,0,0,0,0,0,0,0,0.0,0.0
1004,540,2020-03-17 13:50:00,1,2278.0,2003.0,0.879,11.192,2,2,0,2,0,0,0,0,0.0,0.0
1004,541,2020-03-17 13:53:00,1,2298.0,1970.0,0.858,11.234,2,2,0,2,0,0,0,0,0.0,0.0
1004,542,2020-03-17 13:56:00,1,2264.0,1991.0,0.88,11.123,0,0,0,0,0,0,0,0,0.0,0.0
1004,543,2020-03-17 13:59:00,1,2181.0,1945.5,0.8925,10.747,43,43,0,43,0,0,0,0,0.0,0.0
1004,544,2020-03-17 14:02:00,1,2098.0,1900.0,0.905,10.371,3,3,0,3,0,0,0,0,0.0,0.0
1004,545,2020-03-17 14:05:00,1,2086.0,1926.0,0.923,10.352,14,12,4,8,2,2,0,0,0.0,0.0
1004,546,2020-03-17 14:08:00,1,2188.0,1930.0,0.882,10.756,5,5,2,3,0,0,0,0,0.0,0.0
1004,547,2020-03-17 14:11:00,1,2116.0,1848.0,0.873,10.384,0,0,0,0,0,0,0,0,0.0,0.0
1004,548,2020-03-17 14:14:00,1,2030.0,1804.0,0.889,9.995,5,5,2,3,0,0,0,0,0.0,0.0
1004,549,2020-03-17 14:17:00,1,2112.0,1848.0,0.875,10.368,1,1,0,1,0,0,0,0,0.0,0.0
1004,550,2020-03-17 14:20:00,1,2104.0,1846.0,0.878,10.332,11,11,5,6,0,0,0,0,0.0,0.0
1004,551,2020-03-17 14:23:00,1,2128.0,1841.0,0.866,10.421,41,40,7,33,1,0,1,0,0.0,0.0
1004,552,2020-03-17 14:26:00,1,2134.0,1837.0,0.861,10.44,30,25,12,13,5,3,2,0,0.0,0.0
1004,553,2020-03-17 14:29:00,1,2106.0,1855.0,0.88,10.353,3,3,0,3,0,0,0,0,0.0,0.0
1004,554,2020-03-17 14:32:00,1,2125.0,1855.0,0.873,10.424,10,10,0,10,0,0,0,0,0.0,0.0
1004,555,2020-03-17 14:35:00,1,2126.0,1821.0,0.857,10.393,1,1,0,1,0,0,0,0,0.0,0.0
1004,556,2020-03-17 14:38:00,1,2117.0,1817.0,0.858,10.355,1,1,0,1,0,0,0,0,0.0,0.0
1004,557,2020-03-17 14:41:00,1,2122.0,1797.0,0.847,10.35,8,8,0,8,0,0,0,0,0.0,0.0
1004,558,2020-03-17 14:44:00,1,2132.0,1798.0,0.843,10.389,65,34,0,34,31,1,30,0,0.0,0.0
1004,559,2020-03-17 14:47:00,1,2120.0,1853.0,0.874,10.405,99,61,23,38,38,0,38,0,0.0,0.0
1004,560,2020-03-17 14:50:00,1,2255.0,2041.0,0.905,11.144,183,94,57,37,89,49,40,22,0.0,0.0
1004,561,2020-03-17 14:53:00,1,2514.0,2244.0,0.893,12.389,252,184,125,59,68,49,19,30,0.0,0.0
1004,562,2020-03-17 14:56:00,1,2506.0,2266.0,0.904,12.381,114,47,22,25,67,35,32,39,0.0,0.0
1004,563,2020-03-17 14:59:00,1,2586.0,2301.0,0.89,12.738,129,63,34,29,66,33,33,45,0.0,0.44
1004,564,2020-03-17 15:02:00,1,2022.0,1820.0,0.9,9.98,3,0,0,0,3,1,2,0,0.0,0.02
1004,565,2020-03-17 15:05:00,1,2686.0,2361.0,0.879,13.196,545,252,197,55,293,218,75,11,0.0,0.0
1004,566,2020-03-17 15:08:00,1,2799.0,2655.0,0.949,13.967,502,232,172,60,270,210,60,51,0.0,0.01
1004,567,2020-03-17 15:11:00,1,2738.0,2539.0,0.927,13.599,445,246,169,77,199,134,65,3,0.05,0.0
1004,568,2020-03-17 15:14:00,1,3050.0,2874.0,0.942,15.199,585,261,188,73,324,227,97,8,0.12,0.0
1004,569,2020-03-17 15:17:00,1,2796.0,2701.0,0.966,14.006,16,6,4,2,10,8,2,0,0.0,0.0
1004,570,2020-03-17 15:20:00,1,2975.0,2771.0,0.932,14.788,174,62,41,21,112,84,28,9,0.0,0.0
1004,571,2020-03-17 15:23:00,1,3189.0,2982.0,0.935,15.866,730,314,234,80,416,323,93,13,0.42,0.0
1004,572,2020-03-17 15:26:00,1,3227.0,2972.0,0.921,16.003,849,357,272,85,492,376,116,21,0.0,0.0
1004,573,2020-03-17 15:29:00,1,3020.0,2915.0,0.965,15.128,595,292,212,80,303,220,83,5,0.0,0.0
1004,574,2020-03-17 15:32:00,1,3131.0,2936.0,0.938,15.588,136,59,18,41,77,25,52,1,0.0,0.0
1004,575,2020-03-17 15:35:00,1,3207.0,2994.0,0.933,15.95,79,39,9,30,40,20,20,1,0.0,0.0
1004,576,2020-03-17 15:38:00,1,3063.0,2884.0,0.941,15.261,3,3,0,3,0,0,0,0,0.0,0.0
1004,577,2020-03-17 15:41:00,1,2788.0,2669.0,0.958,13.939,0,0,0,0,0,0,0,0,0.0,0.0
1004,578,2020-03-17 15:44:00,1,2634.0,2521.0,0.957,13.171,3,3,0,3,0,0,0,0,0.0,0.0
1004,579,2020-03-17 15:47:00,1,2472.0,2378.0,0.962,12.371,5,3,0,3,2,1,1,0,0.0,0.0
1004,580,2020-03-17 15:50:00,1,2493.0,2301.0,0.923,12.367,1,1,0,1,0,0,0,0,0.0,0.0
1004,581,2020-03-17 15:53:00,1,2517.0,2278.0,0.905,12.437,31,15,10,5,16,12,4,0,0.0,0.0
1004,582,2020-03-17 15:56:00,1,2223.0,2190.0,0.985,11.182,21,6,1,5,15,5,10,0,0.0,0.0
1004,583,2020-03-17 15:59:00,1,2222.0,2204.0,0.992,11.194,2,1,0,1,1,0,1,0,0.0,0.0
1004,584,2020-03-17 16:02:00,1,2226.0,2186.0,0.982,11.188,0,0,0,0,0,0,0,0,0.0,0.0
1004,585,2020-03-17 16:05:00,1,2237.0,2137.0,0.955,11.178,3,2,1,1,1,0,1,0,0.0,0.0
1004,586,2020-03-17 16:08:00,1,2226.0,2159.0,0.97,11.161,5,5,0,5,0,0,0,0,0.0,0.01
1004,587,2020-03-17 16:11:00,1,2234.0,2164.0,0.969,11.196,29,14,1,13,15,1,14,0,0.0,0.0
1004,588,2020-03-17 16:14:00,1,2219.0,2222.0,1.001,11.204,17,12,8,4,5,4,1,0,0.0,0.0
1004,589,2020-03-17 16:17:00,1,2227.0,2215.0,0.994,11.228,36,10,5,5,26,16,10,1,0.0,0.0
1004,590,2020-03-17 16:20:00,1,2229.0,2169.0,0.973,11.182,17,9,0,9,8,3,5,0,0.0,0.0
1004,591,2020-03-17 16:23:00,1,2243.0,2125.0,0.947,11.189,1,0,0,0,1,0,1,0,0.0,0.0
1004,592,2020-03-17 16:26:00,1,2060.0,2077.0,1.008,10.416,1,1,1,0,0,0,0,0,0.0,0.0
1004,593,2020-03-17 16:29:00,1,2048.0,2046.0,0.999,10.333,11,6,6,0,5,2,3,0,0.0,0.0
1004,594,2020-03-17 16:32:00,1,2244.0,2091.0,0.932,11.155,15,15,5,10,0,0,0,0,0.0,0.0
1004,595,2020-03-17 16:35:00,1,2235.0,2117.0,0.947,11.152,30,17,8,9,13,5,8,0,0.0,0.0
1004,596,2020-03-17 16:38:00,1,2236.0,2151.0,0.962,11.189,0,0,0,0,0,0,0,0,0.0,0.0
1004,597,2020-03-17 16:41:00,1,2229.0,2144.0,0.962,11.155,1,0,0,0,1,0,1,0,0.0,0.0
1004,598,2020-03-17 16:44:00,1,2227.0,2124.0,0.954,11.124,0,0,0,0,0,0,0,0,0.0,0.0
1004,599,2020-03-17 16:47:00,1,2228.0,2128.0,0.955,11.132,16,12,9,3,4,2,2,0,0.0,0.0
1004,600,2020-03-17 16:50:00,1,2150.0,2117.0,0.984,10.815,160,95,48,47,65,40,25,3,0.0,0.0
1004,601,2020-03-17 16:53:00,1,2387.0,2325.0,0.974,11.976,67,30,4,26,37,10,27,2,0.0,0.0
1004,602,2020-03-17 16:56:00,1,2622.0,2561.0,0.977,13.165,73,36,9,27,37,4,33,7,0.0,0.0
1004,603,2020-03-17 16:59:00,1,2627.0,2551.5,0.9715,13.174,140,58,43,15,82,51,31,5,0.0,0.0
1004,604,2020-03-17 17:02:00,1,2632.0,2542.0,0.966,13.183,0,0,0,0,0,0,0,0,0.0,0.0
1004,605,2020-03-17 17:05:00,1,2462.0,2392.0,0.972,12.348,8,4,1,3,4,0,4,0,0.0,0.0
1004,606,2020-03-17 17:08:00,1,2319.0,2258.0,0.974,11.638,13,3,0,3,10,0,10,0,0.0,0.0
1004,607,2020-03-17 17:11:00,1,2241.0,2115.0,0.944,11.17,24,21,0,21,3,0,3,0,0.0,0.0
1004,608,2020-03-17 17:14:00,1,2155.0,2061.0,0.956,10.772,30,28,0,28,2,0,2,0,0.0,0.0
1004,609,2020-03-17 17:17:00,1,2089.0,1985.0,0.95,10.429,27,8,0,8,19,0,19,0,0.0,0.0
1004,610,2020-03-17 17:20:00,1,2231.0,2112.0,0.947,11.128,130,97,41,56,33,4,29,1,0.0,0.0
1004,611,2020-03-17 17:23:00,1,2307.0,2266.0,0.982,11.599,147,66,36,30,81,34,47,4,0.0,0.0
1004,612,2020-03-17 17:26:00,1,2477.0,2397.0,0.968,12.413,190,94,50,44,96,54,42,3,0.0,0.0
1004,613,2020-03-17 17:29:00,1,2452.0,2468.0,1.006,12.394,221,114,63,51,107,59,48,21,0.0,0.0
1004,614,2020-03-17 17:32:00,1,2461.0,2456.0,0.998,12.415,153,66,49,17,87,63,24,30,0.0,0.0
1004,615,2020-03-17 17:35:00,1,2639.0,2476.0,0.938,13.139,8,8,0,8,0,0,0,0,0.0,0.0
1004,616,2020-03-17 17:38:00,1,2482.0,2302.0,0.927,12.326,4,3,0,3,1,0,1,0,0.0,0.0
1004,617,2020-03-17 17:41:00,1,2314.0,2202.0,0.952,11.555,20,14,0,14,6,2,4,0,0.0,0.0
1004,618,2020-03-17 17:44:00,1,2246.0,2111.0,0.94,11.187,40,31,0,31,9,2,7,0,0.0,0.0
1004,619,2020-03-17 17:47:00,1,2255.0,2062.0,0.914,11.167,5,4,0,4,1,0,1,0,0.0,0.0
1004,620,2020-03-17 17:50:00,1,2068.0,2004.0,0.969,10.367,12,5,0,5,7,0,7,0,0.0,0.0
1004,621,2020-03-17 17:53:00,1,2256.0,2041.0,0.905,11.146,13,8,0,8,5,0,5,0,0.0,0.0
1004,622,2020-03-17 17:56:00,1,2162.0,2014.0,0.931,10.747,8,6,0,6,2,0,2,0,0.0,0.0
1004,623,2020-03-17 17:59:00,1,2170.0,2023.0,0.932,10.79,21,12,4,8,9,2,7,0,0.0,0.0
1004,624,2020-03-17 18:02:00,0,2245.0,2077.0,0.925,11.144,3,1,1,0,2,1,1,0,0.0,0.0
1004,625,2020-03-17 18:05:00,0,2239.0,2069.0,0.924,11.114,4,1,0,1,3,0,3,0,0.0,0.0
1004,626,2020-03-17 18:08:00,0,2235.0,2145.0,0.96,11.18,11,11,1,10,0,0,0,0,0.0,0.0
1004,627,2020-03-17 18:11:00,0,2232.0,2126.0,0.953,11.15,12,12,0,12,0,0,0,0,0.0,0.0
1004,628,2020-03-17 18:14:00,0,2432.0,2172.0,0.893,11.989,219,115,66,49,104,73,31,42,0.0,0.0
1004,629,2020-03-17 18:17:00,0,2801.0,2621.0,0.936,13.936,333,176,126,50,157,119,38,114,0.0,0.0
1004,630,2020-03-17 18:20:00,0,3058.0,2822.0,0.923,15.171,337,169,126,43,168,108,60,151,0.0,0.0
1004,631,2020-03-17 18:23:00,0,3048.0,2854.0,0.936,15.169,364,192,130,62,172,115,57,91,0.0,0.0
1004,632,2020-03-17 18:26:00,0,3088.0,2762.0,0.894,15.222,263,132,72,60,131,75,56,72,0.0,0.0
1004,633,2020-03-17 18:29:00,0,3284.0,3098.0,0.944,16.367,215,96,59,37,119,68,51,83,0.0,0.0
1004,634,2020-03-17 18:32:00,0,2087.0,1946.0,0.933,10.375,135,82,32,50,53,11,42,33,0.0,0.0
1004,635,2020-03-17 18:35:00,0,2130.0,1799.0,0.844,10.385,208,75,36,39,133,75,58,11,0.0,0.0
1004,636,2020-03-17 18:38:00,0,2697.0,2307.0,0.855,13.18,113,58,23,35,55,26,29,3,0.0,0.0
1004,637,2020-03-17 18:41:00,0,3066.0,2754.0,0.898,15.129,182,93,49,44,89,46,43,14,0.0,0.0
1004,638,2020-03-17 18:44:00,0,3760.0,3605.0,0.959,18.804,345,169,111,58,176,112,64,74,0.0,0.0
1004,639,2020-03-17 18:47:00,0,3779.0,3493.0,0.924,18.757,192,81,43,38,111,53,58,55,0.0,0.02
1004,640,2020-03-17 18:50:00,0,4178.0,3832.0,0.917,20.703,156,56,20,36,100,63,37,27,0.0,0.12
1004,641,2020-03-17 18:53:00,0,3135.0,2893.0,0.923,15.554,66,2,2,0,64,4,60,0,0.0,0.22
1004,642,2020-03-17 18:56:00,0,2683.0,2365.0,0.882,13.188,264,105,82,23,159,102,57,33,0.16,0.0
1004,643,2020-03-17 18:59:00,0,3937.0,3646.0,0.926,19.549,417,193,142,51,224,180,44,88,0.0,0.02
1004,644,2020-03-17 19:02:00,0,3744.0,3595.0,0.96,18.733,333,148,96,52,185,121,64,27,0.11,0.0
1004,645,2020-03-17 19:05:00,0,3064.0,2774.0,0.905,15.143,198,87,57,30,111,54,57,30,0.0,0.0
1004,646,2020-03-17 19:08:00,0,3075.0,2764.0,0.899,15.177,108,22,2,20,86,42,44,0,0.0,0.0
1004,647,2020-03-17 19:11:00,0,3551.0,3269.0,0.921,17.611,59,28,18,10,31,19,12,0,0.0,0.0
1004,648,2020-03-17 19:14:00,0,3293.0,3076.0,0.934,16.382,5,2,1,1,3,0,3,0,0.0,0.0
1004,649,2020-03-17 19:17:00,0,3206.0,3069.0,0.957,16.028,4,0,0,0,4,0,4,0,0.0,0.0
1004,650,2020-03-17 19:20:00,0,3466.0,3276.0,0.945,17.281,0,0,0,0,0,0,0,0,0.0,0.0
1004,651,2020-03-17 19:23:00,0,3520.0,3377.0,0.96,17.605,72,20,12,8,52,34,18,0,0.0,0.0
1004,652,2020-03-17 19:26:00,0,3171.0,3106.0,0.979,15.934,162,68,46,22,94,70,24,0,0.0,0.0
1004,653,2020-03-17 19:29:00,0,2780.0,2725.0,0.98,13.97,162,71,35,36,91,55,36,2,0.0,0.0
1004,654,2020-03-17 19:32:00,0,3196.0,3073.0,0.962,15.992,14,4,2,2,10,2,8,0,0.0,0.0
1004,655,2020-03-17 19:35:00,0,3046.0,2882.0,0.946,15.191,23,3,1,2,20,0,20,0,0.0,0.0
1004,656,2020-03-17 19:38:00,0,2959.0,2823.0,0.954,14.785,0,0,0,0,0,0,0,0,0.0,0.0
1004,657,2020-03-17 19:41:00,0,2783.0,2721.0,0.978,13.979,73,25,15,10,48,26,22,0,0.0,0.0
1004,658,2020-03-17 19:44:00,0,2789.0,2737.0,0.981,14.021,317,150,95,55,167,107,60,40,0.0,0.0
1004,659,2020-03-17 19:47:00,0,3020.0,2929.0,0.97,15.14,235,76,31,45,159,93,66,3,0.0,0.0
1004,660,2020-03-17 19:50:00,0,3196.0,3095.0,0.968,16.019,158,52,11,41,106,59,47,1,0.0,0.0
1004,661,2020-03-17 19:53:00,0,3164.0,3208.0,1.014,16.016,255,104,69,35,151,97,54,29,0.0,0.0
1004,662,2020-03-17 19:56:00,0,3144.0,3192.0,1.015,15.921,253,107,54,53,146,101,45,49,0.0,0.0
1004,663,2020-03-17 19:59:00,0,3163.0,3181.0,1.0055,15.9835,367,186,147,39,181,132,49,144,0.0,0.0
1004,664,2020-03-17 20:02:00,0,3182.0,3170.0,0.996,16.046,302,126,87,39,176,116,60,35,0.08,0.0
1004,665,2020-03-17 20:05:00,0,3201.0,3088.0,0.965,16.03,157,89,50,39,68,35,33,58,0.0,0.0
1004,666,2020-03-17 20:08:00,0,3348.0,3233.0,0.966,16.772,121,46,11,35,75,40,35,40,0.0,0.0
1004,667,2020-03-17 20:11:00,0,3422.0,3367.0,0.984,17.21,117,54,20,34,63,31,32,37,0.0,0.12
1004,668,2020-03-17 20:14:00,0,3564.0,3533.0,0.991,17.953,345,144,104,40,201,146,55,54,0.0,0.02
1004,669,2020-03-17 20:17:00,0,3402.0,3358.0,0.987,17.12,328,113,81,32,215,162,53,40,0.26,0.0
1004,670,2020-03-17 20:20:00,0,3431.0,3344.0,0.975,17.22,300,141,96,45,159,105,54,61,0.0,0.01
1004,671,2020-03-17 20:23:00,0,3590.0,3433.0,0.956,17.947,114,31,10,21,83,43,40,36,0.0,0.0
1004,672,2020-03-17 20:26:00,0,3721.0,3708.0,0.996,18.768,124,52,9,43,72,27,45,14,0.0,0.04
1004,673,2020-03-17 20:29:00,0,3737.0,3674.0,0.983,18.791,284,105,66,39,179,122,57,12,0.0,0.08
1004,674,2020-03-17 20:32:00,0,3173.0,3138.0,0.989,15.977,60,13,2,11,47,16,31,0,0.0,0.02
1004,675,2020-03-17 20:35:00,0,3014.0,2984.0,0.99,15.179,13,7,4,3,6,2,4,0,0.0,0.0
1004,676,2020-03-17 20:38:00,0,2758.0,2794.0,1.013,13.958,34,17,10,7,17,2,15,0,0.0,0.0
1004,677,2020-03-17 20:41:00,0,2785.0,2688.0,0.965,13.949,13,13,4,9,0,0,0,0,0.0,0.0
1004,678,2020-03-17 20:44:00,0,2805.0,2650.0,0.945,13.986,57,52,16,36,5,2,3,0,0.0,0.0
1004,679,2020-03-17 20:47:00,0,2321.0,2219.0,0.956,11.601,19,7,5,2,12,1,11,0,0.0,0.0
1004,680,2020-03-17 20:50:00,0,1924.0,1827.0,0.95,9.603,17,5,2,3,12,5,7,0,0.0,0.0
1004,681,2020-03-17 20:53:00,0,1944.0,1728.0,0.889,9.572,25,9,5,4,16,10,6,0,0.0,0.0
1004,682,2020-03-17 20:56:00,0,1938.0,1772.0,0.914,9.596,12,1,0,1,11,4,7,0,0.0,0.0
1004,683,2020-03-17 20:59:00,0,2014.0,1847.0,0.917,9.981,6,2,0,2,4,2,2,0,0.0,0.0
1004,684,2020-03-17 21:02:00,0,2177.0,2027.0,0.931,10.821,160,67,49,18,93,48,45,2,0.0,0.0
1004,685,2020-03-17 21:05:00,0,3086.0,3093.0,1.002,15.581,186,97,54,43,89,56,33,64,0.0,0.0
1004,686,2020-03-17 21:08:00,0,3400.0,3389.0,0.997,17.148,91,34,10,24,57,24,33,60,0.0,0.01
1004,687,2020-03-17 21:11:00,0,3559.0,3565.0,1.002,17.967,452,206,155,51,246,181,65,76,0.0,0.03
1004,688,2020-03-17 21:14:00,0,2829.0,2897.0,1.024,14.355,252,101,50,51,151,92,59,8,0.0,0.02
1004,689,2020-03-17 21:17:00,0,2623.0,2578.0,0.983,13.19,152,55,18,37,97,54,43,13,0.0,0.0
1004,690,2020-03-17 21:20:00,0,3677.0,3577.0,0.973,18.448,328,162,110,52,166,113,53,63,0.18,0.01
1004,691,2020-03-17 21:23:00,0,3543.0,3641.0,1.028,17.992,248,95,51,44,153,99,54,48,0.0,0.0
1004,692,2020-03-17 21:26:00,0,3996.0,3887.0,0.973,20.049,93,39,6,33,54,23,31,22,0.0,0.0
1004,693,2020-03-17 21:29:00,0,3953.0,4013.0,1.015,20.017,90,22,3,19,68,30,38,20,0.0,0.17
1004,694,2020-03-17 21:32:00,0,4046.0,4000.0,0.989,20.369,189,66,38,28,123,75,48,23,0.16,0.1
1004,695,2020-03-17 21:35:00,0,3418.0,3329.0,0.974,17.153,103,33,25,8,70,47,23,3,0.0,0.01
1004,696,2020-03-17 21:38:00,0,3190.0,3096.0,0.971,15.995,5,0,0,0,5,4,1,0,0.0,0.0
1004,697,2020-03-17 21:41:00,0,2753.0,2774.0,1.007,13.918,30,9,1,8,21,11,10,0,0.0,0.0
1004,698,2020-03-17 21:44:00,0,2789.0,2666.0,0.956,13.941,14,8,3,5,6,4,2,0,0.0,0.0
1004,699,2020-03-17 21:47:00,0,2623.0,2599.0,0.991,13.211,4,3,2,1,1,0,1,0,0.0,0.0
1004,700,2020-03-17 21:50:00,0,2646.0,2516.0,0.951,13.21,41,12,7,5,29,13,16,0,0.0,0.0
1004,701,2020-03-17 21:53:00,0,2398.0,2296.0,0.957,11.99,5,3,1,2,2,0,2,0,0.0,0.0
1004,702,2020-03-17 21:56:00,0,2251.0,2080.0,0.924,11.173,288,140,91,49,148,103,45,29,0.0,0.0
1004,703,2020-03-17 21:59:00,0,3575.0,3572.0,0.999,18.04,407,139,88,51,268,210,58,62,0.0,0.0
1004,704,2020-03-17 22:02:00,0,3425.0,3344.0,0.976,17.198,294,140,92,48,154,105,49,88,0.0,0.0
1004,705,2020-03-17 22:05:00,0,2454.0,2409.0,0.981,12.337,206,40,11,29,166,116,50,23,0.0,0.0
1004,706,2020-03-17 22:08:00,0,3720.0,3698.0,0.994,18.75,343,135,93,42,208,151,57,41,0.03,0.04
1004,707,2020-03-17 22:11:00,0,3195.0,3113.0,0.974,16.036,395,123,72,51,272,191,81,0,0.0,0.0
1004,708,2020-03-17 22:14:00,0,3408.0,3303.0,0.969,17.084,319,131,93,38,188,125,63,59,0.0,0.0
1004,709,2020-03-17 22:17:00,0,3794.0,3722.0,0.981,19.068,107,30,4,26,77,46,31,26,0.0,0.0
1004,710,2020-03-17 22:20:00,0,3703.0,3734.0,1.008,18.723,136,24,3,21,112,62,50,32,0.0,0.04
1004,711,2020-03-17 22:23:00,0,3901.0,3810.0,0.977,19.586,156,52,23,29,104,63,41,35,0.0,0.0
1004,712,2020-03-17 22:26:00,0,4124.0,4130.0,1.002,20.819,325,121,79,42,204,157,47,57,0.14,0.21
1004,713,2020-03-17 22:29:00,0,3387.0,3433.0,1.014,17.145,373,118,83,35,255,201,54,29,0.0,0.0
1004,714,2020-03-17 22:32:00,0,3244.0,3281.0,1.011,16.413,258,108,67,41,150,101,49,18,0.24,0.0
1004,715,2020-03-17 22:35:00,0,3743.0,3705.0,0.99,18.85,139,63,42,21,76,46,30,27,0.0,0.0
1004,716,2020-03-17 22:38:00,0,3150.0,3204.0,1.017,15.958,157,67,31,36,90,40,50,0,0.0,0.0
1004,717,2020-03-17 22:41:00,0,3161.0,3209.0,1.015,16.005,14,9,0,9,5,0,5,0,0.0,0.0
1004,718,2020-03-17 22:44:00,0,2705.0,2642.0,0.977,13.584,1,1,1,0,0,0,0,0,0.0,0.0
1004,719,2020-03-17 22:47:00,0,2627.0,2562.0,0.975,13.187,51,37,17,20,14,7,7,0,0.0,0.0
1004,720,2020-03-17 22:50:00,0,2598.0,2602.0,1.001,13.118,12,6,2,4,6,1,5,0,0.0,0.0
1004,721,2020-03-17 22:53:00,0,2453.0,2442.0,0.996,12.367,21,10,5,5,11,1,10,0,0.0,0.0
1004,722,2020-03-17 22:56:00,0,2222.0,2217.0,0.998,11.207,5,0,0,0,5,0,5,0,0.0,0.0
1004,723,2020-03-17 22:59:00,0,2082.5,1972.0,0.9435,10.388,3,0,0,0,3,1,2,0,0.0,0.0
1004,724,2020-03-17 23:02:00,0,1943.0,1727.0,0.889,9.569,32,17,13,4,15,7,8,0,0.0,0.0
1004,725,2020-03-17 23:05:00,0,1939.0,1718.0,0.886,9.544,6,1,0,1,5,0,5,0,0.0,0.0
1004,726,2020-03-17 23:08:00,0,2011.0,1879.0,0.934,10.004,0,0,0,0,0,0,0,0,0.0,0.0
1004,727,2020-03-17 23:11:00,0,2236.0,2157.0,0.965,11.196,0,0,0,0,0,0,0,0,0.0,0.0
1004,728,2020-03-17 23:14:00,0,2071.0,2044.0,0.987,10.422,9,7,3,4,2,1,1,0,0.0,0.0
1004,729,2020-03-17 23:17:00,0,1922.0,1819.0,0.946,9.588,1,1,0,1,0,0,0,0,0.0,0.0
1004,730,2020-03-17 23:20:00,0,1940.0,1723.0,0.888,9.552,6,2,1,1,4,1,3,0,0.0,0.0
1004,731,2020-03-17 23:23:00,0,2007.0,1903.0,0.948,10.014,229,72,39,33,157,92,65,1,0.0,0.0
1004,732,2020-03-17 23:26:00,0,2541.0,2478.0,0.975,12.754,331,183,122,61,148,101,47,30,0.0,0.0
1004,733,2020-03-17 23:29:00,0,3965.0,3931.0,0.991,19.975,285,111,63,48,174,120,54,56,0.0,0.0
1004,734,2020-03-17 23:32:00,0,3875.0,3848.0,0.993,19.527,169,30,10,20,139,97,42,25,0.0,0.07
1004,735,2020-03-17 23:35:00,0,4088.0,4239.0,1.037,20.8,193,38,2,36,155,91,64,36,0.0,0.0
1004,736,2020-03-17 23:38:00,0,4242.0,4255.0,1.003,21.426,375,115,76,39,260,193,67,34,0.14,0.12
1004,737,2020-03-17 23:41:00,0,3951.0,3961.0,1.003,19.952,455,195,141,54,260,191,69,81,0.03,0.02
1004,738,2020-03-17 23:44:00,0,3512.0,3402.0,0.969,17.602,477,203,158,45,274,207,67,55,0.0,0.0
1004,739,2020-03-17 23:47:00,0,2764.0,2762.0,0.999,13.947,440,193,141,52,247,177,70,23,0.02,0.0
1004,740,2020-03-17 23:50:00,0,3020.0,2993.0,0.991,15.212,516,214,159,55,302,221,81,18,0.0,0.09
1004,741,2020-03-17 23:53:00,0,2807.0,2673.0,0.952,14.02,591,232,167,65,359,271,88,17,0.0,0.0
1004,742,2020-03-17 23:56:00,0,3984.0,3922.0,0.984,20.036,479,228,163,65,251,174,77,56,0.0,0.0
1004,743,2020-03-17 23:59:00,0,4019.0,4000.0,0.995,20.263,107,29,13,16,78,41,37,0,0.0,0.0
1004,744,2020-03-18 00:02:00,0,3948.0,3898.0,0.987,19.87,95,37,15,22,58,31,27,0,0.0,0.0
1004,745,2020-03-18 00:05:00,0,3723.0,3676.0,0.987,18.74,11,11,2,9,0,0,0,0,0.0,0.0
1004,746,2020-03-18 00:08:00,0,3412.0,3365.0,0.986,17.167,2,2,0,2,0,0,0,0,0.0,0.0
1004,747,2020-03-18 00:11:00,0,3172.0,3143.0,0.991,15.979,16,16,6,10,0,0,0,0,0.0,0.0
1004,748,2020-03-18 00:14:00,0,3021.0,2921.0,0.967,15.135,7,7,2,5,0,0,0,0,0.0,0.0
1004,749,2020-03-18 00:17:00,0,2774.0,2755.0,0.993,13.979,33,33,2,31,0,0,0,0,0.0,0.0
1004,750,2020-03-18 00:20:00,0,2616.0,2597.0,0.993,13.182,50,29,7,22,21,12,9,0,0.0,0.0
1004,751,2020-03-18 00:23:00,0,2638.0,2508.0,0.951,13.169,11,11,1,10,0,0,0,0,0.0,0.0
1004,752,2020-03-18 00:26:00,0,2496.0,2333.0,0.935,12.418,214,91,48,43,123,74,49,2,0.0,0.0
1004,753,2020-03-18 00:29:00,0,2608.0,2620.0,1.004,13.177,186,117,70,47,69,40,29,38,0.0,0.0
1004,754,2020-03-18 00:32:00,0,3039.0,2886.0,0.95,15.167,189,79,33,46,110,67,43,68,0.0,0.0
1004,755,2020-03-18 00:35:00,0,3410.0,3351.0,0.983,17.144,201,47,9,38,154,93,61,51,0.0,0.0
1004,756,2020-03-18 00:38:00,0,3249.0,3244.0,0.999,16.393,144,45,27,18,99,55,44,19,0.0,0.22
1004,757,2020-03-18 00:41:00,0,2638.0,2542.0,0.964,13.208,149,43,27,16,106,69,37,15,0.13,0.0
1004,758,2020-03-18 00:44:00,0,2770.0,2832.0,1.023,14.049,509,241,178,63,268,203,65,74,0.08,0.0
1004,759,2020-03-18 00:47:00,0,3424.0,3329.0,0.972,17.176,374,134,97,37,240,195,45,62,0.01,0.02
1004,760,2020-03-18 00:50:00,0,3594.0,3468.0,0.965,17.998,694,309,245,64,385,299,86,5,0.0,0.0
1004,761,2020-03-18 00:53:00,0,3744.0,3627.0,0.969,18.766,558,205,142,63,353,263,90,24,0.0,0.0
1004,762,2020-03-18 00:56:00,0,3737.0,3635.0,0.973,18.75,716,356,274,82,360,281,79,16,0.0,0.0
1004,763,2020-03-18 00:59:00,0,3565.0,3601.0,1.01,18.031,670,282,208,74,388,304,84,8,0.03,0.0
1004,764,2020-03-18 01:02:00,0,3749.0,3636.0,0.97,18.798,831,399,307,92,432,327,105,1,0.0,0.0
1004,765,2020-03-18 01:05:00,0,3588.0,3478.0,0.969,17.988,485,264,192,72,221,151,70,76,0.0,0.0
1004,766,2020-03-18 01:08:00,0,3406.0,3402.0,0.999,17.184,160,66,45,21,94,53,41,70,0.0,0.07
1004,767,2020-03-18 01:11:00,0,3402.0,3402.0,1.0,17.17,166,78,48,30,88,54,34,86,0.29,0.11
1004,768,2020-03-18 01:14:00,0,2783.0,2743.0,0.986,14.001,205,69,36,33,136,93,43,14,0.0,0.01
1004,769,2020-03-18 01:17:00,0,2500.0,2268.0,0.907,12.36,109,46,17,29,63,29,34,2,0.0,0.0
1004,770,2020-03-18 01:20:00,0,3578.0,3465.0,0.968,17.932,140,103,65,38,37,10,27,0,0.0,0.03
1004,771,2020-03-18 01:23:00,0,3409.0,3382.0,0.992,17.175,4,2,0,2,2,1,1,0,0.0,0.01
1004,772,2020-03-18 01:26:00,0,3347.0,3272.0,0.978,16.807,5,5,1,4,0,0,0,0,0.0,0.0
1004,773,2020-03-18 01:29:00,0,3193.0,3102.0,0.971,16.016,16,16,0,16,0,0,0,0,0.0,0.0
1004,774,2020-03-18 01:32:00,0,3040.0,2884.0,0.949,15.173,324,187,125,62,137,82,55,4,0.0,0.0
1004,775,2020-03-18 01:35:00,0,3023.0,2975.0,0.984,15.203,757,323,228,95,434,326,108,0,0.0,0.0
1004,776,2020-03-18 01:38:00,0,3197.0,3111.0,0.973,16.039,820,326,244,82,494,390,104,3,0.0,0.0
1004,777,2020-03-18 01:41:00,0,3197.0,3061.0,0.957,15.984,1045,457,368,89,588,461,127,8,0.0,0.0
1004,778,2020-03-18 01:44:00,0,3166.0,3178.0,1.004,15.993,819,365,296,69,454,342,112,24,0.0,0.0
1004,779,2020-03-18 01:47:00,0,3191.0,3125.0,0.979,16.033,451,214,160,54,237,174,63,24,0.0,0.0
1004,780,2020-03-18 01:50:00,0,3179.0,3154.0,0.992,16.018,802,337,278,59,465,362,103,11,0.0,0.0
1004,781,2020-03-18 01:53:00,0,3015.0,2993.0,0.993,15.194,166,68,36,32,98,61,37,12,0.0,0.0
1004,782,2020-03-18 01:56:00,0,3213.0,3027.0,0.942,16.012,106,66,33,33,40,17,23,2,0.0,0.0
1004,783,2020-03-18 01:59:00,0,3194.0,3071.5,0.9615,15.985,78,52,16,36,26,4,22,0,0.0,0.03
1004,784,2020-03-18 02:02:00,0,3175.0,3116.0,0.981,15.958,581,188,128,60,393,308,85,0,0.0,0.0
1004,785,2020-03-18 02:05:00,0,3194.0,3066.0,0.96,15.981,291,109,72,37,182,139,43,7,0.0,0.0
1004,786,2020-03-18 02:08:00,0,3208.0,3045.0,0.949,16.009,136,55,15,40,81,33,48,1,0.0,0.0
1004,787,2020-03-18 02:11:00,0,3211.0,3012.0,0.938,15.984,54,39,9,30,15,3,12,0,0.0,0.0
1004,788,2020-03-18 02:14:00,0,3034.0,2938.0,0.968,15.206,34,19,2,17,15,5,10,0,0.0,0.0
1004,789,2020-03-18 02:17:00,0,2791.0,2718.0,0.974,14.007,7,3,0,3,4,3,1,0,0.0,0.0
1004,790,2020-03-18 02:20:00,0,2625.0,2511.0,0.957,13.124,29,16,8,8,13,10,3,0,0.0,0.03
1004,791,2020-03-18 02:23:00,0,2660.0,2430.0,0.913,13.172,0,0,0,0,0,0,0,0,0.0,0.0
1004,792,2020-03-18 02:26:00,0,2489.0,2327.0,0.935,12.381,0,0,0,0,0,0,0,0,0.0,0.0
1004,793,2020-03-18 02:29:00,0,2517.0,2289.0,0.909,12.45,8,2,1,1,6,2,4,0,0.0,0.0
1004,794,2020-03-18 02:32:00,0,2416.0,2220.0,0.919,11.975,2,0,0,0,2,1,1,0,0.0,0.0
1004,795,2020-03-18 02:35:00,0,2415.0,2216.0,0.918,11.971,39,17,7,10,22,15,7,0,0.0,0.0
1004,796,2020-03-18 02:38:00,0,2327.0,2201.0,0.946,11.604,53,0,0,0,53,14,39,0,0.0,0.0
1004,797,2020-03-18 02:41:00,0,2238.0,2146.0,0.959,11.192,38,1,0,1,37,2,35,0,0.0,0.0
1004,798,2020-03-18 02:44:00,0,2223.0,2144.0,0.965,11.131,9,0,0,0,9,2,7,0,0.0,0.0
1004,799,2020-03-18 02:47:00,0,2511.0,2285.0,0.91,12.422,40,0,0,0,40,8,32,0,0.0,0.0
1004,800,2020-03-18 02:50:00,0,2325.0,2215.0,0.953,11.611,71,30,14,16,41,32,9,0,0.0,0.0
1004,801,2020-03-18 02:53:00,0,2488.0,2301.0,0.925,12.351,76,25,3,22,51,0,51,0,0.0,0.0
1004,802,2020-03-18 02:56:00,0,2488.0,2299.0,0.924,12.349,57,21,13,8,36,0,36,0,0.0,0.0
1004,803,2020-03-18 02:59:00,0,2218.0,2190.0,0.987,11.163,19,6,3,3,13,2,11,0,0.0,0.0
1004,804,2020-03-18 03:02:00,0,2236.0,2145.0,0.959,11.186,31,2,1,1,29,0,29,0,0.0,0.0
1004,805,2020-03-18 03:05:00,0,2237.0,2138.0,0.956,11.182,51,8,3,5,43,2,41,0,0.0,0.0
1004,806,2020-03-18 03:08:00,0,2244.0,2107.0,0.939,11.174,31,0,0,0,31,2,29,0,0.0,0.0
1004,807,2020-03-18 03:11:00,0,2234.0,2166.0,0.97,11.2,228,66,37,29,162,109,53,15,0.0,0.0
1004,808,2020-03-18 03:14:00,0,2452.0,2453.0,1.001,12.375,233,89,60,29,144,100,44,43,0.0,0.0
1004,809,2020-03-18 03:17:00,0,2696.0,2641.0,0.979,13.547,50,14,5,9,36,6,30,7,0.0,0.0
1004,810,2020-03-18 03:20:00,0,2865.0,2821.0,0.985,14.412,81,37,12,25,44,23,21,13,0.0,0.0
1004,811,2020-03-18 03:23:00,0,3017.0,2917.0,0.967,15.118,347,156,107,49,191,131,60,43,0.0,0.0
1004,812,2020-03-18 03:26:00,0,3192.0,3078.0,0.964,15.985,403,190,149,41,213,165,48,114,0.0,0.0
1004,813,2020-03-18 03:29:00,0,3179.0,3094.0,0.973,15.951,180,67,32,35,113,68,45,10,0.0,0.0
1004,814,2020-03-18 03:32:00,0,3215.0,3009.0,0.936,15.996,264,162,127,35,102,57,45,102,0.0,0.0
1004,815,2020-03-18 03:35:00,0,3192.0,3130.0,0.98,16.043,269,148,116,32,121,75,46,116,0.0,0.0
1004,816,2020-03-18 03:38:00,0,3195.0,3041.0,0.952,15.955,145,77,43,34,68,27,41,83,0.0,0.0
1004,817,2020-03-18 03:41:00,0,3183.0,3125.0,0.982,15.999,460,188,129,59,272,187,85,34,0.15,0.05
1004,818,2020-03-18 03:44:00,0,3437.0,3297.0,0.959,17.193,327,140,109,31,187,143,44,91,0.0,0.0
1004,819,2020-03-18 03:47:00,0,3222.0,3026.0,0.939,16.044,827,295,247,48,532,422,110,7,0.17,0.0
1004,820,2020-03-18 03:50:00,0,3186.0,3061.0,0.961,15.942,516,155,107,48,361,277,84,12,0.0,0.0
1004,821,2020-03-18 03:53:00,0,3169.0,3108.0,0.981,15.927,464,185,127,58,279,207,72,1,0.0,0.01
1004,822,2020-03-18 03:56:00,0,3446.0,3297.0,0.957,17.228,556,198,147,51,358,281,77,21,0.0,0.05
1004,823,2020-03-18 03:59:00,0,2653.0,2464.0,0.929,13.179,554,233,169,64,321,231,90,9,0.0,0.0
1004,824,2020-03-18 04:02:00,0,3431.0,3360.0,0.979,17.238,386,180,122,58,206,149,57,0,0.0,0.0
1004,825,2020-03-18 04:05:00,0,3426.0,3274.0,0.956,17.125,141,57,14,43,84,35,49,3,0.0,0.0
1004,826,2020-03-18 04:08:00,0,3431.0,3287.0,0.958,17.159,45,34,17,17,11,1,10,0,0.0,0.0
1004,827,2020-03-18 04:11:00,0,3198.0,3068.0,0.959,15.996,2,1,0,1,1,0,1,0,0.0,0.0
1004,828,2020-03-18 04:14:00,0,3068.0,2826.0,0.921,15.217,0,0,0,0,0,0,0,0,0.0,0.0
1004,829,2020-03-18 04:17:00,0,2815.0,2586.0,0.919,13.953,3,1,0,1,2,1,1,0,0.0,0.0
1004,830,2020-03-18 04:20:00,0,2666.0,2408.0,0.903,13.172,3,0,0,0,3,0,3,0,0.0,0.0
1004,831,2020-03-18 04:23:00,0,2519.0,2245.0,0.891,12.41,27,15,8,7,12,6,6,0,0.0,0.0
1004,832,2020-03-18 04:26:00,0,2517.0,2239.0,0.89,12.394,25,1,1,0,24,9,15,0,0.0,0.0
1004,833,2020-03-18 04:29:00,0,2418.0,2203.0,0.911,11.964,4,0,0,0,4,2,2,0,0.0,0.0
1004,834,2020-03-18 04:32:00,0,2266.0,2030.0,0.896,11.175,2,0,0,0,2,0,2,0,0.0,0.0
1004,835,2020-03-18 04:35:00,0,2185.0,1982.0,0.907,10.802,7,3,1,2,4,2,2,0,0.0,0.0
1004,836,2020-03-18 04:38:00,0,2180.0,1956.0,0.897,10.755,0,0,0,0,0,0,0,0,0.0,0.0
1004,837,2020-03-18 04:41:00,0,2189.0,1964.0,0.897,10.8,6,0,0,0,6,2,4,0,0.0,0.0
1004,838,2020-03-18 04:44:00,0,2091.0,1943.0,0.929,10.39,9,0,0,0,9,0,9,0,0.0,0.0
1004,839,2020-03-18 04:47:00,0,2087.0,1927.0,0.923,10.356,1,0,0,0,1,0,1,0,0.0,0.0
1004,840,2020-03-18 04:50:00,0,2081.0,1956.0,0.94,10.366,8,3,1,2,5,1,4,0,0.0,0.0
1004,841,2020-03-18 04:53:00,0,2351.0,2107.0,0.896,11.598,388,156,106,50,232,160,72,58,0.0,0.0
1004,842,2020-03-18 04:56:00,0,2732.0,2505.0,0.917,13.535,195,128,70,58,67,32,35,115,0.0,0.0
1004,843,2020-03-18 04:59:00,0,2862.0,2612.0,0.913,14.1665,166,110,62,48,56,21,35,110,0.0,0.0
1004,844,2020-03-18 05:02:00,0,2992.0,2719.0,0.909,14.798,170,86,55,31,84,34,50,93,0.0,0.0
1004,845,2020-03-18 05:05:00,0,2648.0,2430.0,0.918,13.122,172,63,30,33,109,64,45,30,0.0,0.0
1004,846,2020-03-18 05:08:00,0,2607.0,2284.0,0.876,12.801,181,57,17,40,124,76,48,15,0.0,0.0
1004,847,2020-03-18 05:11:00,0,3134.0,2906.0,0.927,15.566,153,58,22,36,95,49,46,17,0.0,0.0
1004,848,2020-03-18 05:14:00,0,3196.0,3035.0,0.95,15.952,330,149,105,44,181,144,37,113,0.0,0.0
1004,849,2020-03-18 05:17:00,0,3203.0,3000.0,0.937,15.94,204,130,74,56,74,40,34,96,0.0,0.0
1004,850,2020-03-18 05:20:00,0,3395.0,3096.0,0.912,16.805,272,148,82,66,124,47,77,92,0.0,0.0
1004,851,2020-03-18 05:23:00,0,3380.0,3108.0,0.919,16.757,171,92,44,48,79,16,63,79,0.0,0.0
1004,852,2020-03-18 05:26:00,0,3621.0,3335.0,0.921,17.961,234,114,77,37,120,61,59,68,0.0,0.04
1004,853,2020-03-18 05:29:00,0,3527.0,3294.0,0.934,17.544,199,79,46,33,120,69,51,39,0.12,0.03
1004,854,2020-03-18 05:32:00,0,3061.0,2797.0,0.914,15.159,376,161,118,43,215,145,70,28,0.15,0.0
1004,855,2020-03-18 05:35:00,0,2640.0,2474.0,0.937,13.14,759,379,296,83,380,283,97,5,0.0,0.0
1004,856,2020-03-18 05:38:00,0,3439.0,3251.0,0.945,17.149,839,340,275,65,499,399,100,8,0.0,0.0
1004,857,2020-03-18 05:41:00,0,3776.0,3462.0,0.917,18.709,245,113,78,35,132,70,62,64,0.0,0.0
1004,858,2020-03-18 05:44:00,0,3695.0,3480.0,0.942,18.409,128,60,28,32,68,5,63,69,0.0,0.06
1004,859,2020-03-18 05:47:00,0,3680.0,3474.0,0.944,18.344,205,83,39,44,122,55,67,62,0.08,0.1
1004,860,2020-03-18 05:50:00,0,3442.0,3212.0,0.933,17.119,364,169,110,59,195,133,62,15,0.0,0.03
1004,861,2020-03-18 05:53:00,0,2656.0,2419.0,0.911,13.141,62,43,19,24,19,6,13,0,0.0,0.0
1004,862,2020-03-18 05:56:00,0,2343.0,2121.0,0.905,11.58,7,4,1,3,3,1,2,0,0.0,0.0
1004,863,2020-03-18 05:59:00,0,2545.0,2147.0,0.843,12.404,14,5,2,3,9,3,6,0,0.0,0.0
1004,864,2020-03-18 06:02:00,1,2492.0,2248.0,0.902,12.307,298,136,98,38,162,126,36,25,0.0,0.0
1004,865,2020-03-18 06:05:00,1,2666.0,2375.0,0.891,13.132,418,190,137,53,228,152,76,3,0.0,0.0
1004,866,2020-03-18 06:08:00,1,3492.0,3372.0,0.966,17.491,432,190,142,48,242,183,59,72,0.0,0.0
1004,867,2020-03-18 06:11:00,1,3457.0,3210.0,0.928,17.173,181,94,53,41,87,22,65,80,0.0,0.0
1004,868,2020-03-18 06:14:00,1,3609.0,3397.0,0.941,17.981,291,110,66,44,181,121,60,64,0.06,0.03
1004,869,2020-03-18 06:17:00,1,2512.0,2245.0,0.894,12.381,69,57,32,25,12,6,6,2,0.0,0.0
1004,870,2020-03-18 06:20:00,1,1965.0,1667.0,0.848,9.589,311,145,99,46,166,121,45,2,0.0,0.0
1004,871,2020-03-18 06:23:00,1,3441.0,3229.0,0.938,17.134,852,347,278,69,505,407,98,9,0.0,0.0
1004,872,2020-03-18 06:26:00,1,3596.0,3485.0,0.969,18.027,271,168,113,55,103,67,36,21,0.0,0.0
1004,873,2020-03-18 06:29:00,1,3413.0,3298.0,0.966,17.096,16,14,8,6,2,1,1,0,0.0,0.0
1004,874,2020-03-18 06:32:00,1,3191.0,3089.0,0.968,15.991,5,4,2,2,1,0,1,0,0.0,0.0
1004,875,2020-03-18 06:35:00,1,3054.0,2830.0,0.926,15.167,2,2,0,2,0,0,0,0,0.0,0.0
1004,876,2020-03-18 06:38:00,1,2798.0,2656.0,0.949,13.963,3,3,0,3,0,0,0,0,0.0,0.0
1004,877,2020-03-18 06:41:00,1,2646.0,2516.0,0.951,13.212,8,6,2,4,2,1,1,0,0.0,0.0
1004,878,2020-03-18 06:44:00,1,2477.0,2340.0,0.945,12.351,0,0,0,0,0,0,0,0,0.0,0.0
1004,879,2020-03-18 06:47:00,1,2427.0,2186.0,0.901,11.983,13,6,0,6,7,0,7,0,0.0,0.0
1004,880,2020-03-18 06:50:00,1,2245.0,2095.0,0.933,11.166,21,12,7,5,9,6,3,0,0.0,0.0
1004,881,2020-03-18 06:53:00,1,2264.0,2056.0,0.908,11.196,0,0,0,0,0,0,0,0,0.0,0.0
1004,882,2020-03-18 06:56:00,1,2089.0,1927.0,0.923,10.362,5,5,2,3,0,0,0,0,0.0,0.0
1004,883,2020-03-18 06:59:00,1,2089.0,1922.0,0.92,10.358,4,4,1,3,0,0,0,0,0.0,0.0
1004,884,2020-03-18 07:02:00,1,2285.0,1944.0,0.851,11.157,29,24,15,9,5,0,5,0,0.0,0.0
1004,885,2020-03-18 07:05:00,1,2256.0,2039.0,0.904,11.147,0,0,0,0,0,0,0,0,0.0,0.0
1004,886,2020-03-18 07:08:00,1,2267.0,1981.0,0.874,11.124,0,0,0,0,0,0,0,0,0.0,0.0
1004,887,2020-03-18 07:11:00,1,2279.0,1991.0,0.874,11.183,3,3,0,3,0,0,0,0,0.0,0.0
1004,888,2020-03-18 07:14:00,1,2100.0,1875.0,0.893,10.35,2,2,1,1,0,0,0,0,0.0,0.0
1004,889,2020-03-18 07:17:00,1,2295.0,1911.0,0.833,11.156,152,152,125,27,0,0,0,0,0.0,0.0
1004,890,2020-03-18 07:20:00,1,2196.0,1900.0,0.865,10.755,53,47,12,35,6,4,2,14,0.0,0.0
1004,891,2020-03-18 07:23:00,1,2262.0,2063.0,0.912,11.196,228,95,46,49,133,79,54,38,0.0,0.0
1004,892,2020-03-18 07:26:00,1,2593.0,2305.0,0.889,12.77,93,49,24,25,44,3,41,71,0.0,0.01
1004,893,2020-03-18 07:29:00,1,2655.0,2450.0,0.923,13.172,234,113,71,42,121,64,57,93,0.0,0.04
1004,894,2020-03-18 07:32:00,1,2519.0,2218.0,0.88,12.381,150,97,54,43,53,24,29,33,0.0,0.0
1004,895,2020-03-18 07:35:00,1,2842.0,2497.0,0.879,13.962,153,138,81,57,15,8,7,0,0.0,0.0
1004,896,2020-03-18 07:38:00,1,2815.0,2590.0,0.92,13.958,47,25,13,12,22,3,19,0,0.0,0.0
1004,897,2020-03-18 07:41:00,1,2820.0,2608.0,0.925,13.998,31,20,2,18,11,0,11,0,0.0,0.0
1004,898,2020-03-18 07:44:00,1,2655.0,2403.0,0.905,13.122,8,5,3,2,3,0,3,0,0.0,0.0
1004,899,2020-03-18 07:47:00,1,2509.0,2262.0,0.902,12.388,3,2,0,2,1,0,1,0,0.0,0.0
1004,900,2020-03-18 07:50:00,1,2340.0,2069.0,0.884,11.51,3,1,0,1,2,0,2,0,0.0,0.0
1004,901,2020-03-18 07:53:00,1,2281.0,1997.0,0.876,11.199,12,10,7,3,2,0,2,0,0.0,0.0
1004,902,2020-03-18 07:56:00,1,2285.0,1964.0,0.86,11.176,1,1,0,1,0,0,0,0,0.0,0.0
1004,903,2020-03-18 07:59:00,1,2281.5,1981.5,0.869,11.1815,3,3,1,2,0,0,0,0,0.0,0.0
1004,904,2020-03-18 08:02:00,1,2278.0,1999.0,0.878,11.187,17,13,6,7,4,1,3,0,0.0,0.0
1004,905,2020-03-18 08:05:00,1,2277.0,2009.0,0.882,11.194,0,0,0,0,0,0,0,0,0.0,0.0
1004,906,2020-03-18 08:08:00,1,2289.0,1955.0,0.854,11.182,4,3,0,3,1,0,1,0,0.0,0.01
1004,907,2020-03-18 08:11:00,1,2304.0,1933.0,0.839,11.218,9,9,0,9,0,0,0,0,0.0,0.0
1004,908,2020-03-18 08:14:00,1,2296.0,1891.0,0.824,11.141,25,19,8,11,6,3,3,0,0.0,0.0
1004,909,2020-03-18 08:17:00,1,2211.0,1858.0,0.84,10.768,15,15,0,15,0,0,0,0,0.0,0.0
1004,910,2020-03-18 08:20:00,1,2287.0,2001.0,0.875,11.227,94,28,16,12,66,40,26,8,0.0,0.04
1004,911,2020-03-18 08:23:00,1,2860.0,2423.0,0.847,13.95,192,98,55,43,94,60,34,10,0.0,0.0
1004,912,2020-03-18 08:26:00,1,3110.0,2648.0,0.852,15.186,190,96,54,42,94,47,47,18,0.0,0.0
1004,913,2020-03-18 08:29:00,1,3092.0,2687.0,0.869,15.158,202,97,55,42,105,51,54,62,0.0,0.0
1004,914,2020-03-18 08:32:00,1,3110.0,2675.0,0.86,15.216,294,144,95,49,150,92,58,63,0.0,0.0
1004,915,2020-03-18 08:35:00,1,3018.0,2540.0,0.842,14.702,355,174,122,52,181,128,53,14,0.0,0.0
1004,916,2020-03-18 08:38:00,1,3206.0,2713.0,0.846,15.634,395,152,111,41,243,195,48,18,0.0,0.0
1004,917,2020-03-18 08:41:00,1,3273.0,2762.0,0.844,15.956,34,13,6,7,21,4,17,0,0.0,0.0
1004,918,2020-03-18 08:44:00,1,3180.0,2708.0,0.852,15.527,75,61,31,30,14,7,7,6,0.0,0.0
1004,919,2020-03-18 08:47:00,1,2938.0,2540.0,0.865,14.388,69,65,26,39,4,1,3,0,0.0,0.0
1004,920,2020-03-18 08:50:00,1,2694.0,2304.0,0.855,13.165,22,22,7,15,0,0,0,0,0.0,0.0
1004,921,2020-03-18 08:53:00,1,2546.0,2109.0,0.829,12.366,24,18,7,11,6,1,5,0,0.0,0.0
1004,922,2020-03-18 08:56:00,1,2569.0,2042.0,0.795,12.382,10,6,0,6,4,0,4,0,0.0,0.0
1004,923,2020-03-18 08:59:00,1,2386.0,1954.0,0.819,11.564,6,5,0,5,1,1,0,0,0.0,0.0
1004,924,2020-03-18 09:02:00,1,2309.0,1894.0,0.82,11.193,2,1,0,1,1,0,1,0,0.0,0.0
1004,925,2020-03-18 09:05:00,1,2310.0,1861.0,0.805,11.163,0,0,0,0,0,0,0,0,0.0,0.0
1004,926,2020-03-18 09:08:00,1,2316.0,1808.0,0.781,11.127,37,30,16,14,7,2,5,0,0.0,0.0
1004,927,2020-03-18 09:11:00,1,2322.0,1827.0,0.787,11.173,0,0,0,0,0,0,0,0,0.0,0.0
1004,928,2020-03-18 09:14:00,1,2325.0,1805.0,0.776,11.158,17,9,3,6,8,0,8,0,0.0,0.0
1004,929,2020-03-18 09:17:00,1,2330.0,1778.0,0.763,11.15,0,0,0,0,0,0,0,0,0.0,0.0
1004,930,2020-03-18 09:20:00,1,2155.0,1716.0,0.797,10.39,1,0,0,0,1,0,1,0,0.0,0.0
1004,931,2020-03-18 09:23:00,1,2165.0,1659.0,0.766,10.368,0,0,0,0,0,0,0,0,0.0,0.0
1004,932,2020-03-18 09:26:00,1,2085.0,1587.0,0.761,9.973,23,17,11,6,6,0,6,0,0.0,0.0
1004,933,2020-03-18 09:29:00,1,2091.0,1593.0,0.762,10.004,4,0,0,0,4,0,4,0,0.0,0.0
1004,934,2020-03-18 09:32:00,1,2077.0,1588.0,0.765,9.942,16,0,0,0,16,0,16,0,0.0,0.0
1004,935,2020-03-18 09:35:00,1,2078.0,1589.0,0.765,9.946,17,8,1,7,9,0,9,0,0.0,0.0
1004,936,2020-03-18 09:38:00,1,2178.0,1619.0,0.743,10.373,2,2,1,1,0,0,0,0,0.0,0.0
1004,937,2020-03-18 09:41:00,1,2175.0,1597.0,0.734,10.338,26,26,13,13,0,0,0,0,0.0,0.0
1004,938,2020-03-18 09:44:00,1,2175.0,1629.0,0.749,10.374,2,2,1,1,0,0,0,0,0.0,0.0
1004,939,2020-03-18 09:47:00,1,1997.0,1561.0,0.782,9.595,29,22,5,17,7,2,5,0,0.0,0.0
1004,940,2020-03-18 09:50:00,1,2170.0,1607.0,0.741,10.328,17,9,2,7,8,0,8,0,0.0,0.0
1004,941,2020-03-18 09:53:00,1,2181.0,1643.0,0.753,10.414,0,0,0,0,0,0,0,0,0.0,0.0
1004,942,2020-03-18 09:56:00,1,2176.0,1641.0,0.754,10.391,30,24,2,22,6,0,6,0,0.0,0.0
1004,943,2020-03-18 09:59:00,1,2178.0,1593.0,0.731,10.348,6,4,0,4,2,0,2,0,0.0,0.0
1004,944,2020-03-18 10:02:00,1,2189.0,1619.0,0.74,10.417,16,16,0,16,0,0,0,0,0.0,0.0
1004,945,2020-03-18 10:05:00,1,2164.0,1641.0,0.758,10.344,0,0,0,0,0,0,0,0,0.0,0.0
1004,946,2020-03-18 10:08:00,1,2334.0,1734.0,0.743,11.118,150,93,50,43,57,30,27,4,0.0,0.0
1004,947,2020-03-18 10:11:00,1,2885.0,2354.0,0.816,13.971,301,138,88,50,163,118,45,70,0.0,0.0
1004,948,2020-03-18 10:14:00,1,2895.0,2334.0,0.806,13.989,184,110,64,46,74,31,43,99,0.0,0.0
1004,949,2020-03-18 10:17:00,1,3064.0,2406.0,0.785,14.736,159,101,46,55,58,31,27,64,0.0,0.0
1004,950,2020-03-18 10:20:00,1,2550.0,2077.0,0.814,12.347,289,156,98,58,133,86,47,7,0.0,0.0
1004,951,2020-03-18 10:23:00,1,2871.0,2379.0,0.829,13.947,721,283,221,62,438,341,97,13,0.03,0.0
1004,952,2020-03-18 10:26:00,1,2896.0,2339.0,0.807,14.0,459,156,111,45,303,224,79,8,0.0,0.0
1004,953,2020-03-18 10:29:00,1,2873.0,2424.0,0.844,14.004,648,260,182,78,388,295,93,9,0.0,0.0
1004,954,2020-03-18 10:32:00,1,2879.0,2382.0,0.827,13.98,362,145,90,55,217,158,59,6,0.0,0.0
1004,955,2020-03-18 10:35:00,1,2861.0,2414.0,0.844,13.945,503,234,161,73,269,186,83,0,0.0,0.0
1004,956,2020-03-18 10:38:00,1,2861.0,2401.0,0.839,13.932,653,267,198,69,386,286,100,3,0.0,0.0
1004,957,2020-03-18 10:41:00,1,2883.0,2371.0,0.823,13.983,774,317,260,57,457,349,108,9,0.0,0.0
1004,958,2020-03-18 10:44:00,1,2893.0,2320.0,0.802,13.967,267,141,103,38,126,93,33,4,0.08,0.0
1004,959,2020-03-18 10:47:00,1,2889.0,2276.0,0.788,13.904,56,40,8,32,16,0,16,0,0.0,0.0
1004,960,2020-03-18 10:50:00,1,2906.0,2275.0,0.783,13.97,71,59,20,39,12,0,12,0,0.0,0.0
1004,961,2020-03-18 10:53:00,1,2810.0,2263.0,0.805,13.579,111,86,38,48,25,2,23,0,0.0,0.0
1004,962,2020-03-18 10:56:00,1,2711.0,2233.0,0.823,13.154,24,16,6,10,8,0,8,0,0.0,0.0
1004,963,2020-03-18 10:59:00,1,2508.0,2037.0,0.811,12.137,0,0,0,0,0,0,0,0,0.0,0.0
1004,964,2020-03-18 11:02:00,1,2305.0,1841.0,0.799,11.12,11,8,3,5,3,0,3,0,0.0,0.0
1004,965,2020-03-18 11:05:00,1,2338.0,1793.0,0.767,11.196,5,3,0,3,2,0,2,0,0.0,0.0
1004,966,2020-03-18 11:08:00,1,2345.0,1747.0,0.745,11.174,1,1,0,1,0,0,0,0,0.0,0.0
1004,967,2020-03-18 11:11:00,1,2348.0,1698.0,0.723,11.131,0,0,0,0,0,0,0,0,0.0,0.0
1004,968,2020-03-18 11:14:00,1,2275.0,1667.0,0.733,10.811,19,19,0,19,0,0,0,0,0.0,0.0
1004,969,2020-03-18 11:17:00,1,2177.0,1597.0,0.734,10.347,37,31,10,21,6,0,6,0,0.0,0.0
1004,970,2020-03-18 11:20:00,1,2362.0,1670.0,0.707,11.155,0,0,0,0,0,0,0,0,0.0,0.0
1004,971,2020-03-18 11:23:00,1,2350.0,1681.0,0.715,11.119,4,4,3,1,0,0,0,0,0.0,0.0
1004,972,2020-03-18 11:26:00,1,2367.0,1690.0,0.714,11.198,10,9,3,6,1,0,1,0,0.0,0.0
1004,973,2020-03-18 11:29:00,1,2353.0,1703.0,0.724,11.157,17,17,1,16,0,0,0,0,0.0,0.0
1004,974,2020-03-18 11:32:00,1,2358.0,1720.0,0.73,11.194,22,21,1,20,1,1,0,0,0.0,0.0
1004,975,2020-03-18 11:35:00,1,2352.0,1718.0,0.73,11.171,4,4,0,4,0,0,0,0,0.0,0.0
1004,976,2020-03-18 11:38:00,1,2352.0,1716.0,0.73,11.166,29,16,8,8,13,4,9,0,0.0,0.0
1004,977,2020-03-18 11:41:00,1,2347.0,1743.0,0.743,11.176,24,0,0,0,24,1,23,0,0.0,0.0
1004,978,2020-03-18 11:44:00,1,2350.0,1696.0,0.722,11.136,26,12,6,6,14,3,11,0,0.0,0.0
1004,979,2020-03-18 11:47:00,1,2345.0,1692.0,0.722,11.114,2,0,0,0,2,1,1,0,0.0,0.0
1004,980,2020-03-18 11:50:00,1,2270.0,1658.0,0.73,10.779,1,0,0,0,1,0,1,0,0.0,0.0
1004,981,2020-03-18 11:53:00,1,2256.0,1652.0,0.732,10.717,20,12,6,6,8,1,7,0,0.0,0.0
1004,982,2020-03-18 11:56:00,1,2356.0,1713.0,0.727,11.179,41,27,10,17,14,4,10,0,0.0,0.0
1004,983,2020-03-18 11:59:00,1,2348.0,1731.0,0.737,11.167,34,31,9,22,3,0,3,0,0.0,0.0
1004,984,2020-03-18 12:02:00,1,2338.0,1732.0,0.741,11.13,45,26,12,14,19,5,14,0,0.0,0.0
1004,985,2020-03-18 12:05:00,1,2341.0,1697.0,0.725,11.103,0,0,0,0,0,0,0,0,0.0,0.0
1004,986,2020-03-18 12:08:00,1,2169.0,1631.0,0.752,10.351,12,8,6,2,4,0,4,0,0.0,0.0
1004,987,2020-03-18 12:11:00,1,2177.0,1624.0,0.746,10.376,0,0,0,0,0,0,0,0,0.0,0.0
1004,988,2020-03-18 12:14:00,1,2167.0,1661.0,0.766,10.378,0,0,0,0,0,0,0,0,0.0,0.0
1004,989,2020-03-18 12:17:00,1,2166.0,1636.0,0.756,10.344,9,3,2,1,6,2,4,0,0.0,0.0
1004,990,2020-03-18 12:20:00,1,2270.0,1665.0,0.734,10.787,59,52,10,42,7,0,7,0,0.0,0.0
1004,991,2020-03-18 12:23:00,1,2251.0,1664.0,0.74,10.71,67,67,0,67,0,0,0,0,0.0,0.0
1004,992,2020-03-18 12:26:00,1,2159.0,1654.0,0.766,10.339,79,66,10,56,13,7,6,0,0.0,0.0
1004,993,2020-03-18 12:29:00,1,2361.0,1678.0,0.711,11.159,10,7,1,6,3,1,2,0,0.0,0.0
1004,994,2020-03-18 12:32:00,1,2259.0,1668.0,0.738,10.746,5,4,2,2,1,0,1,0,0.0,0.0
1004,995,2020-03-18 12:35:00,1,2253.0,1683.0,0.747,10.741,76,24,6,18,52,16,36,0,0.0,0.0
1004,996,2020-03-18 12:38:00,1,2426.0,1863.0,0.768,11.622,173,55,20,35,118,67,51,11,0.0,0.0
1004,997,2020-03-18 12:41:00,1,2567.0,2032.0,0.792,12.364,224,126,68,58,98,66,32,40,0.0,0.0
1004,998,2020-03-18 12:44:00,1,2804.0,2239.0,0.799,13.525,156,76,42,34,80,50,30,57,0.0,0.0
1004,999,2020-03-18 12:47:00,1,2895.0,2238.0,0.773,13.883,125,58,25,33,67,24,43,90,0.0,0.0
1004,1000,2020-03-18 12:50:00,1,2888.0,2336.0,0.809,13.964,124,54,13,41,70,9,61,59,0.0,0.0
1004,1001,2020-03-18 12:53:00,1,3070.0,2364.0,0.77,14.714,294,123,78,45,171,102,69,54,0.34,0.06
1004,1002,2020-03-18 12:56:00,1,2892.0,2312.0,0.799,13.953,595,219,166,53,376,302,74,25,0.0,0.0
1004,1003,2020-03-18 12:59:00,1,2399.0,1862.0,0.776,11.513,86,51,10,41,35,4,31,2,0.0,0.0
1004,1004,2020-03-18 13:02:00,1,2718.0,2163.0,0.796,13.103,40,35,4,31,5,1,4,0,0.0,0.0
1004,1005,2020-03-18 13:05:00,1,3111.0,2612.0,0.84,15.151,7,7,2,5,0,0,0,0,0.0,0.0
1004,1006,2020-03-18 13:08:00,1,3032.0,2457.0,0.81,14.667,9,6,1,5,3,1,2,0,0.0,0.0
1004,1007,2020-03-18 13:11:00,1,2890.0,2325.0,0.804,13.959,18,10,4,6,8,2,6,0,0.0,0.0
1004,1008,2020-03-18 13:14:00,1,2725.0,2167.0,0.795,13.137,0,0,0,0,0,0,0,0,0.0,0.0
1004,1009,2020-03-18 13:17:00,1,2549.0,2076.0,0.814,12.343,34,14,9,5,20,7,13,0,0.0,0.0
1004,1010,2020-03-18 13:20:00,1,2274.0,1983.0,0.872,11.154,3,1,0,1,2,0,2,0,0.0,0.0
1004,1011,2020-03-18 13:23:00,1,2286.0,1974.0,0.864,11.19,71,37,15,22,34,14,20,0,0.0,0.0
1004,1012,2020-03-18 13:26:00,1,2547.0,2102.0,0.825,12.362,2,2,1,1,0,0,0,0,0.0,0.0
1004,1013,2020-03-18 13:29:00,1,2559.0,2071.0,0.809,12.375,2,2,0,2,0,0,0,0,0.0,0.0
1004,1014,2020-03-18 13:32:00,1,2277.0,1982.0,0.871,11.164,0,0,0,0,0,0,0,0,0.0,0.0
1004,1015,2020-03-18 13:35:00,1,2305.0,1898.0,0.824,11.183,19,19,9,10,0,0,0,0,0.0,0.0
1004,1016,2020-03-18 13:38:00,1,2304.0,1911.0,0.829,11.193,14,13,4,9,1,0,1,0,0.0,0.0
1004,1017,2020-03-18 13:41:00,1,2304.0,1906.0,0.827,11.186,10,8,3,5,2,1,1,0,0.0,0.0
1004,1018,2020-03-18 13:44:00,1,2294.0,1957.0,0.853,11.204,2,0,0,0,2,0,2,0,0.0,0.03
1004,1019,2020-03-18 13:47:00,1,2301.0,1880.0,0.817,11.146,6,5,1,4,1,0,1,0,0.0,0.0
1004,1020,2020-03-18 13:50:00,1,2307.0,1886.0,0.817,11.178,7,3,2,1,4,1,3,0,0.0,0.0
1004,1021,2020-03-18 13:53:00,1,2281.0,1960.0,0.859,11.156,186,103,62,41,83,47,36,41,0.0,0.0
1004,1022,2020-03-18 13:56:00,1,2710.0,2259.0,0.833,13.179,161,88,35,53,73,19,54,85,0.0,0.0
1004,1023,2020-03-18 13:59:00,1,2506.0,2068.0,0.824,12.1645,158,90,43,47,68,28,40,47,0.0,0.0
1004,1024,2020-03-18 14:02:00,1,2302.0,1877.0,0.815,11.15,163,119,68,51,44,10,34,6,0.0,0.0
1004,1025,2020-03-18 14:05:00,1,2928.0,2545.0,0.869,14.354,70,26,6,20,44,7,37,1,0.0,0.0
1004,1026,2020-03-18 14:08:00,1,3076.0,2697.0,0.877,15.107,70,48,16,32,22,5,17,0,0.0,0.0
1004,1027,2020-03-18 14:11:00,1,3095.0,2714.0,0.877,15.201,166,81,38,43,85,51,34,0,0.0,0.0
1004,1028,2020-03-18 14:14:00,1,3085.0,2698.0,0.875,15.14,254,119,79,40,135,85,50,4,0.0,0.0
1004,1029,2020-03-18 14:17:00,1,3099.0,2661.0,0.858,15.157,396,191,141,50,205,149,56,31,0.0,0.0
1004,1030,2020-03-18 14:20:00,1,3012.0,2609.0,0.866,14.757,82,52,31,21,30,22,8,0,0.0,0.0
1004,1031,2020-03-18 14:23:00,1,2858.0,2490.0,0.871,14.016,233,233,182,51,0,0,0,0,0.0,0.0
1004,1032,2020-03-18 14:26:00,1,2692.0,2277.0,0.846,13.127,72,72,6,66,0,0,0,0,0.0,0.0
1004,1033,2020-03-18 14:29:00,1,2546.0,2104.0,0.827,12.36,45,45,2,43,0,0,0,0,0.0,0.0
1004,1034,2020-03-18 14:32:00,1,2293.0,1941.0,0.846,11.181,158,158,119,39,0,0,0,0,0.0,0.0
1004,1035,2020-03-18 14:35:00,1,2322.0,1844.0,0.794,11.191,41,41,0,41,0,0,0,0,0.0,0.0
1004,1036,2020-03-18 14:38:00,1,2223.0,1799.0,0.809,10.751,27,15,12,3,12,4,8,0,0.0,0.0
1004,1037,2020-03-18 14:41:00,1,2133.0,1768.0,0.829,10.361,9,6,1,5,3,0,3,0,0.0,0.0
1004,1038,2020-03-18 14:44:00,1,2136.0,1747.0,0.818,10.352,29,29,0,29,0,0,0,0,0.0,0.0
1004,1039,2020-03-18 14:47:00,1,2145.0,1742.0,0.812,10.381,8,8,0,8,0,0,0,0,0.0,0.0
1004,1040,2020-03-18 14:50:00,1,2146.0,1738.0,0.81,10.378,1,1,0,1,0,0,0,0,0.0,0.0
1004,1041,2020-03-18 14:53:00,1,2145.0,1696.0,0.791,10.33,30,26,2,24,4,0,4,0,0.0,0.0
1004,1042,2020-03-18 14:56:00,1,2152.0,1691.0,0.786,10.35,7,6,0,6,1,0,1,0,0.0,0.0
1004,1043,2020-03-18 14:59:00,1,2152.0,1678.0,0.78,10.336,57,35,8,27,22,16,6,0,0.0,0.0
1004,1044,2020-03-18 15:02:00,1,2156.0,1678.0,0.779,10.351,36,36,0,36,0,0,0,0,0.0,0.0
1004,1045,2020-03-18 15:05:00,1,2160.0,1647.0,0.763,10.333,30,14,1,13,16,1,15,0,0.0,0.0
1004,1046,2020-03-18 15:08:00,1,2170.0,1645.0,0.758,10.372,33,30,5,25,3,2,1,0,0.0,0.0
1004,1047,2020-03-18 15:11:00,1,2163.0,1638.0,0.757,10.335,16,16,0,16,0,0,0,0,0.0,0.0
1004,1048,2020-03-18 15:14:00,1,2167.0,1638.0,0.756,10.352,4,4,1,3,0,0,0,0,0.0,0.0
1004,1049,2020-03-18 15:17:00,1,2169.0,1637.0,0.755,10.357,3,3,0,3,0,0,0,0,0.0,0.0
1004,1050,2020-03-18 15:20:00,1,2157.0,1661.0,0.77,10.337,37,23,2,21,14,1,13,0,0.0,0.0
1004,1051,2020-03-18 15:23:00,1,2327.0,1814.0,0.78,11.177,161,96,39,57,65,27,38,25,0.0,0.0
1004,1052,2020-03-18 15:26:00,1,2559.0,2016.0,0.788,12.314,89,61,17,44,28,7,21,11,0.0,0.0
1004,1053,2020-03-18 15:29:00,1,2542.0,2116.0,0.832,12.358,184,101,59,42,83,42,41,50,0.0,0.0
1004,1054,2020-03-18 15:32:00,1,2721.0,2241.0,0.823,13.202,207,101,54,47,106,63,43,75,0.0,0.0
1004,1055,2020-03-18 15:35:00,1,2885.0,2335.0,0.81,13.952,134,58,19,39,76,29,47,31,0.0,0.0
1004,1056,2020-03-18 15:38:00,1,2941.0,2467.0,0.839,14.32,96,36,2,34,60,31,29,21,0.0,0.0
1004,1057,2020-03-18 15:41:00,1,2535.0,2120.0,0.836,12.335,515,249,184,65,266,205,61,55,0.08,0.16
1004,1058,2020-03-18 15:44:00,1,2865.0,2396.0,0.837,13.94,591,269,209,60,322,247,75,29,0.0,0.0
1004,1059,2020-03-18 15:47:00,1,3106.0,2620.0,0.843,15.139,690,258,187,71,432,330,102,3,0.0,0.03
1004,1060,2020-03-18 15:50:00,1,2058.0,1682.0,0.817,9.972,84,41,1,40,43,12,31,0,0.0,0.0
1004,1061,2020-03-18 15:53:00,1,1731.0,1399.0,0.808,8.371,4,4,0,4,0,0,0,0,0.0,0.0
1004,1062,2020-03-18 15:56:00,1,2561.0,2048.0,0.8,12.357,27,17,8,9,10,3,7,0,0.0,0.0
1004,1063,2020-03-18 15:59:00,1,3109.0,2674.0,0.86,15.211,0,0,0,0,0,0,0,0,0.0,0.0
1004,1064,2020-03-18 16:02:00,1,3006.0,2606.0,0.867,14.729,17,8,4,4,9,4,5,0,0.0,0.0
1004,1065,2020-03-18 16:05:00,1,2844.0,2500.0,0.879,13.974,2,2,0,2,0,0,0,0,0.0,0.0
1004,1066,2020-03-18 16:08:00,1,2672.0,2385.0,0.893,13.169,11,9,1,8,2,1,1,0,0.0,0.0
1004,1067,2020-03-18 16:11:00,1,2692.0,2296.0,0.853,13.148,20,19,4,15,1,0,1,0,0.0,0.0
1004,1068,2020-03-18 16:14:00,1,2511.0,2245.0,0.894,12.379,18,18,1,17,0,0,0,0,0.0,0.0
1004,1069,2020-03-18 16:17:00,1,2529.0,2197.0,0.869,12.398,14,12,0,12,2,0,2,0,0.0,0.0
1004,1070,2020-03-18 16:20:00,1,2537.0,2128.0,0.839,12.354,14,10,0,10,4,0,4,0,0.0,0.0
1004,1071,2020-03-18 16:23:00,1,2542.0,2152.0,0.847,12.396,0,0,0,0,0,0,0,0,0.0,0.0
1004,1072,2020-03-18 16:26:00,1,2535.0,2137.0,0.843,12.355,11,0,0,0,11,0,11,0,0.0,0.0
1004,1073,2020-03-18 16:29:00,1,2527.0,2153.0,0.852,12.341,5,2,0,2,3,0,3,0,0.0,0.0
1004,1074,2020-03-18 16:32:00,1,2543.0,2123.0,0.835,12.371,0,0,0,0,0,0,0,0,0.0,0.0
1004,1075,2020-03-18 16:35:00,1,2358.0,2038.0,0.864,11.547,2,2,2,0,0,0,0,0,0.0,0.0
1004,1076,2020-03-18 16:38:00,1,2282.0,1970.0,0.863,11.173,46,40,11,29,6,4,2,0,0.0,0.0
1004,1077,2020-03-18 16:41:00,1,2444.0,2063.0,0.844,11.912,11,11,0,11,0,0,0,0,0.0,0.0
1004,1078,2020-03-18 16:44:00,1,2263.0,2013.0,0.89,11.146,4,2,2,0,2,1,1,0,0.0,0.0
1004,1079,2020-03-18 16:47:00,1,2280.0,2007.0,0.88,11.205,1,1,0,1,0,0,0,0,0.0,0.0
1004,1080,2020-03-18 16:50:00,1,2261.0,1994.0,0.882,11.116,4,1,0,1,3,0,3,0,0.0,0.0
1004,1081,2020-03-18 16:53:00,1,2300.0,1895.0,0.824,11.159,93,71,41,30,22,8,14,6,0.0,0.0
1004,1082,2020-03-18 16:56:00,1,2536.0,2126.0,0.838,12.347,107,44,15,29,63,26,37,2,0.0,0.0
1004,1083,2020-03-18 16:59:00,1,2600.5,2280.0,0.8755,12.7715,116,76,22,54,40,16,24,4,0.0,0.0
1004,1084,2020-03-18 17:02:00,1,2665.0,2434.0,0.913,13.196,88,48,10,38,40,12,28,3,0.0,0.0
1004,1085,2020-03-18 17:05:00,1,2661.0,2437.0,0.916,13.182,172,70,38,32,102,56,46,34,0.0,0.0
1004,1086,2020-03-18 17:08:00,1,2998.0,2649.0,0.883,14.746,119,32,4,28,87,44,43,24,0.0,0.07
1004,1087,2020-03-18 17:11:00,1,3259.0,2872.0,0.881,16.019,155,28,11,17,127,84,43,17,0.0,0.09
1004,1088,2020-03-18 17:14:00,1,2516.0,2195.0,0.873,12.341,260,108,59,49,152,99,53,25,0.0,0.02
1004,1089,2020-03-18 17:17:00,1,1784.0,1574.0,0.882,8.772,1,0,0,0,1,0,1,0,0.0,0.0
1004,1090,2020-03-18 17:20:00,1,1889.0,1556.0,0.824,9.166,14,4,2,2,10,0,10,0,0.0,0.0
1004,1091,2020-03-18 17:23:00,1,2528.0,2161.0,0.855,12.352,10,0,0,0,10,0,10,0,0.0,0.0
1004,1092,2020-03-18 17:26:00,1,3059.0,2801.0,0.916,15.154,3,0,0,0,3,1,2,0,0.0,0.0
1004,1093,2020-03-18 17:29:00,1,2981.0,2719.0,0.912,14.757,10,3,0,3,7,0,7,0,0.0,0.0
1004,1094,2020-03-18 17:32:00,1,2805.0,2571.0,0.916,13.898,6,5,0,5,1,0,1,0,0.0,0.0
1004,1095,2020-03-18 17:35:00,1,2634.0,2499.0,0.949,13.145,0,0,0,0,0,0,0,0,0.0,0.0
1004,1096,2020-03-18 17:38:00,1,2652.0,2485.0,0.937,13.2,17,17,1,16,0,0,0,0,0.0,0.0
1004,1097,2020-03-18 17:41:00,1,2671.0,2437.0,0.912,13.221,17,12,1,11,5,0,5,0,0.0,0.0
1004,1098,2020-03-18 17:44:00,1,2480.0,2382.0,0.96,12.409,2,2,0,2,0,0,0,0,0.0,0.0
1004,1099,2020-03-18 17:47:00,1,2476.0,2391.0,0.966,12.401,8,8,1,7,0,0,0,0,0.0,0.0
1004,1100,2020-03-18 17:50:00,1,2572.0,2411.0,0.938,12.802,94,45,22,23,49,19,30,1,0.0,0.0
1004,1101,2020-03-18 17:53:00,1,2628.0,2585.0,0.984,13.215,92,56,8,48,36,0,36,1,0.0,0.0
1004,1102,2020-03-18 17:56:00,1,2636.0,2553.0,0.968,13.212,13,9,2,7,4,0,4,0,0.0,0.01
1004,1103,2020-03-18 17:59:00,1,2661.0,2412.0,0.906,13.154,3,1,0,1,2,0,2,0,0.0,0.0
1004,1104,2020-03-18 18:02:00,0,2487.0,2358.0,0.948,12.408,247,122,83,39,125,81,44,28,0.0,0.0
1004,1105,2020-03-18 18:05:00,0,2798.0,2669.0,0.954,13.978,158,79,35,44,79,36,43,59,0.0,0.0
1004,1106,2020-03-18 18:08:00,0,2782.0,2759.0,0.992,14.017,405,187,137,50,218,153,65,119,0.0,0.03
1004,1107,2020-03-18 18:11:00,0,2268.0,1998.0,0.881,11.149,141,54,24,30,87,41,46,14,0.0,0.01
1004,1108,2020-03-18 18:14:00,0,3164.0,3155.0,0.997,15.957,166,51,9,42,115,50,65,4,0.0,0.0
1004,1109,2020-03-18 18:17:00,0,3424.0,3315.0,0.968,17.158,184,91,44,47,93,41,52,9,0.0,0.0
1004,1110,2020-03-18 18:20:00,0,3422.0,3380.0,0.988,17.224,331,136,90,46,195,134,61,51,0.16,0.0
1004,1111,2020-03-18 18:23:00,0,3439.0,3270.0,0.951,17.17,11,10,0,10,1,0,1,0,0.0,0.01
1004,1112,2020-03-18 18:26:00,0,3168.0,3110.0,0.982,15.923,122,69,39,30,53,16,37,5,0.0,0.0
1004,1113,2020-03-18 18:29:00,0,3369.0,3201.0,0.95,16.819,310,117,62,55,193,129,64,49,0.0,0.0
1004,1114,2020-03-18 18:32:00,0,3463.0,3212.0,0.928,17.2,96,32,5,27,64,26,38,19,0.0,0.0
1004,1115,2020-03-18 18:35:00,0,3686.0,3512.0,0.953,18.411,94,41,7,34,53,25,28,20,0.0,0.14
1004,1116,2020-03-18 18:38:00,0,3834.0,3699.0,0.965,19.2,323,114,85,29,209,160,49,46,0.24,0.06
1004,1117,2020-03-18 18:41:00,0,3061.0,2811.0,0.918,15.172,366,183,140,43,183,129,54,85,0.17,0.02
1004,1118,2020-03-18 18:44:00,0,2639.0,2479.0,0.939,13.143,16,11,3,8,5,0,5,0,0.0,0.0
1004,1119,2020-03-18 18:47:00,0,2477.0,2366.0,0.955,12.38,11,2,1,1,9,4,5,0,0.0,0.0
1004,1120,2020-03-18 18:50:00,0,1945.0,1717.0,0.883,9.562,13,10,4,6,3,0,3,0,0.0,0.0
1004,1121,2020-03-18 18:53:00,0,2035.0,1763.0,0.866,9.97,50,26,12,14,24,12,12,0,0.0,0.0
1004,1122,2020-03-18 18:56:00,0,2515.0,2192.0,0.871,12.337,8,7,1,6,1,0,1,0,0.0,0.0
1004,1123,2020-03-18 18:59:00,0,3049.0,2890.0,0.948,15.214,78,41,19,22,37,17,20,3,0.0,0.0
1004,1124,2020-03-18 19:02:00,0,3753.0,3576.0,0.953,18.744,318,143,80,63,175,98,77,55,0.0,0.0
1004,1125,2020-03-18 19:05:00,0,3770.0,3540.0,0.939,18.771,136,70,41,29,66,0,66,81,0.0,0.04
1004,1126,2020-03-18 19:08:00,0,3771.0,3552.0,0.942,18.791,141,70,39,31,71,13,58,71,0.0,0.11
1004,1127,2020-03-18 19:11:00,0,3762.0,3606.0,0.959,18.814,309,125,82,43,184,119,65,58,0.11,0.09
1004,1128,2020-03-18 19:14:00,0,3660.0,3603.0,0.985,18.408,471,202,160,42,269,208,61,55,0.03,0.04
1004,1129,2020-03-18 19:17:00,0,3256.0,3198.0,0.982,16.369,180,70,35,35,110,66,44,8,0.0,0.0
1004,1130,2020-03-18 19:20:00,0,3048.0,2892.0,0.949,15.211,36,16,8,8,20,0,20,0,0.0,0.0
1004,1131,2020-03-18 19:23:00,0,3068.0,2838.0,0.925,15.229,8,3,0,3,5,0,5,0,0.0,0.0
1004,1132,2020-03-18 19:26:00,0,2489.0,2306.0,0.926,12.36,88,47,17,30,41,16,25,0,0.0,0.0
1004,1133,2020-03-18 19:29:00,0,3744.0,3621.0,0.967,18.76,218,111,71,40,107,48,59,71,0.14,0.0
1004,1134,2020-03-18 19:32:00,0,3812.0,3729.0,0.978,19.146,134,91,49,42,43,0,43,72,0.0,0.1
1004,1135,2020-03-18 19:35:00,0,3899.0,3784.0,0.97,19.55,94,61,37,24,33,0,33,52,0.0,0.15
1004,1136,2020-03-18 19:38:00,0,4003.0,3857.0,0.964,20.041,135,87,46,41,48,13,35,64,0.0,0.06
1004,1137,2020-03-18 19:41:00,0,3724.0,3703.0,0.994,18.772,460,172,132,40,288,210,78,46,0.05,0.05
1004,1138,2020-03-18 19:44:00,0,3888.0,3798.0,0.977,19.522,395,161,119,42,234,179,55,32,0.15,0.0
1004,1139,2020-03-18 19:47:00,0,3171.0,3130.0,0.987,15.957,394,197,149,48,197,141,56,40,0.0,0.0
1004,1140,2020-03-18 19:50:00,0,3140.0,2862.0,0.912,15.542,625,272,220,52,353,268,85,28,0.06,0.0
1004,1141,2020-03-18 19:53:00,0,3996.0,3825.0,0.957,19.977,177,45,27,18,132,84,48,26,0.0,0.51
1004,1142,2020-03-18 19:56:00,0,2494.0,2319.0,0.93,12.392,22,0,0,0,22,0,22,0,0.0,0.0
1004,1143,2020-03-18 19:59:00,0,3274.5,3161.0,0.9585,16.4,191,88,54,34,103,77,26,13,0.23,0.0
1004,1144,2020-03-18 20:02:00,0,4055.0,4003.0,0.987,20.408,402,151,103,48,251,193,58,50,0.02,0.02
1004,1145,2020-03-18 20:05:00,0,4100.0,4151.0,1.012,20.75,507,233,171,62,274,215,59,31,0.0,0.0
1004,1146,2020-03-18 20:08:00,0,4133.0,4076.0,0.986,20.797,529,257,192,65,272,200,72,19,0.03,0.02
1004,1147,2020-03-18 20:11:00,0,3168.0,3151.0,0.995,15.971,651,311,220,91,340,235,105,0,0.0,0.0
1004,1148,2020-03-18 20:14:00,0,4082.0,4142.0,1.015,20.67,446,200,145,55,246,183,63,24,0.0,0.0
1004,1149,2020-03-18 20:17:00,0,3976.0,3918.0,0.985,20.001,325,121,78,43,204,146,58,2,0.0,0.0
1004,1150,2020-03-18 20:20:00,0,3988.0,3813.0,0.956,19.934,67,43,11,32,24,4,20,0,0.0,0.0
1004,1151,2020-03-18 20:23:00,0,3993.0,3838.0,0.961,19.982,17,5,0,5,12,0,12,0,0.0,0.0
1004,1152,2020-03-18 20:26:00,0,3571.0,3552.0,0.995,18.003,30,25,3,22,5,1,4,0,0.0,0.0
1004,1153,2020-03-18 20:29:00,0,3408.0,3354.0,0.984,17.139,4,4,1,3,0,0,0,0,0.0,0.0
1004,1154,2020-03-18 20:32:00,0,3165.0,3156.0,0.997,15.963,14,14,1,13,0,0,0,0,0.0,0.0
1004,1155,2020-03-18 20:35:00,0,3017.0,2931.0,0.971,15.131,49,35,9,26,14,2,12,0,0.0,0.0
1004,1156,2020-03-18 20:38:00,0,2998.0,2957.0,0.986,15.086,33,19,2,17,14,0,14,0,0.0,0.0
1004,1157,2020-03-18 20:41:00,0,3097.0,3042.0,0.982,15.57,333,214,165,49,119,86,33,20,0.12,0.0
1004,1158,2020-03-18 20:44:00,0,3162.0,3165.0,1.001,15.96,403,157,111,46,246,177,69,70,0.0,0.0
1004,1159,2020-03-18 20:47:00,0,3170.0,3190.0,1.006,16.022,533,238,185,53,295,210,85,40,0.0,0.0
1004,1160,2020-03-18 20:50:00,0,3342.0,3305.0,0.989,16.825,682,257,203,54,425,325,100,15,0.0,0.0
1004,1161,2020-03-18 20:53:00,0,3340.0,3304.0,0.989,16.816,366,149,112,37,217,158,59,58,0.0,0.0
1004,1162,2020-03-18 20:56:00,0,2766.0,2829.0,1.023,14.028,468,160,100,60,308,229,79,1,0.0,0.0
1004,1163,2020-03-18 20:59:00,0,3429.0,3308.0,0.965,17.172,676,241,174,67,435,345,90,13,0.04,0.0
1004,1164,2020-03-18 21:02:00,0,3162.0,3171.0,1.003,15.97,86,37,28,9,49,37,12,21,0.0,0.0
1004,1165,2020-03-18 21:05:00,0,3176.0,3161.0,0.995,16.013,230,81,54,27,149,95,54,0,0.0,0.0
1004,1166,2020-03-18 21:08:00,0,3347.0,3267.0,0.976,16.804,130,54,29,25,76,42,34,0,0.0,0.0
1004,1167,2020-03-18 21:11:00,0,3229.0,3242.0,1.004,16.312,47,22,8,14,25,8,17,0,0.0,0.0
1004,1168,2020-03-18 21:14:00,0,3183.0,3065.0,0.963,15.934,1,0,0,0,1,0,1,0,0.0,0.0
1004,1169,2020-03-18 21:17:00,0,2939.0,2875.0,0.978,14.763,0,0,0,0,0,0,0,0,0.0,0.0
1004,1170,2020-03-18 21:20:00,0,2770.0,2780.0,1.003,13.993,0,0,0,0,0,0,0,0,0.0,0.0
1004,1171,2020-03-18 21:23:00,0,2621.0,2575.0,0.983,13.175,16,10,1,9,6,0,6,0,0.0,0.0
1004,1172,2020-03-18 21:26:00,0,2618.0,2590.0,0.989,13.183,32,20,13,7,12,6,6,0,0.0,0.0
1004,1173,2020-03-18 21:29:00,0,2640.0,2506.0,0.949,13.176,19,17,9,8,2,0,2,0,0.0,0.0
1004,1174,2020-03-18 21:32:00,0,2481.0,2425.0,0.977,12.458,43,37,16,21,6,3,3,0,0.0,0.0
1004,1175,2020-03-18 21:35:00,0,2452.0,2421.0,0.988,12.34,10,9,2,7,1,1,0,0,0.0,0.0
1004,1176,2020-03-18 21:38:00,0,2394.0,2315.0,0.967,11.996,90,52,24,28,38,14,24,0,0.0,0.0
1004,1177,2020-03-18 21:41:00,0,2549.0,2490.0,0.977,12.798,223,156,88,68,67,38,29,0,0.0,0.0
1004,1178,2020-03-18 21:44:00,0,2777.0,2762.0,0.994,14.0,244,110,55,55,134,65,69,3,0.0,0.0
1004,1179,2020-03-18 21:47:00,0,2927.0,2916.0,0.996,14.759,117,79,18,61,38,9,29,0,0.0,0.0
1004,1180,2020-03-18 21:50:00,0,3025.0,2930.0,0.969,15.161,336,164,112,52,172,106,66,48,0.0,0.07
1004,1181,2020-03-18 21:53:00,0,2989.0,3049.0,1.02,15.151,490,173,131,42,317,239,78,24,0.0,0.0
1004,1182,2020-03-18 21:56:00,0,3170.0,3190.0,1.006,16.021,51,40,26,14,11,0,11,82,0.0,0.0
1004,1183,2020-03-18 21:59:00,0,3154.0,3242.0,1.028,16.017,195,109,76,33,86,50,36,89,0.15,0.07
1004,1184,2020-03-18 22:02:00,0,3185.0,3096.0,0.972,15.977,510,230,168,62,280,204,76,89,0.0,0.0
1004,1185,2020-03-18 22:05:00,0,3016.0,3033.0,1.006,15.24,155,68,24,44,87,44,43,1,0.0,0.0
1004,1186,2020-03-18 22:08:00,0,3235.0,3274.0,1.012,16.368,11,4,2,2,7,0,7,0,0.0,0.0
1004,1187,2020-03-18 22:11:00,0,3172.0,3196.0,1.008,16.036,34,3,3,0,31,0,31,0,0.0,0.0
1004,1188,2020-03-18 22:14:00,0,3005.0,3028.0,1.008,15.193,20,2,1,1,18,2,16,0,0.0,0.0
1004,1189,2020-03-18 22:17:00,0,2934.0,2864.0,0.976,14.732,1,1,1,0,0,0,0,0,0.0,0.0
1004,1190,2020-03-18 22:20:00,0,2783.0,2756.0,0.99,14.016,4,2,0,2,2,1,1,0,0.0,0.0
1004,1191,2020-03-18 22:23:00,0,2602.0,2627.0,1.01,13.161,8,8,1,7,0,0,0,0,0.0,0.0
1004,1192,2020-03-18 22:26:00,0,2544.0,2469.0,0.971,12.757,6,4,0,4,2,1,1,0,0.0,0.0
1004,1193,2020-03-18 22:29:00,0,2453.0,2444.0,0.996,12.371,53,29,17,12,24,12,12,0,0.0,0.0
1004,1194,2020-03-18 22:32:00,0,2438.0,2461.0,1.01,12.329,131,54,33,21,77,51,26,1,0.0,0.0
1004,1195,2020-03-18 22:35:00,0,2771.0,2821.0,1.018,14.04,116,66,44,22,50,19,31,90,0.0,0.0
1004,1196,2020-03-18 22:38:00,0,2916.0,2912.0,0.998,14.714,123,66,36,30,57,15,42,75,0.0,0.07
1004,1197,2020-03-18 22:41:00,0,3019.0,3013.0,0.998,15.23,191,88,45,43,103,49,54,74,0.16,0.06
1004,1198,2020-03-18 22:44:00,0,2769.0,2848.0,1.029,14.062,348,188,121,67,160,119,41,32,0.0,0.06
1004,1199,2020-03-18 22:47:00,0,3398.0,3461.0,1.018,17.218,302,129,80,49,173,119,54,77,0.08,0.0
1004,1200,2020-03-18 22:50:00,0,2770.0,2850.0,1.029,14.067,647,281,226,55,366,284,82,138,0.0,0.0
1004,1201,2020-03-18 22:53:00,0,2846.0,2867.0,1.008,14.387,563,235,180,55,328,244,84,122,0.0,0.0
1004,1202,2020-03-18 22:56:00,0,3374.0,3403.0,1.009,17.058,320,195,161,34,125,97,28,173,0.0,0.0
1004,1203,2020-03-18 22:59:00,0,3552.0,3577.0,1.007,17.954,286,104,61,43,182,127,55,85,0.0,0.0
1004,1204,2020-03-18 23:02:00,0,3730.0,3751.0,1.005,18.85,201,118,67,51,83,18,65,67,0.0,0.01
1004,1205,2020-03-18 23:05:00,0,3910.0,3810.0,0.974,19.623,200,113,72,41,87,49,38,42,0.17,0.16
1004,1206,2020-03-18 23:08:00,0,2557.0,2426.0,0.949,12.76,181,50,27,23,131,80,51,5,0.0,0.0
1004,1207,2020-03-18 23:11:00,0,2084.0,1968.0,0.945,10.388,41,3,2,1,38,20,18,0,0.0,0.0
1004,1208,2020-03-18 23:14:00,0,2242.0,2109.0,0.941,11.169,11,6,2,4,5,2,3,0,0.0,0.0
1004,1209,2020-03-18 23:17:00,0,2618.0,2589.0,0.989,13.181,0,0,0,0,0,0,0,0,0.0,0.0
1004,1210,2020-03-18 23:20:00,0,2841.0,2864.0,1.008,14.364,22,16,4,12,6,1,5,0,0.0,0.0
1004,1211,2020-03-18 23:23:00,0,3023.0,2935.0,0.971,15.161,236,116,84,32,120,85,35,0,0.0,0.0
1004,1212,2020-03-18 23:26:00,0,3036.0,2882.0,0.949,15.152,789,255,185,70,534,413,121,23,0.0,0.0
1004,1213,2020-03-18 23:29:00,0,3793.0,3823.0,1.008,19.175,207,135,75,60,72,20,52,110,0.0,0.0
1004,1214,2020-03-18 23:32:00,0,3874.0,3830.0,0.989,19.502,277,135,90,45,142,82,60,69,0.23,0.04
1004,1215,2020-03-18 23:35:00,0,3700.0,3764.0,1.017,18.743,505,227,172,55,278,196,82,39,0.0,0.08
1004,1216,2020-03-18 23:38:00,0,3158.0,3222.0,1.02,16.011,522,213,162,51,309,234,75,159,0.0,0.0
1004,1217,2020-03-18 23:41:00,0,4108.0,4126.0,1.004,20.755,267,154,103,51,113,70,43,71,0.0,0.02
1004,1218,2020-03-18 23:44:00,0,3742.0,3632.0,0.971,18.767,256,139,105,34,117,75,42,93,0.0,0.0
1004,1219,2020-03-18 23:47:00,0,3387.0,3422.0,1.01,17.134,668,315,251,64,353,260,93,67,0.0,0.02
1004,1220,2020-03-18 23:50:00,0,2766.0,2783.0,1.006,13.98,1065,612,497,115,453,344,109,3,0.0,0.03
1004,1221,2020-03-18 23:53:00,0,4103.0,4117.0,1.003,20.725,605,211,164,47,394,303,91,24,0.0,0.0
1004,1222,2020-03-18 23:56:00,0,3720.0,3759.0,1.01,18.818,825,320,248,72,505,389,116,8,0.0,0.0
1004,1223,2020-03-18 23:59:00,0,3691.0,3731.0,1.011,18.674,278,140,95,45,138,82,56,64,0.0,0.0
1004,1224,2020-03-19 00:02:00,0,3728.0,3670.0,0.985,18.751,125,35,11,24,90,41,49,1,0.0,0.0
1004,1225,2020-03-19 00:05:00,0,3733.0,3692.0,0.989,18.793,164,93,34,59,71,38,33,0,0.0,0.0
1004,1226,2020-03-19 00:08:00,0,3635.0,3648.0,1.004,18.359,401,180,109,71,221,158,63,0,0.0,0.0
1004,1227,2020-03-19 00:11:00,0,3565.0,3577.0,1.003,18.008,919,376,303,73,543,422,121,3,0.0,0.0
1004,1228,2020-03-19 00:14:00,0,3425.0,3362.0,0.981,17.217,447,195,145,50,252,200,52,9,0.0,0.0
1004,1229,2020-03-19 00:17:00,0,3425.0,3359.0,0.981,17.215,364,158,118,40,206,135,71,65,0.0,0.0
1004,1230,2020-03-19 00:20:00,0,3021.0,2977.0,0.985,15.196,154,60,38,22,94,62,32,17,0.0,0.02
1004,1231,2020-03-19 00:23:00,0,3412.0,3379.0,0.99,17.182,157,78,36,42,79,33,46,2,0.0,0.0
1004,1232,2020-03-19 00:26:00,0,3419.0,3303.0,0.966,17.128,35,5,1,4,30,19,11,0,0.0,0.0
1004,1233,2020-03-19 00:29:00,0,3166.0,3093.0,0.977,15.898,7,6,4,2,1,1,0,0,0.0,0.0
1004,1234,2020-03-19 00:32:00,0,3039.0,2892.0,0.952,15.173,1,1,0,1,0,0,0,0,0.0,0.0
1004,1235,2020-03-19 00:35:00,0,2803.0,2718.0,0.97,14.051,0,0,0,0,0,0,0,0,0.0,0.0
1004,1236,2020-03-19 00:38:00,0,2463.0,2429.0,0.986,12.394,51,24,8,16,27,9,18,1,0.0,0.0
1004,1237,2020-03-19 00:41:00,0,2457.0,2413.0,0.982,12.351,0,0,0,0,0,0,0,0,0.0,0.0
1004,1238,2020-03-19 00:44:00,0,2489.0,2330.0,0.936,12.386,4,4,1,3,0,0,0,0,0.0,0.0
1004,1239,2020-03-19 00:47:00,0,2404.0,2281.0,0.949,11.995,1,1,0,1,0,0,0,0,0.0,0.0
1004,1240,2020-03-19 00:50:00,0,2409.0,2288.0,0.95,12.026,157,64,24,40,93,60,33,23,0.0,0.0
1004,1241,2020-03-19 00:53:00,0,2623.0,2543.0,0.97,13.152,120,55,12,43,65,24,41,6,0.0,0.0
1004,1242,2020-03-19 00:56:00,0,2602.0,2654.0,1.02,13.189,167,88,41,47,79,37,42,6,0.0,0.0
1004,1243,2020-03-19 00:59:00,0,2683.0,2677.0,0.998,13.533,10,2,0,2,8,3,5,0,0.0,0.0
1004,1244,2020-03-19 01:02:00,0,2464.0,2422.0,0.983,12.389,10,3,1,2,7,1,6,0,0.0,0.0
1004,1245,2020-03-19 01:05:00,0,2211.0,2240.0,1.013,11.192,67,29,18,11,38,11,27,0,0.0,0.0
1004,1246,2020-03-19 01:08:00,0,2498.0,2330.0,0.933,12.421,31,0,0,0,31,8,23,0,0.0,0.0
1004,1247,2020-03-19 01:11:00,0,2304.0,2265.0,0.983,11.585,2,0,0,0,2,1,1,0,0.0,0.0
1004,1248,2020-03-19 01:14:00,0,2397.0,2266.0,0.945,11.954,0,0,0,0,0,0,0,0,0.0,0.0
1004,1249,2020-03-19 01:17:00,0,2400.0,2279.0,0.95,11.979,41,23,15,8,18,8,10,0,0.0,0.0
1004,1250,2020-03-19 01:20:00,0,2460.0,2440.0,0.992,12.393,287,23,9,14,264,200,64,4,0.0,0.0
1004,1251,2020-03-19 01:23:00,0,2841.0,2930.0,1.032,14.436,256,114,67,47,142,94,48,60,0.0,0.0
1004,1252,2020-03-19 01:26:00,0,2755.0,2851.0,1.035,14.011,196,110,66,44,86,28,58,95,0.0,0.0
1004,1253,2020-03-19 01:29:00,0,3013.0,3029.0,1.005,15.224,183,89,47,42,94,41,53,70,0.0,0.03
1004,1254,2020-03-19 01:32:00,0,3336.0,3291.0,0.986,16.787,201,109,63,46,92,40,52,71,0.0,0.13
1004,1255,2020-03-19 01:35:00,0,3413.0,3358.0,0.984,17.164,441,173,125,48,268,198,70,113,0.21,0.02
1004,1256,2020-03-19 01:38:00,0,3389.0,3407.0,1.005,17.125,632,262,212,50,370,272,98,29,0.0,0.03
1004,1257,2020-03-19 01:41:00,0,3174.0,3115.0,0.981,15.955,514,258,204,54,256,181,75,137,0.0,0.0
1004,1258,2020-03-19 01:44:00,0,2762.0,2816.0,1.02,14.0,538,217,162,55,321,246,75,58,0.0,0.0
1004,1259,2020-03-19 01:47:00,0,3567.0,3519.0,0.987,17.949,299,141,100,41,158,97,61,27,0.18,0.0
1004,1260,2020-03-19 01:50:00,0,3173.0,3134.0,0.988,15.97,608,244,182,62,364,271,93,2,0.0,0.0
1004,1261,2020-03-19 01:53:00,0,3701.0,3794.0,1.025,18.784,667,293,225,68,374,278,96,11,0.0,0.0
1004,1262,2020-03-19 01:56:00,0,3734.0,3598.0,0.963,18.696,157,93,60,33,64,21,43,85,0.0,0.0
1004,1263,2020-03-19 01:59:00,0,3419.0,3313.5,0.9695,17.1395,149,77,40,37,72,14,58,69,0.0,0.01
1004,1264,2020-03-19 02:02:00,0,3104.0,3029.0,0.976,15.583,517,227,177,50,290,212,78,12,0.13,0.03
1004,1265,2020-03-19 02:05:00,0,3809.0,3768.0,0.989,19.179,164,76,47,29,88,44,44,99,0.0,0.04
1004,1266,2020-03-19 02:08:00,0,2865.0,2831.0,0.988,14.422,163,62,40,22,101,46,55,9,0.0,0.0
1004,1267,2020-03-19 02:11:00,0,2519.0,2237.0,0.888,12.4,157,54,22,32,103,66,37,0,0.0,0.0
1004,1268,2020-03-19 02:14:00,0,2643.0,2482.0,0.939,13.162,4,0,0,0,4,0,4,0,0.0,0.0
1004,1269,2020-03-19 02:17:00,0,2723.0,2553.0,0.938,13.554,2,0,0,0,2,0,2,0,0.0,0.0
1004,1270,2020-03-19 02:20:00,0,3340.0,3253.0,0.974,16.762,7,0,0,0,7,0,7,0,0.0,0.0
1004,1271,2020-03-19 02:23:00,0,3569.0,3552.0,0.995,17.995,1,0,0,0,1,0,1,0,0.0,0.0
1004,1272,2020-03-19 02:26:00,0,3320.0,3278.0,0.987,16.71,18,0,0,0,18,2,16,0,0.0,0.0
1004,1273,2020-03-19 02:29:00,0,3178.0,3148.0,0.991,16.007,8,0,0,0,8,0,8,0,0.0,0.0
1004,1274,2020-03-19 02:32:00,0,3025.0,2964.0,0.98,15.2,20,2,1,1,18,3,15,0,0.0,0.0
1004,1275,2020-03-19 02:35:00,0,2852.0,2858.0,1.002,14.401,19,8,4,4,11,4,7,0,0.0,0.0
1004,1276,2020-03-19 02:38:00,0,2763.0,2771.0,1.003,13.953,19,11,7,4,8,5,3,0,0.0,0.0
1004,1277,2020-03-19 02:41:00,0,2633.0,2577.0,0.979,13.229,6,4,1,3,2,0,2,0,0.0,0.0
1004,1278,2020-03-19 02:44:00,0,2540.0,2498.0,0.983,12.774,34,22,8,14,12,7,5,0,0.0,0.01
1004,1279,2020-03-19 02:47:00,0,2635.0,2572.0,0.976,13.23,11,3,0,3,8,2,6,0,0.0,0.0
1004,1280,2020-03-19 02:50:00,0,2621.0,2525.0,0.963,13.122,122,1,0,1,121,109,12,0,0.0,0.0
1004,1281,2020-03-19 02:53:00,0,2620.0,2607.0,0.995,13.21,123,47,20,27,76,34,42,1,0.0,0.0
1004,1282,2020-03-19 02:56:00,0,2771.0,2810.0,1.014,14.027,218,99,56,43,119,73,46,0,0.0,0.0
1004,1283,2020-03-19 02:59:00,0,3020.0,2934.0,0.972,15.145,269,121,78,43,148,91,57,4,0.0,0.0
1004,1284,2020-03-19 03:02:00,0,2995.0,3047.0,1.017,15.174,155,59,21,38,96,51,45,8,0.0,0.0
1004,1285,2020-03-19 03:05:00,0,3165.0,3150.0,0.995,15.955,371,175,133,42,196,139,57,103,0.0,0.0
1004,1286,2020-03-19 03:08:00,0,3192.0,3082.0,0.966,15.99,165,79,39,40,86,35,51,83,0.0,0.0
1004,1287,2020-03-19 03:11:00,0,3167.0,3213.0,1.014,16.033,144,63,30,33,81,24,57,81,0.0,0.03
1004,1288,2020-03-19 03:14:00,0,3181.0,3178.0,0.999,16.05,162,67,39,28,95,30,65,90,0.0,0.0
1004,1289,2020-03-19 03:17:00,0,3172.0,3142.0,0.991,15.975,144,72,44,28,72,21,51,77,0.0,0.05
1004,1290,2020-03-19 03:20:00,0,3245.0,3285.0,1.013,16.421,313,138,93,45,175,116,59,94,0.22,0.09
1004,1291,2020-03-19 03:23:00,0,3084.0,3069.0,0.995,15.547,196,115,76,39,81,46,35,12,0.09,0.01
1004,1292,2020-03-19 03:26:00,0,3576.0,3546.0,0.992,18.014,287,119,77,42,168,114,54,5,0.0,0.01
1004,1293,2020-03-19 03:29:00,0,2569.0,2405.0,0.936,12.782,838,324,256,68,514,412,102,7,0.0,0.0
1004,1294,2020-03-19 03:32:00,0,3040.0,2931.0,0.964,15.222,355,227,160,67,128,81,47,37,0.0,0.0
1004,1295,2020-03-19 03:35:00,0,2738.0,2540.0,0.928,13.599,632,295,209,86,337,247,90,5,0.0,0.0
1004,1296,2020-03-19 03:38:00,0,3976.0,3927.0,0.987,20.014,588,234,160,74,354,275,79,2,0.0,0.0
1004,1297,2020-03-19 03:41:00,0,3704.0,3752.0,1.013,18.745,96,68,37,31,28,17,11,2,0.0,0.0
1004,1298,2020-03-19 03:44:00,0,3556.0,3607.0,1.014,18.003,3,0,0,0,3,1,2,0,0.0,0.0
1004,1299,2020-03-19 03:47:00,0,3423.0,3343.0,0.976,17.189,21,18,1,17,3,0,3,0,0.0,0.01
1004,1300,2020-03-19 03:50:00,0,3176.0,3131.0,0.986,15.978,0,0,0,0,0,0,0,0,0.0,0.0
1004,1301,2020-03-19 03:53:00,0,3039.0,2891.0,0.951,15.175,4,1,0,1,3,2,1,0,0.0,0.0
1004,1302,2020-03-19 03:56:00,0,2797.0,2694.0,0.963,14.002,12,3,0,3,9,2,7,0,0.0,0.0
1004,1303,2020-03-19 03:59:00,0,2608.0,2605.0,0.999,13.159,1,0,0,0,1,1,0,0,0.0,0.0
1004,1304,2020-03-19 04:02:00,0,2637.0,2527.0,0.958,13.186,15,2,2,0,13,3,10,0,0.0,0.0
1004,1305,2020-03-19 04:05:00,0,2556.0,2472.0,0.967,12.806,51,1,0,1,50,2,48,0,0.0,0.0
1004,1306,2020-03-19 04:08:00,0,2459.0,2405.0,0.978,12.351,297,148,104,44,149,111,38,0,0.0,0.0
1004,1307,2020-03-19 04:11:00,0,2621.0,2607.0,0.994,13.213,269,143,91,52,126,66,60,8,0.0,0.0
1004,1308,2020-03-19 04:14:00,0,2795.0,2675.0,0.957,13.974,113,51,20,31,62,9,53,71,0.0,0.0
1004,1309,2020-03-19 04:17:00,0,2851.0,2850.0,0.999,14.388,140,65,26,39,75,32,43,64,0.0,0.03
1004,1310,2020-03-19 04:20:00,0,3025.0,2984.0,0.986,15.221,202,103,70,33,99,59,40,79,0.0,0.08
1004,1311,2020-03-19 04:23:00,0,2632.0,2599.0,0.987,13.249,189,81,57,24,108,70,38,29,0.0,0.03
1004,1312,2020-03-19 04:26:00,0,2104.0,1899.0,0.902,10.393,31,25,8,17,6,0,6,0,0.0,0.0
1004,1313,2020-03-19 04:29:00,0,2080.0,1982.0,0.953,10.391,0,0,0,0,0,0,0,0,0.0,0.0
1004,1314,2020-03-19 04:32:00,0,3016.0,2908.0,0.964,15.101,40,16,8,8,24,16,8,0,0.0,0.0
1004,1315,2020-03-19 04:35:00,0,3000.0,3020.0,1.006,15.164,0,0,0,0,0,0,0,0,0.0,0.01
1004,1316,2020-03-19 04:38:00,0,2946.0,2905.0,0.986,14.825,6,6,3,3,0,0,0,0,0.0,0.02
1004,1317,2020-03-19 04:41:00,0,2762.0,2811.0,1.018,13.994,23,23,0,23,0,0,0,0,0.0,0.0
1004,1318,2020-03-19 04:44:00,0,2767.0,2724.0,0.985,13.917,65,34,16,18,31,11,20,0,0.0,0.0
1004,1319,2020-03-19 04:47:00,0,2931.0,2886.0,0.984,14.744,120,46,13,33,74,33,41,3,0.0,0.0
1004,1320,2020-03-19 04:50:00,0,3079.0,3090.0,1.004,15.551,208,105,55,50,103,57,46,43,0.0,0.0
1004,1321,2020-03-19 04:53:00,0,3156.0,3259.0,1.033,16.041,85,36,24,12,49,12,37,94,0.0,0.04
1004,1322,2020-03-19 04:56:00,0,3342.0,3294.0,0.986,16.814,270,128,95,33,142,105,37,118,0.12,0.0
1004,1323,2020-03-19 04:59:00,0,3382.0,3333.0,0.9855,17.0155,172,92,73,19,80,36,44,137,0.0,0.0
1004,1324,2020-03-19 05:02:00,0,3422.0,3372.0,0.985,17.217,176,57,29,28,119,59,60,88,0.0,0.01
1004,1325,2020-03-19 05:05:00,0,3185.0,3183.0,0.999,16.071,272,128,81,47,144,81,63,72,0.16,0.05
1004,1326,2020-03-19 05:08:00,0,3576.0,3528.0,0.987,17.993,476,184,124,60,292,213,79,54,0.04,0.02
1004,1327,2020-03-19 05:11:00,0,2624.0,2556.0,0.974,13.166,454,219,166,53,235,173,62,39,0.0,0.0
1004,1328,2020-03-19 05:14:00,0,3193.0,3043.0,0.953,15.949,448,199,149,50,249,180,69,64,0.0,0.0
1004,1329,2020-03-19 05:17:00,0,3152.0,3222.0,1.022,15.986,165,89,65,24,76,38,38,64,0.0,0.02
1004,1330,2020-03-19 05:20:00,0,2227.0,2164.0,0.972,11.17,71,49,11,38,22,0,22,0,0.0,0.01
1004,1331,2020-03-19 05:23:00,0,2268.0,2043.0,0.901,11.198,26,22,9,13,4,0,4,0,0.0,0.24
1004,1332,2020-03-19 05:26:00,0,2072.0,1990.0,0.961,10.368,0,0,0,0,0,0,0,0,0.0,0.01
1004,1333,2020-03-19 05:29:00,0,2104.0,1898.0,0.902,10.39,7,6,4,2,1,0,1,0,0.0,0.0
1004,1334,2020-03-19 05:32:00,0,2430.0,2177.0,0.896,11.986,14,14,0,14,0,0,0,0,0.0,0.0
1004,1335,2020-03-19 05:35:00,0,3536.0,3572.0,1.01,17.884,3,3,0,3,0,0,0,0,0.0,0.0
1004,1336,2020-03-19 05:38:00,0,3413.0,3401.0,0.996,17.211,16,16,0,16,0,0,0,0,0.0,0.0
1004,1337,2020-03-19 05:41:00,0,3175.0,3143.0,0.99,15.991,13,8,6,2,5,4,1,0,0.0,0.0
1004,1338,2020-03-19 05:44:00,0,3017.0,2923.0,0.969,15.124,41,25,7,18,16,5,11,0,0.0,0.0
1004,1339,2020-03-19 05:47:00,0,3032.0,2840.0,0.937,15.092,13,6,2,4,7,1,6,0,0.0,0.0
1004,1340,2020-03-19 05:50:00,0,2800.0,2727.0,0.974,14.05,6,6,2,4,0,0,0,0,0.0,0.0
1004,1341,2020-03-19 05:53:00,0,2697.0,2603.0,0.965,13.51,16,15,4,11,1,0,1,0,0.0,0.0
1004,1342,2020-03-19 05:56:00,0,2618.0,2583.0,0.986,13.175,141,92,41,51,49,13,36,3,0.0,0.0
1004,1343,2020-03-19 05:59:00,0,2770.0,2767.0,0.999,13.975,334,166,105,61,168,105,63,27,0.0,0.0
1004,1344,2020-03-19 06:02:00,1,3202.0,3038.0,0.949,15.981,350,157,101,56,193,140,53,99,0.0,0.0
1004,1345,2020-03-19 06:05:00,1,3191.0,3024.0,0.948,15.92,141,77,49,28,64,12,52,77,0.0,0.0
1004,1346,2020-03-19 06:08:00,1,3215.0,3008.0,0.936,15.996,136,66,41,25,70,22,48,77,0.0,0.0
1004,1347,2020-03-19 06:11:00,1,3193.0,3111.0,0.974,16.026,145,75,34,41,70,22,48,71,0.0,0.0
1004,1348,2020-03-19 06:14:00,1,3597.0,3386.0,0.942,17.92,274,108,64,44,166,99,67,45,0.09,0.0
1004,1349,2020-03-19 06:17:00,1,3176.0,3086.0,0.972,15.931,499,221,168,53,278,206,72,44,0.05,0.0
1004,1350,2020-03-19 06:20:00,1,2711.0,2581.0,0.952,13.54,314,134,93,41,180,133,47,3,0.0,0.0
1004,1351,2020-03-19 06:23:00,1,3212.0,3016.0,0.939,15.995,504,195,137,58,309,229,80,3,0.0,0.0
1004,1352,2020-03-19 06:26:00,1,2785.0,2675.0,0.96,13.935,486,250,175,75,236,149,87,1,0.0,0.0
1004,1353,2020-03-19 06:29:00,1,3267.0,3134.0,0.959,16.341,610,280,207,73,330,247,83,25,0.13,0.0
1004,1354,2020-03-19 06:32:00,1,3736.0,3661.0,0.98,18.773,585,260,181,79,325,231,94,6,0.0,0.0
1004,1355,2020-03-19 06:35:00,1,3650.0,3583.0,0.982,18.347,479,191,146,45,288,217,71,4,0.0,0.0
1004,1356,2020-03-19 06:38:00,1,3505.0,3409.0,0.973,17.585,376,154,118,36,222,161,61,0,0.0,0.0
1004,1357,2020-03-19 06:41:00,1,3428.0,3342.0,0.975,17.206,126,69,24,45,57,24,33,0,0.0,0.0
1004,1358,2020-03-19 06:44:00,1,3462.0,3264.0,0.943,17.253,11,11,0,11,0,0,0,0,0.0,0.0
1004,1359,2020-03-19 06:47:00,1,3213.0,3019.0,0.94,16.003,3,3,0,3,0,0,0,0,0.0,0.0
1004,1360,2020-03-19 06:50:00,1,2859.0,2754.0,0.963,14.312,0,0,0,0,0,0,0,0,0.0,0.0
1004,1361,2020-03-19 06:53:00,1,2635.0,2542.0,0.965,13.197,3,3,2,1,0,0,0,0,0.0,0.0
1004,1362,2020-03-19 06:56:00,1,2561.0,2408.0,0.94,12.756,29,16,8,8,13,8,5,0,0.0,0.0
1004,1363,2020-03-19 06:59:00,1,2492.0,2338.0,0.938,12.407,18,12,5,7,6,1,5,0,0.0,0.0
1004,1364,2020-03-19 07:02:00,1,2506.0,2266.0,0.904,12.384,14,13,0,13,1,0,1,0,0.0,0.0
1004,1365,2020-03-19 07:05:00,1,2312.0,2214.0,0.958,11.56,4,3,0,3,1,0,1,0,0.0,0.0
1004,1366,2020-03-19 07:08:00,1,2315.0,2211.0,0.955,11.568,35,25,11,14,10,3,7,0,0.0,0.0
1004,1367,2020-03-19 07:11:00,1,2321.0,2195.0,0.946,11.575,53,46,7,39,7,2,5,0,0.0,0.0
1004,1368,2020-03-19 07:14:00,1,2225.0,2163.0,0.972,11.162,2,0,0,0,2,0,2,0,0.0,0.0
1004,1369,2020-03-19 07:17:00,1,2251.0,2083.0,0.925,11.174,0,0,0,0,0,0,0,0,0.0,0.0
1004,1370,2020-03-19 07:20:00,1,2243.0,2069.0,0.922,11.127,31,13,6,7,18,3,15,0,0.0,0.0
1004,1371,2020-03-19 07:23:00,1,2254.0,2052.0,0.911,11.154,0,0,0,0,0,0,0,0,0.0,0.0
1004,1372,2020-03-19 07:26:00,1,2168.0,1986.0,0.916,10.742,28,12,5,7,16,9,7,0,0.0,0.0
1004,1373,2020-03-19 07:29:00,1,2270.0,2016.0,0.888,11.174,0,0,0,0,0,0,0,0,0.0,0.0
1004,1374,2020-03-19 07:32:00,1,2260.0,2039.0,0.902,11.159,21,10,7,3,11,4,7,0,0.0,0.0
1004,1375,2020-03-19 07:35:00,1,2254.0,2038.0,0.904,11.138,65,54,17,37,11,4,7,0,0.0,0.0
1004,1376,2020-03-19 07:38:00,1,2265.0,2017.0,0.89,11.159,0,0,0,0,0,0,0,0,0.0,0.0
1004,1377,2020-03-19 07:41:00,1,2272.0,1993.0,0.877,11.159,35,3,0,3,32,4,28,0,0.0,0.0
1004,1378,2020-03-19 07:44:00,1,2269.0,1995.0,0.879,11.15,7,7,1,6,0,0,0,0,0.0,0.0
1004,1379,2020-03-19 07:47:00,1,2264.0,2027.0,0.895,11.165,23,22,0,22,1,0,1,0,0.0,0.0
1004,1380,2020-03-19 07:50:00,1,2251.0,2036.0,0.904,11.125,37,37,0,37,0,0,0,0,0.0,0.0
1004,1381,2020-03-19 07:53:00,1,2253.0,2080.0,0.923,11.179,82,38,11,27,44,20,24,1,0.0,0.0
1004,1382,2020-03-19 07:56:00,1,2682.0,2332.0,0.87,13.148,70,25,8,17,45,14,31,0,0.0,0.0
1004,1383,2020-03-19 07:59:00,1,2747.0,2469.0,0.8985,13.557,36,18,7,11,18,2,16,2,0.0,0.0
1004,1384,2020-03-19 08:02:00,1,2812.0,2606.0,0.927,13.966,360,188,130,58,172,116,56,12,0.0,0.0
1004,1385,2020-03-19 08:05:00,1,2776.0,2675.0,0.964,13.898,211,109,71,38,102,62,40,21,0.0,0.0
1004,1386,2020-03-19 08:08:00,1,3079.0,2740.0,0.89,15.164,17,10,1,9,7,4,3,0,0.0,0.0
1004,1387,2020-03-19 08:11:00,1,2815.0,2576.0,0.915,13.945,18,18,2,16,0,0,0,0,0.0,0.0
1004,1388,2020-03-19 08:14:00,1,2676.0,2392.0,0.894,13.192,7,7,0,7,0,0,0,0,0.0,0.0
1004,1389,2020-03-19 08:17:00,1,2510.0,2216.0,0.883,12.345,18,18,2,16,0,0,0,0,0.0,0.0
1004,1390,2020-03-19 08:20:00,1,2262.0,2083.0,0.921,11.22,29,19,7,12,10,5,5,0,0.0,0.0
1004,1391,2020-03-19 08:23:00,1,2273.0,1980.0,0.871,11.147,12,4,2,2,8,3,5,0,0.0,0.0
1004,1392,2020-03-19 08:26:00,1,2100.0,1920.0,0.914,10.402,16,2,0,2,14,0,14,0,0.0,0.0
1004,1393,2020-03-19 08:29:00,1,2087.0,1940.0,0.929,10.372,487,241,173,68,246,169,77,2,0.0,0.0
1004,1394,2020-03-19 08:32:00,1,2254.0,2109.0,0.936,11.215,459,226,159,67,233,172,61,10,0.0,0.0
1004,1395,2020-03-19 08:35:00,1,2520.0,2207.0,0.876,12.373,511,241,180,61,270,194,76,27,0.0,0.0
1004,1396,2020-03-19 08:38:00,1,2499.0,2307.0,0.923,12.4,98,45,16,29,53,24,29,5,0.0,0.0
1004,1397,2020-03-19 08:41:00,1,2675.0,2375.0,0.888,13.169,83,44,11,33,39,10,29,3,0.0,0.0
1004,1398,2020-03-19 08:44:00,1,2676.0,2393.0,0.894,13.194,10,7,1,6,3,1,2,0,0.0,0.0
1004,1399,2020-03-19 08:47:00,1,2674.0,2386.0,0.893,13.176,26,26,3,23,0,0,0,0,0.0,0.0
1004,1400,2020-03-19 08:50:00,1,2516.0,2200.0,0.874,12.35,11,11,0,11,0,0,0,0,0.0,0.0
1004,1401,2020-03-19 08:53:00,1,2266.0,2055.0,0.907,11.204,29,29,2,27,0,0,0,0,0.0,0.0
1004,1402,2020-03-19 08:56:00,1,2302.0,1951.0,0.848,11.23,0,0,0,0,0,0,0,0,0.0,0.0
1004,1403,2020-03-19 08:59:00,1,2108.0,1863.0,0.884,10.37,0,0,0,0,0,0,0,0,0.0,0.0
1004,1404,2020-03-19 09:02:00,1,2110.0,1856.0,0.879,10.37,1,0,0,0,1,0,1,0,0.0,0.0
1004,1405,2020-03-19 09:05:00,1,2307.0,1882.0,0.816,11.172,0,0,0,0,0,0,0,0,0.0,0.0
1004,1406,2020-03-19 09:08:00,1,2310.0,1860.0,0.805,11.161,0,0,0,0,0,0,0,0,0.0,0.0
1004,1407,2020-03-19 09:11:00,1,2305.0,1914.0,0.83,11.2,4,0,0,0,4,2,2,0,0.0,0.0
1004,1408,2020-03-19 09:14:00,1,2276.0,1963.0,0.862,11.14,0,0,0,0,0,0,0,0,0.0,0.0
1004,1409,2020-03-19 09:17:00,1,2306.0,1930.0,0.837,11.223,8,6,1,5,2,0,2,0,0.0,0.0
1004,1410,2020-03-19 09:20:00,1,2298.0,1935.0,0.842,11.197,15,13,0,13,2,1,1,0,0.0,0.0
1004,1411,2020-03-19 09:23:00,1,2300.0,1919.0,0.834,11.187,14,9,5,4,5,3,2,0,0.0,0.0
1004,1412,2020-03-19 09:26:00,1,2307.0,1930.0,0.837,11.224,8,4,0,4,4,0,4,0,0.0,0.0
1004,1413,2020-03-19 09:29:00,1,2302.0,1889.0,0.821,11.162,5,4,0,4,1,0,1,0,0.0,0.0
1004,1414,2020-03-19 09:32:00,1,2302.0,1878.0,0.816,11.148,2,2,0,2,0,0,0,0,0.0,0.0
1004,1415,2020-03-19 09:35:00,1,2304.0,1902.0,0.826,11.184,20,15,0,15,5,1,4,0,0.0,0.0
1004,1416,2020-03-19 09:38:00,1,2311.0,1872.0,0.81,11.176,9,4,0,4,5,0,5,0,0.0,0.0
1004,1417,2020-03-19 09:41:00,1,2331.0,1826.0,0.783,11.206,15,9,0,9,6,0,6,0,0.0,0.0
1004,1418,2020-03-19 09:44:00,1,2158.0,1737.0,0.805,10.424,26,23,3,20,3,0,3,0,0.0,0.0
1004,1419,2020-03-19 09:47:00,1,2121.0,1793.0,0.846,10.34,98,49,24,25,49,20,29,8,0.0,0.0
1004,1420,2020-03-19 09:50:00,1,2537.0,2179.0,0.859,12.408,54,31,2,29,23,2,21,2,0.0,0.0
1004,1421,2020-03-19 09:53:00,1,2848.0,2493.0,0.875,13.982,199,115,66,49,84,35,49,61,0.0,0.0
1004,1422,2020-03-19 09:56:00,1,2825.0,2521.0,0.892,13.921,161,88,46,42,73,22,51,78,0.0,0.02
1004,1423,2020-03-19 09:59:00,1,2834.0,2581.0,0.911,14.022,341,166,122,44,175,117,58,67,0.12,0.07
1004,1424,2020-03-19 10:02:00,1,2831.0,2524.0,0.892,13.947,489,212,154,58,277,192,85,10,0.0,0.03
1004,1425,2020-03-19 10:05:00,1,2843.0,2546.0,0.895,14.02,843,355,277,78,488,368,120,2,0.0,0.0
1004,1426,2020-03-19 10:08:00,1,3067.0,2740.0,0.893,15.116,549,322,256,66,227,157,70,9,0.08,0.0
1004,1427,2020-03-19 10:11:00,1,3081.0,2765.0,0.897,15.201,692,267,205,62,425,341,84,0,0.0,0.0
1004,1428,2020-03-19 10:14:00,1,3050.0,2787.0,0.914,15.101,162,84,52,32,78,45,33,0,0.0,0.0
1004,1429,2020-03-19 10:17:00,1,2987.0,2708.0,0.907,14.765,3,0,0,0,3,1,2,0,0.0,0.0
1004,1430,2020-03-19 10:20:00,1,2735.0,2515.0,0.919,13.562,10,3,1,2,7,0,7,0,0.0,0.01
1004,1431,2020-03-19 10:23:00,1,2674.0,2414.0,0.903,13.208,1,0,0,0,1,0,1,0,0.0,0.0
1004,1432,2020-03-19 10:26:00,1,2511.0,2282.0,0.909,12.418,14,9,3,6,5,0,5,0,0.0,0.0
1004,1433,2020-03-19 10:29:00,1,2336.0,2176.0,0.932,11.612,1,1,0,1,0,0,0,0,0.0,0.0
1004,1434,2020-03-19 10:32:00,1,2242.0,2112.0,0.942,11.171,7,4,1,3,3,0,3,0,0.0,0.0
1004,1435,2020-03-19 10:35:00,1,2241.0,2121.0,0.946,11.179,20,8,7,1,12,4,8,0,0.0,0.0
1004,1436,2020-03-19 10:38:00,1,2248.0,2145.0,0.954,11.233,0,0,0,0,0,0,0,0,0.0,0.0
1004,1437,2020-03-19 10:41:00,1,2236.0,2168.0,0.97,11.212,5,0,0,0,5,0,5,0,0.0,0.0
1004,1438,2020-03-19 10:44:00,1,2235.0,2111.0,0.945,11.144,4,2,0,2,2,0,2,0,0.0,0.0
1004,1439,2020-03-19 10:47:00,1,2230.0,2164.0,0.97,11.183,21,21,1,20,0,0,0,0,0.0,0.0
1004,1440,2020-03-19 10:50:00,1,2313.0,2202.0,0.952,11.552,20,9,5,4,11,6,5,0,0.0,0.0
1004,1441,2020-03-19 10:53:00,1,2506.0,2232.0,0.891,12.344,2,2,1,1,0,0,0,0,0.0,0.0
1004,1442,2020-03-19 10:56:00,1,2510.0,2263.0,0.902,12.393,88,25,11,14,63,27,36,0,0.0,0.0
1004,1443,2020-03-19 10:59:00,1,2495.0,2305.5,0.9245,12.382,127,54,30,24,73,39,34,0,0.0,0.0
1004,1444,2020-03-19 11:02:00,1,2480.0,2348.0,0.947,12.371,0,0,0,0,0,0,0,0,0.0,0.0
1004,1445,2020-03-19 11:05:00,1,2517.0,2234.0,0.888,12.39,0,0,0,0,0,0,0,0,0.0,0.0
1004,1446,2020-03-19 11:08:00,1,2239.0,2101.0,0.938,11.148,5,3,1,2,2,0,2,0,0.0,0.0
1004,1447,2020-03-19 11:11:00,1,2256.0,2074.0,0.919,11.186,2,2,0,2,0,0,0,0,0.0,0.01
1004,1448,2020-03-19 11:14:00,1,2258.0,2062.0,0.913,11.181,38,28,19,9,10,2,8,0,0.0,0.0
1004,1449,2020-03-19 11:17:00,1,2265.0,2011.0,0.888,11.149,5,2,1,1,3,0,3,0,0.0,0.01
1004,1450,2020-03-19 11:20:00,1,2261.0,2042.0,0.903,11.168,186,82,56,26,104,70,34,10,0.0,0.0
1004,1451,2020-03-19 11:23:00,1,2519.0,2202.0,0.874,12.363,44,29,2,27,15,4,11,0,0.0,0.0
1004,1452,2020-03-19 11:26:00,1,2489.0,2303.0,0.925,12.356,91,63,25,38,28,1,27,6,0.0,0.0
1004,1453,2020-03-19 11:29:00,1,2481.0,2299.0,0.927,12.322,9,1,1,0,8,3,5,0,0.0,0.0
1004,1454,2020-03-19 11:32:00,1,2526.0,2173.0,0.86,12.357,4,0,0,0,4,1,3,0,0.0,0.0
1004,1455,2020-03-19 11:35:00,1,2255.0,2069.0,0.918,11.173,7,0,0,0,7,2,5,0,0.0,0.0
1004,1456,2020-03-19 11:38:00,1,2267.0,2017.0,0.89,11.166,1,0,0,0,1,1,0,0,0.0,0.0
1004,1457,2020-03-19 11:41:00,1,2274.0,1974.0,0.868,11.145,21,2,0,2,19,7,12,0,0.0,0.0
1004,1458,2020-03-19 11:44:00,1,2196.0,1898.0,0.864,10.754,18,1,1,0,17,10,7,0,0.0,0.0
1004,1459,2020-03-19 11:47:00,1,2291.0,1928.0,0.841,11.163,28,2,0,2,26,4,22,0,0.0,0.0
1004,1460,2020-03-19 11:50:00,1,2286.0,1960.0,0.857,11.177,1,0,0,0,1,0,1,0,0.0,0.0
1004,1461,2020-03-19 11:53:00,1,2289.0,1961.0,0.857,11.188,27,11,3,8,16,4,12,0,0.0,0.0
1004,1462,2020-03-19 11:56:00,1,2277.0,1969.0,0.865,11.15,90,0,0,0,90,30,60,0,0.0,0.0
1004,1463,2020-03-19 11:59:00,1,2281.0,1975.0,0.866,11.175,9,0,0,0,9,7,2,0,0.0,0.0
1004,1464,2020-03-19 12:02:00,1,2306.0,1882.0,0.816,11.17,78,14,6,8,64,30,34,0,0.0,0.0
1004,1465,2020-03-19 12:05:00,1,2298.0,1921.0,0.836,11.182,16,7,4,3,9,2,7,0,0.0,0.0
1004,1466,2020-03-19 12:08:00,1,2302.0,1906.0,0.828,11.181,80,53,27,26,27,12,15,0,0.0,0.0
1004,1467,2020-03-19 12:11:00,1,2447.0,2056.0,0.84,11.917,141,75,40,35,66,19,47,2,0.0,0.0
1004,1468,2020-03-19 12:14:00,1,2529.0,2227.0,0.881,12.429,81,51,15,36,30,10,20,1,0.0,0.0
1004,1469,2020-03-19 12:17:00,1,2698.0,2317.0,0.859,13.197,194,112,62,50,82,35,47,56,0.0,0.0
1004,1470,2020-03-19 12:20:00,1,2642.0,2453.0,0.929,13.125,146,55,24,31,91,49,42,66,0.0,0.07
1004,1471,2020-03-19 12:23:00,1,2898.0,2674.0,0.922,14.38,544,206,159,47,338,249,89,90,0.14,0.05
1004,1472,2020-03-19 12:26:00,1,2826.0,2604.0,0.922,14.017,605,242,183,59,363,283,80,39,0.03,0.0
1004,1473,2020-03-19 12:29:00,1,2510.0,2202.0,0.877,12.328,104,54,20,34,50,28,22,0,0.0,0.0
1004,1474,2020-03-19 12:32:00,1,2906.0,2682.0,0.923,14.421,75,33,12,21,42,5,37,0,0.0,0.0
1004,1475,2020-03-19 12:35:00,1,3074.0,2781.0,0.905,15.191,28,14,1,13,14,4,10,0,0.0,0.02
1004,1476,2020-03-19 12:38:00,1,2807.0,2666.0,0.95,14.011,15,15,9,6,0,0,0,0,0.0,0.0
1004,1477,2020-03-19 12:41:00,1,2653.0,2493.0,0.94,13.212,12,12,5,7,0,0,0,0,0.0,0.01
1004,1478,2020-03-19 12:44:00,1,2485.0,2322.0,0.935,12.361,0,0,0,0,0,0,0,0,0.0,0.0
1004,1479,2020-03-19 12:47:00,1,2427.0,2185.0,0.9,11.981,10,10,3,7,0,0,0,0,0.0,0.01
1004,1480,2020-03-19 12:50:00,1,2324.0,2196.0,0.945,11.587,31,19,7,12,12,6,6,0,0.0,0.0
1004,1481,2020-03-19 12:53:00,1,2495.0,2238.0,0.897,12.307,19,18,0,18,1,0,1,0,0.0,0.0
1004,1482,2020-03-19 12:56:00,1,2496.0,2226.0,0.892,12.299,2,2,0,2,0,0,0,0,0.0,0.0
1004,1483,2020-03-19 12:59:00,1,2519.0,2233.0,0.887,12.395,6,5,3,2,1,0,1,0,0.0,0.0
1004,1484,2020-03-19 13:02:00,1,2489.0,2298.0,0.923,12.351,0,0,0,0,0,0,0,0,0.0,0.0
1004,1485,2020-03-19 13:05:00,1,2495.0,2298.0,0.921,12.375,0,0,0,0,0,0,0,0,0.0,0.0
1004,1486,2020-03-19 13:08:00,1,2485.0,2272.0,0.914,12.308,0,0,0,0,0,0,0,0,0.0,0.0
1004,1487,2020-03-19 13:11:00,1,2507.0,2261.0,0.902,12.379,0,0,0,0,0,0,0,0,0.0,0.0
1004,1488,2020-03-19 13:14:00,1,2500.0,2232.0,0.893,12.321,29,15,7,8,14,9,5,0,0.0,0.0
1004,1489,2020-03-19 13:17:00,1,2425.0,2209.0,0.911,11.998,8,6,0,6,2,0,2,0,0.0,0.0
1004,1490,2020-03-19 13:20:00,1,2421.0,2173.0,0.898,11.945,11,9,2,7,2,0,2,0,0.0,0.0
1004,1491,2020-03-19 13:23:00,1,2333.0,2152.0,0.922,11.574,1,1,1,0,0,0,0,0,0.0,0.0
1004,1492,2020-03-19 13:26:00,1,2252.0,2125.0,0.944,11.224,60,34,20,14,26,12,14,0,0.0,0.0
1004,1493,2020-03-19 13:29:00,1,2432.0,2195.0,0.902,12.012,173,73,37,36,100,54,46,2,0.0,0.0
1004,1494,2020-03-19 13:32:00,1,2481.0,2340.0,0.943,12.367,217,158,106,52,59,20,39,0,0.0,0.0
1004,1495,2020-03-19 13:35:00,1,2655.0,2472.0,0.931,13.198,146,71,33,38,75,35,40,2,0.0,0.0
1004,1496,2020-03-19 13:38:00,1,2626.0,2581.0,0.983,13.205,125,60,24,36,65,18,47,0,0.0,0.0
1004,1497,2020-03-19 13:41:00,1,2723.0,2588.0,0.95,13.596,37,27,10,17,10,3,7,0,0.0,0.0
1004,1498,2020-03-19 13:44:00,1,2634.0,2495.0,0.947,13.14,14,12,6,6,2,1,1,0,0.0,0.0
1004,1499,2020-03-19 13:47:00,1,2488.0,2335.0,0.939,12.386,4,4,2,2,0,0,0,0,0.0,0.0
1004,1500,2020-03-19 13:50:00,1,2514.0,2235.0,0.889,12.381,6,4,1,3,2,0,2,0,0.0,0.0
1004,1501,2020-03-19 13:53:00,1,2425.0,2154.0,0.888,11.938,0,0,0,0,0,0,0,0,0.0,0.0
1004,1502,2020-03-19 13:56:00,1,2341.0,2126.0,0.908,11.577,19,9,4,5,10,4,6,0,0.0,0.0
1004,1503,2020-03-19 13:59:00,1,2483.0,2162.0,0.8725,12.1765,2,1,0,1,1,0,1,0,0.0,0.0
1004,1504,2020-03-19 14:02:00,1,2625.0,2198.0,0.837,12.776,4,4,1,3,0,0,0,0,0.0,0.0
1004,1505,2020-03-19 14:05:00,1,2620.0,2189.0,0.836,12.749,114,64,44,20,50,23,27,22,0.0,0.0
1004,1506,2020-03-19 14:08:00,1,2776.0,2362.0,0.851,13.553,129,73,42,31,56,31,25,18,0.0,0.4
1004,1507,2020-03-19 14:11:00,1,2929.0,2566.0,0.876,14.381,0,0,0,0,0,0,0,0,0.0,0.0
1004,1508,2020-03-19 14:14:00,1,2890.0,2695.0,0.932,14.37,159,79,51,28,80,49,31,31,0.0,0.2
1004,1509,2020-03-19 14:17:00,1,3295.0,3078.0,0.934,16.389,411,173,122,51,238,174,64,37,0.0,0.0
1004,1510,2020-03-19 14:20:00,1,3216.0,2965.0,0.922,15.954,375,164,120,44,211,149,62,15,0.05,0.0
1004,1511,2020-03-19 14:23:00,1,3310.0,3041.0,0.919,16.41,26,9,4,5,17,11,6,0,0.0,0.0
1004,1512,2020-03-19 14:26:00,1,3280.0,3121.0,0.951,16.38,390,182,139,43,208,145,63,6,0.26,0.0
1004,1513,2020-03-19 14:29:00,1,3282.0,3060.0,0.932,16.319,412,184,135,49,228,153,75,4,0.0,0.0
1004,1514,2020-03-19 14:32:00,1,3307.0,3059.0,0.925,16.418,108,36,5,31,72,31,41,0,0.0,0.0
1004,1515,2020-03-19 14:35:00,1,3290.0,3062.0,0.93,16.354,79,50,19,31,29,8,21,0,0.0,0.0
1004,1516,2020-03-19 14:38:00,1,3137.0,2891.0,0.922,15.56,23,9,2,7,14,3,11,0,0.0,0.0
1004,1517,2020-03-19 14:41:00,1,2864.0,2769.0,0.967,14.351,18,6,0,6,12,2,10,0,0.0,0.0
1004,1518,2020-03-19 14:44:00,1,2714.0,2656.0,0.979,13.633,1,0,0,0,1,0,1,0,0.0,0.0
1004,1519,2020-03-19 14:47:00,1,2724.0,2572.0,0.944,13.579,24,16,0,16,8,0,8,0,0.0,0.0
1004,1520,2020-03-19 14:50:00,1,2638.0,2492.0,0.945,13.152,32,31,0,31,1,0,1,0,0.0,0.0
1004,1521,2020-03-19 14:53:00,1,2547.0,2485.0,0.976,12.784,5,2,0,2,3,0,3,0,0.0,0.0
1004,1522,2020-03-19 14:56:00,1,2639.0,2512.0,0.952,13.179,12,3,0,3,9,1,8,0,0.0,0.0
1004,1523,2020-03-19 14:59:00,1,2556.0,2504.0,0.98,12.842,16,0,0,0,16,0,16,0,0.0,0.0
1004,1524,2020-03-19 15:02:00,1,2563.0,2416.0,0.942,12.773,4,3,0,3,1,0,1,0,0.0,0.0
1004,1525,2020-03-19 15:05:00,1,2581.0,2390.0,0.926,12.814,41,11,7,4,30,16,14,0,0.0,0.0
1004,1526,2020-03-19 15:08:00,1,2550.0,2425.0,0.951,12.731,10,0,0,0,10,0,10,0,0.0,0.0
1004,1527,2020-03-19 15:11:00,1,2573.0,2413.0,0.938,12.808,0,0,0,0,0,0,0,0,0.0,0.0
1004,1528,2020-03-19 15:14:00,1,2570.0,2405.0,0.936,12.787,0,0,0,0,0,0,0,0,0.0,0.0
1004,1529,2020-03-19 15:17:00,1,2564.0,2458.0,0.958,12.824,4,0,0,0,4,3,1,0,0.0,0.0
1004,1530,2020-03-19 15:20:00,1,2556.0,2464.0,0.964,12.797,0,0,0,0,0,0,0,0,0.0,0.0
1004,1531,2020-03-19 15:23:00,1,2548.0,2461.0,0.966,12.766,89,17,8,9,72,20,52,0,0.0,0.0
1004,1532,2020-03-19 15:26:00,1,2549.0,2461.0,0.965,12.768,76,10,4,6,66,13,53,0,0.0,0.0
1004,1533,2020-03-19 15:29:00,1,2552.0,2473.0,0.969,12.793,38,15,7,8,23,5,18,0,0.0,0.0
1004,1534,2020-03-19 15:32:00,1,2555.0,2469.0,0.966,12.802,29,6,3,3,23,8,15,0,0.0,0.0
1004,1535,2020-03-19 15:35:00,1,2541.0,2469.0,0.971,12.746,85,6,2,4,79,6,73,0,0.0,0.0
1004,1536,2020-03-19 15:38:00,1,2546.0,2490.0,0.978,12.786,105,11,7,4,94,30,64,0,0.0,0.0
1004,1537,2020-03-19 15:41:00,1,2533.0,2530.0,0.999,12.78,30,3,1,2,27,11,16,0,0.0,0.0
1004,1538,2020-03-19 15:44:00,1,2542.0,2507.0,0.986,12.792,8,0,0,0,8,2,6,0,0.0,0.0
1004,1539,2020-03-19 15:47:00,1,2553.0,2450.0,0.96,12.77,81,20,7,13,61,23,38,0,0.0,0.0
1004,1540,2020-03-19 15:50:00,1,2716.0,2599.0,0.957,13.579,128,56,14,42,72,37,35,3,0.0,0.0
1004,1541,2020-03-19 15:53:00,1,2677.0,2694.0,1.007,13.529,95,35,7,28,60,26,34,1,0.0,0.0
1004,1542,2020-03-19 15:56:00,1,2695.0,2695.0,1.0,13.602,1,1,0,1,0,0,0,0,0.0,0.0
1004,1543,2020-03-19 15:59:00,1,2729.0,2534.0,0.929,13.557,0,0,0,0,0,0,0,0,0.0,0.0
1004,1544,2020-03-19 16:02:00,1,2567.0,2445.0,0.953,12.822,49,41,8,33,8,1,7,0,0.0,0.0
1004,1545,2020-03-19 16:05:00,1,2483.0,2350.0,0.947,12.383,13,13,2,11,0,0,0,0,0.0,0.0
1004,1546,2020-03-19 16:08:00,1,2308.0,2291.0,0.993,11.63,2,2,0,2,0,0,0,0,0.0,0.0
1004,1547,2020-03-19 16:11:00,1,2295.0,2283.0,0.995,11.571,18,9,0,9,9,2,7,0,0.0,0.0
1004,1548,2020-03-19 16:14:00,1,2559.0,2380.0,0.93,12.719,16,11,2,9,5,2,3,0,0.0,0.0
1004,1549,2020-03-19 16:17:00,1,2576.0,2386.0,0.926,12.791,13,13,0,13,0,0,0,0,0.0,0.0
1004,1550,2020-03-19 16:20:00,1,2483.0,2367.0,0.953,12.402,17,0,0,0,17,1,16,0,0.0,0.0
1004,1551,2020-03-19 16:23:00,1,2578.0,2367.0,0.918,12.778,183,77,27,50,106,57,49,12,0.0,0.0
1004,1552,2020-03-19 16:26:00,1,2700.0,2683.0,0.993,13.608,102,56,23,33,46,17,29,8,0.0,0.0
1004,1553,2020-03-19 16:29:00,1,2927.0,2943.0,1.005,14.792,178,105,60,45,73,37,36,62,0.0,0.0
1004,1554,2020-03-19 16:32:00,1,2842.0,2871.0,1.01,14.375,189,108,70,38,81,43,38,106,0.0,0.0
1004,1555,2020-03-19 16:35:00,1,2740.0,2550.0,0.931,13.618,293,159,109,50,134,88,46,80,0.0,0.0
1004,1556,2020-03-19 16:38:00,1,2728.0,2530.0,0.927,13.551,147,65,35,30,82,39,43,13,0.0,0.0
1004,1557,2020-03-19 16:41:00,1,2883.0,2677.0,0.929,14.323,55,23,2,21,32,4,28,0,0.0,0.0
1004,1558,2020-03-19 16:44:00,1,3284.0,3110.0,0.947,16.383,59,34,10,24,25,10,15,0,0.0,0.0
1004,1559,2020-03-19 16:47:00,1,3094.0,2989.0,0.966,15.498,12,4,2,2,8,0,8,0,0.0,0.0
1004,1560,2020-03-19 16:50:00,1,2860.0,2783.0,0.973,14.351,6,2,1,1,4,0,4,0,0.0,0.0
1004,1561,2020-03-19 16:53:00,1,2722.0,2588.0,0.951,13.587,5,1,1,0,4,0,4,0,0.0,0.0
1004,1562,2020-03-19 16:56:00,1,2561.0,2426.0,0.947,12.776,5,2,0,2,3,0,3,0,0.0,0.0
1004,1563,2020-03-19 16:59:00,1,2519.5,2380.5,0.9445,12.5625,9,6,1,5,3,1,2,0,0.0,0.0
1004,1564,2020-03-19 17:02:00,1,2478.0,2335.0,0.942,12.349,51,23,5,18,28,3,25,0,0.0,0.0
1004,1565,2020-03-19 17:05:00,1,2654.0,2467.0,0.93,13.188,123,71,33,38,52,15,37,0,0.0,0.0
1004,1566,2020-03-19 17:08:00,1,2478.0,2398.0,0.968,12.42,4,2,2,0,2,1,1,0,0.0,0.0
1004,1567,2020-03-19 17:11:00,1,2506.0,2259.0,0.902,12.374,7,3,0,3,4,0,4,0,0.0,0.0
1004,1568,2020-03-19 17:14:00,1,2233.0,2185.0,0.978,11.218,2,2,0,2,0,0,0,0,0.0,0.0
1004,1569,2020-03-19 17:17:00,1,2239.0,2144.0,0.957,11.195,56,32,12,20,24,9,15,0,0.0,0.0
1004,1570,2020-03-19 17:20:00,1,2515.0,2248.0,0.894,12.397,117,82,47,35,35,8,27,5,0.0,0.0
1004,1571,2020-03-19 17:23:00,1,2664.0,2413.0,0.906,13.168,75,53,20,33,22,3,19,5,0.0,0.0
1004,1572,2020-03-19 17:26:00,1,2622.0,2526.0,0.963,13.125,94,49,21,28,45,12,33,4,0.0,0.0
1004,1573,2020-03-19 17:29:00,1,2809.0,2608.0,0.928,13.955,60,19,10,9,41,29,12,1,0.0,0.0
1004,1574,2020-03-19 17:32:00,1,2648.0,2465.0,0.931,13.163,73,32,20,12,41,24,17,18,0.0,0.0
1004,1575,2020-03-19 17:35:00,1,2675.0,2414.0,0.902,13.214,141,49,29,20,92,45,47,62,0.0,0.0
1004,1576,2020-03-19 17:38:00,1,2829.0,2529.0,0.894,13.948,134,58,33,25,76,27,49,63,0.0,0.0
1004,1577,2020-03-19 17:41:00,1,2644.0,2488.0,0.941,13.172,250,110,69,41,140,79,61,33,0.18,0.01
1004,1578,2020-03-19 17:44:00,1,2124.0,1807.0,0.851,10.37,36,9,2,7,27,6,21,0,0.0,0.0
1004,1579,2020-03-19 17:47:00,1,2293.0,1971.0,0.859,11.218,38,19,3,16,19,7,12,0,0.0,0.0
1004,1580,2020-03-19 17:50:00,1,2748.0,2493.0,0.908,13.586,29,13,1,12,16,5,11,0,0.0,0.0
1004,1581,2020-03-19 17:53:00,1,2800.0,2652.0,0.947,13.967,11,0,0,0,11,0,11,0,0.0,0.01
1004,1582,2020-03-19 17:56:00,1,2790.0,2645.0,0.948,13.92,11,6,0,6,5,1,4,0,0.0,0.02
1004,1583,2020-03-19 17:59:00,1,2816.0,2604.0,0.925,13.979,5,1,0,1,4,2,2,0,0.0,0.0
1004,1584,2020-03-19 18:02:00,0,2887.0,2802.0,0.971,14.474,446,205,152,53,241,190,51,28,0.0,0.0
1004,1585,2020-03-19 18:05:00,0,3163.0,3171.0,1.002,15.973,408,212,152,60,196,146,50,109,0.0,0.0
1004,1586,2020-03-19 18:08:00,0,3257.0,3225.0,0.99,16.403,439,191,131,60,248,188,60,44,0.0,0.0
1004,1587,2020-03-19 18:11:00,0,3160.0,3183.0,1.007,15.973,172,61,19,42,111,59,52,39,0.0,0.0
1004,1588,2020-03-19 18:14:00,0,3172.0,3121.0,0.984,15.954,90,45,15,30,45,22,23,2,0.0,0.0
1004,1589,2020-03-19 18:17:00,0,3185.0,3023.0,0.949,15.897,22,19,0,19,3,0,3,0,0.0,0.0
1004,1590,2020-03-19 18:20:00,0,3070.0,2854.0,0.93,15.255,5,1,0,1,4,2,2,0,0.0,0.0
1004,1591,2020-03-19 18:23:00,0,2794.0,2688.0,0.962,13.982,129,74,41,33,55,31,24,6,0.0,0.0
1004,1592,2020-03-19 18:26:00,0,2972.0,2785.0,0.937,14.793,174,142,86,56,32,12,20,2,0.0,0.0
1004,1593,2020-03-19 18:29:00,0,3058.0,2834.0,0.927,15.186,178,94,46,48,84,49,35,23,0.0,0.0
1004,1594,2020-03-19 18:32:00,0,3203.0,3011.0,0.94,15.955,461,235,198,37,226,155,71,23,0.0,0.0
1004,1595,2020-03-19 18:35:00,0,3228.0,2953.0,0.915,15.987,245,101,70,31,144,95,49,30,0.0,0.0
1004,1596,2020-03-19 18:38:00,0,3192.0,3054.0,0.957,15.957,479,237,187,50,242,186,56,83,0.0,0.0
1004,1597,2020-03-19 18:41:00,0,3225.0,2933.0,0.909,15.956,263,153,94,59,110,79,31,11,0.0,0.0
1004,1598,2020-03-19 18:44:00,0,3212.0,2923.0,0.91,15.89,186,119,64,55,67,36,31,20,0.0,0.0
1004,1599,2020-03-19 18:47:00,0,3234.0,2968.0,0.918,16.029,339,166,110,56,173,124,49,36,0.0,0.0
1004,1600,2020-03-19 18:50:00,0,3239.0,2906.0,0.897,15.978,468,257,191,66,211,161,50,56,0.0,0.0
1004,1601,2020-03-19 18:53:00,0,3219.0,2957.0,0.919,15.957,692,329,244,85,363,264,99,41,0.0,0.0
1004,1602,2020-03-19 18:56:00,0,3232.0,2896.0,0.896,15.942,571,272,195,77,299,217,82,29,0.0,0.0
1004,1603,2020-03-19 18:59:00,0,3268.0,2790.0,0.854,15.965,367,149,106,43,218,158,60,41,0.0,0.0
1004,1604,2020-03-19 19:02:00,0,3099.0,2597.0,0.838,15.084,490,230,164,66,260,216,44,22,0.0,0.0
1004,1605,2020-03-19 19:05:00,0,3442.0,2909.0,0.845,16.782,346,197,133,64,149,111,38,48,0.0,0.07
1004,1606,2020-03-19 19:08:00,0,3273.0,2809.0,0.858,16.006,303,102,62,40,201,175,26,9,0.0,0.0
1004,1607,2020-03-19 19:11:00,0,3277.0,2734.0,0.834,15.939,424,239,171,68,185,135,50,47,0.0,0.0
1004,1608,2020-03-19 19:14:00,0,3266.0,2829.0,0.866,16.003,376,166,108,58,210,143,67,5,0.0,0.0
1004,1609,2020-03-19 19:17:00,0,2723.0,2238.0,0.822,13.208,198,144,93,51,54,36,18,5,0.0,0.0
1004,1610,2020-03-19 19:20:00,0,3263.0,2782.0,0.853,15.937,394,177,121,56,217,149,68,66,0.0,0.0
1004,1611,2020-03-19 19:23:00,0,3252.0,2769.0,0.852,15.879,221,114,67,47,107,53,54,20,0.0,0.0
1004,1612,2020-03-19 19:26:00,0,3270.0,2811.0,0.86,15.998,538,275,183,92,263,189,74,19,0.0,0.0
1004,1613,2020-03-19 19:29:00,0,3261.0,2768.0,0.849,15.913,401,274,198,76,127,81,46,17,0.0,0.0
1004,1614,2020-03-19 19:32:00,0,3090.0,2602.0,0.842,15.057,463,178,133,45,285,222,63,58,0.0,0.0
1004,1615,2020-03-19 19:35:00,0,3117.0,2601.0,0.834,15.162,208,119,73,46,89,58,31,37,0.0,0.0
1004,1616,2020-03-19 19:38:00,0,3304.0,2645.0,0.801,15.945,151,89,44,45,62,40,22,2,0.0,0.0
1004,1617,2020-03-19 19:41:00,0,3139.0,2563.0,0.816,15.206,279,111,69,42,168,112,56,22,0.0,0.0
1004,1618,2020-03-19 19:44:00,0,3113.0,2551.0,0.82,15.09,205,100,58,42,105,70,35,16,0.0,0.0
1004,1619,2020-03-19 19:47:00,0,3184.0,2471.0,0.776,15.281,132,73,34,39,59,25,34,0,0.0,0.0
1004,1620,2020-03-19 19:50:00,0,3328.0,2609.0,0.784,15.999,278,141,88,53,137,85,52,11,0.0,0.0
1004,1621,2020-03-19 19:53:00,0,3302.0,2629.0,0.796,15.922,598,312,223,89,286,209,77,10,0.0,0.0
1004,1622,2020-03-19 19:56:00,0,3293.0,2705.0,0.821,15.97,697,308,227,81,389,290,99,3,0.0,0.0
1004,1623,2020-03-19 19:59:00,0,3373.0,2755.0,0.8165,16.34,476,306,209,97,170,119,51,6,0.0,0.05
1004,1624,2020-03-19 20:02:00,0,3453.0,2805.0,0.812,16.71,379,279,187,92,100,63,37,8,0.0,0.0
1004,1625,2020-03-19 20:05:00,0,3545.0,2843.0,0.802,17.116,372,248,183,65,124,81,43,9,0.0,0.0
1004,1626,2020-03-19 20:08:00,0,2952.0,2426.0,0.822,14.315,344,170,108,62,174,113,61,31,0.0,0.0
1004,1627,2020-03-19 20:11:00,0,3395.0,2748.0,0.81,16.418,366,159,123,36,207,145,62,69,0.24,0.0
1004,1628,2020-03-19 20:14:00,0,3379.0,2750.0,0.814,16.356,201,83,53,30,118,69,49,31,0.0,0.0
1004,1629,2020-03-19 20:17:00,0,3293.0,2722.0,0.826,15.989,329,151,100,51,178,127,51,49,0.0,0.0
1004,1630,2020-03-19 20:20:00,0,3310.0,2667.0,0.806,15.995,435,218,155,63,217,160,57,71,0.0,0.0
1004,1631,2020-03-19 20:23:00,0,3229.0,2517.0,0.779,15.51,190,96,44,52,94,51,43,1,0.0,0.0
1004,1632,2020-03-19 20:26:00,0,3288.0,2662.0,0.81,15.904,326,125,89,36,201,140,61,93,0.0,0.0
1004,1633,2020-03-19 20:29:00,0,3225.0,2534.0,0.786,15.513,389,149,98,51,240,172,68,79,0.0,0.0
1004,1634,2020-03-19 20:32:00,0,3140.0,2449.0,0.78,15.083,306,108,57,51,198,133,65,98,0.0,0.0
1004,1635,2020-03-19 20:35:00,0,3157.0,2494.0,0.79,15.198,262,108,63,45,154,94,60,148,0.0,0.0
1004,1636,2020-03-19 20:38:00,0,3313.0,2577.0,0.778,15.905,271,117,70,47,154,101,53,30,0.0,0.0
1004,1637,2020-03-19 20:41:00,0,3293.0,2664.0,0.809,15.925,355,132,90,42,223,160,63,108,0.0,0.0
1004,1638,2020-03-19 20:44:00,0,3478.0,2786.0,0.801,16.788,307,83,61,22,224,159,65,147,0.0,0.0
1004,1639,2020-03-19 20:47:00,0,3311.0,2617.0,0.79,15.944,251,119,91,28,132,97,35,90,0.0,0.0
1004,1640,2020-03-19 20:50:00,0,3559.0,2783.0,0.782,17.105,369,278,191,87,91,60,31,10,0.0,0.0
1004,1641,2020-03-19 20:53:00,0,3489.0,2740.0,0.785,16.781,370,210,150,60,160,120,40,30,0.0,0.0
1004,1642,2020-03-19 20:56:00,0,3566.0,2846.0,0.798,17.202,267,83,50,33,184,137,47,102,0.0,0.0
1004,1643,2020-03-19 20:59:00,0,3337.0,2565.0,0.769,15.986,384,182,131,51,202,146,56,56,0.0,0.0
1004,1644,2020-03-19 21:02:00,0,3250.0,2515.0,0.774,15.589,296,141,84,57,155,90,65,6,0.0,0.0
1004,1645,2020-03-19 21:05:00,0,3175.0,2442.0,0.769,15.215,171,64,40,24,107,70,37,102,0.0,0.0
1004,1646,2020-03-19 21:08:00,0,3165.0,2423.0,0.766,15.152,362,179,121,58,183,125,58,54,0.0,0.0
1004,1647,2020-03-19 21:11:00,0,3329.0,2527.0,0.759,15.915,190,54,35,19,136,104,32,118,0.0,0.0
1004,1648,2020-03-19 21:14:00,0,3156.0,2403.0,0.761,15.095,128,64,52,12,64,33,31,157,0.0,0.0
1004,1649,2020-03-19 21:17:00,0,3163.0,2439.0,0.771,15.164,205,123,63,60,82,46,36,6,0.0,0.0
1004,1650,2020-03-19 21:20:00,0,3248.0,2495.0,0.768,15.558,323,149,111,38,174,119,55,98,0.0,0.0
1004,1651,2020-03-19 21:23:00,0,3311.0,2664.0,0.804,15.996,385,159,105,54,226,169,57,131,0.0,0.0
1004,1652,2020-03-19 21:26:00,0,3385.0,2661.0,0.786,16.282,519,245,176,69,274,204,70,10,0.01,0.0
1004,1653,2020-03-19 21:29:00,0,3245.0,2531.0,0.78,15.588,246,96,61,35,150,98,52,25,0.0,0.0
1004,1654,2020-03-19 21:32:00,0,3336.0,2500.0,0.749,15.913,102,52,23,29,50,24,26,0,0.0,0.0
1004,1655,2020-03-19 21:35:00,0,3469.0,2692.0,0.776,16.649,235,96,63,33,139,95,44,112,0.0,0.0
1004,1656,2020-03-19 21:38:00,0,3331.0,2561.0,0.769,15.958,260,99,68,31,161,117,44,95,0.15,0.0
1004,1657,2020-03-19 21:41:00,0,3319.0,2614.0,0.787,15.972,244,112,59,53,132,79,53,13,0.0,0.0
1004,1658,2020-03-19 21:44:00,0,3316.0,2554.0,0.77,15.892,303,186,128,58,117,71,46,2,0.0,0.03
1004,1659,2020-03-19 21:47:00,0,3243.0,2472.0,0.762,15.514,323,184,124,60,139,98,41,8,0.0,0.0
1004,1660,2020-03-19 21:50:00,0,3077.0,2320.0,0.754,14.69,459,177,131,46,282,218,64,124,0.0,0.0
1004,1661,2020-03-19 21:53:00,0,3392.0,2638.0,0.778,16.285,459,183,123,60,276,206,70,87,0.0,0.0
1004,1662,2020-03-19 21:56:00,0,2881.0,2288.0,0.794,13.886,119,75,42,33,44,22,22,78,0.0,0.0
1004,1663,2020-03-19 21:59:00,0,3342.0,2547.0,0.762,15.989,378,181,144,37,197,151,46,153,0.0,0.0
1004,1664,2020-03-19 22:02:00,0,3324.0,2619.0,0.788,15.995,344,117,82,35,227,170,57,146,0.0,0.0
1004,1665,2020-03-19 22:05:00,0,3351.0,2544.0,0.759,16.02,172,116,74,42,56,40,16,28,0.0,0.0
1004,1666,2020-03-19 22:08:00,0,3321.0,2547.0,0.767,15.904,348,211,142,69,137,90,47,0,0.0,0.0
1004,1667,2020-03-19 22:11:00,0,3341.0,2581.0,0.773,16.021,376,196,136,60,180,119,61,0,0.0,0.0
1004,1668,2020-03-19 22:14:00,0,3170.0,2412.0,0.761,15.159,208,147,91,56,61,34,27,0,0.0,0.0
1004,1669,2020-03-19 22:17:00,0,3343.0,2530.0,0.757,15.971,95,51,33,18,44,21,23,2,0.15,0.0
1004,1670,2020-03-19 22:20:00,0,3179.0,2401.0,0.755,15.186,77,25,13,12,52,26,26,0,0.02,0.0
1004,1671,2020-03-19 22:23:00,0,3191.0,2355.0,0.738,15.179,176,109,51,58,67,36,31,0,0.0,0.0
1004,1672,2020-03-19 22:26:00,0,3067.0,2339.0,0.763,14.672,267,149,103,46,118,85,33,45,0.0,0.0
1004,1673,2020-03-19 22:29:00,0,2908.0,2292.0,0.788,13.996,235,112,58,54,123,62,61,1,0.0,0.0
1004,1674,2020-03-19 22:32:00,0,3170.0,2384.0,0.752,15.13,294,215,151,64,79,49,30,25,0.0,0.0
1004,1675,2020-03-19 22:35:00,0,3259.0,2470.0,0.758,15.576,225,148,100,48,77,49,28,6,0.0,0.0
1004,1676,2020-03-19 22:38:00,0,2906.0,2297.0,0.79,13.992,395,120,93,27,275,218,57,182,0.06,0.0
1004,1677,2020-03-19 22:41:00,0,2906.0,2249.0,0.774,13.941,278,119,74,45,159,97,62,41,0.0,0.0
1004,1678,2020-03-19 22:44:00,0,2900.0,2303.0,0.794,13.974,247,68,38,30,179,128,51,72,0.0,0.0
1004,1679,2020-03-19 22:47:00,0,2901.0,2262.0,0.78,13.933,155,118,63,55,37,22,15,36,0.0,0.0
1004,1680,2020-03-19 22:50:00,0,2918.0,2197.0,0.753,13.93,275,118,76,42,157,116,41,30,0.0,0.0
1004,1681,2020-03-19 22:53:00,0,3007.0,2314.0,0.77,14.408,400,192,132,60,208,154,54,35,0.0,0.0
1004,1682,2020-03-19 22:56:00,0,3001.0,2332.0,0.777,14.408,320,188,128,60,132,91,41,0,0.0,0.0
1004,1683,2020-03-19 22:59:00,0,3018.0,2261.5,0.7495,14.3955,131,60,26,34,71,19,52,6,0.0,0.0
1004,1684,2020-03-19 23:02:00,0,3035.0,2191.0,0.722,14.383,302,137,98,39,165,116,49,92,0.0,0.0
1004,1685,2020-03-19 23:05:00,0,3027.0,2231.0,0.737,14.394,187,57,39,18,130,91,39,102,0.12,0.0
1004,1686,2020-03-19 23:08:00,0,2936.0,2162.0,0.736,13.963,209,99,64,35,110,63,47,14,0.0,0.0
1004,1687,2020-03-19 23:11:00,0,2843.0,2167.0,0.762,13.602,31,24,6,18,7,1,6,1,0.0,0.0
1004,1688,2020-03-19 23:14:00,0,2851.0,2086.0,0.732,13.542,0,0,0,0,0,0,0,0,0.0,0.0
1004,1689,2020-03-19 23:17:00,0,2761.0,2003.0,0.726,13.095,3,0,0,0,3,0,3,0,0.0,0.0
1004,1690,2020-03-19 23:20:00,0,2704.0,1893.0,0.7,12.748,4,3,1,2,1,0,1,0,0.0,0.0
1004,1691,2020-03-19 23:23:00,0,2428.0,1784.0,0.734,11.543,0,0,0,0,0,0,0,0,0.0,0.0
1004,1692,2020-03-19 23:26:00,0,2353.0,1687.0,0.717,11.14,2,0,0,0,2,1,1,0,0.0,0.0
1004,1693,2020-03-19 23:29:00,0,2271.0,1612.0,0.71,10.734,55,15,1,14,40,7,33,7,0.0,0.0
1004,1694,2020-03-19 23:32:00,0,2439.0,1784.0,0.731,11.586,106,42,15,27,64,21,43,5,0.0,0.0
1004,1695,2020-03-19 23:35:00,0,2599.0,1921.0,0.739,12.368,362,197,137,60,165,112,53,21,0.0,0.0
1004,1696,2020-03-19 23:38:00,0,2693.0,1988.0,0.738,12.811,453,233,197,36,220,162,58,224,0.0,0.0
1004,1697,2020-03-19 23:41:00,0,2995.0,2295.0,0.766,14.339,416,195,166,29,221,159,62,188,0.0,0.0
1004,1698,2020-03-19 23:44:00,0,3346.0,2536.0,0.758,15.992,407,175,144,31,232,169,63,179,0.0,0.0
1004,1699,2020-03-19 23:47:00,0,3391.0,2630.0,0.776,16.272,405,151,125,26,254,191,63,125,0.0,0.0
1004,1700,2020-03-19 23:50:00,0,3441.0,2533.0,0.736,16.365,301,140,97,43,161,118,43,70,0.0,0.0
1004,1701,2020-03-19 23:53:00,0,3422.0,2636.0,0.77,16.402,185,66,34,32,119,77,42,4,0.0,0.0
1004,1702,2020-03-19 23:56:00,0,3507.0,2659.0,0.758,16.761,405,165,137,28,240,183,57,120,0.0,0.0
1004,1703,2020-03-19 23:59:00,0,3419.0,2622.0,0.767,16.373,384,151,119,32,233,167,66,128,0.0,0.0
1004,1704,2020-03-20 00:02:00,0,3418.0,2612.0,0.764,16.359,394,154,122,32,240,185,55,159,0.0,0.0
1004,1705,2020-03-20 00:05:00,0,3281.0,2369.0,0.722,15.55,141,63,43,20,78,48,30,35,0.0,0.0
1004,1706,2020-03-20 00:08:00,0,3706.0,2711.0,0.732,17.603,179,80,62,18,99,70,29,122,0.08,0.0
1004,1707,2020-03-20 00:11:00,0,3590.0,2648.0,0.738,17.076,174,89,60,29,85,55,30,68,0.0,0.0
1004,1708,2020-03-20 00:14:00,0,3416.0,2587.0,0.757,16.322,94,44,19,25,50,23,27,0,0.0,0.0
1004,1709,2020-03-20 00:17:00,0,3510.0,2640.0,0.752,16.755,230,101,76,25,129,91,38,58,0.06,0.0
1004,1710,2020-03-20 00:20:00,0,3429.0,2552.0,0.744,16.336,233,110,80,30,123,87,36,177,0.0,0.0
1004,1711,2020-03-20 00:23:00,0,3439.0,2478.0,0.721,16.294,184,71,47,24,113,76,37,45,0.0,0.0
1004,1712,2020-03-20 00:26:00,0,3262.0,2437.0,0.747,15.552,223,102,72,30,121,72,49,37,0.0,0.0
1004,1713,2020-03-20 00:29:00,0,3257.0,2450.0,0.752,15.547,325,138,104,34,187,133,54,92,0.0,0.0
1004,1714,2020-03-20 00:32:00,0,3445.0,2500.0,0.726,16.343,335,164,127,37,171,125,46,138,0.0,0.0
1004,1715,2020-03-20 00:35:00,0,3268.0,2393.0,0.732,15.527,180,99,54,45,81,53,28,0,0.0,0.0
1004,1716,2020-03-20 00:38:00,0,3284.0,2359.0,0.718,15.551,236,140,90,50,96,59,37,21,0.21,0.0
1004,1717,2020-03-20 00:41:00,0,3008.0,2261.0,0.752,14.354,117,51,21,30,66,25,41,6,0.0,0.0
1004,1718,2020-03-20 00:44:00,0,3183.0,2327.0,0.731,15.118,29,20,6,14,9,0,9,0,0.0,0.0
1004,1719,2020-03-20 00:47:00,0,2934.0,2153.0,0.734,13.946,5,1,0,1,4,1,3,0,0.0,0.0
1004,1720,2020-03-20 00:50:00,0,2770.0,1980.0,0.715,13.107,5,0,0,0,5,0,5,0,0.0,0.0
1004,1721,2020-03-20 00:53:00,0,2622.0,1844.0,0.703,12.372,32,1,0,1,31,0,31,0,0.0,0.0
1004,1722,2020-03-20 00:56:00,0,2446.0,1716.0,0.702,11.538,4,1,0,1,3,0,3,0,0.0,0.0
1004,1723,2020-03-20 00:59:00,0,2269.0,1620.0,0.714,10.733,11,0,0,0,11,0,11,0,0.0,0.0
1004,1724,2020-03-20 01:02:00,0,2090.0,1534.0,0.734,9.933,2,1,0,1,1,0,1,0,0.0,0.0
1004,1725,2020-03-20 01:05:00,0,2117.0,1460.0,0.69,9.957,2,0,0,0,2,0,2,0,0.0,0.0
1004,1726,2020-03-20 01:08:00,0,1931.0,1394.0,0.722,9.15,100,36,27,9,64,46,18,10,0.0,0.0
1004,1727,2020-03-20 01:11:00,0,2082.0,1571.0,0.755,9.94,351,141,101,40,210,134,76,34,0.0,0.0
1004,1728,2020-03-20 01:14:00,0,2263.0,1646.0,0.727,10.739,353,159,130,29,194,143,51,186,0.0,0.0
1004,1729,2020-03-20 01:17:00,0,2429.0,1779.0,0.732,11.541,303,124,92,32,179,123,56,66,0.0,0.0
1004,1730,2020-03-20 01:20:00,0,2681.0,1969.0,0.734,12.743,342,139,99,40,203,136,67,91,0.0,0.0
1004,1731,2020-03-20 01:23:00,0,2860.0,2079.0,0.727,13.569,356,155,109,46,201,144,57,68,0.0,0.0
1004,1732,2020-03-20 01:26:00,0,2936.0,2169.0,0.739,13.969,208,96,58,38,112,69,43,9,0.0,0.0
1004,1733,2020-03-20 01:29:00,0,3010.0,2238.0,0.744,14.339,386,147,97,50,239,180,59,42,0.09,0.0
1004,1734,2020-03-20 01:32:00,0,3260.0,2403.0,0.737,15.507,141,72,56,16,69,46,23,72,0.0,0.0
1004,1735,2020-03-20 01:35:00,0,2999.0,2297.0,0.766,14.361,276,109,77,32,167,118,49,63,0.03,0.0
1004,1736,2020-03-20 01:38:00,0,3429.0,2531.0,0.738,16.312,356,128,104,24,228,168,60,110,0.0,0.0
1004,1737,2020-03-20 01:41:00,0,3683.0,2705.0,0.734,17.508,162,23,5,18,139,78,61,37,0.15,0.0
1004,1738,2020-03-20 01:44:00,0,3098.0,2322.0,0.75,14.779,312,151,99,52,161,109,52,8,0.0,0.0
1004,1739,2020-03-20 01:47:00,0,3348.0,2473.0,0.738,15.931,571,197,147,50,374,273,101,28,0.0,0.0
1004,1740,2020-03-20 01:50:00,0,3273.0,2398.0,0.733,15.553,233,111,76,35,122,87,35,41,0.0,0.0
1004,1741,2020-03-20 01:53:00,0,3090.0,2315.0,0.749,14.739,265,117,89,28,148,101,47,43,0.0,0.0
1004,1742,2020-03-20 01:56:00,0,3270.0,2423.0,0.741,15.567,260,133,108,25,127,90,37,175,0.0,0.0
1004,1743,2020-03-20 01:59:00,0,3276.0,2401.5,0.733,15.5675,254,129,96,33,125,81,44,95,0.0,0.0
1004,1744,2020-03-20 02:02:00,0,3282.0,2380.0,0.725,15.568,398,182,144,38,216,163,53,139,0.0,0.0
1004,1745,2020-03-20 02:05:00,0,3283.0,2374.0,0.723,15.563,94,58,30,28,36,17,19,11,0.0,0.0
1004,1746,2020-03-20 02:08:00,0,3007.0,2267.0,0.754,14.359,170,68,45,23,102,68,34,1,0.05,0.0
1004,1747,2020-03-20 02:11:00,0,3013.0,2239.0,0.743,14.35,73,38,14,24,35,14,21,0,0.0,0.0
1004,1748,2020-03-20 02:14:00,0,3004.0,2258.0,0.752,14.338,157,75,38,37,82,50,32,0,0.0,0.0
1004,1749,2020-03-20 02:17:00,0,2847.0,2138.0,0.751,13.587,293,113,69,44,180,119,61,1,0.0,0.0
1004,1750,2020-03-20 02:20:00,0,2856.0,2098.0,0.735,13.576,263,75,40,35,188,131,57,27,0.0,0.0
1004,1751,2020-03-20 02:23:00,0,2772.0,1998.0,0.721,13.133,167,84,44,40,83,42,41,10,0.0,0.0
1004,1752,2020-03-20 02:26:00,0,2860.0,2073.0,0.725,13.566,63,34,10,24,29,5,24,1,0.0,0.0
1004,1753,2020-03-20 02:29:00,0,2700.0,1919.0,0.711,12.765,12,3,0,3,9,3,6,0,0.0,0.0
1004,1754,2020-03-20 02:32:00,0,2442.0,1757.0,0.72,11.566,20,0,0,0,20,0,20,0,0.0,0.0
1004,1755,2020-03-20 02:35:00,0,2266.0,1654.0,0.73,10.759,50,1,0,1,49,39,10,0,0.0,0.0
1004,1756,2020-03-20 02:38:00,0,2198.0,1544.0,0.702,10.37,0,0,0,0,0,0,0,0,0.0,0.0
1004,1757,2020-03-20 02:41:00,0,2123.0,1443.0,0.68,9.963,0,0,0,0,0,0,0,0,0.0,0.0
1004,1758,2020-03-20 02:44:00,0,1833.0,1363.0,0.744,8.73,0,0,0,0,0,0,0,0,0.0,0.0
1004,1759,2020-03-20 02:47:00,0,1852.0,1321.0,0.713,8.761,135,65,43,22,70,41,29,14,0.0,0.0
1004,1760,2020-03-20 02:50:00,0,2111.0,1493.0,0.707,9.969,165,78,56,22,87,59,28,19,0.0,0.0
1004,1761,2020-03-20 02:53:00,0,2090.0,1531.0,0.733,9.932,136,59,18,41,77,31,46,1,0.0,0.0
1004,1762,2020-03-20 02:56:00,0,2264.0,1645.0,0.726,10.74,404,162,129,33,242,182,60,75,0.0,0.0
1004,1763,2020-03-20 02:59:00,0,2238.0,1709.0,0.763,10.711,272,178,116,62,94,52,42,2,0.0,0.0
1004,1764,2020-03-20 03:02:00,0,2448.0,1730.0,0.706,11.562,92,45,18,27,47,31,16,0,0.0,0.0
1004,1765,2020-03-20 03:05:00,0,2264.0,1651.0,0.729,10.748,1,0,0,0,1,0,1,0,0.0,0.0
1004,1766,2020-03-20 03:08:00,0,2085.0,1547.0,0.742,9.928,0,0,0,0,0,0,0,0,0.0,0.0
1004,1767,2020-03-20 03:11:00,0,2109.0,1454.0,0.689,9.92,0,0,0,0,0,0,0,0,0.0,0.0
1004,1768,2020-03-20 03:14:00,0,1840.0,1379.0,0.75,8.777,0,0,0,0,0,0,0,0,0.0,0.0
1004,1769,2020-03-20 03:17:00,0,1856.0,1306.0,0.704,8.758,40,19,7,12,21,11,10,0,0.0,0.0
1004,1770,2020-03-20 03:20:00,0,1848.0,1310.0,0.709,8.732,37,0,0,0,37,7,30,0,0.0,0.0
1004,1771,2020-03-20 03:23:00,0,1871.0,1266.0,0.677,8.772,61,1,0,1,60,5,55,0,0.0,0.0
1004,1772,2020-03-20 03:26:00,0,1677.0,1214.0,0.724,7.952,38,3,1,2,35,1,34,0,0.0,0.0
1004,1773,2020-03-20 03:29:00,0,1689.0,1202.0,0.712,7.985,201,76,46,30,125,71,54,14,0.0,0.0
1004,1774,2020-03-20 03:32:00,0,2082.0,1595.0,0.766,9.968,174,50,28,22,124,82,42,15,0.11,0.0
1004,1775,2020-03-20 03:35:00,0,2076.0,1598.0,0.77,9.948,174,38,15,23,136,88,48,2,0.0,0.0
1004,1776,2020-03-20 03:38:00,0,2103.0,1510.0,0.718,9.957,310,100,65,35,210,142,68,31,0.0,0.0
1004,1777,2020-03-20 03:41:00,0,2348.0,1724.0,0.734,11.16,237,84,67,17,153,106,47,181,0.0,0.0
1004,1778,2020-03-20 03:44:00,0,2611.0,1890.0,0.724,12.382,149,82,69,13,67,50,17,140,0.0,0.0
1004,1779,2020-03-20 03:47:00,0,2420.0,1861.0,0.769,11.595,309,143,115,28,166,118,48,173,0.0,0.0
1004,1780,2020-03-20 03:50:00,0,2701.0,1916.0,0.709,12.765,268,133,83,50,135,101,34,7,0.0,0.0
1004,1781,2020-03-20 03:53:00,0,2686.0,1939.0,0.722,12.731,277,102,63,39,175,122,53,12,0.03,0.0
1004,1782,2020-03-20 03:56:00,0,2672.0,1978.0,0.741,12.718,320,129,105,24,191,144,47,194,0.0,0.0
1004,1783,2020-03-20 03:59:00,0,2691.0,1940.0,0.721,12.753,179,87,51,36,92,57,35,6,0.0,0.0
1004,1784,2020-03-20 04:02:00,0,2851.0,2046.0,0.717,13.499,320,123,92,31,197,146,51,91,0.0,0.0
1004,1785,2020-03-20 04:05:00,0,2849.0,2016.0,0.708,13.457,164,68,32,36,96,47,49,3,0.0,0.0
1004,1786,2020-03-20 04:08:00,0,2775.0,2008.0,0.723,13.159,958,422,341,81,536,435,101,0,0.0,0.0
1004,1787,2020-03-20 04:11:00,0,2675.0,1986.0,0.742,12.74,691,318,273,45,373,282,91,0,0.0,0.0
1004,1788,2020-03-20 04:14:00,0,2690.0,1970.0,0.732,12.781,59,20,13,7,39,13,26,0,0.0,0.0
1004,1789,2020-03-20 04:17:00,0,2704.0,1909.0,0.706,12.767,19,4,1,3,15,12,3,0,0.0,0.0
1004,1790,2020-03-20 04:20:00,0,2439.0,1759.0,0.721,11.556,0,0,0,0,0,0,0,0,0.0,0.0
1004,1791,2020-03-20 04:23:00,0,2262.0,1638.0,0.724,10.726,0,0,0,0,0,0,0,0,0.0,0.0
1004,1792,2020-03-20 04:26:00,0,2185.0,1543.0,0.706,10.317,53,0,0,0,53,0,53,0,0.0,0.0
1004,1793,2020-03-20 04:29:00,0,2117.0,1466.0,0.693,9.963,13,0,0,0,13,0,13,0,0.0,0.0
1004,1794,2020-03-20 04:32:00,0,1936.0,1389.0,0.717,9.166,20,3,1,2,17,0,17,0,0.0,0.0
1004,1795,2020-03-20 04:35:00,0,1858.0,1318.0,0.709,8.782,28,25,0,25,3,0,3,0,0.0,0.0
1004,1796,2020-03-20 04:38:00,0,1865.0,1256.0,0.674,8.739,26,0,0,0,26,0,26,0,0.0,0.0
1004,1797,2020-03-20 04:41:00,0,1674.0,1223.0,0.73,7.949,36,0,0,0,36,0,36,0,0.0,0.0
1004,1798,2020-03-20 04:44:00,0,1696.0,1179.0,0.695,7.988,27,7,4,3,20,9,11,0,0.0,0.0
1004,1799,2020-03-20 04:47:00,0,1857.0,1291.0,0.695,8.747,170,89,37,52,81,26,55,4,0.0,0.0
1004,1800,2020-03-20 04:50:00,0,2017.0,1468.0,0.728,9.573,37,15,0,15,22,3,19,0,0.0,0.0
1004,1801,2020-03-20 04:53:00,0,2024.0,1476.0,0.729,9.609,9,1,0,1,8,0,8,0,0.0,0.0
1004,1802,2020-03-20 04:56:00,0,1838.0,1401.0,0.762,8.793,0,0,0,0,0,0,0,0,0.0,0.0
1004,1803,2020-03-20 04:59:00,0,1851.0,1343.5,0.726,8.7805,2,0,0,0,2,0,2,0,0.0,0.0
1004,1804,2020-03-20 05:02:00,0,1864.0,1286.0,0.69,8.768,0,0,0,0,0,0,0,0,0.0,0.0
1004,1805,2020-03-20 05:05:00,0,1672.0,1236.0,0.74,7.955,0,0,0,0,0,0,0,0,0.0,0.0
1004,1806,2020-03-20 05:08:00,0,1682.0,1194.0,0.71,7.95,79,35,21,14,44,28,16,0,0.0,0.0
1004,1807,2020-03-20 05:11:00,0,1762.0,1315.0,0.746,8.397,104,57,35,22,47,31,16,18,0.0,0.0
1004,1808,2020-03-20 05:14:00,0,1832.0,1397.0,0.763,8.766,134,66,41,25,68,30,38,37,0.0,0.0
1004,1809,2020-03-20 05:17:00,0,1920.0,1459.0,0.76,9.181,28,6,2,4,22,4,18,0,0.0,0.0
1004,1810,2020-03-20 05:20:00,0,1828.0,1415.0,0.774,8.771,34,1,1,0,33,1,32,0,0.0,0.0
1004,1811,2020-03-20 05:23:00,0,1840.0,1367.0,0.743,8.762,6,0,0,0,6,2,4,0,0.0,0.0
1004,1812,2020-03-20 05:26:00,0,1854.0,1320.0,0.712,8.766,54,10,4,6,44,8,36,0,0.0,0.0
1004,1813,2020-03-20 05:29:00,0,1762.0,1276.0,0.724,8.356,39,12,2,10,27,2,25,0,0.0,0.0
1004,1814,2020-03-20 05:32:00,0,1679.0,1225.0,0.729,7.971,17,17,10,7,0,0,0,0,0.0,0.0
1004,1815,2020-03-20 05:35:00,0,1683.0,1184.0,0.704,7.941,9,9,4,5,0,0,0,0,0.0,0.0
1004,1816,2020-03-20 05:38:00,0,1692.0,1156.0,0.683,7.949,21,10,4,6,11,0,11,0,0.0,0.0
1004,1817,2020-03-20 05:41:00,0,1701.0,1143.0,0.672,7.966,33,17,5,12,16,0,16,0,0.0,0.0
1004,1818,2020-03-20 05:44:00,0,1694.0,1161.0,0.685,7.961,293,109,66,43,184,125,59,9,0.0,0.0
1004,1819,2020-03-20 05:47:00,0,1840.0,1382.0,0.751,8.78,139,46,31,15,93,55,38,0,0.0,0.0
1004,1820,2020-03-20 05:50:00,0,1808.0,1460.0,0.808,8.739,124,88,51,37,36,21,15,17,0.0,0.0
1004,1821,2020-03-20 05:53:00,0,2076.0,1598.0,0.77,9.949,202,63,45,18,139,104,35,3,0.0,0.0
1004,1822,2020-03-20 05:56:00,0,2434.0,1792.0,0.736,11.574,143,53,20,33,90,63,27,0,0.0,0.0
1004,1823,2020-03-20 05:59:00,0,2412.0,1857.0,0.77,11.558,178,68,34,34,110,82,28,9,0.0,0.0
1004,1824,2020-03-20 06:02:00,1,2504.0,1887.0,0.754,11.957,461,222,161,61,239,161,78,91,0.0,0.12
1004,1825,2020-03-20 06:05:00,1,2828.0,2115.0,0.748,13.485,148,94,50,44,54,3,51,71,0.0,0.0
1004,1826,2020-03-20 06:08:00,1,2995.0,2287.0,0.763,14.333,126,75,34,41,51,13,38,69,0.0,0.0
1004,1827,2020-03-20 06:11:00,1,3231.0,2453.0,0.759,15.445,153,72,39,33,81,25,56,71,0.0,0.0
1004,1828,2020-03-20 06:14:00,1,3386.0,2702.0,0.798,16.331,131,51,21,30,80,36,44,38,0.0,0.11
1004,1829,2020-03-20 06:17:00,1,3556.0,2832.0,0.796,17.148,301,123,87,36,178,118,60,54,0.26,0.05
1004,1830,2020-03-20 06:20:00,1,3640.0,2918.0,0.802,17.575,158,91,46,45,67,15,52,37,0.0,0.04
1004,1831,2020-03-20 06:23:00,1,3758.0,3193.0,0.85,18.343,227,95,63,32,132,69,63,33,0.46,0.13
1004,1832,2020-03-20 06:26:00,1,3763.0,3188.0,0.847,18.354,284,125,92,33,159,111,48,123,0.0,0.03
1004,1833,2020-03-20 06:29:00,1,3775.0,3163.0,0.838,18.376,266,105,73,32,161,114,47,74,0.15,0.12
1004,1834,2020-03-20 06:32:00,1,3910.0,3286.0,0.84,19.042,204,123,73,50,81,23,58,47,0.0,0.0
1004,1835,2020-03-20 06:35:00,1,3907.0,3461.0,0.886,19.227,161,80,52,28,81,35,46,99,0.12,0.07
1004,1836,2020-03-20 06:38:00,1,4193.0,3575.0,0.853,20.476,221,115,74,41,106,41,65,64,0.07,0.03
1004,1837,2020-03-20 06:41:00,1,3566.0,3218.0,0.902,17.613,336,169,122,47,167,115,52,74,0.05,0.04
1004,1838,2020-03-20 06:44:00,1,4146.0,3625.0,0.874,20.348,211,94,60,34,117,43,74,96,0.0,0.0
1004,1839,2020-03-20 06:47:00,1,3856.0,3540.0,0.918,19.112,246,125,81,44,121,61,60,79,0.16,0.05
1004,1840,2020-03-20 06:50:00,1,3863.0,3562.0,0.922,19.164,142,48,17,31,94,60,34,29,0.13,0.06
1004,1841,2020-03-20 06:53:00,1,4147.0,3713.0,0.895,20.451,280,120,70,50,160,109,51,69,0.11,0.04
1004,1842,2020-03-20 06:56:00,1,3889.0,3484.0,0.896,19.179,88,45,21,24,43,22,21,37,0.0,0.02
1004,1843,2020-03-20 06:59:00,1,4194.0,3805.0,0.907,20.737,90,21,0,21,69,36,33,36,0.0,0.1
1004,1844,2020-03-20 07:02:00,1,3858.0,3699.0,0.959,19.294,496,189,132,57,307,229,78,19,0.22,0.02
1004,1845,2020-03-20 07:05:00,1,3395.0,3130.0,0.922,16.841,367,186,135,51,181,124,57,65,0.0,0.06
1004,1846,2020-03-20 07:08:00,1,2871.0,2776.0,0.967,14.385,788,324,248,76,464,380,84,7,0.0,0.15
1004,1847,2020-03-20 07:11:00,1,3200.0,2961.0,0.925,15.885,700,262,193,69,438,336,102,0,0.0,0.0
1004,1848,2020-03-20 07:14:00,1,2967.0,2731.0,0.92,14.711,365,146,98,48,219,154,65,0,0.06,0.0
1004,1849,2020-03-20 07:17:00,1,2924.0,2602.0,0.89,14.401,85,47,13,34,38,22,16,0,0.0,0.0
1004,1850,2020-03-20 07:20:00,1,2744.0,2446.0,0.891,13.519,0,0,0,0,0,0,0,0,0.0,0.0
1004,1851,2020-03-20 07:23:00,1,2963.0,2766.0,0.934,14.738,8,8,4,4,0,0,0,0,0.0,0.0
1004,1852,2020-03-20 07:26:00,1,3281.0,3143.0,0.958,16.405,0,0,0,0,0,0,0,0,0.0,0.0
1004,1853,2020-03-20 07:29:00,1,3205.0,3032.0,0.946,15.984,63,29,23,6,34,26,8,0,0.0,0.02
1004,1854,2020-03-20 07:32:00,1,2887.0,2703.0,0.936,14.366,32,32,1,31,0,0,0,0,0.0,0.0
1004,1855,2020-03-20 07:35:00,1,2722.0,2589.0,0.951,13.592,66,66,0,66,0,0,0,0,0.0,0.0
1004,1856,2020-03-20 07:38:00,1,2745.0,2520.0,0.918,13.607,12,11,0,11,1,1,0,0,0.0,0.0
1004,1857,2020-03-20 07:41:00,1,2733.0,2507.0,0.917,13.542,1,1,0,1,0,0,0,0,0.0,0.0
1004,1858,2020-03-20 07:44:00,1,2561.0,2418.0,0.944,12.766,7,4,1,3,3,1,2,0,0.0,0.0
1004,1859,2020-03-20 07:47:00,1,2395.0,2292.0,0.957,11.972,14,10,1,9,4,0,4,0,0.0,0.0
1004,1860,2020-03-20 07:50:00,1,2314.0,2238.0,0.967,11.593,2,2,1,1,0,0,0,0,0.0,0.0
1004,1861,2020-03-20 07:53:00,1,2331.0,2161.0,0.927,11.577,10,10,4,6,0,0,0,0,0.0,0.0
1004,1862,2020-03-20 07:56:00,1,2316.0,2180.0,0.941,11.54,87,44,13,31,43,22,21,0,0.0,0.08
1004,1863,2020-03-20 07:59:00,1,2437.5,2336.0,0.9575,12.19,110,61,17,44,49,7,42,1,0.0,0.01
1004,1864,2020-03-20 08:02:00,1,2559.0,2492.0,0.974,12.84,57,44,12,32,13,0,13,2,0.0,0.0
1004,1865,2020-03-20 08:05:00,1,2699.0,2608.0,0.966,13.52,28,18,4,14,10,1,9,0,0.0,0.0
1004,1866,2020-03-20 08:08:00,1,2551.0,2447.0,0.959,12.762,13,10,3,7,3,1,2,0,0.0,0.0
1004,1867,2020-03-20 08:11:00,1,2562.0,2418.0,0.944,12.771,26,16,4,12,10,2,8,0,0.0,0.0
1004,1868,2020-03-20 08:14:00,1,2564.0,2388.0,0.932,12.745,182,92,55,37,90,39,51,95,0.0,0.0
1004,1869,2020-03-20 08:17:00,1,2705.0,2631.0,0.973,13.572,58,24,7,17,34,14,20,36,0.0,0.0
1004,1870,2020-03-20 08:20:00,1,2846.0,2854.0,1.003,14.372,60,27,0,27,33,13,20,28,0.0,0.0
1004,1871,2020-03-20 08:23:00,1,3242.0,3248.0,1.002,16.37,108,49,0,49,59,23,36,37,0.0,0.0
1004,1872,2020-03-20 08:26:00,1,3090.0,3040.0,0.984,15.54,290,136,104,32,154,102,52,47,0.24,0.0
1004,1873,2020-03-20 08:29:00,1,2782.0,2694.0,0.968,13.942,232,114,83,31,118,75,43,73,0.06,0.0
1004,1874,2020-03-20 08:32:00,1,3266.0,3156.0,0.966,16.363,66,33,20,13,33,7,26,20,0.0,0.03
1004,1875,2020-03-20 08:35:00,1,3245.0,3260.0,1.005,16.395,376,150,105,45,226,178,48,7,0.2,0.08
1004,1876,2020-03-20 08:38:00,1,2699.0,2644.0,0.98,13.562,793,315,234,81,478,387,91,0,0.08,0.0
1004,1877,2020-03-20 08:41:00,1,2848.0,2882.0,1.012,14.411,228,87,58,29,141,96,45,1,0.0,0.0
1004,1878,2020-03-20 08:44:00,1,2651.0,2467.0,0.931,13.178,61,29,2,27,32,16,16,0,0.0,0.01
1004,1879,2020-03-20 08:47:00,1,3273.0,3111.0,0.951,16.341,29,10,3,7,19,5,14,0,0.0,0.02
1004,1880,2020-03-20 08:50:00,1,3216.0,3256.0,1.013,16.276,34,4,1,3,30,4,26,0,0.0,0.0
1004,1881,2020-03-20 08:53:00,1,3098.0,3027.0,0.977,15.556,33,31,0,31,2,0,2,0,0.0,0.0
1004,1882,2020-03-20 08:56:00,1,2858.0,2791.0,0.977,14.349,1,1,0,1,0,0,0,0,0.0,0.0
1004,1883,2020-03-20 08:59:00,1,2702.0,2643.0,0.978,13.573,2,1,0,1,1,0,1,0,0.0,0.0
1004,1884,2020-03-20 09:02:00,1,2648.0,2542.0,0.96,13.247,0,0,0,0,0,0,0,0,0.0,0.0
1004,1885,2020-03-20 09:05:00,1,2565.0,2396.0,0.934,12.76,9,9,0,9,0,0,0,0,0.0,0.0
1004,1886,2020-03-20 09:08:00,1,2293.0,2293.0,1.0,11.572,0,0,0,0,0,0,0,0,0.0,0.0
1004,1887,2020-03-20 09:11:00,1,2312.0,2214.0,0.958,11.558,31,12,4,8,19,6,13,0,0.0,0.0
1004,1888,2020-03-20 09:14:00,1,2141.0,2116.0,0.989,10.776,14,13,0,13,1,0,1,0,0.0,0.0
1004,1889,2020-03-20 09:17:00,1,2157.0,2053.0,0.952,10.773,23,1,1,0,22,0,22,0,0.0,0.0
1004,1890,2020-03-20 09:20:00,1,2155.0,2021.0,0.938,10.728,0,0,0,0,0,0,0,0,0.0,0.0
1004,1891,2020-03-20 09:23:00,1,1980.0,1971.0,0.996,9.982,45,22,7,15,23,9,14,0,0.0,0.0
1004,1892,2020-03-20 09:26:00,1,2068.0,2028.0,0.981,10.392,17,1,0,1,16,0,16,0,0.0,0.0
1004,1893,2020-03-20 09:29:00,1,1969.0,2008.0,1.019,9.982,38,0,0,0,38,12,26,0,0.0,0.0
1004,1894,2020-03-20 09:32:00,1,1975.0,1987.0,1.006,9.982,47,3,0,3,44,20,24,0,0.0,0.0
1004,1895,2020-03-20 09:35:00,1,1980.0,1964.0,0.992,9.975,15,3,0,3,12,2,10,0,0.0,0.0
1004,1896,2020-03-20 09:38:00,1,1977.0,1993.0,1.008,9.996,297,113,68,45,184,120,64,17,0.0,0.0
1004,1897,2020-03-20 09:41:00,1,2143.0,2157.0,1.007,10.83,178,46,27,19,132,80,52,8,0.0,0.0
1004,1898,2020-03-20 09:44:00,1,2128.0,2161.0,1.016,10.775,28,8,2,6,20,1,19,0,0.0,0.0
1004,1899,2020-03-20 09:47:00,1,2161.0,2054.0,0.95,10.787,43,16,0,16,27,0,27,0,0.0,0.0
1004,1900,2020-03-20 09:50:00,1,1977.0,1998.0,1.01,10.003,19,0,0,0,19,0,19,0,0.0,0.0
1004,1901,2020-03-20 09:53:00,1,1989.0,1966.0,0.989,10.012,10,7,1,6,3,1,2,0,0.0,0.0
1004,1902,2020-03-20 09:56:00,1,2002.0,1903.0,0.95,9.997,19,11,3,8,8,5,3,0,0.0,0.0
1004,1903,2020-03-20 09:59:00,1,1998.0,1924.0,0.963,10.003,2,0,0,0,2,1,1,0,0.0,0.0
1004,1904,2020-03-20 10:02:00,1,2003.0,1949.0,0.973,10.047,7,0,0,0,7,0,7,0,0.0,0.0
1004,1905,2020-03-20 10:05:00,1,1984.0,1932.0,0.974,9.955,0,0,0,0,0,0,0,0,0.0,0.0
1004,1906,2020-03-20 10:08:00,1,1990.0,1937.0,0.974,9.985,0,0,0,0,0,0,0,0,0.0,0.0
1004,1907,2020-03-20 10:11:00,1,1989.0,1942.0,0.976,9.987,0,0,0,0,0,0,0,0,0.0,0.0
1004,1908,2020-03-20 10:14:00,1,1983.0,1950.0,0.983,9.974,0,0,0,0,0,0,0,0,0.0,0.0
1004,1909,2020-03-20 10:17:00,1,1980.0,1990.0,1.005,10.003,0,0,0,0,0,0,0,0,0.0,0.0
1004,1910,2020-03-20 10:20:00,1,1994.0,1962.0,0.984,10.029,110,57,39,18,53,36,17,2,0.0,0.0
1004,1911,2020-03-20 10:23:00,1,2053.0,2094.0,1.02,10.406,91,45,27,18,46,37,9,2,0.0,0.0
1004,1912,2020-03-20 10:26:00,1,2146.0,2079.0,0.969,10.757,11,1,1,0,10,0,10,0,0.0,0.0
1004,1913,2020-03-20 10:29:00,1,2152.0,2071.0,0.962,10.771,13,1,0,1,12,0,12,0,0.0,0.0
1004,1914,2020-03-20 10:32:00,1,2062.0,2090.0,1.014,10.439,5,2,0,2,3,1,2,0,0.0,0.0
1004,1915,2020-03-20 10:35:00,1,1964.0,2052.0,1.045,10.011,49,23,8,15,26,16,10,0,0.0,0.0
1004,1916,2020-03-20 10:38:00,1,2052.0,2077.0,1.012,10.382,12,10,0,10,2,0,2,0,0.0,0.0
1004,1917,2020-03-20 10:41:00,1,2146.0,2133.0,0.994,10.817,196,67,20,47,129,70,59,1,0.0,0.0
1004,1918,2020-03-20 10:44:00,1,2274.0,2376.0,1.045,11.591,143,61,20,41,82,48,34,2,0.0,0.0
1004,1919,2020-03-20 10:47:00,1,2512.0,2599.0,1.035,12.773,150,66,41,25,84,38,46,12,0.0,0.0
1004,1920,2020-03-20 10:50:00,1,2678.0,2693.0,1.005,13.533,111,46,25,21,65,40,25,34,0.0,0.0
1004,1921,2020-03-20 10:53:00,1,3009.0,3068.0,1.02,15.25,123,43,19,24,80,45,35,40,0.0,0.02
1004,1922,2020-03-20 10:56:00,1,3057.0,3142.0,1.028,15.524,187,96,54,42,91,57,34,90,0.0,0.0
1004,1923,2020-03-20 10:59:00,1,3148.5,3213.5,1.021,15.9625,145,66,29,37,79,20,59,131,0.0,0.0
1004,1924,2020-03-20 11:02:00,1,3240.0,3285.0,1.014,16.401,159,75,42,33,84,39,45,38,0.0,0.14
1004,1925,2020-03-20 11:05:00,1,3382.0,3466.0,1.025,17.161,484,191,149,42,293,216,77,21,0.23,0.11
1004,1926,2020-03-20 11:08:00,1,3158.0,3165.0,1.002,15.947,352,123,77,46,229,164,65,18,0.14,0.03
1004,1927,2020-03-20 11:11:00,1,3450.0,3601.0,1.044,17.579,98,38,10,28,60,33,27,24,0.0,0.04
1004,1928,2020-03-20 11:14:00,1,3206.0,3352.0,1.046,16.343,333,126,89,37,207,152,55,46,0.25,0.08
1004,1929,2020-03-20 11:17:00,1,2538.0,2530.0,0.997,12.8,848,337,265,72,511,388,123,10,0.0,0.01
1004,1930,2020-03-20 11:20:00,1,3615.0,3744.0,1.036,18.387,146,51,14,37,95,50,45,29,0.0,0.02
1004,1931,2020-03-20 11:23:00,1,3779.0,3828.0,1.013,19.128,179,72,35,37,107,66,41,39,0.0,0.12
1004,1932,2020-03-20 11:26:00,1,3082.0,3114.0,1.011,15.59,66,37,26,11,29,20,9,8,0.0,0.24
1004,1933,2020-03-20 11:29:00,1,2710.0,2631.0,0.971,13.591,25,12,4,8,13,8,5,0,0.0,0.04
1004,1934,2020-03-20 11:32:00,1,2996.0,3017.0,1.007,15.144,703,310,239,71,393,300,93,22,0.18,0.0
1004,1935,2020-03-20 11:35:00,1,3206.0,3389.0,1.057,16.384,222,92,64,28,130,98,32,6,0.0,0.03
1004,1936,2020-03-20 11:38:00,1,3112.0,3002.0,0.965,15.586,117,68,34,34,49,23,26,0,0.0,0.0
1004,1937,2020-03-20 11:41:00,1,3473.0,3564.0,1.026,17.628,3,0,0,0,3,1,2,0,0.0,0.0
1004,1938,2020-03-20 11:44:00,1,3500.0,3493.0,0.998,17.655,15,2,0,2,13,3,10,0,0.0,0.0
1004,1939,2020-03-20 11:47:00,1,3224.0,3354.0,1.04,16.417,30,0,0,0,30,0,30,0,0.0,0.0
1004,1940,2020-03-20 11:50:00,1,3174.0,3159.0,0.995,16.004,24,5,0,5,19,0,19,0,0.0,0.0
1004,1941,2020-03-20 11:53:00,1,3013.0,3012.0,0.999,15.206,4,4,1,3,0,0,0,0,0.0,0.0
1004,1942,2020-03-20 11:56:00,1,2863.0,2876.0,1.004,14.466,14,10,1,9,4,1,3,0,0.0,0.0
1004,1943,2020-03-20 11:59:00,1,2696.0,2669.0,0.99,13.577,1,0,0,0,1,0,1,0,0.0,0.0
1004,1944,2020-03-20 12:02:00,1,2523.0,2597.0,1.03,12.816,49,9,4,5,40,8,32,0,0.0,0.0
1004,1945,2020-03-20 12:05:00,1,2511.0,2589.0,1.031,12.76,54,0,0,0,54,0,54,0,0.0,0.0
1004,1946,2020-03-20 12:08:00,1,2547.0,2508.0,0.985,12.811,41,0,0,0,41,0,41,0,0.0,0.0
1005,1,2020-03-16 10:53:00,1,4452.0,3531.0,0.793,21.45,708,393,318,75,315,236,79,103,0.02,0.0
1005,2,2020-03-16 10:56:00,1,4461.0,3550.0,0.796,21.506,613,338,260,78,275,213,62,82,0.0,0.0
1005,3,2020-03-16 10:59:00,1,4621.0,3700.0,0.801,22.302,672,325,255,70,347,248,99,37,0.01,0.02
1005,4,2020-03-16 11:02:00,1,4539.0,3624.0,0.7985,21.896,508,229,170,59,279,212,67,39,0.01,0.0
1005,5,2020-03-16 11:05:00,1,4457.0,3548.0,0.796,21.49,636,238,188,50,398,333,65,75,0.0,0.0
1005,6,2020-03-16 11:08:00,1,4216.0,3339.0,0.792,20.307,545,94,51,43,451,394,57,40,0.0,0.0
1005,7,2020-03-16 11:11:00,1,4114.0,3286.0,0.799,19.848,650,257,191,66,393,333,60,48,0.0,0.0
1005,8,2020-03-16 11:14:00,1,3948.0,3115.0,0.789,19.006,629,43,14,29,586,553,33,0,0.0,0.0
1005,9,2020-03-16 11:17:00,1,3792.0,3020.0,0.796,18.284,783,36,22,14,747,693,54,10,0.0,0.0
1005,10,2020-03-16 11:20:00,1,3599.0,2901.0,0.806,17.393,791,0,0,0,791,751,40,0,0.0,0.0
1005,11,2020-03-16 11:23:00,1,3648.0,2832.0,0.776,17.51,602,16,1,15,586,548,38,0,0.0,0.0
1005,12,2020-03-16 11:26:00,1,3631.0,2807.0,0.773,17.416,453,144,98,46,309,246,63,30,0.0,0.0
1005,13,2020-03-16 11:29:00,1,3777.0,3015.0,0.798,18.221,820,253,196,57,567,501,66,51,0.03,0.0
1005,14,2020-03-16 11:32:00,1,3612.0,2888.0,0.8,17.429,154,57,41,16,97,71,26,13,0.0,0.0
1005,15,2020-03-16 11:35:00,1,3569.0,2737.0,0.767,17.094,29,8,3,5,21,1,20,0,0.0,0.0
1005,16,2020-03-16 11:38:00,1,3388.0,2586.0,0.763,16.213,11,2,0,2,9,4,5,0,0.0,0.0
1005,17,2020-03-16 11:41:00,1,3210.0,2499.0,0.778,15.414,6,0,0,0,6,4,2,0,0.0,0.0
1005,18,2020-03-16 11:44:00,1,3225.0,2474.0,0.767,15.447,42,0,0,0,42,13,29,0,0.0,0.0
1005,19,2020-03-16 11:47:00,1,3233.0,2478.0,0.767,15.482,29,0,0,0,29,24,5,0,0.01,0.0
1005,20,2020-03-16 11:50:00,1,3234.0,2490.0,0.77,15.499,145,18,10,8,127,113,14,0,0.0,0.0
1005,21,2020-03-16 11:53:00,1,2950.0,2383.0,0.808,14.262,94,24,8,16,70,61,9,20,0.0,0.0
1005,22,2020-03-16 11:56:00,1,3393.0,2619.0,0.772,16.27,677,203,142,61,474,407,67,38,0.0,0.0
1005,23,2020-03-16 11:59:00,1,3779.0,3045.0,0.806,18.262,549,207,145,62,342,277,65,29,0.0,0.0
1005,24,2020-03-16 12:02:00,1,3365.0,2745.0,0.815,16.299,108,68,44,24,40,16,24,4,0.0,0.0
1005,25,2020-03-16 12:05:00,1,3380.0,2664.0,0.788,16.267,106,36,19,17,70,55,15,5,0.0,0.0
1005,26,2020-03-16 12:08:00,1,3213.0,2555.0,0.795,15.489,295,6,1,5,289,243,46,0,0.05,0.0
1005,27,2020-03-16 12:11:00,1,3207.0,2518.0,0.785,15.426,262,3,1,2,259,233,26,0,0.0,0.0
1005,28,2020-03-16 12:14:00,1,2642.0,2107.0,0.797,12.743,60,3,1,2,57,49,8,0,0.0,0.0
1005,29,2020-03-16 12:17:00,1,2648.0,2068.0,0.781,12.722,267,15,1,14,252,228,24,0,0.0,0.0
1005,30,2020-03-16 12:20:00,1,2633.0,2045.0,0.777,12.637,0,0,0,0,0,0,0,0,0.0,0.0
1005,31,2020-03-16 12:23:00,1,2622.0,2103.0,0.802,12.661,0,0,0,0,0,0,0,0,0.0,0.0
1005,32,2020-03-16 12:26:00,1,2722.0,2155.0,0.792,13.111,6,6,2,4,0,0,0,0,0.0,0.0
1005,33,2020-03-16 12:29:00,1,2808.0,2169.0,0.772,13.467,8,8,2,6,0,0,0,0,0.0,0.0
1005,34,2020-03-16 12:32:00,1,2816.0,2197.0,0.78,13.526,158,82,51,31,76,53,23,1,0.0,0.0
1005,35,2020-03-16 12:35:00,1,2944.0,2406.0,0.817,14.262,23,8,3,5,15,10,5,0,0.01,0.0
1005,36,2020-03-16 12:38:00,1,2727.0,2175.0,0.798,13.152,1,1,0,1,0,0,0,0,0.0,0.0
1005,37,2020-03-16 12:41:00,1,2618.0,2124.0,0.811,12.667,1,0,0,0,1,1,0,0,0.01,0.0
1005,38,2020-03-16 12:44:00,1,2625.0,2108.0,0.803,12.676,1,0,0,0,1,0,1,0,0.0,0.0
1005,39,2020-03-16 12:47:00,1,2629.0,2093.0,0.796,12.676,6,4,2,2,2,0,2,0,0.0,0.0
1005,40,2020-03-16 12:50:00,1,2643.0,2021.0,0.765,12.65,4,0,0,0,4,0,4,0,0.0,0.0
1005,41,2020-03-16 12:53:00,1,2565.0,1968.0,0.767,12.284,57,8,5,3,49,34,15,3,0.0,0.0
1005,42,2020-03-16 12:56:00,1,2643.0,2032.0,0.769,12.662,251,64,31,33,187,146,41,17,0.0,0.0
1005,43,2020-03-16 12:59:00,1,3365.0,2729.0,0.811,16.278,530,187,120,67,343,288,55,29,0.06,0.0
1005,44,2020-03-16 13:02:00,1,3600.0,2973.0,0.826,17.477,669,271,208,63,398,307,91,53,0.0,0.0
1005,45,2020-03-16 13:05:00,1,3769.0,3048.0,0.809,18.223,620,245,186,59,375,315,60,50,0.0,0.0
1005,46,2020-03-16 13:08:00,1,3765.0,3108.0,0.826,18.276,538,199,145,54,339,271,68,19,0.0,0.0
1005,47,2020-03-16 13:11:00,1,3617.0,2898.0,0.801,17.458,504,143,97,46,361,295,66,39,0.0,0.0
1005,48,2020-03-16 13:14:00,1,3768.0,3088.0,0.82,18.265,685,237,178,59,448,354,94,37,0.04,0.0
1005,49,2020-03-16 13:17:00,1,3643.0,2888.0,0.793,17.552,543,188,149,39,355,285,70,95,0.0,0.0
1005,50,2020-03-16 13:20:00,1,3358.0,2787.0,0.83,16.315,576,119,83,36,457,381,76,41,0.0,0.0
1005,51,2020-03-16 13:23:00,1,3339.0,2755.0,0.825,16.206,693,42,10,32,651,557,94,7,0.0,0.0
1005,52,2020-03-16 13:26:00,1,3366.0,2695.0,0.801,16.245,492,82,45,37,410,327,83,10,0.0,0.0
1005,53,2020-03-16 13:29:00,1,3305.0,2655.0,0.803,15.962,530,146,105,41,384,314,70,3,0.0,0.0
1005,54,2020-03-16 13:32:00,1,3032.0,2489.0,0.821,14.702,389,122,77,45,267,217,50,9,0.0,0.0
1005,55,2020-03-16 13:35:00,1,3292.0,2642.0,0.803,15.896,612,173,132,41,439,342,97,21,0.0,0.0
1005,56,2020-03-16 13:38:00,1,2947.0,2425.0,0.823,14.296,535,65,49,16,470,388,82,0,0.0,0.0
1005,57,2020-03-16 13:41:00,1,2947.0,2387.0,0.81,14.256,1070,58,14,44,1012,892,120,0,0.0,0.0
1005,58,2020-03-16 13:44:00,1,2961.0,2403.0,0.812,14.327,761,34,13,21,727,603,124,0,0.0,0.0
1005,59,2020-03-16 13:47:00,1,2798.0,2203.0,0.788,13.463,473,0,0,0,473,360,113,0,0.0,0.0
1005,60,2020-03-16 13:50:00,1,2640.0,2090.0,0.791,12.716,473,0,0,0,473,354,119,0,0.0,0.0
1005,61,2020-03-16 13:53:00,1,2664.0,2014.0,0.756,12.728,533,1,0,1,532,425,107,0,0.0,0.0
1005,62,2020-03-16 13:56:00,1,2648.0,2004.0,0.757,12.653,561,0,0,0,561,468,93,0,0.0,0.0
1005,63,2020-03-16 13:59:00,1,2658.0,2060.0,0.775,12.752,524,3,0,3,521,404,117,0,0.0,0.0
1005,64,2020-03-16 14:02:00,1,2748.0,2055.5,0.749,13.103,527,0,0,0,527,409,118,0,0.0,0.0
1005,65,2020-03-16 14:05:00,1,2838.0,2051.0,0.723,13.454,512,0,0,0,512,385,127,0,0.0,0.0
1005,66,2020-03-16 14:08:00,1,2846.0,2075.0,0.729,13.511,556,2,0,2,554,412,142,0,0.0,0.0
1005,67,2020-03-16 14:11:00,1,2664.0,1993.0,0.748,12.703,535,5,0,5,530,376,154,0,0.0,0.0
1005,68,2020-03-16 14:14:00,1,2564.0,1972.0,0.769,12.286,531,5,0,5,526,379,147,0,0.0,0.0
1005,69,2020-03-16 14:17:00,1,2571.0,1924.0,0.748,12.263,542,10,0,10,532,404,128,0,0.0,0.0
1005,70,2020-03-16 14:20:00,1,2565.0,1979.0,0.771,12.298,668,48,29,19,620,479,141,0,0.0,0.0
1005,71,2020-03-16 14:23:00,1,2590.0,1880.0,0.726,12.286,524,5,4,1,519,384,135,0,0.0,0.0
1005,72,2020-03-16 14:26:00,1,2405.0,1842.0,0.766,11.516,467,0,0,0,467,325,142,0,0.0,0.0
1005,73,2020-03-16 14:29:00,1,2417.0,1777.0,0.735,11.491,960,23,14,9,937,867,70,0,0.0,0.0
1005,74,2020-03-16 14:32:00,1,2439.0,1729.0,0.709,11.523,878,0,0,0,878,767,111,0,0.0,0.0
1005,75,2020-03-16 14:35:00,1,2423.0,1736.0,0.717,11.469,249,6,4,2,243,194,49,0,0.0,0.0
1005,76,2020-03-16 14:38:00,1,2429.0,1753.0,0.722,11.512,0,0,0,0,0,0,0,0,0.0,0.0
1005,77,2020-03-16 14:41:00,1,2414.0,1760.0,0.729,11.46,0,0,0,0,0,0,0,0,0.0,0.0
1005,78,2020-03-16 14:44:00,1,2424.0,1783.0,0.735,11.526,78,8,5,3,70,59,11,0,0.0,0.0
1005,79,2020-03-16 14:47:00,1,2424.0,1746.0,0.72,11.484,2,0,0,0,2,1,1,0,0.0,0.0
1005,80,2020-03-16 14:50:00,1,2435.0,1731.0,0.711,11.509,50,7,4,3,43,33,10,0,0.0,0.0
1005,81,2020-03-16 14:53:00,1,2406.0,1821.0,0.757,11.496,673,55,32,23,618,496,122,6,0.0,0.0
1005,82,2020-03-16 14:56:00,1,2428.0,1760.0,0.725,11.516,588,0,0,0,588,486,102,0,0.0,0.0
1005,83,2020-03-16 14:59:00,1,2435.0,1741.0,0.715,11.523,570,0,0,0,570,467,103,0,0.0,0.0
1005,84,2020-03-16 15:02:00,1,2329.0,1707.0,0.733,11.068,389,3,1,2,386,305,81,0,0.0,0.0
1005,85,2020-03-16 15:05:00,1,2331.0,1711.0,0.734,11.078,363,0,0,0,363,276,87,0,0.0,0.0
1005,86,2020-03-16 15:08:00,1,2337.0,1695.0,0.725,11.085,586,0,0,0,586,450,136,0,0.0,0.0
1005,87,2020-03-16 15:11:00,1,2443.0,1709.0,0.7,11.517,766,39,24,15,727,596,131,0,0.0,0.0
1005,88,2020-03-16 15:14:00,1,2412.0,1756.0,0.728,11.447,1671,0,0,0,1671,1514,157,0,0.0,0.0
1005,89,2020-03-16 15:17:00,1,2418.0,1755.0,0.726,11.472,1482,0,0,0,1482,1299,183,0,0.0,0.0
1005,90,2020-03-16 15:20:00,1,2427.0,1784.0,0.735,11.536,1786,0,0,0,1786,1602,184,0,0.0,0.0
1005,91,2020-03-16 15:23:00,1,2415.0,1822.0,0.754,11.534,1476,16,4,12,1460,1315,145,0,0.0,0.0
1005,92,2020-03-16 15:26:00,1,2409.0,1841.0,0.764,11.53,1972,0,0,0,1972,1807,165,0,0.0,0.0
1005,93,2020-03-16 15:29:00,1,2409.0,1818.0,0.754,11.506,1554,11,2,9,1543,1392,151,0,0.0,0.0
1005,94,2020-03-16 15:32:00,1,2418.0,1835.0,0.759,11.56,5,1,0,1,4,1,3,0,0.0,0.0
1005,95,2020-03-16 15:35:00,1,2404.0,1844.0,0.767,11.514,697,18,10,8,679,592,87,0,0.0,0.0
1005,96,2020-03-16 15:38:00,1,2426.0,1770.0,0.73,11.518,713,0,0,0,713,614,99,0,0.0,0.0
1005,97,2020-03-16 15:41:00,1,2235.0,1690.0,0.756,10.676,763,4,1,3,759,644,115,0,0.0,0.0
1005,98,2020-03-16 15:44:00,1,2162.0,1597.0,0.739,10.286,636,0,0,0,636,530,106,0,0.0,0.0
1005,99,2020-03-16 15:47:00,1,2163.0,1640.0,0.758,10.337,923,3,1,2,920,821,99,0,0.0,0.0
1005,100,2020-03-16 15:50:00,1,2169.0,1596.0,0.736,10.312,1341,0,0,0,1341,1190,151,0,0.0,0.0
1005,101,2020-03-16 15:53:00,1,2168.0,1599.0,0.737,10.314,1583,0,0,0,1583,1426,157,0,0.0,0.0
1005,102,2020-03-16 15:56:00,1,2162.0,1628.0,0.753,10.322,1441,0,0,0,1441,1303,138,0,0.0,0.0
1005,103,2020-03-16 15:59:00,1,2246.0,1694.0,0.754,10.726,1557,0,0,0,1557,1437,120,0,0.0,0.0
1005,104,2020-03-16 16:02:00,1,2437.0,1735.0,0.712,11.525,1556,0,0,0,1556,1439,117,0,0.0,0.0
1005,105,2020-03-16 16:05:00,1,2427.0,1736.0,0.715,11.485,1608,4,1,3,1604,1486,118,0,0.0,0.0
1005,106,2020-03-16 16:08:00,1,2431.0,1723.0,0.709,11.485,1309,12,5,7,1297,1183,114,0,0.0,0.0
1005,107,2020-03-16 16:11:00,1,2427.0,1743.0,0.718,11.492,776,20,8,12,756,657,99,0,0.0,0.0
1005,108,2020-03-16 16:14:00,1,2412.0,1756.0,0.728,11.45,662,23,14,9,639,506,133,0,0.0,0.0
1005,109,2020-03-16 16:17:00,1,2398.0,1827.0,0.762,11.47,530,0,0,0,530,398,132,0,0.0,0.0
1005,110,2020-03-16 16:20:00,1,2402.0,1845.0,0.768,11.508,699,0,0,0,699,555,144,0,0.0,0.0
1005,111,2020-03-16 16:23:00,1,2405.0,1778.0,0.739,11.445,779,0,0,0,779,621,158,0,0.0,0.0
1005,112,2020-03-16 16:26:00,1,2400.0,1806.0,0.752,11.458,748,53,40,13,695,557,138,0,0.0,0.0
1005,113,2020-03-16 16:29:00,1,2405.0,1821.0,0.757,11.492,519,1,0,1,518,386,132,0,0.0,0.0
1005,114,2020-03-16 16:32:00,1,2399.0,1837.0,0.766,11.485,592,22,1,21,570,426,144,0,0.0,0.0
1005,115,2020-03-16 16:35:00,1,2412.0,1821.0,0.755,11.521,470,5,1,4,465,340,125,0,0.0,0.0
1005,116,2020-03-16 16:38:00,1,2414.0,1790.0,0.742,11.492,468,1,0,1,467,348,119,0,0.0,0.0
1005,117,2020-03-16 16:41:00,1,2412.0,1797.0,0.745,11.493,485,0,0,0,485,354,131,0,0.0,0.0
1005,118,2020-03-16 16:44:00,1,2400.0,1831.0,0.763,11.484,915,24,7,17,891,771,120,2,0.0,0.0
1005,119,2020-03-16 16:47:00,1,2590.0,1902.0,0.734,12.312,852,30,6,24,822,714,108,0,0.0,0.0
1005,120,2020-03-16 16:50:00,1,2815.0,2179.0,0.774,13.503,927,189,132,57,738,621,117,41,0.0,0.0
1005,121,2020-03-16 16:53:00,1,3000.0,2229.0,0.743,14.29,488,84,63,21,404,301,103,25,0.15,0.0
1005,122,2020-03-16 16:56:00,1,2983.0,2261.0,0.758,14.255,403,143,104,39,260,183,77,56,0.0,0.0
1005,123,2020-03-16 16:59:00,1,2840.0,2075.0,0.731,13.488,340,98,68,30,242,164,78,21,0.0,0.0
1005,124,2020-03-16 17:02:00,1,2831.5,2113.0,0.7465,13.4955,496,177,140,37,319,214,105,25,0.0,0.0
1005,125,2020-03-16 17:05:00,1,2823.0,2151.0,0.762,13.503,353,71,47,24,282,182,100,0,0.0,0.0
1005,126,2020-03-16 17:08:00,1,2815.0,2168.0,0.77,13.494,151,46,25,21,105,23,82,0,0.0,0.0
1005,127,2020-03-16 17:11:00,1,2900.0,2208.0,0.761,13.872,168,47,13,34,121,35,86,4,0.0,0.0
1005,128,2020-03-16 17:14:00,1,2990.0,2262.0,0.757,14.283,390,146,108,38,244,157,87,5,0.0,0.0
1005,129,2020-03-16 17:17:00,1,2820.0,2148.0,0.762,13.491,157,43,19,24,114,32,82,0,0.0,0.0
1005,130,2020-03-16 17:20:00,1,2818.0,2128.0,0.755,13.459,311,75,25,50,236,130,106,0,0.0,0.0
1005,131,2020-03-16 17:23:00,1,2823.0,2173.0,0.77,13.529,114,7,2,5,107,21,86,0,0.0,0.0
1005,132,2020-03-16 17:26:00,1,2654.0,2025.0,0.763,12.697,84,2,0,2,82,0,82,0,0.0,0.0
1005,133,2020-03-16 17:29:00,1,2577.0,1908.0,0.741,12.265,76,0,0,0,76,0,76,0,0.0,0.0
1005,134,2020-03-16 17:32:00,1,2580.0,1892.0,0.733,12.261,87,7,0,7,80,8,72,0,0.0,0.0
1005,135,2020-03-16 17:35:00,1,2486.0,1871.0,0.753,11.865,77,0,0,0,77,0,77,0,0.0,0.0
1005,136,2020-03-16 17:38:00,1,2399.0,1862.0,0.776,11.515,96,4,0,4,92,15,77,0,0.0,0.0
1005,137,2020-03-16 17:41:00,1,2428.0,1807.0,0.744,11.569,90,2,2,0,88,11,77,0,0.0,0.0
1005,138,2020-03-16 17:44:00,1,2595.0,1889.0,0.728,12.315,91,0,0,0,91,10,81,0,0.0,0.0
1005,139,2020-03-16 17:47:00,1,2592.0,1887.0,0.728,12.302,74,0,0,0,74,0,74,0,0.0,0.0
1005,140,2020-03-16 17:50:00,1,2484.0,1865.0,0.751,11.854,123,0,0,0,123,47,76,0,0.0,0.0
1005,141,2020-03-16 17:53:00,1,2575.0,1943.0,0.755,12.299,123,21,13,8,102,22,80,0,0.0,0.0
1005,142,2020-03-16 17:56:00,1,2579.0,1968.0,0.763,12.34,121,2,0,2,119,33,86,0,0.0,0.0
1005,143,2020-03-16 17:59:00,1,2575.0,1953.0,0.758,12.308,131,5,2,3,126,50,76,0,0.0,0.0
1005,144,2020-03-16 18:02:00,0,2577.0,1925.0,0.747,12.283,88,4,2,2,84,11,73,0,0.0,0.0
1005,145,2020-03-16 18:05:00,0,2577.0,1914.0,0.743,12.273,88,2,1,1,86,6,80,0,0.0,0.0
1005,146,2020-03-16 18:08:00,0,2400.0,1829.0,0.762,11.483,86,1,1,0,85,8,77,0,0.0,0.0
1005,147,2020-03-16 18:11:00,0,2427.0,1779.0,0.733,11.531,200,61,39,22,139,61,78,0,0.0,0.0
1005,148,2020-03-16 18:14:00,0,2749.0,2053.0,0.747,13.105,606,242,195,47,364,257,107,85,0.0,0.01
1005,149,2020-03-16 18:17:00,0,2814.0,2148.0,0.763,13.465,719,300,234,66,419,324,95,140,0.0,0.0
1005,150,2020-03-16 18:20:00,0,3151.0,2384.0,0.757,15.057,901,334,263,71,567,460,107,135,0.0,0.0
1005,151,2020-03-16 18:23:00,0,3135.0,2432.0,0.776,15.044,587,231,180,51,356,269,87,117,0.0,0.0
1005,152,2020-03-16 18:26:00,0,3332.0,2458.0,0.738,15.851,517,205,152,53,312,237,75,98,0.0,0.0
1005,153,2020-03-16 18:29:00,0,3405.0,2570.0,0.755,16.263,394,163,109,54,231,173,58,48,0.0,0.02
1005,154,2020-03-16 18:32:00,0,2968.0,2281.0,0.769,14.219,291,99,62,37,192,102,90,34,0.0,0.0
1005,155,2020-03-16 18:35:00,0,3075.0,2351.0,0.764,14.717,239,68,36,32,171,83,88,10,0.0,0.0
1005,156,2020-03-16 18:38:00,0,2958.0,2340.0,0.791,14.246,190,80,36,44,110,42,68,0,0.0,0.0
1005,157,2020-03-16 18:41:00,0,2962.0,2342.0,0.791,14.265,190,80,37,43,110,49,61,10,0.0,0.0
1005,158,2020-03-16 18:44:00,0,2804.0,2176.0,0.776,13.456,74,0,0,0,74,0,74,0,0.0,0.0
1005,159,2020-03-16 18:47:00,0,2653.0,2036.0,0.767,12.708,69,1,1,0,68,0,68,0,0.0,0.0
1005,160,2020-03-16 18:50:00,0,2577.0,1959.0,0.76,12.324,81,3,1,2,78,4,74,0,0.0,0.0
1005,161,2020-03-16 18:53:00,0,2566.0,1949.0,0.759,12.267,61,0,0,0,61,0,61,0,0.0,0.0
1005,162,2020-03-16 18:56:00,0,2577.0,1964.0,0.762,12.328,62,0,0,0,62,0,62,0,0.0,0.0
1005,163,2020-03-16 18:59:00,0,2588.0,1889.0,0.73,12.287,102,13,5,8,89,15,74,0,0.0,0.0
1005,164,2020-03-16 19:02:00,0,2571.0,1930.0,0.751,12.267,175,38,24,14,137,60,77,1,0.0,0.0
1005,165,2020-03-16 19:05:00,0,2584.0,1895.0,0.733,12.278,83,5,2,3,78,10,68,0,0.0,0.0
1005,166,2020-03-16 19:08:00,0,2564.0,1968.0,0.768,12.279,73,8,1,7,65,2,63,0,0.0,0.0
1005,167,2020-03-16 19:11:00,0,2597.0,1904.0,0.733,12.341,61,7,1,6,54,0,54,0,0.0,0.0
1005,168,2020-03-16 19:14:00,0,2574.0,1924.0,0.748,12.273,56,0,0,0,56,0,56,0,0.0,0.0
1005,169,2020-03-16 19:17:00,0,2589.0,1884.0,0.728,12.288,343,120,86,34,223,144,79,20,0.0,0.0
1005,170,2020-03-16 19:20:00,0,2756.0,2022.0,0.734,13.098,148,38,27,11,110,41,69,3,0.0,0.0
1005,171,2020-03-16 19:23:00,0,2589.0,1875.0,0.724,12.277,59,5,1,4,54,6,48,0,0.0,0.0
1005,172,2020-03-16 19:26:00,0,2409.0,1828.0,0.759,11.517,73,0,0,0,73,6,67,0,0.0,0.0
1005,173,2020-03-16 19:29:00,0,2593.0,1892.0,0.73,12.312,197,72,33,39,125,64,61,3,0.0,0.0
1005,174,2020-03-16 19:32:00,0,2830.0,2152.0,0.761,13.534,231,57,22,35,174,95,79,13,0.0,0.0
1005,175,2020-03-16 19:35:00,0,2987.0,2255.0,0.755,14.264,617,336,263,73,281,209,72,103,0.0,0.0
1005,176,2020-03-16 19:38:00,0,3053.0,2372.0,0.777,14.657,533,221,174,47,312,232,80,171,0.0,0.0
1005,177,2020-03-16 19:41:00,0,3564.0,2740.0,0.769,17.077,420,168,130,38,252,185,67,95,0.0,0.0
1005,178,2020-03-16 19:44:00,0,2414.0,1818.0,0.753,11.525,476,235,176,59,241,160,81,65,0.0,0.0
1005,179,2020-03-16 19:47:00,0,3140.0,2431.0,0.774,15.061,521,234,165,69,287,212,75,86,0.0,0.0
1005,180,2020-03-16 19:50:00,0,2415.0,1759.0,0.728,11.463,436,209,160,49,227,152,75,55,0.0,0.0
1005,181,2020-03-16 19:53:00,0,3567.0,2654.0,0.744,16.993,454,165,128,37,289,194,95,44,0.1,0.0
1005,182,2020-03-16 19:56:00,0,3435.0,2505.0,0.729,16.308,478,186,145,41,292,215,77,45,0.0,0.0
1005,183,2020-03-16 19:59:00,0,2442.0,1733.0,0.71,11.542,296,140,81,59,156,79,77,34,0.0,0.0
1005,184,2020-03-16 20:02:00,0,3009.0,2185.5,0.724,14.276,277,156,99,57,121,44,77,7,0.0,0.0
1005,185,2020-03-16 20:05:00,0,3576.0,2638.0,0.738,17.01,262,100,62,38,162,82,80,12,0.0,0.0
1005,186,2020-03-16 20:08:00,0,2897.0,2203.0,0.761,13.853,170,9,2,7,161,93,68,0,0.0,0.0
1005,187,2020-03-16 20:11:00,0,2490.0,1875.0,0.753,11.885,98,3,0,3,95,31,64,0,0.0,0.0
1005,188,2020-03-16 20:14:00,0,2583.0,1908.0,0.739,12.289,141,8,4,4,133,78,55,0,0.0,0.0
1005,189,2020-03-16 20:17:00,0,2754.0,2031.0,0.737,13.099,200,8,1,7,192,159,33,0,0.0,0.0
1005,190,2020-03-16 20:20:00,0,2817.0,2106.0,0.748,13.43,119,9,2,7,110,47,63,0,0.0,0.0
1005,191,2020-03-16 20:23:00,0,2817.0,2149.0,0.763,13.479,80,2,0,2,78,4,74,0,0.0,0.0
1005,192,2020-03-16 20:26:00,0,2812.0,2147.0,0.763,13.458,69,3,0,3,66,4,62,0,0.0,0.0
1005,193,2020-03-16 20:29:00,0,2830.0,2132.0,0.753,13.511,158,41,32,9,117,43,74,0,0.0,0.0
1005,194,2020-03-16 20:32:00,0,2907.0,2168.0,0.746,13.854,254,2,1,1,252,143,109,0,0.0,0.0
1005,195,2020-03-16 20:35:00,0,2843.0,2101.0,0.739,13.528,160,32,25,7,128,55,73,0,0.0,0.0
1005,196,2020-03-16 20:38:00,0,2855.0,2044.0,0.716,13.512,79,1,1,0,78,4,74,0,0.0,0.0
1005,197,2020-03-16 20:41:00,0,2404.0,1809.0,0.753,11.475,132,39,6,33,93,26,67,0,0.3,0.0
1005,198,2020-03-16 20:44:00,0,2832.0,2095.0,0.74,13.479,573,218,163,55,355,263,92,113,0.03,0.0
1005,199,2020-03-16 20:47:00,0,3150.0,2357.0,0.748,15.021,657,297,241,56,360,271,89,129,0.0,0.03
1005,200,2020-03-16 20:50:00,0,3004.0,2265.0,0.754,14.344,188,31,3,28,157,93,64,95,0.0,0.0
1005,201,2020-03-16 20:53:00,0,3423.0,2489.0,0.727,16.243,552,253,186,67,299,216,83,53,0.0,0.0
1005,202,2020-03-16 20:56:00,0,3150.0,2381.0,0.756,15.048,664,235,176,59,429,331,98,58,0.0,0.0
1005,203,2020-03-16 20:59:00,0,3418.0,2544.0,0.744,16.286,566,253,198,55,313,253,60,74,0.0,0.0
1005,204,2020-03-16 21:02:00,0,3136.0,2421.0,0.772,15.036,680,230,171,59,450,399,51,126,0.0,0.0
1005,205,2020-03-16 21:05:00,0,3434.0,2529.0,0.736,16.329,653,219,168,51,434,356,78,95,0.0,0.0
1005,206,2020-03-16 21:08:00,0,3579.0,2686.0,0.751,17.075,535,180,143,37,355,272,83,94,0.0,0.0
1005,207,2020-03-16 21:11:00,0,3323.0,2459.0,0.74,15.814,654,172,129,43,482,376,106,71,0.0,0.0
1005,208,2020-03-16 21:14:00,0,3406.0,2540.0,0.746,16.233,417,179,137,42,238,168,70,56,0.05,0.0
1005,209,2020-03-16 21:17:00,0,3252.0,2444.0,0.751,15.52,553,214,158,56,339,254,85,63,0.0,0.0
1005,210,2020-03-16 21:20:00,0,3420.0,2521.0,0.737,16.265,477,142,95,47,335,251,84,32,0.0,0.0
1005,211,2020-03-16 21:23:00,0,3237.0,2441.0,0.754,15.455,268,65,25,40,203,126,77,5,0.0,0.0
1005,212,2020-03-16 21:26:00,0,3157.0,2413.0,0.764,15.109,194,52,17,35,142,71,71,2,0.0,0.0
1005,213,2020-03-16 21:29:00,0,3171.0,2375.0,0.749,15.123,165,65,39,26,100,37,63,5,0.0,0.0
1005,214,2020-03-16 21:32:00,0,2999.0,2227.0,0.742,14.282,54,0,0,0,54,0,54,0,0.0,0.0
1005,215,2020-03-16 21:35:00,0,2821.0,2138.0,0.758,13.483,75,5,2,3,70,10,60,0,0.0,0.0
1005,216,2020-03-16 21:38:00,0,2591.0,1924.0,0.742,12.34,92,14,1,13,78,10,68,0,0.0,0.0
1005,217,2020-03-16 21:41:00,0,2494.0,1869.0,0.749,11.896,70,1,0,1,69,0,69,0,0.0,0.0
1005,218,2020-03-16 21:44:00,0,2589.0,1889.0,0.73,12.293,79,14,2,12,65,2,63,0,0.0,0.0
1005,219,2020-03-16 21:47:00,0,2437.0,1734.0,0.712,11.522,88,8,4,4,80,17,63,0,0.0,0.0
1005,220,2020-03-16 21:50:00,0,2571.0,1954.0,0.76,12.293,217,87,62,25,130,57,73,3,0.0,0.0
1005,221,2020-03-16 21:53:00,0,2581.0,1873.0,0.726,12.243,103,33,20,13,70,2,68,0,0.0,0.0
1005,222,2020-03-16 21:56:00,0,2405.0,1835.0,0.763,11.506,110,15,3,12,95,26,69,0,0.0,0.0
1005,223,2020-03-16 21:59:00,0,2582.0,1928.0,0.747,12.307,68,3,0,3,65,0,65,0,0.0,0.0
1005,224,2020-03-16 22:02:00,0,2585.0,1907.0,0.738,12.298,342,155,108,47,187,121,66,79,0.0,0.0
1005,225,2020-03-16 22:05:00,0,2488.0,1900.0,0.764,11.908,350,172,133,39,178,120,58,116,0.0,0.0
1005,226,2020-03-16 22:08:00,0,2905.0,2191.0,0.754,13.87,481,157,113,44,324,240,84,126,0.26,0.0
1005,227,2020-03-16 22:11:00,0,3248.0,2410.0,0.742,15.466,614,204,153,51,410,328,82,56,0.0,0.0
1005,228,2020-03-16 22:14:00,0,2900.0,2189.0,0.755,13.851,534,252,184,68,282,200,82,88,0.0,0.0
1005,229,2020-03-16 22:17:00,0,2972.0,2352.0,0.791,14.315,507,210,155,55,297,209,88,86,0.28,0.0
1005,230,2020-03-16 22:20:00,0,3153.0,2401.0,0.761,15.082,614,225,168,57,389,302,87,81,0.0,0.0
1005,231,2020-03-16 22:23:00,0,3414.0,2501.0,0.733,16.22,460,230,168,62,230,156,74,72,0.0,0.0
1005,232,2020-03-16 22:26:00,0,3403.0,2530.0,0.744,16.21,941,368,292,76,573,453,120,69,0.0,0.0
1005,233,2020-03-16 22:29:00,0,3563.0,2673.0,0.75,16.997,435,207,151,56,228,164,64,80,0.0,0.0
1005,234,2020-03-16 22:32:00,0,3230.0,2464.0,0.763,15.453,552,233,180,53,319,239,80,78,0.11,0.0
1005,235,2020-03-16 22:35:00,0,2988.0,2239.0,0.749,14.253,567,164,112,52,403,298,105,40,0.0,0.0
1005,236,2020-03-16 22:38:00,0,2572.0,1934.0,0.752,12.275,356,16,3,13,340,233,107,69,0.0,0.0
1005,237,2020-03-16 22:41:00,0,3159.0,2393.0,0.757,15.095,387,74,32,42,313,211,102,37,0.0,0.0
1005,238,2020-03-16 22:44:00,0,3139.0,2457.0,0.783,15.088,588,230,173,57,358,253,105,82,0.0,0.0
1005,239,2020-03-16 22:47:00,0,3129.0,2449.0,0.783,15.04,413,180,137,43,233,159,74,112,0.0,0.0
1005,240,2020-03-16 22:50:00,0,3418.0,2495.0,0.73,16.228,464,198,144,54,266,201,65,78,0.09,0.0
1005,241,2020-03-16 22:53:00,0,3409.0,2506.0,0.735,16.207,191,68,45,23,123,66,57,44,0.0,0.0
1005,242,2020-03-16 22:56:00,0,2962.0,2312.0,0.781,14.229,115,36,13,23,79,15,64,3,0.0,0.0
1005,243,2020-03-16 22:59:00,0,2571.0,1977.0,0.769,12.321,69,4,2,2,65,2,63,0,0.0,0.0
1005,244,2020-03-16 23:02:00,0,2455.0,1841.5,0.7495,11.7125,57,6,2,4,51,0,51,0,0.0,0.0
1005,245,2020-03-16 23:05:00,0,2339.0,1706.0,0.73,11.104,104,34,17,17,70,10,60,0,0.0,0.0
1005,246,2020-03-16 23:08:00,0,2759.0,2034.0,0.737,13.122,81,8,6,2,73,10,63,0,0.0,0.0
1005,247,2020-03-16 23:11:00,0,2393.0,1818.0,0.76,11.442,75,8,5,3,67,6,61,0,0.0,0.0
1005,248,2020-03-16 23:14:00,0,2162.0,1606.0,0.743,10.295,58,1,0,1,57,0,57,0,0.0,0.0
1005,249,2020-03-16 23:17:00,0,2162.0,1659.0,0.767,10.355,71,6,2,4,65,5,60,0,0.0,0.0
1005,250,2020-03-16 23:20:00,0,2346.0,1716.0,0.732,11.142,80,4,0,4,76,4,72,0,0.0,0.0
1005,251,2020-03-16 23:23:00,0,2150.0,1620.0,0.753,10.266,81,8,2,6,73,6,67,0,0.0,0.0
1005,252,2020-03-16 23:26:00,0,2189.0,1534.0,0.701,10.324,75,9,0,9,66,0,66,0,0.0,0.0
1005,253,2020-03-16 23:29:00,0,2435.0,1779.0,0.731,11.564,339,132,93,39,207,129,78,36,0.16,0.0
1005,254,2020-03-16 23:32:00,0,2840.0,2090.0,0.736,13.506,358,83,63,20,275,203,72,15,0.33,0.0
1005,255,2020-03-16 23:35:00,0,2567.0,1938.0,0.755,12.259,546,212,160,52,334,248,86,70,0.0,0.0
1005,256,2020-03-16 23:38:00,0,2833.0,2085.0,0.736,13.472,242,82,32,50,160,83,77,26,0.0,0.0
1005,257,2020-03-16 23:41:00,0,2813.0,2199.0,0.782,13.52,197,72,29,43,125,56,69,14,0.0,0.0
1005,258,2020-03-16 23:44:00,0,2734.0,2066.0,0.755,13.061,175,54,15,39,121,46,75,5,0.0,0.0
1005,259,2020-03-16 23:47:00,0,2822.0,2143.0,0.76,13.491,338,133,101,32,205,143,62,4,0.0,0.0
1005,260,2020-03-16 23:50:00,0,2794.0,2222.0,0.795,13.469,392,164,118,46,228,161,67,58,0.0,0.0
1005,261,2020-03-16 23:53:00,0,2145.0,1684.0,0.785,10.318,309,121,82,39,188,118,70,61,0.0,0.0
1005,262,2020-03-16 23:56:00,0,2984.0,2330.0,0.781,14.337,536,230,163,67,306,225,81,99,0.07,0.0
1005,263,2020-03-16 23:59:00,0,3240.0,2468.0,0.762,15.498,462,129,86,43,333,247,86,36,0.14,0.0
1005,264,2020-03-17 00:02:00,0,2980.0,2299.0,0.771,14.288,583,169,132,37,414,322,92,42,0.0,0.0
1005,265,2020-03-17 00:05:00,0,2843.0,2119.0,0.745,13.548,229,15,10,5,214,168,46,0,0.0,0.0
1005,266,2020-03-17 00:08:00,0,2744.0,2026.0,0.738,13.056,231,0,0,0,231,158,73,0,0.0,0.0
1005,267,2020-03-17 00:11:00,0,2839.0,2060.0,0.726,13.466,282,22,4,18,260,208,52,0,0.0,0.0
1005,268,2020-03-17 00:14:00,0,2563.0,1963.0,0.766,12.272,248,22,8,14,226,167,59,0,0.0,0.0
1005,269,2020-03-17 00:17:00,0,2841.0,2073.0,0.73,13.489,287,21,1,20,266,171,95,0,0.0,0.0
1005,270,2020-03-17 00:20:00,0,2756.0,2030.0,0.737,13.106,67,5,1,4,62,10,52,0,0.0,0.0
1005,271,2020-03-17 00:23:00,0,2572.0,1978.0,0.769,12.324,55,2,0,2,53,2,51,0,0.0,0.0
1005,272,2020-03-17 00:26:00,0,2397.0,1836.0,0.766,11.476,47,0,0,0,47,0,47,0,0.0,0.0
1005,273,2020-03-17 00:29:00,0,2423.0,1748.0,0.721,11.484,50,2,0,2,48,0,48,0,0.0,0.0
1005,274,2020-03-17 00:32:00,0,2246.0,1695.0,0.755,10.725,92,12,9,3,80,30,50,0,0.0,0.0
1005,275,2020-03-17 00:35:00,0,2424.0,1793.0,0.74,11.535,166,1,1,0,165,92,73,0,0.0,0.0
1005,276,2020-03-17 00:38:00,0,2323.0,1734.0,0.747,11.073,159,45,12,33,114,44,70,0,0.0,0.0
1005,277,2020-03-17 00:41:00,0,2163.0,1603.0,0.741,10.299,106,17,2,15,89,31,58,0,0.0,0.0
1005,278,2020-03-17 00:44:00,0,2170.0,1609.0,0.742,10.334,260,14,7,7,246,141,105,0,0.0,0.0
1005,279,2020-03-17 00:47:00,0,2172.0,1593.0,0.733,10.321,208,19,7,12,189,103,86,0,0.0,0.0
1005,280,2020-03-17 00:50:00,0,2574.0,1930.0,0.75,12.278,554,192,139,53,362,252,110,28,0.0,0.0
1005,281,2020-03-17 00:53:00,0,2551.0,1979.0,0.776,12.244,442,125,86,39,317,231,86,59,0.13,0.0
1005,282,2020-03-17 00:56:00,0,2805.0,2176.0,0.776,13.461,454,163,120,43,291,222,69,100,0.01,0.0
1005,283,2020-03-17 00:59:00,0,2832.0,2148.0,0.759,13.535,514,225,183,42,289,220,69,146,0.02,0.0
1005,284,2020-03-17 01:02:00,0,2798.0,2187.0,0.782,13.446,717,267,206,61,450,337,113,78,0.0,0.0
1005,285,2020-03-17 01:05:00,0,2975.0,2309.0,0.776,14.277,644,296,243,53,348,269,79,77,0.0,0.0
1005,286,2020-03-17 01:08:00,0,2995.0,2232.0,0.745,14.272,553,228,184,44,325,229,96,131,0.06,0.0
1005,287,2020-03-17 01:11:00,0,2969.0,2311.0,0.778,14.256,504,159,110,49,345,248,97,73,0.0,0.0
1005,288,2020-03-17 01:14:00,0,2971.0,2305.0,0.776,14.258,642,158,114,44,484,363,121,38,0.4,0.0
1005,289,2020-03-17 01:17:00,0,3321.0,2447.0,0.737,15.794,321,89,64,25,232,162,70,51,0.12,0.0
1005,290,2020-03-17 01:20:00,0,2975.0,2306.0,0.775,14.275,299,90,45,45,209,122,87,47,0.0,0.0
1005,291,2020-03-17 01:23:00,0,2976.0,2285.0,0.768,14.257,374,162,114,48,212,142,70,33,0.0,0.0
1005,292,2020-03-17 01:26:00,0,2967.0,2387.0,0.804,14.335,662,278,214,64,384,283,101,49,0.0,0.0
1005,293,2020-03-17 01:29:00,0,3230.0,2499.0,0.774,15.492,297,127,96,31,170,113,57,27,0.34,0.0
1005,294,2020-03-17 01:32:00,0,2895.0,2250.0,0.777,13.899,100,20,8,12,80,34,46,0,0.0,0.0
1005,295,2020-03-17 01:35:00,0,2817.0,2150.0,0.763,13.481,349,174,121,53,175,114,61,12,0.0,0.0
1005,296,2020-03-17 01:38:00,0,2799.0,2181.0,0.779,13.442,515,270,214,56,245,184,61,112,0.0,0.0
1005,297,2020-03-17 01:41:00,0,2810.0,2180.0,0.776,13.485,260,37,16,21,223,148,75,0,0.0,0.0
1005,298,2020-03-17 01:44:00,0,2825.0,2093.0,0.741,13.45,150,15,4,11,135,80,55,0,0.0,0.0
1005,299,2020-03-17 01:47:00,0,2836.0,2138.0,0.754,13.543,468,176,130,46,292,224,68,65,0.0,0.0
1005,300,2020-03-17 01:50:00,0,2809.0,2165.0,0.77,13.466,479,135,109,26,344,243,101,60,0.0,0.0
1005,301,2020-03-17 01:53:00,0,2828.0,2164.0,0.765,13.539,599,256,210,46,343,265,78,48,0.0,0.0
1005,302,2020-03-17 01:56:00,0,3146.0,2400.0,0.763,15.051,154,16,8,8,138,69,69,2,0.49,0.0
1005,303,2020-03-17 01:59:00,0,2836.0,2097.0,0.739,13.495,380,94,63,31,286,193,93,17,0.0,0.0
1005,304,2020-03-17 02:02:00,0,2694.5,2049.5,0.7615,12.8845,167,23,5,18,144,83,61,0,0.0,0.0
1005,305,2020-03-17 02:05:00,0,2553.0,2002.0,0.784,12.274,118,12,0,12,106,45,61,0,0.0,0.0
1005,306,2020-03-17 02:08:00,0,2582.0,1969.0,0.763,12.353,319,115,81,34,204,150,54,4,0.0,0.0
1005,307,2020-03-17 02:11:00,0,2805.0,2248.0,0.801,13.54,125,9,4,5,116,83,33,21,0.0,0.0
1005,308,2020-03-17 02:14:00,0,2948.0,2391.0,0.811,14.262,232,58,21,37,174,104,70,80,0.0,0.0
1005,309,2020-03-17 02:17:00,0,3042.0,2439.0,0.802,14.684,162,0,0,0,162,114,48,1,0.0,0.0
1005,310,2020-03-17 02:20:00,0,2788.0,2250.0,0.807,13.477,240,0,0,0,240,191,49,0,0.0,0.0
1005,311,2020-03-17 02:23:00,0,2823.0,2138.0,0.757,13.489,183,0,0,0,183,127,56,0,0.0,0.0
1005,312,2020-03-17 02:26:00,0,2641.0,2049.0,0.776,12.675,205,15,6,9,190,151,39,14,0.0,0.0
1005,313,2020-03-17 02:29:00,0,2821.0,2107.0,0.747,13.446,381,75,31,44,306,238,68,29,0.0,0.0
1005,314,2020-03-17 02:32:00,0,2986.0,2283.0,0.765,14.292,270,52,21,31,218,134,84,17,0.0,0.0
1005,315,2020-03-17 02:35:00,0,2899.0,2263.0,0.781,13.928,217,5,0,5,212,130,82,0,0.0,0.0
1005,316,2020-03-17 02:38:00,0,2833.0,2119.0,0.748,13.508,204,0,0,0,204,134,70,0,0.0,0.0
1005,317,2020-03-17 02:41:00,0,2550.0,1974.0,0.774,12.234,222,0,0,0,222,172,50,0,0.0,0.0
1005,318,2020-03-17 02:44:00,0,2395.0,1876.0,0.783,11.513,189,4,0,4,185,143,42,0,0.0,0.0
1005,319,2020-03-17 02:47:00,0,2415.0,1818.0,0.753,11.528,204,6,0,6,198,172,26,0,0.0,0.0
1005,320,2020-03-17 02:50:00,0,2324.0,1747.0,0.752,11.091,337,103,62,41,234,171,63,0,0.0,0.0
1005,321,2020-03-17 02:53:00,0,2572.0,1972.0,0.766,12.318,466,89,54,35,377,270,107,1,0.0,0.0
1005,322,2020-03-17 02:56:00,0,2565.0,1996.0,0.778,12.318,56,1,1,0,55,21,34,0,0.0,0.0
1005,323,2020-03-17 02:59:00,0,2481.0,1887.0,0.76,11.866,70,0,0,0,70,24,46,0,0.0,0.0
1005,324,2020-03-17 03:02:00,0,2423.0,1773.0,0.732,11.51,85,1,1,0,84,27,57,0,0.0,0.0
1005,325,2020-03-17 03:05:00,0,2144.0,1663.0,0.776,10.291,67,0,0,0,67,24,43,0,0.0,0.0
1005,326,2020-03-17 03:08:00,0,2165.0,1621.0,0.749,10.325,136,15,9,6,121,53,68,0,0.0,0.0
1005,327,2020-03-17 03:11:00,0,2166.0,1621.0,0.748,10.329,92,0,0,0,92,37,55,0,0.0,0.0
1005,328,2020-03-17 03:14:00,0,2172.0,1585.0,0.73,10.315,79,0,0,0,79,22,57,0,0.0,0.0
1005,329,2020-03-17 03:17:00,0,2177.0,1573.0,0.723,10.317,157,0,0,0,157,73,84,0,0.0,0.0
1005,330,2020-03-17 03:20:00,0,2175.0,1587.0,0.73,10.326,127,1,0,1,126,58,68,0,0.0,0.0
1005,331,2020-03-17 03:23:00,0,2177.0,1547.0,0.71,10.292,90,10,2,8,80,21,59,0,0.0,0.0
1005,332,2020-03-17 03:26:00,0,2166.0,1608.0,0.742,10.316,201,49,30,19,152,76,76,0,0.0,0.0
1005,333,2020-03-17 03:29:00,0,2152.0,1638.0,0.761,10.293,294,31,15,16,263,191,72,0,0.0,0.0
1005,334,2020-03-17 03:32:00,0,2150.0,1653.0,0.769,10.301,131,26,13,13,105,39,66,0,0.0,0.0
1005,335,2020-03-17 03:35:00,0,2332.0,1719.0,0.737,11.092,81,17,2,15,64,6,58,0,0.0,0.0
1005,336,2020-03-17 03:38:00,0,2245.0,1698.0,0.756,10.725,80,4,0,4,76,17,59,0,0.0,0.0
1005,337,2020-03-17 03:41:00,0,2167.0,1640.0,0.757,10.354,202,0,0,0,202,155,47,0,0.0,0.0
1005,338,2020-03-17 03:44:00,0,2185.0,1556.0,0.712,10.331,92,2,1,1,90,37,53,0,0.0,0.0
1005,339,2020-03-17 03:47:00,0,1984.0,1521.0,0.767,9.5,233,19,11,8,214,154,60,0,0.0,0.0
1005,340,2020-03-17 03:50:00,0,1986.0,1516.0,0.763,9.503,191,0,0,0,191,151,40,0,0.0,0.0
1005,341,2020-03-17 03:53:00,0,1988.0,1497.0,0.753,9.489,202,0,0,0,202,118,84,0,0.0,0.0
1005,342,2020-03-17 03:56:00,0,2000.0,1483.0,0.742,9.522,209,7,1,6,202,122,80,0,0.0,0.0
1005,343,2020-03-17 03:59:00,0,1998.0,1501.0,0.751,9.533,260,4,0,4,256,151,105,0,0.0,0.0
1005,344,2020-03-17 04:02:00,0,1998.0,1476.0,0.738,9.508,242,6,0,6,236,130,106,0,0.0,0.0
1005,345,2020-03-17 04:05:00,0,1997.0,1457.0,0.729,9.48,188,8,0,8,180,90,90,0,0.0,0.0
1005,346,2020-03-17 04:08:00,0,2010.0,1471.0,0.732,9.549,214,62,34,28,152,81,71,0,0.0,0.0
1005,347,2020-03-17 04:11:00,0,1994.0,1538.0,0.771,9.559,149,42,35,7,107,49,58,4,0.0,0.0
1005,348,2020-03-17 04:14:00,0,2174.0,1583.0,0.728,10.318,55,0,0,0,55,0,55,0,0.0,0.0
1005,349,2020-03-17 04:17:00,0,2089.0,1534.0,0.734,9.93,59,0,0,0,59,0,59,0,0.0,0.0
1005,350,2020-03-17 04:20:00,0,1997.0,1501.0,0.752,9.53,64,2,1,1,62,8,54,0,0.0,0.0
1005,351,2020-03-17 04:23:00,0,2008.0,1473.0,0.734,9.544,62,0,0,0,62,10,52,0,0.0,0.0
1005,352,2020-03-17 04:26:00,0,2011.0,1458.0,0.725,9.538,57,1,0,1,56,0,56,0,0.0,0.0
1005,353,2020-03-17 04:29:00,0,2006.0,1439.0,0.717,9.498,65,3,0,3,62,0,62,0,0.0,0.0
1005,354,2020-03-17 04:32:00,0,2009.0,1466.0,0.729,9.54,68,8,4,4,60,10,50,0,0.0,0.0
1005,355,2020-03-17 04:35:00,0,2003.0,1458.0,0.728,9.507,189,42,21,21,147,76,71,0,0.0,0.0
1005,356,2020-03-17 04:38:00,0,2162.0,1639.0,0.758,10.336,235,67,16,51,168,100,68,9,0.0,0.0
1005,357,2020-03-17 04:41:00,0,2403.0,1831.0,0.762,11.495,422,150,104,46,272,180,92,27,0.0,0.0
1005,358,2020-03-17 04:44:00,0,2839.0,2054.0,0.724,13.46,479,195,146,49,284,221,63,97,0.19,0.0
1005,359,2020-03-17 04:47:00,0,2843.0,2053.0,0.722,13.475,127,11,6,5,116,84,32,4,0.0,0.0
1005,360,2020-03-17 04:50:00,0,2577.0,1954.0,0.758,12.317,104,0,0,0,104,64,40,0,0.0,0.0
1005,361,2020-03-17 04:53:00,0,2504.0,1865.0,0.745,11.933,118,10,5,5,108,50,58,0,0.0,0.0
1005,362,2020-03-17 04:56:00,0,2424.0,1748.0,0.721,11.486,81,16,2,14,65,6,59,0,0.0,0.0
1005,363,2020-03-17 04:59:00,0,2150.0,1665.0,0.774,10.314,78,15,2,13,63,4,59,0,0.0,0.0
1005,364,2020-03-17 05:02:00,0,2069.0,1594.0,0.77,9.917,114,14,1,13,100,39,61,0,0.0,0.0
1005,365,2020-03-17 05:05:00,0,1988.0,1523.0,0.766,9.52,87,4,3,1,83,20,63,0,0.0,0.0
1005,366,2020-03-17 05:08:00,0,2005.0,1460.0,0.728,9.518,59,0,0,0,59,0,59,0,0.0,0.0
1005,367,2020-03-17 05:11:00,0,2017.0,1435.0,0.712,9.535,55,0,0,0,55,0,55,0,0.0,0.0
1005,368,2020-03-17 05:14:00,0,2015.0,1429.0,0.709,9.522,102,1,0,1,101,38,63,0,0.0,0.0
1005,369,2020-03-17 05:17:00,0,2005.0,1427.0,0.712,9.479,222,15,6,9,207,126,81,0,0.0,0.0
1005,370,2020-03-17 05:20:00,0,1996.0,1467.0,0.735,9.488,59,6,0,6,53,1,52,0,0.0,0.0
1005,371,2020-03-17 05:23:00,0,2016.0,1445.0,0.717,9.543,60,15,7,8,45,1,44,0,0.0,0.0
1005,372,2020-03-17 05:26:00,0,2018.0,1398.0,0.693,9.501,19,16,3,13,3,2,1,0,0.0,0.0
1005,373,2020-03-17 05:29:00,0,1834.0,1349.0,0.736,8.719,11,9,0,9,2,0,2,0,0.0,0.0
1005,374,2020-03-17 05:32:00,0,1743.0,1318.0,0.756,8.328,149,46,26,20,103,59,44,0,0.0,0.0
1005,375,2020-03-17 05:35:00,0,2004.0,1475.0,0.736,9.529,218,32,4,28,186,111,75,30,0.0,0.0
1005,376,2020-03-17 05:38:00,0,2237.0,1716.0,0.767,10.715,486,130,86,44,356,249,107,61,0.0,0.0
1005,377,2020-03-17 05:41:00,0,2747.0,1997.0,0.727,13.035,350,66,43,23,284,185,99,10,0.46,0.0
1005,378,2020-03-17 05:44:00,0,2576.0,1979.0,0.768,12.341,147,9,3,6,138,77,61,0,0.0,0.0
1005,379,2020-03-17 05:47:00,0,2592.0,1897.0,0.732,12.313,116,0,0,0,116,54,62,0,0.0,0.0
1005,380,2020-03-17 05:50:00,0,2423.0,1775.0,0.732,11.512,8,0,0,0,8,3,5,0,0.0,0.0
1005,381,2020-03-17 05:53:00,0,2144.0,1645.0,0.767,10.27,5,2,0,2,3,1,2,0,0.0,0.0
1005,382,2020-03-17 05:56:00,0,2174.0,1588.0,0.73,10.325,0,0,0,0,0,0,0,0,0.0,0.0
1005,383,2020-03-17 05:59:00,0,2086.0,1548.0,0.742,9.933,64,3,2,1,61,20,41,0,0.0,0.0
1005,384,2020-03-17 06:02:00,1,1995.0,1524.0,0.764,9.546,9,0,0,0,9,1,8,0,0.0,0.0
1005,385,2020-03-17 06:05:00,1,1995.0,1510.0,0.757,9.535,3,0,0,0,3,0,3,0,0.0,0.0
1005,386,2020-03-17 06:08:00,1,1988.0,1501.0,0.755,9.496,9,1,1,0,8,4,4,0,0.0,0.0
1005,387,2020-03-17 06:11:00,1,2175.0,1598.0,0.735,10.34,24,9,6,3,15,6,9,0,0.0,0.0
1005,388,2020-03-17 06:14:00,1,2180.0,1584.0,0.727,10.345,4,4,0,4,0,0,0,0,0.0,0.0
1005,389,2020-03-17 06:17:00,1,1994.0,1520.0,0.762,9.538,14,0,0,0,14,0,14,0,0.0,0.0
1005,390,2020-03-17 06:20:00,1,1994.0,1480.0,0.742,9.496,5,0,0,0,5,1,4,0,0.0,0.0
1005,391,2020-03-17 06:23:00,1,2007.0,1450.0,0.722,9.513,130,38,25,13,92,59,33,2,0.02,0.0
1005,392,2020-03-17 06:26:00,1,2147.0,1688.0,0.786,10.33,256,109,61,48,147,87,60,3,0.19,0.0
1005,393,2020-03-17 06:29:00,1,2431.0,1758.0,0.723,11.524,235,80,41,39,155,111,44,22,0.29,0.0
1005,394,2020-03-17 06:32:00,1,2826.0,2135.0,0.755,13.497,485,133,99,34,352,272,80,52,0.28,0.0
1005,395,2020-03-17 06:35:00,1,2576.0,2002.0,0.777,12.366,357,24,8,16,333,235,98,12,0.0,0.0
1005,396,2020-03-17 06:38:00,1,2821.0,2087.0,0.74,13.425,443,87,51,36,356,246,110,7,0.0,0.0
1005,397,2020-03-17 06:41:00,1,2998.0,2277.0,0.76,14.332,496,166,129,37,330,244,86,131,0.2,0.0
1005,398,2020-03-17 06:44:00,1,2986.0,2262.0,0.757,14.271,102,44,29,15,58,45,13,20,0.0,0.0
1005,399,2020-03-17 06:47:00,1,2989.0,2285.0,0.764,14.308,48,41,16,25,7,1,6,11,0.0,0.0
1005,400,2020-03-17 06:50:00,1,2816.0,2136.0,0.759,13.459,11,11,4,7,0,0,0,0,0.0,0.0
1005,401,2020-03-17 06:53:00,1,2556.0,1999.0,0.782,12.285,3,0,0,0,3,1,2,0,0.0,0.0
1005,402,2020-03-17 06:56:00,1,2386.0,1852.0,0.776,11.451,3,0,0,0,3,0,3,0,0.0,0.0
1005,403,2020-03-17 06:59:00,1,2154.0,1666.0,0.774,10.333,6,6,1,5,0,0,0,0,0.0,0.0
1005,404,2020-03-17 07:02:00,1,1984.0,1547.0,0.78,9.53,2,2,0,2,0,0,0,0,0.0,0.0
1005,405,2020-03-17 07:05:00,1,1983.0,1504.0,0.758,9.479,0,0,0,0,0,0,0,0,0.0,0.0
1005,406,2020-03-17 07:08:00,1,1999.0,1499.0,0.75,9.536,85,42,34,8,43,34,9,0,0.0,0.0
1005,407,2020-03-17 07:11:00,1,2181.0,1583.0,0.726,10.347,143,54,43,11,89,42,47,0,0.0,0.0
1005,408,2020-03-17 07:14:00,1,2159.0,1613.0,0.747,10.293,25,9,4,5,16,10,6,0,0.0,0.0
1005,409,2020-03-17 07:17:00,1,2073.0,1558.0,0.752,9.893,0,0,0,0,0,0,0,0,0.0,0.0
1005,410,2020-03-17 07:20:00,1,1987.0,1511.0,0.76,9.501,0,0,0,0,0,0,0,0,0.0,0.0
1005,411,2020-03-17 07:23:00,1,1989.0,1497.0,0.752,9.495,14,0,0,0,14,7,7,0,0.0,0.0
1005,412,2020-03-17 07:26:00,1,1998.0,1464.0,0.733,9.493,49,3,1,2,46,17,29,0,0.0,0.0
1005,413,2020-03-17 07:29:00,1,1727.0,1366.0,0.791,8.316,139,2,0,2,137,56,81,0,0.0,0.0
1005,414,2020-03-17 07:32:00,1,1841.0,1364.0,0.741,8.762,144,16,0,16,128,44,84,0,0.0,0.0
1005,415,2020-03-17 07:35:00,1,2020.0,1435.0,0.71,9.548,110,0,0,0,110,29,81,0,0.0,0.0
1005,416,2020-03-17 07:38:00,1,2005.0,1431.0,0.714,9.484,90,11,0,11,79,0,79,0,0.0,0.0
1005,417,2020-03-17 07:41:00,1,2008.0,1444.0,0.719,9.511,108,28,2,26,80,14,66,0,0.0,0.0
1005,418,2020-03-17 07:44:00,1,2171.0,1583.0,0.729,10.306,197,31,21,10,166,105,61,1,0.0,0.0
1005,419,2020-03-17 07:47:00,1,2164.0,1668.0,0.771,10.372,110,0,0,0,110,33,77,0,0.0,0.0
1005,420,2020-03-17 07:50:00,1,2168.0,1596.0,0.736,10.312,126,23,10,13,103,57,46,4,0.0,0.0
1005,421,2020-03-17 07:53:00,1,2135.0,1704.0,0.798,10.299,178,32,14,18,146,92,54,12,0.0,0.0
1005,422,2020-03-17 07:56:00,1,2575.0,1909.0,0.741,12.26,434,52,13,39,382,304,78,0,0.55,0.0
1005,423,2020-03-17 07:59:00,1,2818.0,2173.0,0.771,13.51,451,163,114,49,288,219,69,85,0.05,0.0
1005,424,2020-03-17 08:02:00,1,2859.5,2200.0,0.7695,13.7035,677,241,188,53,436,330,106,27,0.07,0.0
1005,425,2020-03-17 08:05:00,1,2901.0,2227.0,0.768,13.897,195,91,53,38,104,36,68,17,0.0,0.0
1005,426,2020-03-17 08:08:00,1,2974.0,2257.0,0.759,14.217,773,324,234,90,449,323,126,1,0.0,0.0
1005,427,2020-03-17 08:11:00,1,2987.0,2278.0,0.763,14.293,735,372,286,86,363,256,107,13,0.0,0.0
1005,428,2020-03-17 08:14:00,1,2992.0,2279.0,0.762,14.311,528,230,177,53,298,223,75,0,0.0,0.0
1005,429,2020-03-17 08:17:00,1,3123.0,2452.0,0.785,15.021,52,22,12,10,30,23,7,0,0.0,0.0
1005,430,2020-03-17 08:20:00,1,2789.0,2221.0,0.796,13.448,74,30,5,25,44,22,22,0,0.0,0.02
1005,431,2020-03-17 08:23:00,1,2536.0,2085.0,0.822,12.299,221,75,40,35,146,81,65,0,0.0,0.0
1005,432,2020-03-17 08:26:00,1,2542.0,2055.0,0.808,12.291,81,5,1,4,76,16,60,0,0.0,0.0
1005,433,2020-03-17 08:29:00,1,2548.0,2042.0,0.801,12.299,82,0,0,0,82,17,65,0,0.0,0.0
1005,434,2020-03-17 08:32:00,1,2557.0,1949.0,0.762,12.231,58,0,0,0,58,0,58,0,0.0,0.0
1005,435,2020-03-17 08:35:00,1,2419.0,1820.0,0.753,11.548,69,0,0,0,69,0,69,0,0.0,0.0
1005,436,2020-03-17 08:38:00,1,2142.0,1670.0,0.78,10.287,74,0,0,0,74,9,65,0,0.0,0.0
1005,437,2020-03-17 08:41:00,1,2158.0,1670.0,0.774,10.35,67,0,0,0,67,4,63,0,0.0,0.0
1005,438,2020-03-17 08:44:00,1,2160.0,1621.0,0.751,10.306,67,0,0,0,67,2,65,0,0.0,0.0
1005,439,2020-03-17 08:47:00,1,2173.0,1581.0,0.728,10.312,81,5,2,3,76,8,68,0,0.0,0.0
1005,440,2020-03-17 08:50:00,1,1997.0,1508.0,0.755,9.539,77,9,0,9,68,2,66,0,0.0,0.0
1005,441,2020-03-17 08:53:00,1,1916.0,1385.0,0.723,9.085,67,0,0,0,67,0,67,0,0.0,0.0
1005,442,2020-03-17 08:56:00,1,2013.0,1402.0,0.696,9.484,68,0,0,0,68,2,66,0,0.0,0.0
1005,443,2020-03-17 08:59:00,1,1992.0,1488.0,0.747,9.494,74,0,0,0,74,12,62,0,0.0,0.0
1005,444,2020-03-17 09:02:00,1,1999.0,1495.0,0.748,9.532,96,9,2,7,87,21,66,0,0.0,0.0
1005,445,2020-03-17 09:05:00,1,1842.0,1364.0,0.741,8.768,78,0,0,0,78,8,70,0,0.0,0.0
1005,446,2020-03-17 09:08:00,1,1758.0,1266.0,0.72,8.329,85,4,1,3,81,10,71,0,0.0,0.0
1005,447,2020-03-17 09:11:00,1,1762.0,1255.0,0.712,8.331,78,0,0,0,78,2,76,0,0.0,0.0
1005,448,2020-03-17 09:14:00,1,1744.0,1312.0,0.752,8.326,65,0,0,0,65,0,65,0,0.0,0.0
1005,449,2020-03-17 09:17:00,1,1919.0,1381.0,0.72,9.09,105,0,0,0,105,28,77,0,0.0,0.0
1005,450,2020-03-17 09:20:00,1,2010.0,1447.0,0.72,9.523,92,13,1,12,79,10,69,0,0.0,0.0
1005,451,2020-03-17 09:23:00,1,2006.0,1464.0,0.729,9.526,82,7,0,7,75,0,75,0,0.0,0.0
1005,452,2020-03-17 09:26:00,1,1923.0,1396.0,0.726,9.121,86,3,0,3,83,4,79,0,0.0,0.0
1005,453,2020-03-17 09:29:00,1,1923.0,1393.0,0.724,9.12,85,4,0,4,81,0,81,0,0.0,0.0
1005,454,2020-03-17 09:32:00,1,2006.0,1433.0,0.714,9.491,126,17,8,9,109,32,77,0,0.0,0.0
1005,455,2020-03-17 09:35:00,1,2738.0,2085.0,0.762,13.095,111,20,6,14,91,45,46,0,0.0,0.0
1005,456,2020-03-17 09:38:00,1,2568.0,1982.0,0.772,12.312,19,4,1,3,15,0,15,0,0.0,0.0
1005,457,2020-03-17 09:41:00,1,2237.0,1712.0,0.765,10.71,65,0,0,0,65,0,65,0,0.0,0.0
1005,458,2020-03-17 09:44:00,1,2152.0,1645.0,0.764,10.301,227,66,54,12,161,82,79,2,0.0,0.0
1005,459,2020-03-17 09:47:00,1,2394.0,1854.0,0.774,11.485,243,0,0,0,243,159,84,0,0.0,0.0
1005,460,2020-03-17 09:50:00,1,2575.0,1926.0,0.748,12.277,199,25,6,19,174,92,82,0,0.32,0.0
1005,461,2020-03-17 09:53:00,1,2893.0,2200.0,0.761,13.833,488,173,107,66,315,220,95,1,0.0,0.0
1005,462,2020-03-17 09:56:00,1,2489.0,1924.0,0.773,11.936,170,57,25,32,113,43,70,3,0.0,0.0
1005,463,2020-03-17 09:59:00,1,2562.0,1955.0,0.763,12.258,120,35,2,33,85,4,81,0,0.0,0.0
1005,464,2020-03-17 10:02:00,1,2401.0,1829.0,0.762,11.486,79,1,0,1,78,2,76,0,0.0,0.0
1005,465,2020-03-17 10:05:00,1,2414.0,1801.0,0.746,11.506,95,9,5,4,86,5,81,0,0.0,0.0
1005,466,2020-03-17 10:08:00,1,2564.0,1987.0,0.775,12.304,117,0,0,0,117,32,85,0,0.0,0.0
1005,467,2020-03-17 10:11:00,1,2477.0,1929.0,0.779,11.898,102,1,0,1,101,21,80,0,0.0,0.0
1005,468,2020-03-17 10:14:00,1,2388.0,1898.0,0.795,11.512,120,17,10,7,103,16,87,0,0.0,0.0
1005,469,2020-03-17 10:17:00,1,2414.0,1808.0,0.749,11.513,74,1,0,1,73,0,73,0,0.0,0.0
1005,470,2020-03-17 10:20:00,1,2229.0,1745.0,0.783,10.714,81,6,2,4,75,0,75,0,0.0,0.0
1005,471,2020-03-17 10:23:00,1,2144.0,1647.0,0.768,10.269,78,2,1,1,76,0,76,0,0.0,0.0
1005,472,2020-03-17 10:26:00,1,2149.0,1680.0,0.782,10.328,81,0,0,0,81,4,77,0,0.0,0.0
1005,473,2020-03-17 10:29:00,1,2155.0,1668.0,0.774,10.337,79,0,0,0,79,2,77,0,0.0,0.0
1005,474,2020-03-17 10:32:00,1,2150.0,1693.0,0.787,10.348,79,0,0,0,79,9,70,0,0.0,0.0
1005,475,2020-03-17 10:35:00,1,2154.0,1634.0,0.759,10.295,99,16,7,9,83,8,75,0,0.0,0.0
1005,476,2020-03-17 10:38:00,1,2025.0,1416.0,0.699,9.545,75,1,0,1,74,0,74,0,0.0,0.0
1005,477,2020-03-17 10:41:00,1,2005.0,1477.0,0.737,9.534,88,0,0,0,88,4,84,0,0.0,0.0
1005,478,2020-03-17 10:44:00,1,1979.0,1529.0,0.773,9.491,81,0,0,0,81,10,71,0,0.0,0.0
1005,479,2020-03-17 10:47:00,1,1997.0,1509.0,0.756,9.539,102,19,4,15,83,10,73,0,0.0,0.0
1005,480,2020-03-17 10:50:00,1,2017.0,1437.0,0.712,9.54,95,23,10,13,72,6,66,0,0.0,0.0
1005,481,2020-03-17 10:53:00,1,1992.0,1517.0,0.761,9.529,90,8,2,6,82,7,75,0,0.0,0.0
1005,482,2020-03-17 10:56:00,1,2010.0,1456.0,0.724,9.532,125,19,0,19,106,48,58,0,0.0,0.0
1005,483,2020-03-17 10:59:00,1,2010.0,1442.0,0.717,9.514,84,15,3,12,69,8,61,0,0.0,0.0
1005,484,2020-03-17 11:02:00,1,2079.0,1552.5,0.7455,9.909,128,22,11,11,106,33,73,0,0.0,0.0
1005,485,2020-03-17 11:05:00,1,2148.0,1663.0,0.774,10.304,204,46,33,13,158,74,84,9,0.0,0.0
1005,486,2020-03-17 11:08:00,1,2336.0,1745.0,0.747,11.134,83,0,0,0,83,9,74,0,0.0,0.0
1005,487,2020-03-17 11:11:00,1,2177.0,1583.0,0.727,10.33,120,16,0,16,104,28,76,0,0.0,0.0
1005,488,2020-03-17 11:14:00,1,1986.0,1503.0,0.757,9.489,109,12,9,3,97,31,66,0,0.0,0.0
1005,489,2020-03-17 11:17:00,1,1744.0,1295.0,0.742,8.304,202,15,2,13,187,123,64,0,0.0,0.0
1005,490,2020-03-17 11:20:00,1,1749.0,1285.0,0.735,8.314,274,77,59,18,197,122,75,22,0.0,0.0
1005,491,2020-03-17 11:23:00,1,1726.0,1392.0,0.806,8.342,219,0,0,0,219,126,93,0,0.0,0.0
1005,492,2020-03-17 11:26:00,1,1984.0,1496.0,0.754,9.474,97,5,0,5,92,22,70,0,0.0,0.0
1005,493,2020-03-17 11:29:00,1,1985.0,1551.0,0.782,9.537,154,63,3,60,91,26,65,0,0.0,0.0
1005,494,2020-03-17 11:32:00,1,1995.0,1498.0,0.751,9.521,24,2,1,1,22,0,22,0,0.0,0.0
1005,495,2020-03-17 11:35:00,1,2000.0,1482.0,0.741,9.521,90,7,4,3,83,13,70,0,0.0,0.0
1005,496,2020-03-17 11:38:00,1,2011.0,1440.0,0.716,9.518,70,0,0,0,70,2,68,0,0.0,0.0
1005,497,2020-03-17 11:41:00,1,2022.0,1433.0,0.709,9.554,15,0,0,0,15,0,15,0,0.0,0.0
1005,498,2020-03-17 11:44:00,1,2008.0,1403.0,0.699,9.465,71,0,0,0,71,8,63,0,0.0,0.0
1005,499,2020-03-17 11:47:00,1,2017.0,1421.0,0.705,9.521,95,0,0,0,95,10,85,0,0.0,0.0
1005,500,2020-03-17 11:50:00,1,2007.0,1413.0,0.704,9.472,58,0,0,0,58,0,58,0,0.0,0.0
1005,501,2020-03-17 11:53:00,1,2003.0,1463.0,0.73,9.511,482,0,0,0,482,372,110,0,0.0,0.0
1005,502,2020-03-17 11:56:00,1,2009.0,1447.0,0.72,9.52,344,0,0,0,344,230,114,0,0.0,0.0
1005,503,2020-03-17 11:59:00,1,2007.0,1430.0,0.712,9.492,298,20,10,10,278,180,98,0,0.0,0.0
1005,504,2020-03-17 12:02:00,1,2153.0,1632.0,0.758,10.291,60,11,3,8,49,25,24,0,0.0,0.0
1005,505,2020-03-17 12:05:00,1,2157.0,1633.0,0.757,10.307,6,0,0,0,6,3,3,0,0.0,0.0
1005,506,2020-03-17 12:08:00,1,2181.0,1583.0,0.726,10.347,25,0,0,0,25,18,7,0,0.0,0.0
1005,507,2020-03-17 12:11:00,1,2086.0,1556.0,0.746,9.943,22,0,0,0,22,1,21,0,0.0,0.0
1005,508,2020-03-17 12:14:00,1,1987.0,1517.0,0.764,9.509,30,9,3,6,21,4,17,0,0.0,0.0
1005,509,2020-03-17 12:17:00,1,1989.0,1544.0,0.776,9.544,77,0,0,0,77,16,61,0,0.0,0.0
1005,510,2020-03-17 12:20:00,1,1977.0,1541.0,0.779,9.493,109,4,1,3,105,45,60,0,0.0,0.0
1005,511,2020-03-17 12:23:00,1,1986.0,1499.0,0.755,9.485,87,0,0,0,87,22,65,0,0.0,0.0
1005,512,2020-03-17 12:26:00,1,2005.0,1441.0,0.718,9.496,236,14,5,9,222,135,87,0,0.0,0.0
1005,513,2020-03-17 12:29:00,1,2146.0,1653.0,0.77,10.283,360,65,30,35,295,194,101,8,0.2,0.0
1005,514,2020-03-17 12:32:00,1,2823.0,2114.0,0.749,13.462,591,195,132,63,396,290,106,13,0.18,0.02
1005,515,2020-03-17 12:35:00,1,2552.0,2009.0,0.787,12.278,728,241,173,68,487,379,108,0,0.08,0.0
1005,516,2020-03-17 12:38:00,1,2742.0,2115.0,0.771,13.145,603,213,159,54,390,278,112,2,0.0,0.0
1005,517,2020-03-17 12:41:00,1,2875.0,2287.0,0.795,13.86,281,127,77,50,154,79,75,19,0.0,0.0
1005,518,2020-03-17 12:44:00,1,2815.0,2205.0,0.783,13.531,731,302,224,78,429,324,105,5,0.0,0.0
1005,519,2020-03-17 12:47:00,1,2780.0,2290.0,0.824,13.489,642,268,184,84,374,276,98,10,0.34,0.0
1005,520,2020-03-17 12:50:00,1,2801.0,2206.0,0.788,13.48,861,378,282,96,483,366,117,0,0.0,0.0
1005,521,2020-03-17 12:53:00,1,2787.0,2290.0,0.822,13.514,929,286,211,75,643,503,140,7,0.0,0.0
1005,522,2020-03-17 12:56:00,1,2938.0,2398.0,0.816,14.229,655,204,149,55,451,351,100,5,0.11,0.0
1005,523,2020-03-17 12:59:00,1,2971.0,2374.0,0.799,14.336,814,277,205,72,537,402,135,7,0.0,0.0
1005,524,2020-03-17 13:02:00,1,2789.0,2279.0,0.817,13.511,225,39,21,18,186,101,85,13,0.0,0.0
1005,525,2020-03-17 13:05:00,1,2800.0,2177.0,0.778,13.44,229,68,42,26,161,86,75,6,0.0,0.0
1005,526,2020-03-17 13:08:00,1,2858.0,2369.0,0.829,13.882,649,218,141,77,431,314,117,14,0.0,0.0
1005,527,2020-03-17 13:11:00,1,2792.0,2272.0,0.814,13.515,940,292,206,86,648,514,134,12,0.07,0.0
1005,528,2020-03-17 13:14:00,1,2801.0,2256.0,0.805,13.535,311,36,6,30,275,162,113,5,0.0,0.0
1005,529,2020-03-17 13:17:00,1,2797.0,2194.0,0.784,13.45,325,24,9,15,301,212,89,0,0.0,0.0
1005,530,2020-03-17 13:20:00,1,2807.0,2235.0,0.796,13.532,290,35,17,18,255,149,106,0,0.0,0.0
1005,531,2020-03-17 13:23:00,1,2550.0,1984.0,0.778,12.245,187,0,0,0,187,86,101,0,0.0,0.0
1005,532,2020-03-17 13:26:00,1,2394.0,1856.0,0.775,11.486,151,6,3,3,145,71,74,0,0.0,0.0
1005,533,2020-03-17 13:29:00,1,2393.0,1829.0,0.764,11.453,95,12,3,9,83,6,77,16,0.0,0.0
1005,534,2020-03-17 13:32:00,1,2384.0,1857.0,0.779,11.447,74,2,0,2,72,2,70,21,0.0,0.0
1005,535,2020-03-17 13:35:00,1,2405.0,1815.0,0.755,11.484,82,0,0,0,82,2,80,1,0.0,0.0
1005,536,2020-03-17 13:38:00,1,2317.0,1771.0,0.764,11.088,63,0,0,0,63,2,61,0,0.0,0.0
1005,537,2020-03-17 13:41:00,1,2142.0,1688.0,0.788,10.308,66,0,0,0,66,2,64,0,0.01,0.0
1005,538,2020-03-17 13:44:00,1,2159.0,1639.0,0.759,10.323,70,0,0,0,70,0,70,1,0.0,0.0
1005,539,2020-03-17 13:47:00,1,2173.0,1601.0,0.737,10.333,67,1,1,0,66,4,62,12,0.0,0.0
1005,540,2020-03-17 13:50:00,1,2175.0,1610.0,0.74,10.354,69,7,3,4,62,4,58,16,0.0,0.0
1005,541,2020-03-17 13:53:00,1,2165.0,1568.0,0.724,10.267,89,0,0,0,89,24,65,0,0.0,0.0
1005,542,2020-03-17 13:56:00,1,1995.0,1532.0,0.768,9.558,117,6,0,6,111,47,64,0,0.0,0.0
1005,543,2020-03-17 13:59:00,1,2007.0,1474.0,0.734,9.539,62,4,0,4,58,0,58,0,0.0,0.0
1005,544,2020-03-17 14:02:00,1,2000.0,1477.0,0.738,9.5145,80,10,2,8,70,2,68,0,0.0,0.0
1005,545,2020-03-17 14:05:00,1,1993.0,1480.0,0.742,9.49,75,3,0,3,72,0,72,0,0.0,0.0
1005,546,2020-03-17 14:08:00,1,1985.0,1491.0,0.751,9.471,67,1,0,1,66,0,66,0,0.0,0.0
1005,547,2020-03-17 14:11:00,1,2159.0,1602.0,0.742,10.281,102,21,7,14,81,21,60,0,0.0,0.0
1005,548,2020-03-17 14:14:00,1,2147.0,1689.0,0.787,10.328,79,12,0,12,67,10,57,0,0.0,0.0
1005,549,2020-03-17 14:17:00,1,2135.0,1707.0,0.799,10.302,79,2,0,2,77,2,75,0,0.0,0.0
1005,550,2020-03-17 14:20:00,1,2141.0,1695.0,0.792,10.313,186,12,0,12,174,109,65,0,0.01,0.0
1005,551,2020-03-17 14:23:00,1,2163.0,1628.0,0.753,10.327,206,27,9,18,179,83,96,0,0.0,0.0
1005,552,2020-03-17 14:26:00,1,2179.0,1578.0,0.724,10.333,240,31,8,23,209,118,91,7,0.0,0.0
1005,553,2020-03-17 14:29:00,1,2412.0,1819.0,0.754,11.517,142,42,22,20,100,25,75,11,0.36,0.0
1005,554,2020-03-17 14:32:00,1,2593.0,1952.0,0.753,12.38,216,22,11,11,194,98,96,0,0.21,0.0
1005,555,2020-03-17 14:35:00,1,2320.0,1758.0,0.758,11.087,106,4,1,3,102,35,67,0,0.0,0.0
1005,556,2020-03-17 14:38:00,1,2150.0,1700.0,0.79,10.354,207,62,50,12,145,50,95,0,0.0,0.0
1005,557,2020-03-17 14:41:00,1,2530.0,2059.0,0.814,12.247,675,159,111,48,516,392,124,9,0.26,0.0
1005,558,2020-03-17 14:44:00,1,2821.0,2190.0,0.777,13.538,722,229,174,55,493,373,120,15,0.14,0.0
1005,559,2020-03-17 14:47:00,1,2519.0,2137.0,0.848,12.291,806,291,211,80,515,404,111,3,0.0,0.0
1005,560,2020-03-17 14:50:00,1,2771.0,2353.0,0.849,13.522,568,192,133,59,376,264,112,1,0.0,0.0
1005,561,2020-03-17 14:53:00,1,2855.0,2375.0,0.832,13.877,230,18,10,8,212,115,97,0,0.0,0.0
1005,562,2020-03-17 14:56:00,1,2788.0,2269.0,0.814,13.498,246,66,25,41,180,92,88,21,0.0,0.0
1005,563,2020-03-17 14:59:00,1,2752.0,2377.0,0.864,13.475,375,46,22,24,329,240,89,0,0.0,0.0
1005,564,2020-03-17 15:02:00,1,2531.0,2126.0,0.84,12.326,77,5,1,4,72,0,72,0,0.0,0.0
1005,565,2020-03-17 15:05:00,1,2354.0,1999.0,0.849,11.487,72,0,0,0,72,0,72,0,0.0,0.0
1005,566,2020-03-17 15:08:00,1,2370.0,1934.0,0.816,11.479,73,0,0,0,73,4,69,0,0.0,0.0
1005,567,2020-03-17 15:11:00,1,2121.0,1786.0,0.842,10.336,80,0,0,0,80,14,66,0,0.0,0.0
1005,568,2020-03-17 15:14:00,1,2141.0,1685.0,0.787,10.304,91,0,0,0,91,23,68,0,0.0,0.0
1005,569,2020-03-17 15:17:00,1,2220.0,1760.0,0.793,10.695,85,0,0,0,85,15,70,0,0.0,0.0
1005,570,2020-03-17 15:20:00,1,2215.0,1764.0,0.796,10.681,73,3,1,2,70,4,66,0,0.0,0.0
1005,571,2020-03-17 15:23:00,1,2145.0,1702.0,0.793,10.334,96,2,1,1,94,12,82,0,0.0,0.0
1005,572,2020-03-17 15:26:00,1,2139.0,1730.0,0.809,10.342,121,11,3,8,110,30,80,0,0.0,0.0
1005,573,2020-03-17 15:29:00,1,2143.0,1701.0,0.794,10.327,150,40,0,40,110,33,77,0,0.0,0.0
1005,574,2020-03-17 15:32:00,1,2144.0,1743.0,0.813,10.375,111,34,0,34,77,2,75,0,0.0,0.0
1005,575,2020-03-17 15:35:00,1,2319.0,1748.0,0.754,11.073,84,19,9,10,65,0,65,0,0.0,0.0
1005,576,2020-03-17 15:38:00,1,2426.0,1778.0,0.733,11.527,134,21,8,13,113,46,67,0,0.0,0.0
1005,577,2020-03-17 15:41:00,1,2131.0,1718.0,0.806,10.3,75,1,0,1,74,8,66,0,0.0,0.0
1005,578,2020-03-17 15:44:00,1,2141.0,1672.0,0.781,10.287,86,8,0,8,78,7,71,0,0.0,0.0
1005,579,2020-03-17 15:47:00,1,2168.0,1627.0,0.751,10.343,86,2,0,2,84,2,82,0,0.0,0.0
1005,580,2020-03-17 15:50:00,1,2157.0,1664.0,0.771,10.343,93,9,0,9,84,12,72,0,0.0,0.0
1005,581,2020-03-17 15:53:00,1,2159.0,1634.0,0.757,10.317,61,11,0,11,50,4,46,0,0.0,0.0
1005,582,2020-03-17 15:56:00,1,2154.0,1626.0,0.755,10.289,58,6,0,6,52,0,52,0,0.0,0.0
1005,583,2020-03-17 15:59:00,1,2153.0,1625.0,0.755,10.282,61,10,0,10,51,0,51,0,0.0,0.0
1005,584,2020-03-17 16:02:00,1,2143.0,1664.0,0.777,10.288,186,61,49,12,125,59,66,4,0.0,0.0
1005,585,2020-03-17 16:05:00,1,2149.0,1682.0,0.783,10.33,84,0,0,0,84,39,45,0,0.0,0.0
1005,586,2020-03-17 16:08:00,1,2148.0,1693.0,0.788,10.336,64,0,0,0,64,13,51,0,0.0,0.0
1005,587,2020-03-17 16:11:00,1,2164.0,1646.0,0.761,10.349,104,20,10,10,84,31,53,0,0.0,0.0
1005,588,2020-03-17 16:14:00,1,2190.0,1548.0,0.707,10.343,65,0,0,0,65,2,63,0,0.0,0.0
1005,589,2020-03-17 16:17:00,1,1994.0,1475.0,0.74,9.489,55,0,0,0,55,0,55,0,0.0,0.0
1005,590,2020-03-17 16:20:00,1,2089.0,1529.0,0.732,9.925,81,0,0,0,81,20,61,0,0.0,0.0
1005,591,2020-03-17 16:23:00,1,2179.0,1560.0,0.716,10.312,72,0,0,0,72,14,58,0,0.0,0.0
1005,592,2020-03-17 16:26:00,1,1994.0,1479.0,0.742,9.496,58,2,1,1,56,4,52,0,0.0,0.0
1005,593,2020-03-17 16:29:00,1,2086.0,1547.0,0.742,9.932,53,0,0,0,53,0,53,0,0.0,0.0
1005,594,2020-03-17 16:32:00,1,2163.0,1577.0,0.729,10.271,47,0,0,0,47,2,45,0,0.0,0.0
1005,595,2020-03-17 16:35:00,1,2165.0,1635.0,0.755,10.342,49,4,1,3,45,6,39,0,0.0,0.0
1005,596,2020-03-17 16:38:00,1,2085.0,1545.0,0.741,9.924,45,0,0,0,45,2,43,0,0.0,0.0
1005,597,2020-03-17 16:41:00,1,2003.0,1499.0,0.748,9.55,57,6,2,4,51,4,47,0,0.0,0.0
1005,598,2020-03-17 16:44:00,1,1982.0,1519.0,0.767,9.491,72,3,0,3,69,14,55,0,0.0,0.0
1005,599,2020-03-17 16:47:00,1,1988.0,1510.0,0.76,9.503,68,7,0,7,61,12,49,0,0.0,0.0
1005,600,2020-03-17 16:50:00,1,1991.0,1479.0,0.743,9.483,101,3,1,2,98,33,65,0,0.0,0.0
1005,601,2020-03-17 16:53:00,1,2017.0,1396.0,0.692,9.492,73,0,0,0,73,25,48,0,0.0,0.0
1005,602,2020-03-17 16:56:00,1,2016.0,1403.0,0.696,9.496,65,1,0,1,64,10,54,0,0.0,0.0
1005,603,2020-03-17 16:59:00,1,2091.0,1563.0,0.748,9.969,155,41,19,22,114,51,63,1,0.0,0.0
1005,604,2020-03-17 17:02:00,1,2237.5,1737.5,0.775,10.739,199,36,9,27,163,95,68,1,0.27,0.0
1005,605,2020-03-17 17:05:00,1,2384.0,1912.0,0.802,11.509,176,22,7,15,154,100,54,0,0.49,0.0
1005,606,2020-03-17 17:08:00,1,2542.0,2063.0,0.812,12.3,519,190,139,51,329,243,86,45,0.08,0.0
1005,607,2020-03-17 17:11:00,1,2952.0,2423.0,0.821,14.314,588,297,222,75,291,218,73,138,0.0,0.0
1005,608,2020-03-17 17:14:00,1,2940.0,2460.0,0.837,14.306,437,242,194,48,195,151,44,161,0.0,0.0
1005,609,2020-03-17 17:17:00,1,3099.0,2610.0,0.842,15.099,657,261,213,48,396,312,84,109,0.0,0.0
1005,610,2020-03-17 17:20:00,1,2935.0,2454.0,0.836,14.281,372,107,68,39,265,180,85,25,0.3,0.0
1005,611,2020-03-17 17:23:00,1,3073.0,2663.0,0.866,15.058,548,208,166,42,340,275,65,151,0.0,0.0
1005,612,2020-03-17 17:26:00,1,3163.0,2694.0,0.852,15.447,471,215,167,48,256,205,51,213,0.0,0.0
1005,613,2020-03-17 17:29:00,1,3331.0,2845.0,0.854,16.274,555,251,202,49,304,237,67,149,0.08,0.0
1005,614,2020-03-17 17:32:00,1,3350.0,2765.0,0.825,16.26,467,73,42,31,394,337,57,2,0.0,0.0
1005,615,2020-03-17 17:35:00,1,3074.0,2629.0,0.855,15.022,318,33,11,22,285,215,70,14,0.0,0.0
1005,616,2020-03-17 17:38:00,1,3325.0,2836.0,0.853,16.241,303,64,37,27,239,190,49,0,0.0,0.0
1005,617,2020-03-17 17:41:00,1,2901.0,2561.0,0.883,14.266,356,57,22,35,299,236,63,9,0.0,0.0
1005,618,2020-03-17 17:44:00,1,2922.0,2546.0,0.871,14.329,337,13,3,10,324,257,67,0,0.0,0.0
1005,619,2020-03-17 17:47:00,1,2842.0,2376.0,0.836,13.83,347,27,0,27,320,255,65,11,0.0,0.0
1005,620,2020-03-17 17:50:00,1,2767.0,2315.0,0.836,13.466,293,43,10,33,250,208,42,0,0.0,0.0
1005,621,2020-03-17 17:53:00,1,2798.0,2241.0,0.801,13.506,192,10,7,3,182,131,51,0,0.0,0.0
1005,622,2020-03-17 17:56:00,1,2559.0,2021.0,0.79,12.32,72,1,0,1,71,5,66,0,0.0,0.0
1005,623,2020-03-17 17:59:00,1,2464.0,1989.0,0.807,11.909,70,5,1,4,65,4,61,0,0.0,0.0
1005,624,2020-03-17 18:02:00,0,2303.0,1806.0,0.784,11.075,63,1,1,0,62,0,62,0,0.0,0.0
1005,625,2020-03-17 18:05:00,0,2400.0,1831.0,0.763,11.484,164,22,5,17,142,64,78,0,0.0,0.0
1005,626,2020-03-17 18:08:00,0,2557.0,1966.0,0.769,12.252,166,2,0,2,164,92,72,0,0.0,0.0
1005,627,2020-03-17 18:11:00,0,2388.0,1949.0,0.816,11.568,168,10,1,9,158,78,80,0,0.0,0.0
1005,628,2020-03-17 18:14:00,0,2383.0,1939.0,0.814,11.536,419,63,23,40,356,291,65,4,0.0,0.0
1005,629,2020-03-17 18:17:00,0,2525.0,2083.0,0.825,12.253,513,147,118,29,366,304,62,12,0.45,0.0
1005,630,2020-03-17 18:20:00,0,2636.0,2096.0,0.795,12.707,447,94,52,42,353,290,63,5,0.0,0.0
1005,631,2020-03-17 18:23:00,0,2785.0,2242.0,0.805,13.456,550,55,24,31,495,424,71,44,0.0,0.0
1005,632,2020-03-17 18:26:00,0,2446.0,2005.0,0.82,11.856,281,5,1,4,276,216,60,61,0.0,0.0
1005,633,2020-03-17 18:29:00,0,2374.0,1904.0,0.802,11.462,283,5,0,5,278,170,108,53,0.0,0.0
1005,634,2020-03-17 18:32:00,0,2390.0,1857.0,0.777,11.473,223,7,1,6,216,150,66,29,0.0,0.0
1005,635,2020-03-17 18:35:00,0,2551.0,1982.0,0.777,12.244,291,6,1,5,285,231,54,0,0.0,0.0
1005,636,2020-03-17 18:38:00,0,2547.0,2025.0,0.795,12.278,261,10,8,2,251,174,77,0,0.11,0.0
1005,637,2020-03-17 18:41:00,0,2777.0,2295.0,0.827,13.482,440,17,7,10,423,354,69,0,0.54,0.0
1005,638,2020-03-17 18:44:00,0,2536.0,2049.0,0.808,12.26,287,0,0,0,287,259,28,0,0.0,0.0
1005,639,2020-03-17 18:47:00,0,2356.0,1968.0,0.836,11.461,249,3,0,3,246,211,35,0,0.0,0.0
1005,640,2020-03-17 18:50:00,0,2349.0,2064.0,0.879,11.54,345,80,63,17,265,222,43,2,0.34,0.0
1005,641,2020-03-17 18:53:00,0,2775.0,2337.0,0.842,13.52,336,70,32,38,266,183,83,2,0.09,0.0
1005,642,2020-03-17 18:56:00,0,2760.0,2331.0,0.845,13.456,185,48,13,35,137,67,70,0,0.0,0.0
1005,643,2020-03-17 18:59:00,0,2913.0,2569.0,0.882,14.32,286,52,18,34,234,153,81,1,0.0,0.0
1005,644,2020-03-17 19:02:00,0,2983.0,2668.0,0.894,14.708,315,93,66,27,222,139,83,41,0.19,0.0
1005,645,2020-03-17 19:05:00,0,3316.0,2931.0,0.884,16.308,600,201,158,43,399,317,82,129,0.25,0.0
1005,646,2020-03-17 19:08:00,0,3338.0,2861.0,0.857,16.319,400,204,171,33,196,158,38,168,0.08,0.0
1005,647,2020-03-17 19:11:00,0,3286.0,2955.0,0.899,16.216,565,316,258,58,249,202,47,137,0.0,0.0
1005,648,2020-03-17 19:14:00,0,3465.0,3074.0,0.887,17.055,532,243,209,34,289,235,54,116,0.0,0.0
1005,649,2020-03-17 19:17:00,0,3732.0,3174.0,0.85,18.22,437,186,154,32,251,193,58,75,0.63,0.0
1005,650,2020-03-17 19:20:00,0,3469.0,3086.0,0.89,17.084,468,120,80,40,348,266,82,38,0.15,0.0
1005,651,2020-03-17 19:23:00,0,3733.0,3187.0,0.854,18.236,304,117,78,39,187,118,69,40,0.38,0.0
1005,652,2020-03-17 19:26:00,0,3492.0,3031.0,0.868,17.115,485,200,145,55,285,212,73,48,0.0,0.0
1005,653,2020-03-17 19:29:00,0,3391.0,3007.0,0.887,16.687,199,102,53,49,97,48,49,6,0.0,0.0
1005,654,2020-03-17 19:32:00,0,3328.0,2888.0,0.868,16.308,237,132,89,43,105,66,39,28,0.0,0.0
1005,655,2020-03-17 19:35:00,0,3231.0,2858.0,0.885,15.895,115,42,29,13,73,32,41,17,0.0,0.0
1005,656,2020-03-17 19:38:00,0,3128.0,2826.0,0.903,15.454,53,5,0,5,48,2,46,2,0.0,0.0
1005,657,2020-03-17 19:41:00,0,2901.0,2585.0,0.891,14.293,43,0,0,0,43,2,41,1,0.0,0.0
1005,658,2020-03-17 19:44:00,0,2915.0,2534.0,0.869,14.291,43,2,0,2,41,0,41,3,0.0,0.0
1005,659,2020-03-17 19:47:00,0,2759.0,2381.0,0.863,13.506,257,14,8,6,243,149,94,3,0.7,0.0
1005,660,2020-03-17 19:50:00,0,2740.0,2439.0,0.89,13.496,501,130,96,34,371,272,99,34,0.14,0.0
1005,661,2020-03-17 19:53:00,0,2920.0,2528.0,0.866,14.302,371,71,43,28,300,209,91,7,0.21,0.0
1005,662,2020-03-17 19:56:00,0,2901.0,2575.0,0.888,14.281,296,53,21,32,243,163,80,9,0.07,0.0
1005,663,2020-03-17 19:59:00,0,2720.0,2513.0,0.924,13.499,276,47,25,22,229,163,66,8,0.0,0.0
1005,664,2020-03-17 20:02:00,0,2736.5,2451.5,0.896,13.495,387,85,51,34,302,218,84,8,0.23,0.0
1005,665,2020-03-17 20:05:00,0,2753.0,2390.0,0.868,13.491,215,7,2,5,208,128,80,0,0.0,0.0
1005,666,2020-03-17 20:08:00,0,2403.0,2187.0,0.91,11.889,279,9,5,4,270,158,112,0,0.0,0.0
1005,667,2020-03-17 20:11:00,0,2500.0,2210.0,0.884,12.299,234,9,0,9,225,132,93,0,0.0,0.0
1005,668,2020-03-17 20:14:00,0,2722.0,2492.0,0.915,13.484,385,74,60,14,311,220,91,0,0.4,0.0
1005,669,2020-03-17 20:17:00,0,2754.0,2382.0,0.865,13.487,276,3,0,3,273,157,116,0,0.0,0.0
1005,670,2020-03-17 20:20:00,0,2482.0,2282.0,0.92,12.305,255,17,4,13,238,140,98,0,0.0,0.0
1005,671,2020-03-17 20:23:00,0,2325.0,2124.0,0.914,11.512,255,2,1,1,253,139,114,0,0.0,0.0
1005,672,2020-03-17 20:26:00,0,2899.0,2545.0,0.878,14.239,316,40,23,17,276,193,83,0,0.3,0.0
1005,673,2020-03-17 20:29:00,0,2483.0,2289.0,0.922,12.317,300,52,43,9,248,155,93,0,0.0,0.0
1005,674,2020-03-17 20:32:00,0,2754.0,2421.0,0.879,13.53,226,11,8,3,215,156,59,0,0.02,0.0
1005,675,2020-03-17 20:35:00,0,2514.0,2202.0,0.876,12.341,211,8,1,7,203,126,77,0,0.0,0.0
1005,676,2020-03-17 20:38:00,0,2498.0,2283.0,0.914,12.369,228,8,1,7,220,145,75,0,0.0,0.0
1005,677,2020-03-17 20:41:00,0,2768.0,2312.0,0.835,13.466,303,1,0,1,302,228,74,0,0.0,0.0
1005,678,2020-03-17 20:44:00,0,2596.0,2267.0,0.873,12.737,262,18,13,5,244,164,80,0,0.11,0.0
1005,679,2020-03-17 20:47:00,0,2351.0,2060.0,0.876,11.542,416,2,1,1,414,314,100,0,0.0,0.0
1005,680,2020-03-17 20:50:00,0,2360.0,1960.0,0.831,11.466,707,45,35,10,662,549,113,0,0.0,0.0
1005,681,2020-03-17 20:53:00,0,2770.0,2375.0,0.857,13.543,314,43,25,18,271,190,81,1,0.51,0.0
1005,682,2020-03-17 20:56:00,0,2854.0,2416.0,0.847,13.919,283,66,26,40,217,129,88,8,0.0,0.0
1005,683,2020-03-17 20:59:00,0,2749.0,2433.0,0.885,13.525,273,46,27,19,227,145,82,2,0.0,0.0
1005,684,2020-03-17 21:02:00,0,3084.0,2700.0,0.876,15.139,312,68,32,36,244,168,76,4,0.21,0.0
1005,685,2020-03-17 21:05:00,0,3318.0,2870.0,0.865,16.252,218,50,19,31,168,97,71,2,0.57,0.0
1005,686,2020-03-17 21:08:00,0,3164.0,2794.0,0.883,15.56,763,361,307,54,402,312,90,162,0.0,0.0
1005,687,2020-03-17 21:11:00,0,3307.0,2968.0,0.898,16.317,572,280,234,46,292,227,65,110,0.0,0.0
1005,688,2020-03-17 21:14:00,0,3472.0,3092.0,0.891,17.101,539,228,189,39,311,229,82,139,0.0,0.0
1005,689,2020-03-17 21:17:00,0,3534.0,3202.0,0.906,17.467,721,303,260,43,418,336,82,186,0.0,0.0
1005,690,2020-03-17 21:20:00,0,3638.0,3188.0,0.876,17.863,440,107,78,29,333,240,93,56,0.71,0.0
1005,691,2020-03-17 21:23:00,0,3537.0,3162.0,0.894,17.438,482,174,129,45,308,215,93,91,0.21,0.0
1005,692,2020-03-17 21:26:00,0,3477.0,3113.0,0.895,17.144,642,257,202,55,385,299,86,96,0.03,0.0
1005,693,2020-03-17 21:29:00,0,3734.0,3269.0,0.875,18.332,525,171,128,43,354,250,104,42,0.07,0.0
1005,694,2020-03-17 21:32:00,0,3451.0,3158.0,0.915,17.094,557,189,143,46,368,279,89,106,0.0,0.0
1005,695,2020-03-17 21:35:00,0,3702.0,3392.0,0.916,18.34,334,81,51,30,253,160,93,13,0.12,0.0
1005,696,2020-03-17 21:38:00,0,3375.0,3097.0,0.917,16.727,713,354,287,67,359,291,68,163,0.0,0.0
1005,697,2020-03-17 21:41:00,0,3370.0,3096.0,0.919,16.707,822,430,362,68,392,321,71,176,0.0,0.0
1005,698,2020-03-17 21:44:00,0,3705.0,3245.0,0.876,18.189,334,49,29,20,285,203,82,9,0.87,0.0
1005,699,2020-03-17 21:47:00,0,3474.0,3056.0,0.88,17.07,398,147,91,56,251,177,74,8,0.16,0.0
1005,700,2020-03-17 21:50:00,0,3464.0,3040.0,0.878,17.014,442,69,27,42,373,295,78,4,0.0,0.0
1005,701,2020-03-17 21:53:00,0,3215.0,2901.0,0.902,15.877,640,236,187,49,404,294,110,102,0.0,0.0
1005,702,2020-03-17 21:56:00,0,3353.0,3118.0,0.93,16.663,539,203,159,44,336,275,61,119,0.0,0.0
1005,703,2020-03-17 21:59:00,0,3457.0,3162.0,0.914,17.123,631,246,191,55,385,290,95,117,0.0,0.0
1005,704,2020-03-17 22:02:00,0,3441.0,3195.0,0.928,17.095,630,352,279,73,278,201,77,156,0.0,0.0
1005,705,2020-03-17 22:05:00,0,3614.0,3248.0,0.899,17.836,289,86,53,33,203,128,75,20,0.64,0.0
1005,706,2020-03-17 22:08:00,0,3462.0,3053.0,0.882,17.02,374,68,29,39,306,230,76,17,0.01,0.0
1005,707,2020-03-17 22:11:00,0,3285.0,3026.0,0.921,16.294,323,68,39,29,255,153,102,7,0.15,0.0
1005,708,2020-03-17 22:14:00,0,3109.0,2880.0,0.926,15.439,172,14,0,14,158,75,83,0,0.0,0.0
1005,709,2020-03-17 22:17:00,0,2963.0,2768.0,0.934,14.739,86,17,3,14,69,14,55,0,0.0,0.0
1005,710,2020-03-17 22:20:00,0,3038.0,2847.0,0.937,15.12,172,55,45,10,117,46,71,5,0.26,0.0
1005,711,2020-03-17 22:23:00,0,3290.0,3049.0,0.927,16.338,614,297,237,60,317,243,74,123,0.0,0.0
1005,712,2020-03-17 22:26:00,0,3280.0,3082.0,0.94,16.334,339,154,111,43,185,114,71,32,0.58,0.0
1005,713,2020-03-17 22:29:00,0,3209.0,2937.0,0.915,15.896,228,54,26,28,174,111,63,2,0.02,0.0
1005,714,2020-03-17 22:32:00,0,2866.0,2761.0,0.963,14.348,102,20,6,14,82,35,47,0,0.0,0.0
1005,715,2020-03-17 22:35:00,0,2938.0,2796.0,0.952,14.671,121,35,11,24,86,35,51,0,0.0,0.0
1005,716,2020-03-17 22:38:00,0,2952.0,2772.0,0.939,14.701,214,74,53,21,140,86,54,0,0.23,0.0
1005,717,2020-03-17 22:41:00,0,3469.0,3099.0,0.893,17.1,336,109,68,41,227,156,71,24,0.39,0.0
1005,718,2020-03-17 22:44:00,0,3312.0,2972.0,0.897,16.339,332,75,33,42,257,174,83,6,0.12,0.0
1005,719,2020-03-17 22:47:00,0,3294.0,3009.0,0.914,16.31,576,63,21,42,513,413,100,3,0.0,0.0
1005,720,2020-03-17 22:50:00,0,3285.0,3007.0,0.915,16.274,281,71,54,17,210,139,71,3,0.0,0.0
1005,721,2020-03-17 22:53:00,0,2936.0,2794.0,0.952,14.662,56,6,2,4,50,7,43,0,0.0,0.0
1005,722,2020-03-17 22:56:00,0,2880.0,2678.0,0.93,14.31,50,9,5,4,41,2,39,0,0.0,0.0
1005,723,2020-03-17 22:59:00,0,3059.0,2782.0,0.909,15.134,319,88,66,22,231,156,75,2,0.54,0.0
1005,724,2020-03-17 23:02:00,0,3144.5,2841.0,0.9035,15.5355,232,110,70,40,122,68,54,6,0.33,0.0
1005,725,2020-03-17 23:05:00,0,3230.0,2900.0,0.898,15.937,636,328,257,71,308,253,55,127,0.0,0.0
1005,726,2020-03-17 23:08:00,0,3480.0,3085.0,0.887,17.125,730,370,313,57,360,276,84,188,0.01,0.0
1005,727,2020-03-17 23:11:00,0,3860.0,3505.0,0.908,19.089,710,231,178,53,479,371,108,93,0.0,0.0
1005,728,2020-03-17 23:14:00,0,3430.0,3163.0,0.922,17.017,838,414,331,83,424,335,89,189,0.0,0.0
1005,729,2020-03-17 23:17:00,0,3714.0,3269.0,0.88,18.251,743,362,294,68,381,306,75,147,0.28,0.0
1005,730,2020-03-17 23:20:00,0,3526.0,3163.0,0.897,17.396,588,215,149,66,373,326,47,85,0.28,0.0
1005,731,2020-03-17 23:23:00,0,3538.0,3174.0,0.897,17.453,758,291,223,68,467,373,94,68,0.03,0.0
1005,732,2020-03-17 23:26:00,0,3698.0,3370.0,0.911,18.3,892,333,250,83,559,454,105,106,0.02,0.0
1005,733,2020-03-17 23:29:00,0,3710.0,3226.0,0.87,18.188,546,172,122,50,374,308,66,47,0.33,0.0
1005,734,2020-03-17 23:32:00,0,3710.0,3220.0,0.868,18.182,549,100,52,48,449,389,60,26,0.18,0.0
1005,735,2020-03-17 23:35:00,0,3649.0,3232.0,0.886,17.954,393,122,61,61,271,199,72,0,0.0,0.0
1005,736,2020-03-17 23:38:00,0,3302.0,3020.0,0.915,16.352,271,75,54,21,196,141,55,1,0.0,0.0
1005,737,2020-03-17 23:41:00,0,3138.0,2839.0,0.905,15.506,210,18,3,15,192,142,50,0,0.0,0.0
1005,738,2020-03-17 23:44:00,0,3071.0,2733.0,0.89,15.126,287,11,3,8,276,168,108,0,0.0,0.0
1005,739,2020-03-17 23:47:00,0,3046.0,2756.0,0.905,15.051,239,6,1,5,233,129,104,0,0.0,0.0
1005,740,2020-03-17 23:50:00,0,3236.0,2785.0,0.86,15.835,164,21,4,17,143,73,70,0,0.0,0.0
1005,741,2020-03-17 23:53:00,0,3520.0,2937.0,0.834,17.119,519,131,84,47,388,287,101,5,0.62,0.0
1005,742,2020-03-17 23:56:00,0,3519.0,2966.0,0.843,17.147,722,316,260,56,406,318,88,148,0.03,0.0
1005,743,2020-03-17 23:59:00,0,3652.0,3191.0,0.874,17.922,670,327,260,67,343,266,77,80,0.16,0.0
1005,744,2020-03-18 00:02:00,0,3731.0,3258.0,0.873,18.309,771,320,271,49,451,373,78,207,0.0,0.0
1005,745,2020-03-18 00:05:00,0,3543.0,3165.0,0.893,17.463,736,365,288,77,371,280,91,110,0.0,0.0
1005,746,2020-03-18 00:08:00,0,3703.0,3312.0,0.894,18.254,1100,443,369,74,657,553,104,122,0.18,0.0
1005,747,2020-03-18 00:11:00,0,3901.0,3374.0,0.865,19.104,99,38,0,38,61,21,40,9,0.76,0.0
1005,748,2020-03-18 00:14:00,0,3672.0,3146.0,0.857,17.951,465,115,62,53,350,295,55,17,0.0,0.0
1005,749,2020-03-18 00:17:00,0,3558.0,3136.0,0.882,17.49,488,169,121,48,319,266,53,0,0.0,0.0
1005,750,2020-03-18 00:20:00,0,3329.0,2838.0,0.853,16.258,258,37,10,27,221,186,35,0,0.0,0.0
1005,751,2020-03-18 00:23:00,0,2986.0,2680.0,0.897,14.733,254,95,51,44,159,135,24,4,0.11,0.0
1005,752,2020-03-18 00:26:00,0,3713.0,3277.0,0.883,18.258,516,135,90,45,381,301,80,5,0.36,0.0
1005,753,2020-03-18 00:29:00,0,3460.0,3121.0,0.902,17.089,683,266,204,62,417,320,97,45,0.01,0.0
1005,754,2020-03-18 00:32:00,0,3784.0,3420.0,0.904,18.696,442,210,164,46,232,184,48,29,0.03,0.96
1005,755,2020-03-18 00:35:00,0,3620.0,3266.0,0.902,17.878,479,222,161,61,257,202,55,58,0.0,0.0
1005,756,2020-03-18 00:38:00,0,3433.0,3216.0,0.937,17.087,524,240,176,64,284,222,62,88,0.0,0.0
1005,757,2020-03-18 00:41:00,0,3309.0,2916.0,0.881,16.268,428,192,145,47,236,185,51,78,0.0,0.0
1005,758,2020-03-18 00:44:00,0,3304.0,2952.0,0.894,16.285,624,226,150,76,398,330,68,34,0.1,0.0
1005,759,2020-03-18 00:47:00,0,3047.0,2771.0,0.909,15.073,114,64,23,41,50,24,26,0,0.0,0.0
1005,760,2020-03-18 00:50:00,0,2892.0,2652.0,0.917,14.329,38,15,3,12,23,0,23,0,0.0,0.0
1005,761,2020-03-18 00:53:00,0,2894.0,2556.0,0.883,14.232,311,114,81,33,197,144,53,18,0.21,0.0
1005,762,2020-03-18 00:56:00,0,3248.0,2782.0,0.856,15.879,298,177,109,68,121,83,38,0,0.22,0.0
1005,763,2020-03-18 00:59:00,0,2999.0,2634.0,0.878,14.733,175,62,22,40,113,63,50,0,0.0,0.0
1005,764,2020-03-18 01:02:00,0,3046.0,2756.0,0.905,15.051,191,127,62,65,64,28,36,0,0.0,0.0
1005,765,2020-03-18 01:05:00,0,3073.0,2731.0,0.889,15.13,59,12,2,10,47,21,26,0,0.0,0.0
1005,766,2020-03-18 01:08:00,0,2907.0,2605.0,0.896,14.339,81,0,0,0,81,35,46,0,0.0,0.0
1005,767,2020-03-18 01:11:00,0,2837.0,2434.0,0.858,13.874,84,6,4,2,78,38,40,0,0.0,0.0
1005,768,2020-03-18 01:14:00,0,2952.0,2436.0,0.825,14.327,70,40,12,28,30,17,13,0,0.0,0.0
1005,769,2020-03-18 01:17:00,0,2692.0,2189.0,0.813,13.032,86,47,3,44,39,14,25,0,0.0,0.0
1005,770,2020-03-18 01:20:00,0,2624.0,2163.0,0.824,12.731,36,4,2,2,32,5,27,0,0.0,0.0
1005,771,2020-03-18 01:23:00,0,2785.0,2252.0,0.809,13.466,301,146,115,31,155,103,52,1,0.39,0.0
1005,772,2020-03-18 01:26:00,0,2932.0,2499.0,0.852,14.318,594,259,185,74,335,260,75,4,0.3,0.0
1005,773,2020-03-18 01:29:00,0,3368.0,2739.0,0.813,16.304,934,313,222,91,621,503,118,22,0.14,0.0
1005,774,2020-03-18 01:32:00,0,3062.0,2686.0,0.877,15.038,1168,487,375,112,681,559,122,55,0.0,0.0
1005,775,2020-03-18 01:35:00,0,3263.0,2775.0,0.85,15.93,575,326,261,65,249,182,67,111,0.0,0.0
1005,776,2020-03-18 01:38:00,0,3320.0,2923.0,0.881,16.317,97,35,0,35,62,32,30,12,0.0,0.0
1005,777,2020-03-18 01:41:00,0,3424.0,2938.0,0.858,16.742,301,129,95,34,172,122,50,74,0.21,0.0
1005,778,2020-03-18 01:44:00,0,3316.0,2841.0,0.857,16.21,507,241,189,52,266,206,60,91,0.0,0.0
1005,779,2020-03-18 01:47:00,0,3327.0,2787.0,0.838,16.193,754,277,220,57,477,375,102,89,0.27,0.0
1005,780,2020-03-18 01:50:00,0,3318.0,2889.0,0.871,16.272,579,233,166,67,346,260,86,20,0.23,0.0
1005,781,2020-03-18 01:53:00,0,2905.0,2604.0,0.896,14.329,680,248,182,66,432,328,104,67,0.21,0.0
1005,782,2020-03-18 01:56:00,0,3311.0,2892.0,0.874,16.248,288,54,25,29,234,160,74,31,0.05,0.0
1005,783,2020-03-18 01:59:00,0,3332.0,2862.0,0.859,16.296,123,43,14,29,80,42,38,0,0.0,0.0
1005,784,2020-03-18 02:02:00,0,3244.0,2835.0,0.8745,15.919,122,37,5,32,85,46,39,0,0.0,0.0
1005,785,2020-03-18 02:05:00,0,3156.0,2808.0,0.89,15.542,122,29,18,11,93,40,53,0,0.0,0.0
1005,786,2020-03-18 02:08:00,0,3072.0,2748.0,0.895,15.144,47,3,0,3,44,7,37,0,0.0,0.0
1005,787,2020-03-18 02:11:00,0,2904.0,2615.0,0.9,14.338,36,0,0,0,36,5,31,0,0.0,0.0
1005,788,2020-03-18 02:14:00,0,2917.0,2491.0,0.854,14.252,29,0,0,0,29,0,29,0,0.0,0.0
1005,789,2020-03-18 02:17:00,0,2758.0,2379.0,0.863,13.501,116,44,32,12,72,36,36,4,0.26,0.0
1005,790,2020-03-18 02:20:00,0,3093.0,2631.0,0.85,15.1,570,250,184,66,320,262,58,4,0.37,0.0
1005,791,2020-03-18 02:23:00,0,3081.0,2613.0,0.848,15.031,499,214,144,70,285,239,46,3,0.09,0.0
1005,792,2020-03-18 02:26:00,0,2929.0,2522.0,0.861,14.334,78,29,15,14,49,7,42,0,0.0,0.0
1005,793,2020-03-18 02:29:00,0,2988.0,2606.0,0.872,14.659,107,74,41,33,33,12,21,1,0.0,0.0
1005,794,2020-03-18 02:32:00,0,2746.0,2376.0,0.865,13.452,91,72,5,67,19,0,19,0,0.0,0.0
1005,795,2020-03-18 02:35:00,0,2755.0,2410.0,0.875,13.522,56,23,6,17,33,2,31,0,0.0,0.0
1005,796,2020-03-18 02:38:00,0,2753.0,2383.0,0.866,13.485,58,18,6,12,40,15,25,0,0.0,0.0
1005,797,2020-03-18 02:41:00,0,3102.0,2614.0,0.843,15.115,486,179,125,54,307,235,72,6,0.69,0.0
1005,798,2020-03-18 02:44:00,0,3082.0,2677.0,0.869,15.109,275,37,17,20,238,173,65,9,0.08,0.0
1005,799,2020-03-18 02:47:00,0,2921.0,2509.0,0.859,14.288,153,30,1,29,123,64,59,0,0.0,0.0
1005,800,2020-03-18 02:50:00,0,2755.0,2379.0,0.864,13.49,136,12,1,11,124,98,26,0,0.0,0.0
1005,801,2020-03-18 02:53:00,0,2775.0,2323.0,0.837,13.507,98,37,5,32,61,57,4,0,0.0,0.0
1005,802,2020-03-18 02:56:00,0,2687.0,2289.0,0.852,13.12,69,5,0,5,64,61,3,0,0.0,0.0
1005,803,2020-03-18 02:59:00,0,2896.0,2582.0,0.892,14.268,167,1,0,1,166,127,39,0,0.0,0.0
1005,804,2020-03-18 03:02:00,0,2742.0,2455.0,0.895,13.52,182,98,58,40,84,50,34,4,0.18,0.0
1005,805,2020-03-18 03:05:00,0,2498.0,2204.0,0.882,12.282,100,62,1,61,38,0,38,0,0.0,0.0
1005,806,2020-03-18 03:08:00,0,2691.0,2261.0,0.84,13.108,229,181,116,65,48,16,32,0,0.0,0.0
1005,807,2020-03-18 03:11:00,0,2783.0,2248.0,0.808,13.455,639,524,435,89,115,70,45,0,0.0,0.0
1005,808,2020-03-18 03:14:00,0,2771.0,2326.0,0.839,13.492,117,84,25,59,33,0,33,0,0.0,0.0
1005,809,2020-03-18 03:17:00,0,2946.0,2393.0,0.812,14.259,313,281,216,65,32,12,20,0,0.0,0.0
1005,810,2020-03-18 03:20:00,0,2785.0,2256.0,0.81,13.471,531,507,407,100,24,4,20,0,0.0,0.0
1005,811,2020-03-18 03:23:00,0,2719.0,2177.0,0.801,13.125,105,99,53,46,6,2,4,0,0.0,0.0
1005,812,2020-03-18 03:26:00,0,2809.0,2187.0,0.779,13.491,136,99,60,39,37,24,13,0,0.19,0.0
1005,813,2020-03-18 03:29:00,0,2817.0,2186.0,0.776,13.522,157,71,55,16,86,57,29,0,0.05,0.0
1005,814,2020-03-18 03:32:00,0,2710.0,2163.0,0.798,13.072,29,9,3,6,20,0,20,0,0.0,0.0
1005,815,2020-03-18 03:35:00,0,2614.0,2148.0,0.822,12.678,54,32,5,27,22,2,20,0,0.0,0.0
1005,816,2020-03-18 03:38:00,0,2545.0,2066.0,0.812,12.314,184,161,107,54,23,4,19,0,0.0,0.0
1005,817,2020-03-18 03:41:00,0,2561.0,2022.0,0.79,12.328,313,288,193,95,25,4,21,0,0.0,0.0
1005,818,2020-03-18 03:44:00,0,2555.0,1984.0,0.776,12.264,57,20,1,19,37,4,33,0,0.0,0.0
1005,819,2020-03-18 03:47:00,0,2378.0,1964.0,0.826,11.546,128,41,21,20,87,39,48,0,0.33,0.0
1005,820,2020-03-18 03:50:00,0,2519.0,2084.0,0.827,12.231,125,56,28,28,69,37,32,9,0.42,0.0
1005,821,2020-03-18 03:53:00,0,2528.0,2131.0,0.843,12.32,188,49,18,31,139,85,54,2,0.08,0.0
1005,822,2020-03-18 03:56:00,0,2744.0,2392.0,0.872,13.461,595,263,212,51,332,251,81,28,0.18,0.0
1005,823,2020-03-18 03:59:00,0,3314.0,2844.0,0.858,16.207,169,65,45,20,104,57,47,3,0.0,0.0
1005,824,2020-03-18 04:02:00,0,2763.0,2381.0,0.862,13.524,60,55,4,51,5,0,5,0,0.0,0.0
1005,825,2020-03-18 04:05:00,0,2764.0,2324.0,0.841,13.463,254,251,169,82,3,1,2,0,0.0,0.0
1005,826,2020-03-18 04:08:00,0,2783.0,2320.0,0.833,13.535,354,352,262,90,2,0,2,0,0.0,0.0
1005,827,2020-03-18 04:11:00,0,2771.0,2305.0,0.832,13.468,78,65,6,59,13,0,13,0,0.0,0.0
1005,828,2020-03-18 04:14:00,0,2786.0,2288.0,0.821,13.51,98,64,4,60,34,1,33,0,0.0,0.0
1005,829,2020-03-18 04:17:00,0,2710.0,2212.0,0.816,13.128,100,87,35,52,13,2,11,0,0.0,0.0
1005,830,2020-03-18 04:20:00,0,2795.0,2216.0,0.793,13.465,102,75,19,56,27,8,19,0,0.0,0.0
1005,831,2020-03-18 04:23:00,0,2534.0,2122.0,0.837,12.335,178,73,40,33,105,67,38,0,0.3,0.0
1005,832,2020-03-18 04:26:00,0,2803.0,2268.0,0.809,13.555,116,54,34,20,62,28,34,0,0.1,0.0
1005,833,2020-03-18 04:29:00,0,2704.0,2186.0,0.808,13.075,37,0,0,0,37,0,37,0,0.0,0.0
1005,834,2020-03-18 04:32:00,0,2531.0,2119.0,0.837,12.319,55,22,7,15,33,0,33,0,0.0,0.0
1005,835,2020-03-18 04:35:00,0,2536.0,2119.0,0.835,12.339,65,23,4,19,42,0,42,0,0.0,0.0
1005,836,2020-03-18 04:38:00,0,2414.0,2151.0,0.891,11.891,58,23,13,10,35,0,35,0,0.01,0.0
1005,837,2020-03-18 04:41:00,0,2521.0,2143.0,0.85,12.304,80,42,19,23,38,0,38,0,0.0,0.0
1005,838,2020-03-18 04:44:00,0,2548.0,2029.0,0.796,12.286,97,51,6,45,46,0,46,0,0.0,0.0
1005,839,2020-03-18 04:47:00,0,2558.0,2038.0,0.797,12.336,159,107,12,95,52,6,46,0,0.0,0.0
1005,840,2020-03-18 04:50:00,0,2295.0,1834.0,0.799,11.072,47,4,1,3,43,0,43,0,0.0,0.0
1005,841,2020-03-18 04:53:00,0,2386.0,1887.0,0.791,11.489,48,8,1,7,40,0,40,0,0.0,0.0
1005,842,2020-03-18 04:56:00,0,2391.0,1860.0,0.778,11.48,64,14,2,12,50,2,48,0,0.0,0.0
1005,843,2020-03-18 04:59:00,0,2391.0,1860.0,0.778,11.479,88,43,29,14,45,2,43,0,0.0,0.0
1005,844,2020-03-18 05:02:00,0,2554.0,2013.0,0.7875,12.292,314,133,86,47,181,126,55,4,0.5,0.0
1005,845,2020-03-18 05:05:00,0,2717.0,2166.0,0.797,13.105,165,81,18,63,84,40,44,0,0.01,0.0
1005,846,2020-03-18 05:08:00,0,2712.0,2198.0,0.81,13.118,387,284,194,90,103,47,56,0,0.0,0.0
1005,847,2020-03-18 05:11:00,0,2770.0,2302.0,0.831,13.463,295,140,77,63,155,85,70,0,0.0,0.0
1005,848,2020-03-18 05:14:00,0,2768.0,2313.0,0.836,13.468,276,126,72,54,150,96,54,1,0.28,0.0
1005,849,2020-03-18 05:17:00,0,2932.0,2524.0,0.861,14.347,536,282,213,69,254,202,52,126,0.01,0.0
1005,850,2020-03-18 05:20:00,0,3518.0,2877.0,0.818,17.048,604,297,230,67,307,243,64,177,0.04,0.0
1005,851,2020-03-18 05:23:00,0,3577.0,3053.0,0.853,17.474,274,92,63,29,182,125,57,75,0.61,0.0
1005,852,2020-03-18 05:26:00,0,3334.0,2793.0,0.838,16.229,728,377,310,67,351,290,61,248,0.0,0.0
1005,853,2020-03-18 05:29:00,0,3740.0,3249.0,0.869,18.334,329,166,134,32,163,117,46,63,0.26,0.0
1005,854,2020-03-18 05:32:00,0,3401.0,2969.0,0.873,16.689,273,99,69,30,174,110,64,46,0.0,0.0
1005,855,2020-03-18 05:35:00,0,3496.0,2974.0,0.851,17.067,360,111,66,45,249,178,71,27,0.13,0.0
1005,856,2020-03-18 05:38:00,0,3311.0,2857.0,0.863,16.208,393,162,122,40,231,172,59,57,0.0,0.0
1005,857,2020-03-18 05:41:00,0,3236.0,2831.0,0.875,15.886,1061,427,343,84,634,524,110,134,0.03,0.0
1005,858,2020-03-18 05:44:00,0,3396.0,2966.0,0.873,16.663,578,258,205,53,320,267,53,134,0.09,0.0
1005,859,2020-03-18 05:47:00,0,3739.0,3119.0,0.834,18.186,398,212,159,53,186,143,43,62,0.0,0.0
1005,860,2020-03-18 05:50:00,0,3343.0,2858.0,0.855,16.334,637,277,220,57,360,286,74,147,0.0,0.0
1005,861,2020-03-18 05:53:00,0,3337.0,2843.0,0.852,16.296,270,127,107,20,143,110,33,84,0.41,0.0
1005,862,2020-03-18 05:56:00,0,3162.0,2709.0,0.857,15.457,176,81,29,52,95,57,38,0,0.0,0.0
1005,863,2020-03-18 05:59:00,0,3346.0,2765.0,0.826,16.244,178,38,12,26,140,95,45,2,0.0,0.0
1005,864,2020-03-18 06:02:00,1,3336.0,2833.0,0.849,16.281,655,293,230,63,362,293,69,100,0.0,0.0
1005,865,2020-03-18 06:05:00,1,3498.0,2977.0,0.851,17.078,279,162,137,25,117,85,32,95,0.4,0.0
1005,866,2020-03-18 06:08:00,1,3507.0,2909.0,0.83,17.038,99,72,55,17,27,20,7,105,0.0,0.0
1005,867,2020-03-18 06:11:00,1,3350.0,2837.0,0.847,16.339,146,88,65,23,58,45,13,66,0.0,0.0
1005,868,2020-03-18 06:14:00,1,3359.0,2819.0,0.839,16.355,66,29,16,13,37,28,9,42,0.0,0.0
1005,869,2020-03-18 06:17:00,1,3085.0,2656.0,0.861,15.095,1,1,0,1,0,0,0,0,0.0,0.0
1005,870,2020-03-18 06:20:00,1,2917.0,2511.0,0.861,14.272,9,7,0,7,2,0,2,1,0.0,0.0
1005,871,2020-03-18 06:23:00,1,2854.0,2374.0,0.832,13.872,3,2,0,2,1,0,1,2,0.0,0.0
1005,872,2020-03-18 06:26:00,1,2780.0,2243.0,0.807,13.438,0,0,0,0,0,0,0,0,0.0,0.0
1005,873,2020-03-18 06:29:00,1,2731.0,2150.0,0.787,13.14,0,0,0,0,0,0,0,8,0.0,0.0
1005,874,2020-03-18 06:32:00,1,2535.0,2049.0,0.808,12.256,0,0,0,0,0,0,0,0,0.0,0.0
1005,875,2020-03-18 06:35:00,1,2550.0,2027.0,0.795,12.291,0,0,0,0,0,0,0,0,0.0,0.0
1005,876,2020-03-18 06:38:00,1,2480.0,1942.0,0.783,11.922,180,99,83,16,81,60,21,33,0.2,0.0
1005,877,2020-03-18 06:41:00,1,2890.0,2287.0,0.791,13.92,121,41,22,19,80,51,29,44,0.11,0.0
1005,878,2020-03-18 06:44:00,1,2804.0,2235.0,0.797,13.523,11,8,2,6,3,3,0,28,0.0,0.0
1005,879,2020-03-18 06:47:00,1,2968.0,2381.0,0.802,14.33,167,46,27,19,121,76,45,12,0.07,0.0
1005,880,2020-03-18 06:50:00,1,2792.0,2276.0,0.815,13.52,7,5,0,5,2,1,1,21,0.0,0.0
1005,881,2020-03-18 06:53:00,1,2925.0,2463.0,0.842,14.251,291,152,111,41,139,91,48,32,0.23,0.0
1005,882,2020-03-18 06:56:00,1,3110.0,2509.0,0.807,15.031,378,173,121,52,205,143,62,15,0.25,0.0
1005,883,2020-03-18 06:59:00,1,2962.0,2401.0,0.811,14.327,10,10,3,7,0,0,0,28,0.0,0.0
1005,884,2020-03-18 07:02:00,1,2756.0,2349.0,0.853,13.458,89,29,14,15,60,39,21,1,0.0,0.0
1005,885,2020-03-18 07:05:00,1,2772.0,2339.0,0.844,13.512,18,0,0,0,18,0,18,0,0.0,0.0
1005,886,2020-03-18 07:08:00,1,2793.0,2276.0,0.815,13.524,28,1,0,1,27,0,27,0,0.0,0.0
1005,887,2020-03-18 07:11:00,1,2707.0,2195.0,0.811,13.096,28,0,0,0,28,0,28,0,0.0,0.0
1005,888,2020-03-18 07:14:00,1,2544.0,2111.0,0.83,12.36,46,1,0,1,45,11,34,0,0.0,0.0
1005,889,2020-03-18 07:17:00,1,2451.0,1979.0,0.808,11.848,42,2,1,1,40,6,34,0,0.0,0.0
1005,890,2020-03-18 07:20:00,1,2392.0,1883.0,0.787,11.511,65,18,11,7,47,19,28,0,0.0,0.0
1005,891,2020-03-18 07:23:00,1,2386.0,1888.0,0.791,11.492,35,1,0,1,34,11,23,0,0.0,0.0
1005,892,2020-03-18 07:26:00,1,2387.0,1894.0,0.793,11.501,39,1,0,1,38,8,30,0,0.0,0.0
1005,893,2020-03-18 07:29:00,1,2373.0,1919.0,0.809,11.476,33,0,0,0,33,4,29,0,0.0,0.0
1005,894,2020-03-18 07:32:00,1,2391.0,1844.0,0.771,11.463,40,0,0,0,40,6,34,0,0.0,0.0
1005,895,2020-03-18 07:35:00,1,2391.0,1853.0,0.775,11.471,141,39,34,5,102,53,49,6,0.25,0.0
1005,896,2020-03-18 07:38:00,1,2840.0,2095.0,0.737,13.51,232,11,2,9,221,157,64,7,0.18,0.0
1005,897,2020-03-18 07:41:00,1,2823.0,2150.0,0.762,13.504,142,58,29,29,84,36,48,5,0.0,0.0
1005,898,2020-03-18 07:44:00,1,2622.0,2119.0,0.808,12.678,64,1,0,1,63,24,39,0,0.0,0.0
1005,899,2020-03-18 07:47:00,1,2558.0,2016.0,0.788,12.31,43,2,0,2,41,0,41,0,0.0,0.0
1005,900,2020-03-18 07:50:00,1,2469.0,1972.0,0.799,11.912,59,13,1,12,46,4,42,0,0.0,0.0
1005,901,2020-03-18 07:53:00,1,2401.0,1865.0,0.777,11.525,57,8,2,6,49,0,49,0,0.0,0.0
1005,902,2020-03-18 07:56:00,1,2400.0,1845.0,0.769,11.497,98,20,11,9,78,6,72,0,0.0,0.0
1005,903,2020-03-18 07:59:00,1,2414.0,1789.0,0.741,11.491,78,21,1,20,57,0,57,0,0.0,0.0
1005,904,2020-03-18 08:02:00,1,2369.0,1782.5,0.7525,11.308,209,23,11,12,186,110,76,0,0.01,0.0
1005,905,2020-03-18 08:05:00,1,2324.0,1776.0,0.764,11.125,354,1,0,1,353,252,101,0,0.0,0.0
1005,906,2020-03-18 08:08:00,1,2234.0,1732.0,0.775,10.72,107,1,1,0,106,42,64,0,0.0,0.0
1005,907,2020-03-18 08:11:00,1,2325.0,1729.0,0.744,11.074,50,0,0,0,50,0,50,0,0.0,0.0
1005,908,2020-03-18 08:14:00,1,2134.0,1700.0,0.797,10.291,60,4,0,4,56,4,52,0,0.0,0.0
1005,909,2020-03-18 08:17:00,1,2153.0,1659.0,0.771,10.321,113,9,5,4,104,34,70,0,0.01,0.0
1005,910,2020-03-18 08:20:00,1,2560.0,2039.0,0.796,12.346,394,210,162,48,184,115,69,21,0.16,0.0
1005,911,2020-03-18 08:23:00,1,3416.0,2581.0,0.756,16.317,120,60,37,23,60,43,17,14,0.41,0.01
1005,912,2020-03-18 08:26:00,1,3468.0,2693.0,0.776,16.646,350,204,155,49,146,106,40,57,0.25,0.01
1005,913,2020-03-18 08:29:00,1,2948.0,2373.0,0.805,14.242,98,39,26,13,59,43,16,56,0.0,0.0
1005,914,2020-03-18 08:32:00,1,3145.0,2480.0,0.789,15.135,2,2,0,2,0,0,0,36,0.0,0.01
1005,915,2020-03-18 08:35:00,1,2940.0,2450.0,0.833,14.297,0,0,0,0,0,0,0,3,0.0,0.0
1005,916,2020-03-18 08:38:00,1,2780.0,2329.0,0.838,13.53,0,0,0,0,0,0,0,0,0.0,0.03
1005,917,2020-03-18 08:41:00,1,3175.0,2623.0,0.826,15.415,541,321,252,69,220,165,55,36,0.0,0.06
1005,918,2020-03-18 08:44:00,1,3106.0,2596.0,0.836,15.112,160,97,73,24,63,46,17,72,0.21,0.0
1005,919,2020-03-18 08:47:00,1,3092.0,2577.0,0.834,15.035,277,129,96,33,148,103,45,102,0.0,0.0
1005,920,2020-03-18 08:50:00,1,2936.0,2476.0,0.843,14.307,9,9,3,6,0,0,0,13,0.0,0.0
1005,921,2020-03-18 08:53:00,1,2878.0,2325.0,0.808,13.913,0,0,0,0,0,0,0,0,0.0,0.0
1005,922,2020-03-18 08:56:00,1,2719.0,2132.0,0.784,13.071,0,0,0,0,0,0,0,0,0.0,0.0
1005,923,2020-03-18 08:59:00,1,2575.0,2015.0,0.783,12.377,2,2,0,2,0,0,0,5,0.0,0.0
1005,924,2020-03-18 09:02:00,1,2642.0,2059.0,0.779,12.689,0,0,0,0,0,0,0,23,0.0,0.0
1005,925,2020-03-18 09:05:00,1,2815.0,2136.0,0.759,13.456,0,0,0,0,0,0,0,43,0.0,0.0
1005,926,2020-03-18 09:08:00,1,2825.0,2161.0,0.765,13.524,0,0,0,0,0,0,0,3,0.0,0.0
1005,927,2020-03-18 09:11:00,1,2733.0,2070.0,0.757,13.06,0,0,0,0,0,0,0,0,0.0,0.0
1005,928,2020-03-18 09:14:00,1,2579.0,1974.0,0.765,12.348,0,0,0,0,0,0,0,0,0.0,0.0
1005,929,2020-03-18 09:17:00,1,2383.0,1868.0,0.784,11.459,0,0,0,0,0,0,0,0,0.0,0.0
1005,930,2020-03-18 09:20:00,1,2578.0,1890.0,0.733,12.249,0,0,0,0,0,0,0,0,0.0,0.0
1005,931,2020-03-18 09:23:00,1,2490.0,1866.0,0.749,11.876,0,0,0,0,0,0,0,0,0.0,0.0
1005,932,2020-03-18 09:26:00,1,2402.0,1832.0,0.763,11.492,0,0,0,0,0,0,0,0,0.0,0.0
1005,933,2020-03-18 09:29:00,1,2415.0,1832.0,0.758,11.543,0,0,0,0,0,0,0,0,0.0,0.0
1005,934,2020-03-18 09:32:00,1,2427.0,1742.0,0.718,11.491,0,0,0,0,0,0,0,0,0.0,0.0
1005,935,2020-03-18 09:35:00,1,2336.0,1695.0,0.725,11.081,0,0,0,0,0,0,0,0,0.0,0.0
1005,936,2020-03-18 09:38:00,1,2337.0,1718.0,0.735,11.11,0,0,0,0,0,0,0,0,0.0,0.0
1005,937,2020-03-18 09:41:00,1,2241.0,1685.0,0.752,10.695,0,0,0,0,0,0,0,0,0.0,0.0
1005,938,2020-03-18 09:44:00,1,2153.0,1676.0,0.778,10.34,0,0,0,0,0,0,0,3,0.0,0.0
1005,939,2020-03-18 09:47:00,1,2163.0,1635.0,0.756,10.334,0,0,0,0,0,0,0,0,0.0,0.0
1005,940,2020-03-18 09:50:00,1,2165.0,1626.0,0.751,10.33,0,0,0,0,0,0,0,0,0.0,0.0
1005,941,2020-03-18 09:53:00,1,2148.0,1638.0,0.763,10.277,0,0,0,0,0,0,0,0,0.0,0.0
1005,942,2020-03-18 09:56:00,1,2148.0,1644.0,0.766,10.283,0,0,0,0,0,0,0,0,0.0,0.0
1005,943,2020-03-18 09:59:00,1,2154.0,1637.0,0.76,10.299,0,0,0,0,0,0,0,0,0.0,0.0
1005,944,2020-03-18 10:02:00,1,2248.0,1680.0,0.747,10.715,0,0,0,0,0,0,0,0,0.0,0.0
1005,945,2020-03-18 10:05:00,1,2250.0,1686.0,0.749,10.733,0,0,0,0,0,0,0,0,0.0,0.0
1005,946,2020-03-18 10:08:00,1,2173.0,1581.0,0.728,10.314,0,0,0,0,0,0,0,0,0.0,0.0
1005,947,2020-03-18 10:11:00,1,2159.0,1655.0,0.766,10.337,0,0,0,0,0,0,0,3,0.0,0.0
1005,948,2020-03-18 10:14:00,1,2418.0,1776.0,0.735,11.492,18,9,0,9,9,0,9,1,0.0,0.0
1005,949,2020-03-18 10:17:00,1,2341.0,1696.0,0.724,11.103,1,1,1,0,0,0,0,3,0.0,0.0
1005,950,2020-03-18 10:20:00,1,2180.0,1581.0,0.725,10.34,0,0,0,0,0,0,0,0,0.0,0.0
1005,951,2020-03-18 10:23:00,1,2196.0,1538.0,0.7,10.355,0,0,0,0,0,0,0,0,0.0,0.0
1005,952,2020-03-18 10:26:00,1,2187.0,1549.0,0.708,10.331,101,67,57,10,34,27,7,13,0.0,0.0
1005,953,2020-03-18 10:29:00,1,2984.0,2246.0,0.753,14.242,42,30,22,8,12,8,4,3,0.0,0.0
1005,954,2020-03-18 10:32:00,1,2578.0,1983.0,0.769,12.354,300,142,112,30,158,120,38,55,0.0,0.0
1005,955,2020-03-18 10:35:00,1,2417.0,1819.0,0.753,11.538,0,0,0,0,0,0,0,0,0.0,0.0
1005,956,2020-03-18 10:38:00,1,2329.0,1698.0,0.729,11.055,0,0,0,0,0,0,0,0,0.0,0.0
1005,957,2020-03-18 10:41:00,1,2158.0,1643.0,0.761,10.321,0,0,0,0,0,0,0,2,0.0,0.0
1005,958,2020-03-18 10:44:00,1,2175.0,1552.0,0.714,10.289,0,0,0,0,0,0,0,0,0.0,0.0
1005,959,2020-03-18 10:47:00,1,2179.0,1554.0,0.713,10.308,0,0,0,0,0,0,0,0,0.0,0.0
1005,960,2020-03-18 10:50:00,1,2187.0,1544.0,0.706,10.325,0,0,0,0,0,0,0,0,0.0,0.0
1005,961,2020-03-18 10:53:00,1,2183.0,1565.0,0.717,10.334,0,0,0,0,0,0,0,0,0.0,0.0
1005,962,2020-03-18 10:56:00,1,2172.0,1557.0,0.717,10.283,0,0,0,0,0,0,0,0,0.0,0.0
1005,963,2020-03-18 10:59:00,1,2168.0,1563.0,0.721,10.271,0,0,0,0,0,0,0,0,0.0,0.0
1005,964,2020-03-18 11:02:00,1,2087.0,1525.0,0.731,9.911,0,0,0,0,0,0,0,0,0.0,0.0
1005,965,2020-03-18 11:05:00,1,2006.0,1487.0,0.741,9.551,0,0,0,0,0,0,0,0,0.0,0.0
1005,966,2020-03-18 11:08:00,1,2004.0,1473.0,0.735,9.526,0,0,0,0,0,0,0,0,0.0,0.0
1005,967,2020-03-18 11:11:00,1,2101.0,1490.0,0.709,9.928,0,0,0,0,0,0,0,0,0.0,0.0
1005,968,2020-03-18 11:14:00,1,2090.0,1486.0,0.711,9.881,0,0,0,0,0,0,0,4,0.0,0.0
1005,969,2020-03-18 11:17:00,1,1902.0,1456.0,0.765,9.107,0,0,0,0,0,0,0,0,0.0,0.0
1005,970,2020-03-18 11:20:00,1,1925.0,1422.0,0.739,9.159,0,0,0,0,0,0,0,0,0.0,0.0
1005,971,2020-03-18 11:23:00,1,1919.0,1403.0,0.731,9.116,0,0,0,0,0,0,0,0,0.0,0.0
1005,972,2020-03-18 11:26:00,1,1908.0,1445.0,0.757,9.12,0,0,0,0,0,0,0,0,0.0,0.0
1005,973,2020-03-18 11:29:00,1,1906.0,1459.0,0.765,9.127,3,3,2,1,0,0,0,3,0.0,0.0
1005,974,2020-03-18 11:32:00,1,2071.0,1598.0,0.772,9.931,6,5,0,5,1,1,0,14,0.0,0.0
1005,975,2020-03-18 11:35:00,1,2337.0,1736.0,0.743,11.13,162,74,47,27,88,59,29,44,0.0,0.0
1005,976,2020-03-18 11:38:00,1,2668.0,1979.0,0.742,12.703,568,227,170,57,341,265,76,61,0.0,0.0
1005,977,2020-03-18 11:41:00,1,2485.0,1889.0,0.76,11.883,0,0,0,0,0,0,0,1,0.0,0.0
1005,978,2020-03-18 11:44:00,1,2340.0,1724.0,0.737,11.128,0,0,0,0,0,0,0,1,0.0,0.0
1005,979,2020-03-18 11:47:00,1,2063.0,1631.0,0.79,9.936,5,3,1,2,2,1,1,4,0.0,0.0
1005,980,2020-03-18 11:50:00,1,2252.0,1680.0,0.746,10.735,0,0,0,0,0,0,0,0,0.0,0.0
1005,981,2020-03-18 11:53:00,1,2330.0,1714.0,0.736,11.078,8,6,4,2,2,0,2,17,0.0,0.0
1005,982,2020-03-18 11:56:00,1,2401.0,1882.0,0.784,11.543,0,0,0,0,0,0,0,14,0.0,0.0
1005,983,2020-03-18 11:59:00,1,2490.0,1881.0,0.755,11.893,0,0,0,0,0,0,0,23,0.0,0.0
1005,984,2020-03-18 12:02:00,1,2504.0,1880.0,0.751,11.949,0,0,0,0,0,0,0,0,0.0,0.0
1005,985,2020-03-18 12:05:00,1,2342.0,1704.0,0.728,11.114,0,0,0,0,0,0,0,0,0.0,0.0
1005,986,2020-03-18 12:08:00,1,2080.0,1588.0,0.763,9.952,0,0,0,0,0,0,0,3,0.0,0.0
1005,987,2020-03-18 12:11:00,1,2094.0,1527.0,0.729,9.943,0,0,0,0,0,0,0,1,0.0,0.0
1005,988,2020-03-18 12:14:00,1,2088.0,1495.0,0.716,9.883,0,0,0,0,0,0,0,0,0.0,0.0
1005,989,2020-03-18 12:17:00,1,2088.0,1503.0,0.72,9.892,0,0,0,0,0,0,0,0,0.0,0.0
1005,990,2020-03-18 12:20:00,1,2087.0,1503.0,0.72,9.889,0,0,0,0,0,0,0,0,0.0,0.0
1005,991,2020-03-18 12:23:00,1,1901.0,1459.0,0.768,9.107,0,0,0,0,0,0,0,0,0.0,0.0
1005,992,2020-03-18 12:26:00,1,1903.0,1442.0,0.758,9.095,0,0,0,0,0,0,0,0,0.0,0.0
1005,993,2020-03-18 12:29:00,1,1908.0,1461.0,0.765,9.137,0,0,0,0,0,0,0,0,0.0,0.0
1005,994,2020-03-18 12:32:00,1,1924.0,1387.0,0.721,9.118,0,0,0,0,0,0,0,0,0.01,0.0
1005,995,2020-03-18 12:35:00,1,1937.0,1367.0,0.706,9.145,0,0,0,0,0,0,0,0,0.0,0.0
1005,996,2020-03-18 12:38:00,1,1930.0,1365.0,0.707,9.115,0,0,0,0,0,0,0,0,0.0,0.0
1005,997,2020-03-18 12:41:00,1,1938.0,1352.0,0.698,9.131,0,0,0,0,0,0,0,0,0.0,0.0
1005,998,2020-03-18 12:44:00,1,1930.0,1368.0,0.709,9.119,0,0,0,0,0,0,0,0,0.03,0.0
1005,999,2020-03-18 12:47:00,1,1923.0,1394.0,0.725,9.121,0,0,0,0,0,0,0,0,0.0,0.0
1005,1000,2020-03-18 12:50:00,1,1933.0,1366.0,0.707,9.127,0,0,0,0,0,0,0,5,0.0,0.0
1005,1001,2020-03-18 12:53:00,1,1933.0,1344.0,0.695,9.104,0,0,0,0,0,0,0,0,0.0,0.0
1005,1002,2020-03-18 12:56:00,1,1931.0,1346.0,0.697,9.097,0,0,0,0,0,0,0,0,0.0,0.0
1005,1003,2020-03-18 12:59:00,1,1922.0,1342.0,0.698,9.059,0,0,0,0,0,0,0,0,0.0,0.0
1005,1004,2020-03-18 13:02:00,1,1746.0,1317.0,0.754,8.338,0,0,0,0,0,0,0,0,0.0,0.0
1005,1005,2020-03-18 13:05:00,1,1941.0,1345.0,0.693,9.136,0,0,0,0,0,0,0,0,0.0,0.0
1005,1006,2020-03-18 13:08:00,1,1843.0,1327.0,0.72,8.732,0,0,0,0,0,0,0,0,0.0,0.0
1005,1007,2020-03-18 13:11:00,1,1837.0,1333.0,0.726,8.713,0,0,0,0,0,0,0,4,0.0,0.0
1005,1008,2020-03-18 13:14:00,1,1925.0,1389.0,0.721,9.124,0,0,0,0,0,0,0,0,0.01,0.0
1005,1009,2020-03-18 13:17:00,1,1931.0,1370.0,0.709,9.127,0,0,0,0,0,0,0,0,0.01,0.0
1005,1010,2020-03-18 13:20:00,1,1838.0,1320.0,0.718,8.702,0,0,0,0,0,0,0,0,0.0,0.0
1005,1011,2020-03-18 13:23:00,1,1845.0,1325.0,0.718,8.736,0,0,0,0,0,0,0,0,0.0,0.0
1005,1012,2020-03-18 13:26:00,1,1935.0,1343.0,0.694,9.112,0,0,0,0,0,0,0,0,0.0,0.0
1005,1013,2020-03-18 13:29:00,1,1753.0,1319.0,0.752,8.369,0,0,0,0,0,0,0,2,0.0,0.0
1005,1014,2020-03-18 13:32:00,1,1751.0,1304.0,0.745,8.344,0,0,0,0,0,0,0,0,0.0,0.0
1005,1015,2020-03-18 13:35:00,1,1759.0,1297.0,0.737,8.365,12,8,7,1,4,4,0,13,0.0,0.0
1005,1016,2020-03-18 13:38:00,1,2085.0,1543.0,0.74,9.925,236,80,57,23,156,115,41,28,0.2,0.0
1005,1017,2020-03-18 13:41:00,1,2498.0,1859.0,0.744,11.9,16,9,4,5,7,6,1,0,0.64,0.0
1005,1018,2020-03-18 13:44:00,1,2321.0,1762.0,0.759,11.096,145,60,48,12,85,67,18,23,0.0,0.0
1005,1019,2020-03-18 13:47:00,1,2234.0,1685.0,0.755,10.667,4,3,1,2,1,1,0,3,0.0,0.0
1005,1020,2020-03-18 13:50:00,1,2134.0,1714.0,0.803,10.308,0,0,0,0,0,0,0,0,0.0,0.0
1005,1021,2020-03-18 13:53:00,1,2056.0,1636.0,0.796,9.911,0,0,0,0,0,0,0,0,0.0,0.0
1005,1022,2020-03-18 13:56:00,1,2062.0,1607.0,0.779,9.904,0,0,0,0,0,0,0,1,0.0,0.0
1005,1023,2020-03-18 13:59:00,1,2065.0,1636.0,0.793,9.946,0,0,0,0,0,0,0,1,0.0,0.0
1005,1024,2020-03-18 14:02:00,1,2057.5,1637.5,0.7965,9.9185,0,0,0,0,0,0,0,0,0.0,0.0
1005,1025,2020-03-18 14:05:00,1,2050.0,1639.0,0.8,9.891,1,1,0,1,0,0,0,28,0.0,0.0
1005,1026,2020-03-18 14:08:00,1,2056.0,1660.0,0.808,9.938,1,1,0,1,0,0,0,7,0.0,0.0
1005,1027,2020-03-18 14:11:00,1,1888.0,1539.0,0.815,9.143,0,0,0,0,0,0,0,0,0.0,0.0
1005,1028,2020-03-18 14:14:00,1,1891.0,1514.0,0.801,9.126,0,0,0,0,0,0,0,0,0.0,0.0
1005,1029,2020-03-18 14:17:00,1,1888.0,1541.0,0.816,9.143,0,0,0,0,0,0,0,0,0.0,0.0
1005,1030,2020-03-18 14:20:00,1,1879.0,1529.0,0.814,9.097,0,0,0,0,0,0,0,5,0.0,0.0
1005,1031,2020-03-18 14:23:00,1,1894.0,1522.0,0.803,9.148,0,0,0,0,0,0,0,0,0.0,0.0
1005,1032,2020-03-18 14:26:00,1,1885.0,1522.0,0.807,9.113,0,0,0,0,0,0,0,0,0.0,0.0
1005,1033,2020-03-18 14:29:00,1,1891.0,1505.0,0.796,9.119,0,0,0,0,0,0,0,0,0.0,0.0
1005,1034,2020-03-18 14:32:00,1,1903.0,1505.0,0.791,9.162,0,0,0,0,0,0,0,3,0.0,0.0
1005,1035,2020-03-18 14:35:00,1,1892.0,1475.0,0.779,9.086,0,0,0,0,0,0,0,0,0.0,0.0
1005,1036,2020-03-18 14:38:00,1,1985.0,1519.0,0.765,9.505,0,0,0,0,0,0,0,0,0.0,0.0
1005,1037,2020-03-18 14:41:00,1,2095.0,1541.0,0.735,9.961,0,0,0,0,0,0,0,34,0.0,0.0
1005,1038,2020-03-18 14:44:00,1,2154.0,1677.0,0.778,10.345,19,9,2,7,10,5,5,39,0.0,0.0
1005,1039,2020-03-18 14:47:00,1,2317.0,1779.0,0.768,11.097,32,19,0,19,13,4,9,12,0.0,0.0
1005,1040,2020-03-18 14:50:00,1,2476.0,1988.0,0.803,11.959,243,95,53,42,148,99,49,11,0.54,0.0
1005,1041,2020-03-18 14:53:00,1,2721.0,2121.0,0.779,13.07,450,197,144,53,253,180,73,28,0.0,0.0
1005,1042,2020-03-18 14:56:00,1,2726.0,2083.0,0.764,13.049,510,180,138,42,330,255,75,47,0.06,0.0
1005,1043,2020-03-18 14:59:00,1,2889.0,2244.0,0.777,13.866,189,67,39,28,122,80,42,30,0.0,0.04
1005,1044,2020-03-18 15:02:00,1,2716.0,2144.0,0.789,13.077,326,150,90,60,176,102,74,0,0.04,0.0
1005,1045,2020-03-18 15:05:00,1,2871.0,2292.0,0.798,13.848,692,298,208,90,394,292,102,30,0.0,0.0
1005,1046,2020-03-18 15:08:00,1,3025.0,2476.0,0.819,14.662,222,93,57,36,129,97,32,24,0.34,0.0
1005,1047,2020-03-18 15:11:00,1,3189.0,2610.0,0.818,15.452,197,103,57,46,94,59,35,0,0.12,0.0
1005,1048,2020-03-18 15:14:00,1,2699.0,2249.0,0.833,13.124,485,274,198,76,211,152,59,27,0.0,0.0
1005,1049,2020-03-18 15:17:00,1,2701.0,2263.0,0.838,13.146,18,16,2,14,2,1,1,17,0.0,0.0
1005,1050,2020-03-18 15:20:00,1,2687.0,2273.0,0.846,13.104,1,1,1,0,0,0,0,9,0.0,0.0
1005,1051,2020-03-18 15:23:00,1,2841.0,2422.0,0.852,13.876,15,8,1,7,7,5,2,9,0.0,0.0
1005,1052,2020-03-18 15:26:00,1,2711.0,2153.0,0.794,13.064,0,0,0,0,0,0,0,1,0.0,0.0
1005,1053,2020-03-18 15:29:00,1,2470.0,2018.0,0.817,11.966,0,0,0,0,0,0,0,0,0.0,0.0
1005,1054,2020-03-18 15:32:00,1,2287.0,1899.0,0.83,11.112,0,0,0,0,0,0,0,0,0.0,0.0
1005,1055,2020-03-18 15:35:00,1,2312.0,1822.0,0.788,11.127,0,0,0,0,0,0,0,0,0.0,0.0
1005,1056,2020-03-18 15:38:00,1,2324.0,1784.0,0.767,11.132,0,0,0,0,0,0,0,0,0.0,0.0
1005,1057,2020-03-18 15:41:00,1,2234.0,1743.0,0.78,10.734,0,0,0,0,0,0,0,1,0.0,0.0
1005,1058,2020-03-18 15:44:00,1,2139.0,1697.0,0.793,10.306,0,0,0,0,0,0,0,0,0.0,0.0
1005,1059,2020-03-18 15:47:00,1,2053.0,1684.0,0.82,9.952,0,0,0,0,0,0,0,0,0.0,0.0
1005,1060,2020-03-18 15:50:00,1,2068.0,1606.0,0.776,9.927,0,0,0,0,0,0,0,0,0.0,0.0
1005,1061,2020-03-18 15:53:00,1,2074.0,1602.0,0.773,9.946,0,0,0,0,0,0,0,0,0.0,0.0
1005,1062,2020-03-18 15:56:00,1,2069.0,1630.0,0.788,9.959,0,0,0,0,0,0,0,0,0.0,0.0
1005,1063,2020-03-18 15:59:00,1,2064.0,1610.0,0.78,9.914,0,0,0,0,0,0,0,2,0.0,0.0
1005,1064,2020-03-18 16:02:00,1,2059.0,1592.0,0.773,9.875,0,0,0,0,0,0,0,0,0.0,0.0
1005,1065,2020-03-18 16:05:00,1,2063.0,1569.0,0.76,9.867,0,0,0,0,0,0,0,0,0.0,0.0
1005,1066,2020-03-18 16:08:00,1,2092.0,1564.0,0.748,9.974,0,0,0,0,0,0,0,0,0.0,0.0
1005,1067,2020-03-18 16:11:00,1,2075.0,1582.0,0.763,9.928,0,0,0,0,0,0,0,0,0.0,0.0
1005,1068,2020-03-18 16:14:00,1,2073.0,1557.0,0.751,9.892,0,0,0,0,0,0,0,0,0.0,0.0
1005,1069,2020-03-18 16:17:00,1,2081.0,1537.0,0.739,9.9,0,0,0,0,0,0,0,0,0.0,0.0
1005,1070,2020-03-18 16:20:00,1,2077.0,1542.0,0.743,9.89,0,0,0,0,0,0,0,0,0.0,0.0
1005,1071,2020-03-18 16:23:00,1,2069.0,1605.0,0.776,9.928,0,0,0,0,0,0,0,4,0.0,0.0
1005,1072,2020-03-18 16:26:00,1,2080.0,1601.0,0.77,9.967,0,0,0,0,0,0,0,0,0.0,0.0
1005,1073,2020-03-18 16:29:00,1,2089.0,1540.0,0.737,9.935,0,0,0,0,0,0,0,0,0.0,0.0
1005,1074,2020-03-18 16:32:00,1,2080.0,1561.0,0.75,9.923,0,0,0,0,0,0,0,0,0.0,0.0
1005,1075,2020-03-18 16:35:00,1,2084.0,1573.0,0.755,9.952,0,0,0,0,0,0,0,1,0.0,0.0
1005,1076,2020-03-18 16:38:00,1,2003.0,1517.0,0.757,9.57,140,40,35,5,100,68,32,20,0.2,0.0
1005,1077,2020-03-18 16:41:00,1,2393.0,1838.0,0.768,11.463,160,8,1,7,152,91,61,3,0.16,0.0
1005,1078,2020-03-18 16:44:00,1,2480.0,1885.0,0.76,11.859,91,19,4,15,72,22,50,2,0.0,0.0
1005,1079,2020-03-18 16:47:00,1,2546.0,2048.0,0.804,12.299,186,33,2,31,153,100,53,1,0.0,0.0
1005,1080,2020-03-18 16:50:00,1,2701.0,2150.0,0.796,13.023,204,76,44,32,128,82,46,10,0.2,0.0
1005,1081,2020-03-18 16:53:00,1,2548.0,2052.0,0.805,12.309,522,233,171,62,289,213,76,55,0.0,0.0
1005,1082,2020-03-18 16:56:00,1,2704.0,2161.0,0.799,13.046,213,99,52,47,114,61,53,0,0.04,0.0
1005,1083,2020-03-18 16:59:00,1,2540.0,2064.0,0.813,12.292,224,114,53,61,110,47,63,0,0.0,0.0
1005,1084,2020-03-18 17:02:00,1,2673.0,2142.0,0.802,12.904,220,100,48,52,120,56,64,0,0.0,0.0
1005,1085,2020-03-18 17:05:00,1,2806.0,2220.0,0.791,13.516,145,57,25,32,88,28,60,0,0.0,0.0
1005,1086,2020-03-18 17:08:00,1,2812.0,2160.0,0.768,13.471,241,137,77,60,104,44,60,0,0.0,0.0
1005,1087,2020-03-18 17:11:00,1,2829.0,2121.0,0.749,13.496,244,160,103,57,84,26,58,0,0.0,0.0
1005,1088,2020-03-18 17:14:00,1,2567.0,1943.0,0.757,12.265,98,42,10,32,56,21,35,0,0.0,0.0
1005,1089,2020-03-18 17:17:00,1,2406.0,1825.0,0.758,11.5,110,76,6,70,34,10,24,0,0.0,0.0
1005,1090,2020-03-18 17:20:00,1,2425.0,1812.0,0.747,11.563,183,156,19,137,27,4,23,0,0.0,0.0
1005,1091,2020-03-18 17:23:00,1,2417.0,1769.0,0.732,11.482,180,142,7,135,38,6,32,0,0.0,0.0
1005,1092,2020-03-18 17:26:00,1,2414.0,1789.0,0.741,11.491,131,69,15,54,62,35,27,0,0.0,0.0
1005,1093,2020-03-18 17:29:00,1,2430.0,1769.0,0.728,11.534,129,80,13,67,49,38,11,0,0.0,0.0
1005,1094,2020-03-18 17:32:00,1,2431.0,1748.0,0.719,11.513,98,55,13,42,43,17,26,0,0.0,0.0
1005,1095,2020-03-18 17:35:00,1,2431.0,1742.0,0.716,11.508,43,20,4,16,23,2,21,0,0.0,0.0
1005,1096,2020-03-18 17:38:00,1,2242.0,1671.0,0.745,10.682,172,109,75,34,63,41,22,1,0.0,0.0
1005,1097,2020-03-18 17:41:00,1,2429.0,1728.0,0.712,11.483,148,70,21,49,78,45,33,0,0.15,0.0
1005,1098,2020-03-18 17:44:00,1,2425.0,1705.0,0.703,11.443,74,42,0,42,32,2,30,0,0.0,0.0
1005,1099,2020-03-18 17:47:00,1,2339.0,1698.0,0.726,11.096,80,36,0,36,44,6,38,0,0.0,0.0
1005,1100,2020-03-18 17:50:00,1,2151.0,1685.0,0.784,10.34,56,10,0,10,46,5,41,0,0.0,0.0
1005,1101,2020-03-18 17:53:00,1,2344.0,1698.0,0.724,11.114,132,86,27,59,46,7,39,0,0.0,0.0
1005,1102,2020-03-18 17:56:00,1,2243.0,1684.0,0.751,10.702,184,145,88,57,39,2,37,0,0.0,0.0
1005,1103,2020-03-18 17:59:00,1,2248.0,1680.0,0.747,10.719,142,96,35,61,46,4,42,0,0.0,0.0
1005,1104,2020-03-18 18:02:00,0,2252.0,1687.0,0.749,10.74,265,196,106,90,69,21,48,0,0.0,0.0
1005,1105,2020-03-18 18:05:00,0,2345.0,1709.0,0.729,11.132,364,204,131,73,160,93,67,0,0.0,0.0
1005,1106,2020-03-18 18:08:00,0,3231.0,2475.0,0.766,15.472,396,233,172,61,163,110,53,38,0.38,0.0
1005,1107,2020-03-18 18:11:00,0,2976.0,2253.0,0.757,14.22,395,185,136,49,210,159,51,91,0.23,0.0
1005,1108,2020-03-18 18:14:00,0,3053.0,2369.0,0.776,14.654,305,148,110,38,157,127,30,61,0.04,0.0
1005,1109,2020-03-18 18:17:00,0,2723.0,2067.0,0.759,13.016,310,137,80,57,173,104,69,3,0.0,0.0
1005,1110,2020-03-18 18:20:00,0,2812.0,2157.0,0.767,13.467,178,53,19,34,125,82,43,1,0.0,0.0
1005,1111,2020-03-18 18:23:00,0,2799.0,2258.0,0.807,13.527,228,117,60,57,111,57,54,0,0.0,0.0
1005,1112,2020-03-18 18:26:00,0,2790.0,2253.0,0.808,13.488,208,118,63,55,90,44,46,0,0.31,0.0
1005,1113,2020-03-18 18:29:00,0,2822.0,2169.0,0.769,13.519,130,69,17,52,61,24,37,0,0.26,0.0
1005,1114,2020-03-18 18:32:00,0,2791.0,2217.0,0.794,13.452,239,170,61,109,69,41,28,1,0.22,0.0
1005,1115,2020-03-18 18:35:00,0,2798.0,2267.0,0.81,13.534,239,207,20,187,32,1,31,0,0.0,0.0
1005,1116,2020-03-18 18:38:00,0,2701.0,2166.0,0.802,13.04,222,182,10,172,40,8,32,0,0.0,0.0
1005,1117,2020-03-18 18:41:00,0,2711.0,2184.0,0.806,13.098,248,210,20,190,38,13,25,0,0.0,0.0
1005,1118,2020-03-18 18:44:00,0,2723.0,2201.0,0.808,13.165,180,139,6,133,41,10,31,0,0.0,0.0
1005,1119,2020-03-18 18:47:00,0,3201.0,2643.0,0.826,15.538,68,46,25,21,22,9,13,0,0.64,0.0
1005,1120,2020-03-18 18:50:00,0,3575.0,3008.0,0.841,17.418,281,122,97,25,159,118,41,41,0.24,0.0
1005,1121,2020-03-18 18:53:00,0,2751.0,2347.0,0.853,13.439,27,11,7,4,16,7,9,23,0.0,0.0
1005,1122,2020-03-18 18:56:00,0,2781.0,2322.0,0.835,13.529,83,45,17,28,38,23,15,52,0.06,0.0
1005,1123,2020-03-18 18:59:00,0,3517.0,2939.0,0.836,17.111,488,291,236,55,197,151,46,176,0.0,0.0
1005,1124,2020-03-18 19:02:00,0,3359.0,2767.0,0.824,16.297,714,378,313,65,336,276,60,173,0.04,0.0
1005,1125,2020-03-18 19:05:00,0,3424.0,2949.0,0.861,16.755,286,101,74,27,185,143,42,36,0.57,0.0
1005,1126,2020-03-18 19:08:00,0,3737.0,3275.0,0.876,18.349,59,13,2,11,46,35,11,1,0.16,0.0
1005,1127,2020-03-18 19:11:00,0,3502.0,2985.0,0.852,17.104,137,22,10,12,115,67,48,4,0.0,0.0
1005,1128,2020-03-18 19:14:00,0,3312.0,2931.0,0.885,16.295,556,305,248,57,251,196,55,137,0.14,0.0
1005,1129,2020-03-18 19:17:00,0,3315.0,2846.0,0.858,16.213,1038,562,462,100,476,370,106,191,0.0,0.0
1005,1130,2020-03-18 19:20:00,0,3897.0,3375.0,0.866,19.09,219,92,71,21,127,95,32,37,0.51,0.0
1005,1131,2020-03-18 19:23:00,0,3344.0,2807.0,0.839,16.283,378,153,99,54,225,159,66,21,0.27,0.0
1005,1132,2020-03-18 19:26:00,0,3470.0,2993.0,0.863,16.985,183,48,10,38,135,75,60,3,0.0,0.0
1005,1133,2020-03-18 19:29:00,0,3469.0,3117.0,0.899,17.117,167,32,2,30,135,84,51,4,0.0,0.0
1005,1134,2020-03-18 19:32:00,0,3316.0,2962.0,0.893,16.345,659,280,220,60,379,289,90,65,0.0,0.0
1005,1135,2020-03-18 19:35:00,0,3309.0,2923.0,0.883,16.272,482,176,125,51,306,242,64,73,0.31,0.0
1005,1136,2020-03-18 19:38:00,0,3534.0,3155.0,0.893,17.416,120,10,1,9,110,56,54,1,0.67,0.0
1005,1137,2020-03-18 19:41:00,0,3395.0,2990.0,0.881,16.686,663,327,265,62,336,266,70,144,0.0,0.0
1005,1138,2020-03-18 19:44:00,0,3328.0,2872.0,0.863,16.293,706,393,329,64,313,245,68,205,0.0,0.0
1005,1139,2020-03-18 19:47:00,0,3469.0,3060.0,0.882,17.055,410,175,135,40,235,160,75,74,0.0,0.0
1005,1140,2020-03-18 19:50:00,0,3475.0,3106.0,0.894,17.132,724,348,272,76,376,306,70,120,0.0,0.0
1005,1141,2020-03-18 19:53:00,0,3707.0,3241.0,0.874,18.193,153,49,23,26,104,70,34,1,0.76,0.0
1005,1142,2020-03-18 19:56:00,0,3856.0,3486.0,0.904,19.053,248,61,38,23,187,131,56,7,0.13,0.0
1005,1143,2020-03-18 19:59:00,0,3323.0,2908.0,0.875,16.31,194,75,51,24,119,72,47,20,0.0,0.0
1005,1144,2020-03-18 20:02:00,0,3101.0,2759.0,0.8905,15.271,67,25,9,16,42,9,33,0,0.0,0.0
1005,1145,2020-03-18 20:05:00,0,2879.0,2610.0,0.906,14.232,152,70,43,27,82,40,42,0,0.0,0.0
1005,1146,2020-03-18 20:08:00,0,2893.0,2645.0,0.914,14.329,83,45,5,40,38,12,26,0,0.0,0.0
1005,1147,2020-03-18 20:11:00,0,2822.0,2544.0,0.902,13.935,168,90,51,39,78,31,47,0,0.06,0.0
1005,1148,2020-03-18 20:14:00,0,3252.0,2790.0,0.858,15.901,385,176,126,50,209,152,57,6,0.0,0.0
1005,1149,2020-03-18 20:17:00,0,2924.0,2523.0,0.863,14.316,76,19,13,6,57,25,32,0,0.0,0.0
1005,1150,2020-03-18 20:20:00,0,2905.0,2525.0,0.869,14.239,97,24,14,10,73,38,35,19,0.0,0.0
1005,1151,2020-03-18 20:23:00,0,2905.0,2609.0,0.898,14.334,158,48,19,29,110,56,54,76,0.0,0.0
1005,1152,2020-03-18 20:26:00,0,3164.0,2729.0,0.862,15.489,143,40,15,25,103,50,53,41,0.0,0.0
1005,1153,2020-03-18 20:29:00,0,3109.0,2604.0,0.837,15.134,31,0,0,0,31,7,24,0,0.0,0.0
1005,1154,2020-03-18 20:32:00,0,2946.0,2413.0,0.819,14.28,34,5,3,2,29,10,19,0,0.0,0.0
1005,1155,2020-03-18 20:35:00,0,2784.0,2310.0,0.83,13.528,68,21,11,10,47,12,35,0,0.0,0.0
1005,1156,2020-03-18 20:38:00,0,2784.0,2263.0,0.813,13.475,44,23,0,23,21,2,19,0,0.0,0.0
1005,1157,2020-03-18 20:41:00,0,2820.0,2182.0,0.774,13.528,197,65,35,30,132,73,59,3,0.0,0.0
1005,1158,2020-03-18 20:44:00,0,2944.0,2415.0,0.82,14.273,341,148,70,78,193,124,69,6,0.0,0.0
1005,1159,2020-03-18 20:47:00,0,4180.0,3340.0,0.799,20.166,193,14,4,10,179,100,79,1,0.63,0.0
1005,1160,2020-03-18 20:50:00,0,3925.0,3235.0,0.824,19.045,157,49,12,37,108,66,42,3,0.22,0.0
1005,1161,2020-03-18 20:53:00,0,3525.0,2917.0,0.827,17.12,475,233,186,47,242,187,55,72,0.0,0.0
1005,1162,2020-03-18 20:56:00,0,3778.0,3105.0,0.822,18.325,600,248,191,57,352,276,76,56,0.05,0.0
1005,1163,2020-03-18 20:59:00,0,3318.0,2839.0,0.856,16.218,367,185,143,42,182,137,45,36,0.65,0.0
1005,1164,2020-03-18 21:02:00,0,3489.0,3021.0,0.866,17.092,307,185,124,61,122,84,38,4,0.17,0.2
1005,1165,2020-03-18 21:05:00,0,2924.0,2532.0,0.866,14.324,101,43,34,9,58,29,29,1,0.0,0.0
1005,1166,2020-03-18 21:08:00,0,3659.0,3100.0,0.847,17.849,174,73,44,29,101,69,32,2,0.39,0.0
1005,1167,2020-03-18 21:11:00,0,3065.0,2725.0,0.889,15.091,44,18,0,18,26,0,26,0,0.0,0.0
1005,1168,2020-03-18 21:14:00,0,3068.0,2677.0,0.872,15.052,170,88,52,36,82,38,44,0,0.0,0.0
1005,1169,2020-03-18 21:17:00,0,3081.0,2709.0,0.879,15.138,95,51,20,31,44,4,40,0,0.0,0.0
1005,1170,2020-03-18 21:20:00,0,3060.0,2709.0,0.885,15.057,109,61,48,13,48,29,19,2,0.48,0.0
1005,1171,2020-03-18 21:23:00,0,3704.0,3281.0,0.886,18.226,165,69,33,36,96,60,36,2,0.24,0.0
1005,1172,2020-03-18 21:26:00,0,3149.0,2775.0,0.881,15.478,316,136,87,49,180,123,57,21,0.0,0.0
1005,1173,2020-03-18 21:29:00,0,3330.0,2839.0,0.853,16.264,587,257,211,46,330,268,62,152,0.2,0.0
1005,1174,2020-03-18 21:32:00,0,3321.0,2863.0,0.862,16.254,597,245,193,52,352,276,76,75,0.0,0.0
1005,1175,2020-03-18 21:35:00,0,3253.0,2823.0,0.868,15.943,288,106,78,28,182,124,58,4,0.19,0.0
1005,1176,2020-03-18 21:38:00,0,3067.0,2769.0,0.903,15.149,41,3,0,3,38,4,34,0,0.0,0.0
1005,1177,2020-03-18 21:41:00,0,2905.0,2559.0,0.881,14.281,35,10,1,9,25,2,23,0,0.0,0.0
1005,1178,2020-03-18 21:44:00,0,3479.0,3060.0,0.879,17.095,83,52,38,14,31,21,10,0,0.51,0.0
1005,1179,2020-03-18 21:47:00,0,3078.0,2728.0,0.886,15.145,153,56,32,24,97,59,38,1,0.0,0.0
1005,1180,2020-03-18 21:50:00,0,2895.0,2549.0,0.88,14.23,99,52,37,15,47,25,22,0,0.0,0.0
1005,1181,2020-03-18 21:53:00,0,2746.0,2412.0,0.878,13.49,31,0,0,0,31,0,31,0,0.0,0.0
1005,1182,2020-03-18 21:56:00,0,2735.0,2411.0,0.882,13.446,174,83,64,19,91,63,28,11,0.33,0.0
1005,1183,2020-03-18 21:59:00,0,3326.0,2847.0,0.856,16.256,229,94,59,35,135,100,35,17,0.51,0.0
1005,1184,2020-03-18 22:02:00,0,3048.0,2718.0,0.892,15.017,420,146,99,47,274,204,70,15,0.07,0.0
1005,1185,2020-03-18 22:05:00,0,3076.0,2699.0,0.877,15.108,52,14,8,6,38,11,27,0,0.0,0.0
1005,1186,2020-03-18 22:08:00,0,2909.0,2567.0,0.882,14.305,118,61,43,18,57,21,36,0,0.0,0.0
1005,1187,2020-03-18 22:11:00,0,2888.0,2610.0,0.904,14.269,43,9,3,6,34,0,34,0,0.0,0.0
1005,1188,2020-03-18 22:14:00,0,2815.0,2514.0,0.893,13.876,66,25,1,24,41,4,37,0,0.0,0.0
1005,1189,2020-03-18 22:17:00,0,2759.0,2391.0,0.867,13.516,229,190,134,56,39,0,39,0,0.0,0.0
1005,1190,2020-03-18 22:20:00,0,2759.0,2372.0,0.86,13.495,234,69,53,16,165,103,62,0,0.32,0.0
1005,1191,2020-03-18 22:23:00,0,2930.0,2486.0,0.848,14.295,535,253,177,76,282,190,92,6,0.38,0.0
1005,1192,2020-03-18 22:26:00,0,3484.0,2973.0,0.853,17.019,387,167,134,33,220,161,59,114,0.12,0.0
1005,1193,2020-03-18 22:29:00,0,3252.0,2777.0,0.854,15.887,440,203,149,54,237,186,51,87,0.2,0.0
1005,1194,2020-03-18 22:32:00,0,3063.0,2758.0,0.9,15.121,655,370,293,77,285,226,59,144,0.11,0.0
1005,1195,2020-03-18 22:35:00,0,3314.0,2895.0,0.874,16.26,287,156,108,48,131,86,45,28,0.31,0.0
1005,1196,2020-03-18 22:38:00,0,3717.0,3221.0,0.867,18.212,377,172,134,38,205,154,51,45,0.46,0.0
1005,1197,2020-03-18 22:41:00,0,3306.0,2933.0,0.887,16.271,621,307,245,62,314,233,81,87,0.06,0.0
1005,1198,2020-03-18 22:44:00,0,3306.0,2931.0,0.886,16.271,288,158,107,51,130,88,42,24,0.15,0.0
1005,1199,2020-03-18 22:47:00,0,3705.0,3358.0,0.906,18.315,316,151,108,43,165,129,36,33,0.32,0.0
1005,1200,2020-03-18 22:50:00,0,3060.0,2770.0,0.905,15.124,2,2,1,1,0,0,0,22,0.0,0.0
1005,1201,2020-03-18 22:53:00,0,2868.0,2723.0,0.949,14.314,1,0,0,0,1,1,0,80,0.0,0.0
1005,1202,2020-03-18 22:56:00,0,3046.0,2803.0,0.92,15.104,87,46,36,10,41,34,7,60,0.55,0.0
1005,1203,2020-03-18 22:59:00,0,3787.0,3442.0,0.909,18.731,145,81,56,25,64,50,14,32,0.26,0.0
1005,1204,2020-03-18 23:02:00,0,3339.0,3038.0,0.91,16.5185,0,0,0,0,0,0,0,27,0.0,0.0
1005,1205,2020-03-18 23:05:00,0,2891.0,2634.0,0.911,14.306,30,18,11,7,12,11,1,34,0.0,0.0
1005,1206,2020-03-18 23:08:00,0,3048.0,2801.0,0.919,15.111,190,96,70,26,94,70,24,5,0.46,0.0
1005,1207,2020-03-18 23:11:00,0,3457.0,3122.0,0.903,17.079,276,136,100,36,140,99,41,54,0.03,0.0
1005,1208,2020-03-18 23:14:00,0,2884.0,2680.0,0.929,14.331,51,12,2,10,39,6,33,68,0.0,0.0
1005,1209,2020-03-18 23:17:00,0,2954.0,2755.0,0.933,14.69,103,66,55,11,37,22,15,48,0.0,0.0
1005,1210,2020-03-18 23:20:00,0,2867.0,2719.0,0.948,14.306,1,1,1,0,0,0,0,5,0.0,0.0
1005,1211,2020-03-18 23:23:00,0,2796.0,2609.0,0.933,13.904,3,2,1,1,1,0,1,4,0.0,0.0
1005,1212,2020-03-18 23:26:00,0,2704.0,2562.0,0.948,13.489,0,0,0,0,0,0,0,7,0.0,0.0
1005,1213,2020-03-18 23:29:00,0,2665.0,2383.0,0.894,13.139,0,0,0,0,0,0,0,8,0.0,0.0
1005,1214,2020-03-18 23:32:00,0,2464.0,2294.0,0.931,12.246,9,9,1,8,0,0,0,32,0.0,0.0
1005,1215,2020-03-18 23:35:00,0,3082.0,2705.0,0.878,15.138,147,91,69,22,56,38,18,4,0.6,0.03
1005,1216,2020-03-18 23:38:00,0,2991.0,2663.0,0.89,14.733,493,227,173,54,266,184,82,100,0.09,0.0
1005,1217,2020-03-18 23:41:00,0,3137.0,2804.0,0.894,15.466,714,270,195,75,444,362,82,6,0.12,0.0
1005,1218,2020-03-18 23:44:00,0,2901.0,2602.0,0.897,14.309,1116,541,400,141,575,449,126,0,0.0,0.0
1005,1219,2020-03-18 23:47:00,0,3160.0,2778.0,0.879,15.527,392,192,146,46,200,141,59,100,0.22,0.0
1005,1220,2020-03-18 23:50:00,0,3650.0,3169.0,0.868,17.891,168,34,17,17,134,75,59,8,0.33,0.0
1005,1221,2020-03-18 23:53:00,0,3071.0,2688.0,0.875,15.075,146,83,47,36,63,27,36,41,0.12,0.0
1005,1222,2020-03-18 23:56:00,0,3054.0,2734.0,0.895,15.059,106,69,47,22,37,24,13,55,0.09,0.0
1005,1223,2020-03-18 23:59:00,0,2890.0,2606.0,0.902,14.271,0,0,0,0,0,0,0,1,0.0,0.0
1005,1224,2020-03-19 00:02:00,0,2821.0,2531.0,0.897,13.917,1,0,0,0,1,1,0,1,0.0,0.0
1005,1225,2020-03-19 00:05:00,0,2743.0,2387.0,0.87,13.449,0,0,0,0,0,0,0,5,0.0,0.0
1005,1226,2020-03-19 00:08:00,0,2477.0,2259.0,0.912,12.259,95,62,47,15,33,24,9,13,0.45,0.0
1005,1227,2020-03-19 00:11:00,0,3729.0,3207.0,0.86,18.242,3,3,0,3,0,0,0,0,0.56,0.0
1005,1228,2020-03-19 00:14:00,0,3461.0,3052.0,0.882,17.017,27,19,9,10,8,1,7,0,0.06,0.0
1005,1229,2020-03-19 00:17:00,0,3130.0,2866.0,0.916,15.505,79,55,31,24,24,7,17,1,0.1,0.0
1005,1230,2020-03-19 00:20:00,0,2656.0,2385.0,0.898,13.107,394,261,207,54,133,102,31,122,0.0,0.0
1005,1231,2020-03-19 00:23:00,0,3291.0,2962.0,0.9,16.246,687,284,214,70,403,323,80,123,0.07,0.0
1005,1232,2020-03-19 00:26:00,0,3227.0,2853.0,0.884,15.873,398,154,117,37,244,212,32,18,0.37,0.0
1005,1233,2020-03-19 00:29:00,0,3290.0,2954.0,0.898,16.232,329,135,91,44,194,153,41,4,0.11,0.0
1005,1234,2020-03-19 00:32:00,0,2760.0,2397.0,0.869,13.527,358,200,137,63,158,123,35,0,0.0,0.0
1005,1235,2020-03-19 00:35:00,0,3232.0,2884.0,0.892,15.928,205,63,40,23,142,99,43,6,0.38,0.0
1005,1236,2020-03-19 00:38:00,0,3455.0,3103.0,0.898,17.046,49,19,0,19,30,9,21,0,0.04,0.0
1005,1237,2020-03-19 00:41:00,0,2710.0,2543.0,0.938,13.493,91,48,32,16,43,29,14,0,0.37,0.0
1005,1238,2020-03-19 00:44:00,0,2320.0,2191.0,0.945,11.566,4,3,2,1,1,0,1,20,0.0,0.0
1005,1239,2020-03-19 00:47:00,0,2656.0,2401.0,0.904,13.124,0,0,0,0,0,0,0,3,0.0,0.0
1005,1240,2020-03-19 00:50:00,0,2728.0,2425.0,0.889,13.434,0,0,0,0,0,0,0,5,0.0,0.0
1005,1241,2020-03-19 00:53:00,0,2652.0,2418.0,0.912,13.124,0,0,0,0,0,0,0,0,0.0,0.0
1005,1242,2020-03-19 00:56:00,0,2469.0,2326.0,0.942,12.304,0,0,0,0,0,0,0,2,0.0,0.0
1005,1243,2020-03-19 00:59:00,0,2480.0,2302.0,0.928,12.321,0,0,0,0,0,0,0,0,0.0,0.0
1005,1244,2020-03-19 01:02:00,0,2496.0,2236.0,0.896,12.308,85,55,44,11,30,21,9,5,0.05,0.0
1005,1245,2020-03-19 01:05:00,0,2922.0,2573.0,0.881,14.363,145,56,33,23,89,72,17,0,0.59,0.0
1005,1246,2020-03-19 01:08:00,0,3330.0,2851.0,0.856,16.278,294,8,0,8,286,246,40,2,0.17,0.0
1005,1247,2020-03-19 01:11:00,0,2972.0,2696.0,0.907,14.695,550,4,1,3,546,502,44,3,0.1,0.0
1005,1248,2020-03-19 01:14:00,0,3040.0,2781.0,0.915,15.058,368,104,73,31,264,244,20,15,0.14,0.0
1005,1249,2020-03-19 01:17:00,0,2735.0,2446.0,0.894,13.484,138,32,10,22,106,90,16,29,0.18,0.0
1005,1250,2020-03-19 01:20:00,0,2475.0,2318.0,0.937,12.32,0,0,0,0,0,0,0,14,0.0,0.0
1005,1251,2020-03-19 01:23:00,0,2504.0,2192.0,0.876,12.292,5,3,1,2,2,1,1,39,0.0,0.0
1005,1252,2020-03-19 01:26:00,0,2507.0,2216.0,0.884,12.332,0,0,0,0,0,0,0,8,0.0,0.0
1005,1253,2020-03-19 01:29:00,0,2341.0,2078.0,0.887,11.524,0,0,0,0,0,0,0,1,0.0,0.0
1005,1254,2020-03-19 01:32:00,0,2486.0,2273.0,0.914,12.312,366,88,68,20,278,252,26,20,0.5,0.0
1005,1255,2020-03-19 01:35:00,0,2890.0,2630.0,0.91,14.297,44,23,1,22,21,7,14,1,0.12,0.0
1005,1256,2020-03-19 01:38:00,0,3045.0,2834.0,0.931,15.135,45,28,17,11,17,14,3,43,0.11,0.0
1005,1257,2020-03-19 01:41:00,0,2481.0,2285.0,0.921,12.306,0,0,0,0,0,0,0,7,0.0,0.0
1005,1258,2020-03-19 01:44:00,0,2324.0,2116.0,0.91,11.5,0,0,0,0,0,0,0,40,0.0,0.0
1005,1259,2020-03-19 01:47:00,0,2320.0,2153.0,0.928,11.522,1,1,1,0,0,0,0,7,0.0,0.0
1005,1260,2020-03-19 01:50:00,0,2323.0,2124.0,0.914,11.503,2,1,0,1,1,1,0,45,0.0,0.0
1005,1261,2020-03-19 01:53:00,0,2314.0,2158.0,0.932,11.505,80,41,36,5,39,31,8,21,0.29,0.0
1005,1262,2020-03-19 01:56:00,0,2780.0,2326.0,0.837,13.528,63,12,0,12,51,24,27,0,0.07,0.0
1005,1263,2020-03-19 01:59:00,0,2897.0,2602.0,0.898,14.293,87,26,15,11,61,47,14,51,0.32,0.0
1005,1264,2020-03-19 02:02:00,0,2818.0,2562.5,0.9095,13.939,2,2,0,2,0,0,0,95,0.0,0.0
1005,1265,2020-03-19 02:05:00,0,2739.0,2523.0,0.921,13.585,213,64,45,19,149,127,22,42,0.0,0.0
1005,1266,2020-03-19 02:08:00,0,2755.0,2428.0,0.881,13.545,0,0,0,0,0,0,0,2,0.0,0.0
1005,1267,2020-03-19 02:11:00,0,2566.0,2301.0,0.897,12.656,0,0,0,0,0,0,0,0,0.0,0.0
1005,1268,2020-03-19 02:14:00,0,2504.0,2224.0,0.888,12.33,5,3,1,2,2,2,0,8,0.0,0.0
1005,1269,2020-03-19 02:17:00,0,2533.0,2157.0,0.852,12.367,0,0,0,0,0,0,0,3,0.0,0.0
1005,1270,2020-03-19 02:20:00,0,2352.0,2034.0,0.865,11.518,0,0,0,0,0,0,0,0,0.0,0.0
1005,1271,2020-03-19 02:23:00,0,2365.0,1951.0,0.825,11.479,0,0,0,0,0,0,0,0,0.0,0.0
1005,1272,2020-03-19 02:26:00,0,2110.0,1852.0,0.878,10.364,0,0,0,0,0,0,0,0,0.0,0.0
1005,1273,2020-03-19 02:29:00,0,2104.0,1814.0,0.862,10.297,0,0,0,0,0,0,0,0,0.0,0.0
1005,1274,2020-03-19 02:32:00,0,2122.0,1773.0,0.836,10.323,0,0,0,0,0,0,0,0,0.0,0.0
1005,1275,2020-03-19 02:35:00,0,2197.0,1833.0,0.834,10.686,126,76,65,11,50,38,12,2,0.28,0.0
1005,1276,2020-03-19 02:38:00,0,2940.0,2468.0,0.839,14.318,16,8,0,8,8,2,6,0,0.39,0.0
1005,1277,2020-03-19 02:41:00,0,2604.0,2198.0,0.844,12.692,43,4,1,3,39,0,39,0,0.0,0.0
1005,1278,2020-03-19 02:44:00,0,2296.0,1896.0,0.826,11.146,47,4,0,4,43,6,37,0,0.01,0.0
1005,1279,2020-03-19 02:47:00,0,2190.0,1878.0,0.858,10.709,53,2,0,2,51,5,46,0,0.0,0.0
1005,1280,2020-03-19 02:50:00,0,2274.0,1918.0,0.844,11.084,65,0,0,0,65,17,48,0,0.0,0.0
1005,1281,2020-03-19 02:53:00,0,2289.0,1915.0,0.837,11.138,49,2,0,2,47,4,43,0,0.0,0.0
1005,1282,2020-03-19 02:56:00,0,2182.0,1887.0,0.865,10.688,60,0,0,0,60,11,49,0,0.0,0.0
1005,1283,2020-03-19 02:59:00,0,2105.0,1859.0,0.883,10.35,141,19,0,19,122,81,41,0,0.0,0.0
1005,1284,2020-03-19 03:02:00,0,2298.0,1886.0,0.821,11.141,85,9,1,8,76,27,49,0,0.17,0.0
1005,1285,2020-03-19 03:05:00,0,2540.0,2098.0,0.826,12.332,243,60,44,16,183,112,71,0,0.54,0.0
1005,1286,2020-03-19 03:08:00,0,2791.0,2273.0,0.814,13.515,74,10,1,9,64,15,49,0,0.02,0.0
1005,1287,2020-03-19 03:11:00,0,2522.0,2153.0,0.854,12.32,66,27,0,27,39,0,39,0,0.0,0.0
1005,1288,2020-03-19 03:14:00,0,2522.0,2115.0,0.838,12.279,52,0,0,0,52,13,39,0,0.0,0.0
1005,1289,2020-03-19 03:17:00,0,2491.0,2206.0,0.885,12.258,45,7,1,6,38,17,21,0,0.0,0.0
1005,1290,2020-03-19 03:20:00,0,2343.0,2070.0,0.884,11.523,0,0,0,0,0,0,0,0,0.0,0.0
1005,1291,2020-03-19 03:23:00,0,2362.0,2019.0,0.855,11.541,3,2,0,2,1,1,0,0,0.01,0.0
1005,1292,2020-03-19 03:26:00,0,2363.0,1949.0,0.825,11.468,0,0,0,0,0,0,0,0,0.0,0.0
1005,1293,2020-03-19 03:29:00,0,2745.0,2460.0,0.896,13.537,48,29,24,5,19,11,8,1,0.53,0.0
1005,1294,2020-03-19 03:32:00,0,2525.0,2182.0,0.864,12.366,191,51,32,19,140,86,54,1,0.05,0.0
1005,1295,2020-03-19 03:35:00,0,2342.0,2088.0,0.892,11.538,136,40,3,37,96,44,52,0,0.0,0.0
1005,1296,2020-03-19 03:38:00,0,2730.0,2492.0,0.913,13.516,119,43,19,24,76,59,17,27,0.48,0.0
1005,1297,2020-03-19 03:41:00,0,2727.0,2490.0,0.913,13.5,134,34,27,7,100,52,48,9,0.0,0.0
1005,1298,2020-03-19 03:44:00,0,2732.0,2509.0,0.918,13.542,275,106,70,36,169,119,50,33,0.0,0.0
1005,1299,2020-03-19 03:47:00,0,2894.0,2599.0,0.898,14.281,141,56,40,16,85,63,22,46,0.27,0.0
1005,1300,2020-03-19 03:50:00,0,2343.0,2101.0,0.897,11.557,6,6,1,5,0,0,0,7,0.0,0.0
1005,1301,2020-03-19 03:53:00,0,2413.0,2183.0,0.905,11.925,2,2,0,2,0,0,0,3,0.0,0.0
1005,1302,2020-03-19 03:56:00,0,2499.0,2180.0,0.873,12.258,1,1,0,1,0,0,0,0,0.0,0.0
1005,1303,2020-03-19 03:59:00,0,2414.0,2163.0,0.896,11.905,0,0,0,0,0,0,0,0,0.0,0.0
1005,1304,2020-03-19 04:02:00,0,2415.0,2149.0,0.89,11.893,11,6,1,5,5,1,4,2,0.0,0.0
1005,1305,2020-03-19 04:05:00,0,2338.0,2104.0,0.9,11.54,0,0,0,0,0,0,0,0,0.0,0.0
1005,1306,2020-03-19 04:08:00,0,2340.0,2050.0,0.876,11.491,0,0,0,0,0,0,0,0,0.0,0.0
1005,1307,2020-03-19 04:11:00,0,2515.0,2123.0,0.844,12.261,90,60,36,24,30,20,10,3,0.24,0.0
1005,1308,2020-03-19 04:14:00,0,2855.0,2430.0,0.851,13.94,24,9,0,9,15,9,6,0,0.1,0.0
1005,1309,2020-03-19 04:17:00,0,2510.0,2139.0,0.852,12.256,0,0,0,0,0,0,0,0,0.0,0.0
1005,1310,2020-03-19 04:20:00,0,2337.0,2085.0,0.892,11.517,4,3,0,3,1,0,1,0,0.0,0.0
1005,1311,2020-03-19 04:23:00,0,2516.0,2143.0,0.852,12.287,3,2,0,2,1,0,1,0,0.0,0.0
1005,1312,2020-03-19 04:26:00,0,2518.0,2117.0,0.841,12.263,0,0,0,0,0,0,0,0,0.0,0.0
1005,1313,2020-03-19 04:29:00,0,2521.0,2141.0,0.849,12.302,2,2,0,2,0,0,0,0,0.0,0.0
1005,1314,2020-03-19 04:32:00,0,2539.0,2095.0,0.825,12.324,0,0,0,0,0,0,0,0,0.0,0.0
1005,1315,2020-03-19 04:35:00,0,2458.0,2039.0,0.83,11.94,0,0,0,0,0,0,0,0,0.0,0.0
1005,1316,2020-03-19 04:38:00,0,3079.0,2679.0,0.87,15.096,106,39,31,8,67,42,25,0,0.38,0.0
1005,1317,2020-03-19 04:41:00,0,2764.0,2292.0,0.829,13.427,225,36,29,7,189,132,57,0,0.11,0.0
1005,1318,2020-03-19 04:44:00,0,2693.0,2287.0,0.849,13.141,183,82,46,36,101,54,47,0,0.01,0.0
1005,1319,2020-03-19 04:47:00,0,2748.0,2459.0,0.895,13.548,121,25,4,21,96,50,46,0,0.49,0.0
1005,1320,2020-03-19 04:50:00,0,2888.0,2657.0,0.92,14.321,58,18,2,16,40,20,20,0,0.0,0.0
1005,1321,2020-03-19 04:53:00,0,2740.0,2428.0,0.886,13.483,58,7,4,3,51,23,28,0,0.0,0.0
1005,1322,2020-03-19 04:56:00,0,2506.0,2210.0,0.882,12.319,40,0,0,0,40,4,36,0,0.0,0.0
1005,1323,2020-03-19 04:59:00,0,2588.0,2294.0,0.886,12.737,286,114,78,36,172,112,60,11,0.45,0.0
1005,1324,2020-03-19 05:02:00,0,2336.0,2116.5,0.9085,11.547,309,127,92,35,182,140,42,97,0.18,0.0
1005,1325,2020-03-19 05:05:00,0,2084.0,1939.0,0.931,10.357,62,20,14,6,42,34,8,45,0.0,0.0
1005,1326,2020-03-19 05:08:00,0,2358.0,2025.0,0.859,11.534,0,0,0,0,0,0,0,4,0.0,0.0
1005,1327,2020-03-19 05:11:00,0,2350.0,2060.0,0.876,11.539,0,0,0,0,0,0,0,1,0.0,0.0
1005,1328,2020-03-19 05:14:00,0,2349.0,2082.0,0.887,11.559,0,0,0,0,0,0,0,0,0.0,0.0
1005,1329,2020-03-19 05:17:00,0,2333.0,2085.0,0.894,11.5,0,0,0,0,0,0,0,1,0.0,0.0
1005,1330,2020-03-19 05:20:00,0,2342.0,2081.0,0.889,11.531,2,1,1,0,1,0,1,0,0.0,0.0
1005,1331,2020-03-19 05:23:00,0,2360.0,1993.0,0.844,11.505,56,42,35,7,14,11,3,9,0.23,0.0
1005,1332,2020-03-19 05:26:00,0,2912.0,2550.0,0.876,14.295,65,42,20,22,23,17,6,1,0.27,0.0
1005,1333,2020-03-19 05:29:00,0,3143.0,2769.0,0.881,15.448,64,45,20,25,19,9,10,0,0.11,0.0
1005,1334,2020-03-19 05:32:00,0,2733.0,2449.0,0.896,13.477,202,121,81,40,81,59,22,51,0.0,0.0
1005,1335,2020-03-19 05:35:00,0,2889.0,2668.0,0.923,14.335,256,83,47,36,173,122,51,4,0.0,0.0
1005,1336,2020-03-19 05:38:00,0,2488.0,2241.0,0.901,12.284,132,30,3,27,102,52,50,0,0.48,0.0
1005,1337,2020-03-19 05:41:00,0,2509.0,2239.0,0.893,12.366,69,38,19,19,31,24,7,57,0.09,0.0
1005,1338,2020-03-19 05:44:00,0,2511.0,2219.0,0.884,12.348,77,59,43,16,18,12,6,72,0.0,0.0
1005,1339,2020-03-19 05:47:00,0,2897.0,2659.0,0.918,14.356,39,20,15,5,19,15,4,20,0.0,0.0
1005,1340,2020-03-19 05:50:00,0,2481.0,2285.0,0.921,12.305,0,0,0,0,0,0,0,0,0.0,0.0
1005,1341,2020-03-19 05:53:00,0,2506.0,2228.0,0.889,12.341,0,0,0,0,0,0,0,0,0.0,0.0
1005,1342,2020-03-19 05:56:00,0,2315.0,2138.0,0.924,11.489,0,0,0,0,0,0,0,0,0.0,0.0
1005,1343,2020-03-19 05:59:00,0,2494.0,2244.0,0.9,12.31,291,107,73,34,184,135,49,38,0.42,0.0
1005,1344,2020-03-19 06:02:00,1,2581.0,2295.0,0.889,12.709,4,2,1,1,2,1,1,64,0.0,0.0
1005,1345,2020-03-19 06:05:00,1,2428.0,2145.0,0.884,11.94,0,0,0,0,0,0,0,1,0.0,0.0
1005,1346,2020-03-19 06:08:00,1,2351.0,2063.0,0.878,11.546,0,0,0,0,0,0,0,0,0.0,0.0
1005,1347,2020-03-19 06:11:00,1,2174.0,1976.0,0.909,10.754,0,0,0,0,0,0,0,0,0.0,0.0
1005,1348,2020-03-19 06:14:00,1,2354.0,2007.0,0.853,11.496,0,0,0,0,0,0,0,6,0.0,0.0
1005,1349,2020-03-19 06:17:00,1,2348.0,2016.0,0.859,11.483,0,0,0,0,0,0,0,2,0.0,0.0
1005,1350,2020-03-19 06:20:00,1,2085.0,1912.0,0.917,10.33,0,0,0,0,0,0,0,0,0.01,0.0
1005,1351,2020-03-19 06:23:00,1,2102.0,1853.0,0.882,10.333,61,39,31,8,22,19,3,13,0.0,0.0
1005,1352,2020-03-19 06:26:00,1,2786.0,2322.0,0.833,13.546,198,54,38,16,144,100,44,45,0.44,0.0
1005,1353,2020-03-19 06:29:00,1,2532.0,2079.0,0.821,12.279,0,0,0,0,0,0,0,0,0.0,0.0
1005,1354,2020-03-19 06:32:00,1,2361.0,2001.0,0.848,11.517,0,0,0,0,0,0,0,1,0.0,0.0
1005,1355,2020-03-19 06:35:00,1,2195.0,1886.0,0.859,10.735,0,0,0,0,0,0,0,3,0.01,0.0
1005,1356,2020-03-19 06:38:00,1,2197.0,1896.0,0.863,10.754,0,0,0,0,0,0,0,0,0.0,0.0
1005,1357,2020-03-19 06:41:00,1,2281.0,1877.0,0.823,11.064,0,0,0,0,0,0,0,0,0.0,0.0
1005,1358,2020-03-19 06:44:00,1,2102.0,1875.0,0.892,10.359,0,0,0,0,0,0,0,0,0.0,0.0
1005,1359,2020-03-19 06:47:00,1,2120.0,1799.0,0.849,10.344,0,0,0,0,0,0,0,0,0.0,0.0
1005,1360,2020-03-19 06:50:00,1,2132.0,1761.0,0.826,10.352,0,0,0,0,0,0,0,0,0.0,0.0
1005,1361,2020-03-19 06:53:00,1,2136.0,1722.0,0.806,10.323,0,0,0,0,0,0,0,3,0.0,0.0
1005,1362,2020-03-19 06:56:00,1,2130.0,1700.0,0.798,10.275,101,35,30,5,66,43,23,6,0.21,0.0
1005,1363,2020-03-19 06:59:00,1,2545.0,2072.0,0.814,12.323,190,46,28,18,144,76,68,0,0.28,0.0
1005,1364,2020-03-19 07:02:00,1,2620.0,2185.0,0.834,12.742,77,11,1,10,66,30,36,5,0.17,0.0
1005,1365,2020-03-19 07:05:00,1,2759.0,2357.0,0.854,13.478,460,129,87,42,331,246,85,26,0.03,0.0
1005,1366,2020-03-19 07:08:00,1,2331.0,2085.0,0.894,11.494,1,1,1,0,0,0,0,40,0.0,0.0
1005,1367,2020-03-19 07:11:00,1,2336.0,2059.0,0.882,11.484,0,0,0,0,0,0,0,0,0.0,0.0
1005,1368,2020-03-19 07:14:00,1,2361.0,2012.0,0.852,11.531,28,16,14,2,12,8,4,4,0.52,0.0
1005,1369,2020-03-19 07:17:00,1,2741.0,2428.0,0.886,13.488,149,71,52,19,78,31,47,6,0.07,0.0
1005,1370,2020-03-19 07:20:00,1,2738.0,2444.0,0.892,13.494,100,45,28,17,55,39,16,40,0.17,0.0
1005,1371,2020-03-19 07:23:00,1,2339.0,2061.0,0.881,11.497,0,0,0,0,0,0,0,130,0.0,0.0
1005,1372,2020-03-19 07:26:00,1,2488.0,2237.0,0.899,12.28,0,0,0,0,0,0,0,41,0.0,0.0
1005,1373,2020-03-19 07:29:00,1,2756.0,2382.0,0.864,13.495,0,0,0,0,0,0,0,0,0.0,0.0
1005,1374,2020-03-19 07:32:00,1,2506.0,2230.0,0.89,12.341,0,0,0,0,0,0,0,0,0.0,0.0
1005,1375,2020-03-19 07:35:00,1,2331.0,2061.0,0.884,11.466,0,0,0,0,0,0,0,0,0.0,0.0
1005,1376,2020-03-19 07:38:00,1,2256.0,2000.0,0.886,11.105,0,0,0,0,0,0,0,0,0.0,0.0
1005,1377,2020-03-19 07:41:00,1,2079.0,1947.0,0.936,10.347,0,0,0,0,0,0,0,0,0.0,0.0
1005,1378,2020-03-19 07:44:00,1,2103.0,1854.0,0.882,10.338,1,1,1,0,0,0,0,5,0.0,0.0
1005,1379,2020-03-19 07:47:00,1,2093.0,1867.0,0.892,10.314,0,0,0,0,0,0,0,5,0.0,0.0
1005,1380,2020-03-19 07:50:00,1,2091.0,1858.0,0.889,10.296,0,0,0,0,0,0,0,0,0.0,0.0
1005,1381,2020-03-19 07:53:00,1,2120.0,1786.0,0.843,10.331,73,38,33,5,35,29,6,13,0.29,0.0
1005,1382,2020-03-19 07:56:00,1,2523.0,2111.0,0.837,12.277,45,27,20,7,18,14,4,11,0.09,0.0
1005,1383,2020-03-19 07:59:00,1,2440.0,2096.0,0.859,11.935,0,0,0,0,0,0,0,0,0.0,0.0
1005,1384,2020-03-19 08:02:00,1,2407.0,2027.5,0.842,11.728,0,0,0,0,0,0,0,0,0.01,0.0
1005,1385,2020-03-19 08:05:00,1,2374.0,1959.0,0.825,11.521,0,0,0,0,0,0,0,1,0.0,0.0
1005,1386,2020-03-19 08:08:00,1,2094.0,1871.0,0.894,10.321,0,0,0,0,0,0,0,12,0.0,0.0
1005,1387,2020-03-19 08:11:00,1,2112.0,1794.0,0.849,10.308,0,0,0,0,0,0,0,0,0.0,0.0
1005,1388,2020-03-19 08:14:00,1,2117.0,1774.0,0.838,10.305,0,0,0,0,0,0,0,0,0.0,0.0
1005,1389,2020-03-19 08:17:00,1,2126.0,1727.0,0.812,10.287,0,0,0,0,0,0,0,1,0.0,0.0
1005,1390,2020-03-19 08:20:00,1,2058.0,1673.0,0.813,9.959,0,0,0,0,0,0,0,0,0.0,0.0
1005,1391,2020-03-19 08:23:00,1,2111.0,1797.0,0.851,10.306,100,72,60,12,28,22,6,8,0.5,0.0
1005,1392,2020-03-19 08:26:00,1,2706.0,2190.0,0.809,13.087,142,73,48,25,69,39,30,0,0.07,0.0
1005,1393,2020-03-19 08:29:00,1,2533.0,2137.0,0.844,12.346,19,6,3,3,13,3,10,0,0.0,0.0
1005,1394,2020-03-19 08:32:00,1,2757.0,2413.0,0.875,13.535,49,11,3,8,38,29,9,0,0.47,0.0
1005,1395,2020-03-19 08:35:00,1,2510.0,2192.0,0.873,12.314,330,155,113,42,175,128,47,73,0.01,0.0
1005,1396,2020-03-19 08:38:00,1,2731.0,2479.0,0.908,13.506,183,72,42,30,111,77,34,49,0.23,0.0
1005,1397,2020-03-19 08:41:00,1,2330.0,2127.0,0.913,11.533,4,4,2,2,0,0,0,118,0.0,0.0
1005,1398,2020-03-19 08:44:00,1,2494.0,2223.0,0.891,12.287,17,15,4,11,2,1,1,92,0.0,0.0
1005,1399,2020-03-19 08:47:00,1,2580.0,2305.0,0.894,12.715,1,1,1,0,0,0,0,70,0.0,0.0
1005,1400,2020-03-19 08:50:00,1,2579.0,2345.0,0.909,12.758,0,0,0,0,0,0,0,18,0.0,0.0
1005,1401,2020-03-19 08:53:00,1,2510.0,2201.0,0.877,12.328,0,0,0,0,0,0,0,0,0.0,0.0
1005,1402,2020-03-19 08:56:00,1,2336.0,2068.0,0.885,11.493,4,2,1,1,2,1,1,3,0.0,0.0
1005,1403,2020-03-19 08:59:00,1,2161.0,1957.0,0.905,10.68,0,0,0,0,0,0,0,0,0.0,0.0
1005,1404,2020-03-19 09:02:00,1,2089.0,1895.0,0.907,10.329,0,0,0,0,0,0,0,0,0.0,0.0
1005,1405,2020-03-19 09:05:00,1,2366.0,1960.0,0.828,11.492,217,94,76,18,123,93,30,2,0.31,0.0
1005,1406,2020-03-19 09:08:00,1,2753.0,2381.0,0.865,13.482,64,19,8,11,45,17,28,0,0.25,0.0
1005,1407,2020-03-19 09:11:00,1,2266.0,1951.0,0.861,11.088,48,8,0,8,40,2,38,0,0.0,0.0
1005,1408,2020-03-19 09:14:00,1,2097.0,1812.0,0.864,10.267,38,0,0,0,38,0,38,0,0.0,0.0
1005,1409,2020-03-19 09:17:00,1,2100.0,1876.0,0.893,10.352,50,8,1,7,42,16,26,0,0.0,0.0
1005,1410,2020-03-19 09:20:00,1,2086.0,1896.0,0.909,10.318,44,3,0,3,41,7,34,0,0.0,0.0
1005,1411,2020-03-19 09:23:00,1,2118.0,1804.0,0.852,10.342,38,0,0,0,38,9,29,0,0.0,0.0
1005,1412,2020-03-19 09:26:00,1,2135.0,1764.0,0.826,10.364,33,0,0,0,33,8,25,0,0.0,0.0
1005,1413,2020-03-19 09:29:00,1,2091.0,1835.0,0.878,10.271,52,9,1,8,43,8,35,0,0.0,0.0
1005,1414,2020-03-19 09:32:00,1,2429.0,2102.0,0.866,11.896,191,70,54,16,121,72,49,0,0.31,0.0
1005,1415,2020-03-19 09:35:00,1,2380.0,1901.0,0.799,11.481,62,3,0,3,59,26,33,0,0.0,0.0
1005,1416,2020-03-19 09:38:00,1,2105.0,1804.0,0.857,10.291,50,1,0,1,49,14,35,0,0.0,0.0
1005,1417,2020-03-19 09:41:00,1,2100.0,1852.0,0.882,10.326,34,1,0,1,33,4,29,0,0.0,0.0
1005,1418,2020-03-19 09:44:00,1,2130.0,1787.0,0.839,10.371,77,13,0,13,64,36,28,0,0.01,0.0
1005,1419,2020-03-19 09:47:00,1,2374.0,1994.0,0.84,11.56,93,11,3,8,82,44,38,0,0.16,0.0
1005,1420,2020-03-19 09:50:00,1,2105.0,1847.0,0.877,10.339,60,7,3,4,53,17,36,0,0.17,0.0
1005,1421,2020-03-19 09:53:00,1,2528.0,2147.0,0.85,12.336,77,1,0,1,76,48,28,0,0.02,0.0
1005,1422,2020-03-19 09:56:00,1,2334.0,2053.0,0.88,11.469,67,3,0,3,64,31,33,0,0.14,0.0
1005,1423,2020-03-19 09:59:00,1,2339.0,2124.0,0.908,11.565,304,107,68,39,197,128,69,13,0.23,0.0
1005,1424,2020-03-19 10:02:00,1,2501.0,2216.0,0.886,12.308,725,203,137,66,522,411,111,25,0.01,0.0
1005,1425,2020-03-19 10:05:00,1,2572.0,2304.0,0.896,12.683,534,225,175,50,309,247,62,62,0.0,0.0
1005,1426,2020-03-19 10:08:00,1,2107.0,1788.0,0.849,10.282,0,0,0,0,0,0,0,40,0.0,0.0
1005,1427,2020-03-19 10:11:00,1,2347.0,2081.0,0.887,11.551,7,5,2,3,2,1,1,73,0.0,0.0
1005,1428,2020-03-19 10:14:00,1,2412.0,2137.0,0.886,11.87,0,0,0,0,0,0,0,11,0.0,0.0
1005,1429,2020-03-19 10:17:00,1,2334.0,2119.0,0.908,11.541,0,0,0,0,0,0,0,0,0.0,0.0
1005,1430,2020-03-19 10:20:00,1,2346.0,2033.0,0.867,11.493,0,0,0,0,0,0,0,0,0.0,0.0
1005,1431,2020-03-19 10:23:00,1,2357.0,2008.0,0.852,11.51,0,0,0,0,0,0,0,0,0.0,0.0
1005,1432,2020-03-19 10:26:00,1,2269.0,1947.0,0.858,11.093,0,0,0,0,0,0,0,4,0.0,0.0
1005,1433,2020-03-19 10:29:00,1,2183.0,1926.0,0.882,10.734,0,0,0,0,0,0,0,1,0.0,0.0
1005,1434,2020-03-19 10:32:00,1,2109.0,1840.0,0.873,10.344,0,0,0,0,0,0,0,0,0.0,0.0
1005,1435,2020-03-19 10:35:00,1,2134.0,1738.0,0.815,10.331,0,0,0,0,0,0,0,1,0.0,0.0
1005,1436,2020-03-19 10:38:00,1,1944.0,1674.0,0.861,9.513,0,0,0,0,0,0,0,1,0.0,0.0
1005,1437,2020-03-19 10:41:00,1,1953.0,1648.0,0.844,9.519,0,0,0,0,0,0,0,0,0.0,0.0
1005,1438,2020-03-19 10:44:00,1,1966.0,1633.0,0.831,9.555,0,0,0,0,0,0,0,3,0.0,0.0
1005,1439,2020-03-19 10:47:00,1,1949.0,1645.0,0.844,9.502,0,0,0,0,0,0,0,4,0.0,0.0
1005,1440,2020-03-19 10:50:00,1,1979.0,1568.0,0.792,9.533,0,0,0,0,0,0,0,0,0.0,0.0
1005,1441,2020-03-19 10:53:00,1,1971.0,1586.0,0.805,9.521,0,0,0,0,0,0,0,15,0.0,0.0
1005,1442,2020-03-19 10:56:00,1,2139.0,1693.0,0.791,10.303,0,0,0,0,0,0,0,0,0.0,0.0
1005,1443,2020-03-19 10:59:00,1,1962.0,1613.0,0.822,9.518,1,1,1,0,0,0,0,6,0.0,0.0
1005,1444,2020-03-19 11:02:00,1,2460.5,2012.5,0.8185,11.9235,357,170,140,30,187,141,46,52,0.0,0.0
1005,1445,2020-03-19 11:05:00,1,2959.0,2412.0,0.815,14.329,941,490,421,69,451,358,93,171,0.02,0.0
1005,1446,2020-03-19 11:08:00,1,3116.0,2528.0,0.811,15.075,714,318,260,58,396,319,77,229,0.18,0.0
1005,1447,2020-03-19 11:11:00,1,3538.0,2827.0,0.799,17.072,629,260,210,50,369,278,91,163,0.12,0.0
1005,1448,2020-03-19 11:14:00,1,3284.0,2636.0,0.803,15.856,607,241,190,51,366,278,88,108,0.46,0.0
1005,1449,2020-03-19 11:17:00,1,3354.0,2772.0,0.827,16.284,696,343,272,71,353,278,75,168,0.0,0.0
1005,1450,2020-03-19 11:20:00,1,3437.0,2870.0,0.835,16.72,572,187,135,52,385,284,101,99,0.14,0.0
1005,1451,2020-03-19 11:23:00,1,3331.0,2835.0,0.851,16.265,713,367,287,80,346,272,74,126,0.0,0.0
1005,1452,2020-03-19 11:26:00,1,3334.0,2853.0,0.856,16.293,507,191,147,44,316,220,96,71,0.25,0.0
1005,1453,2020-03-19 11:29:00,1,3398.0,3007.0,0.885,16.719,771,288,220,68,483,371,112,82,0.02,0.0
1005,1454,2020-03-19 11:32:00,1,3308.0,2981.0,0.901,16.335,582,238,176,62,344,256,88,85,0.23,0.0
1005,1455,2020-03-19 11:35:00,1,3218.0,2845.0,0.884,15.829,463,208,157,51,255,200,55,34,0.07,0.0
1005,1456,2020-03-19 11:38:00,1,3057.0,2789.0,0.912,15.13,385,189,139,50,196,137,59,72,0.11,0.0
1005,1457,2020-03-19 11:41:00,1,3044.0,2832.0,0.93,15.127,433,174,120,54,259,197,62,119,0.0,0.0
1005,1458,2020-03-19 11:44:00,1,3144.0,2886.0,0.918,15.584,336,152,116,36,184,130,54,96,0.29,0.0
1005,1459,2020-03-19 11:47:00,1,3282.0,2967.0,0.904,16.215,344,125,85,40,219,149,70,57,0.02,0.0
1005,1460,2020-03-19 11:50:00,1,2870.0,2698.0,0.94,14.294,472,244,176,68,228,158,70,3,0.0,0.0
1005,1461,2020-03-19 11:53:00,1,2867.0,2663.0,0.929,14.244,256,93,52,41,163,96,67,5,0.0,0.0
1005,1462,2020-03-19 11:56:00,1,2732.0,2467.0,0.903,13.496,238,92,47,45,146,89,57,10,0.0,0.0
1005,1463,2020-03-19 11:59:00,1,2864.0,2690.0,0.939,14.262,286,139,108,31,147,107,40,45,0.32,0.0
1005,1464,2020-03-19 12:02:00,1,2880.0,2732.0,0.949,14.371,572,240,184,56,332,254,78,104,0.04,0.0
1005,1465,2020-03-19 12:05:00,1,3043.0,2838.0,0.932,15.132,25,11,4,7,14,8,6,2,0.4,0.0
1005,1466,2020-03-19 12:08:00,1,3283.0,3009.0,0.916,16.268,21,14,0,14,7,2,5,6,0.0,0.0
1005,1467,2020-03-19 12:11:00,1,2968.0,2786.0,0.939,14.777,128,42,6,36,86,55,31,1,0.0,0.0
1005,1468,2020-03-19 12:14:00,1,3035.0,2860.0,0.942,15.122,120,61,26,35,59,42,17,0,0.21,0.0
1005,1469,2020-03-19 12:17:00,1,3034.0,2892.0,0.953,15.154,303,133,85,48,170,115,55,3,0.25,0.0
1005,1470,2020-03-19 12:20:00,1,3040.0,2836.0,0.933,15.116,465,189,140,49,276,197,79,61,0.0,0.0
1005,1471,2020-03-19 12:23:00,1,2712.0,2565.0,0.946,13.524,217,106,76,30,111,66,45,11,0.06,0.0
1005,1472,2020-03-19 12:26:00,1,3027.0,2844.0,0.94,15.077,224,93,58,35,131,85,46,5,0.29,0.0
1005,1473,2020-03-19 12:29:00,1,3134.0,2918.0,0.931,15.58,104,12,1,11,92,45,47,4,0.0,0.0
1005,1474,2020-03-19 12:32:00,1,2872.0,2717.0,0.946,14.323,153,25,3,22,128,69,59,0,0.0,0.0
1005,1475,2020-03-19 12:35:00,1,2869.0,2716.0,0.947,14.311,114,11,2,9,103,53,50,0,0.0,0.0
1005,1476,2020-03-19 12:38:00,1,2732.0,2535.0,0.928,13.57,62,3,1,2,59,23,36,0,0.0,0.0
1005,1477,2020-03-19 12:41:00,1,2760.0,2411.0,0.874,13.544,44,5,2,3,39,12,27,0,0.0,0.0
1005,1478,2020-03-19 12:44:00,1,2486.0,2304.0,0.927,12.348,32,1,0,1,31,2,29,0,0.0,0.0
1005,1479,2020-03-19 12:47:00,1,2499.0,2256.0,0.903,12.342,32,0,0,0,32,4,28,0,0.0,0.0
1005,1480,2020-03-19 12:50:00,1,2508.0,2184.0,0.871,12.298,152,52,43,9,100,60,40,0,0.18,0.0
1005,1481,2020-03-19 12:53:00,1,2335.0,2049.0,0.878,11.468,58,11,4,7,47,14,33,0,0.02,0.0
1005,1482,2020-03-19 12:56:00,1,2376.0,1952.0,0.822,11.522,34,0,0,0,34,4,30,0,0.0,0.0
1005,1483,2020-03-19 12:59:00,1,2276.0,1927.0,0.847,11.102,40,11,0,11,29,0,29,0,0.0,0.0
1005,1484,2020-03-19 13:02:00,1,2373.0,1938.0,0.817,11.495,65,22,8,14,43,11,32,0,0.0,0.0
1005,1485,2020-03-19 13:05:00,1,2186.0,1888.0,0.864,10.705,79,32,21,11,47,22,25,0,0.0,0.0
1005,1486,2020-03-19 13:08:00,1,2113.0,1820.0,0.861,10.341,75,7,0,7,68,55,13,0,0.0,0.0
1005,1487,2020-03-19 13:11:00,1,2279.0,1885.0,0.827,11.065,82,34,8,26,48,21,27,0,0.0,0.0
1005,1488,2020-03-19 13:14:00,1,2112.0,1819.0,0.862,10.334,24,0,0,0,24,0,24,0,0.0,0.0
1005,1489,2020-03-19 13:17:00,1,2109.0,1820.0,0.863,10.324,27,0,0,0,27,0,27,0,0.0,0.0
1005,1490,2020-03-19 13:20:00,1,2699.0,2249.0,0.833,13.126,180,70,36,34,110,69,41,38,0.0,0.0
1005,1491,2020-03-19 13:23:00,1,3164.0,2722.0,0.86,15.479,620,237,179,58,383,289,94,61,0.12,0.0
1005,1492,2020-03-19 13:26:00,1,2931.0,2519.0,0.859,14.335,130,16,11,5,114,66,48,5,0.0,0.0
1005,1493,2020-03-19 13:29:00,1,3030.0,2501.0,0.825,14.706,231,35,1,34,196,113,83,4,0.0,0.0
1005,1494,2020-03-19 13:32:00,1,3105.0,2599.0,0.837,15.109,668,306,250,56,362,276,86,128,0.14,0.0
1005,1495,2020-03-19 13:35:00,1,3326.0,2794.0,0.84,16.198,475,151,130,21,324,227,97,29,0.52,0.0
1005,1496,2020-03-19 13:38:00,1,3585.0,3059.0,0.853,17.511,193,34,8,26,159,98,61,4,0.19,0.0
1005,1497,2020-03-19 13:41:00,1,3295.0,2939.0,0.892,16.235,509,272,225,47,237,175,62,69,0.22,0.0
1005,1498,2020-03-19 13:44:00,1,3317.0,2849.0,0.859,16.221,267,96,75,21,171,126,45,100,0.22,0.0
1005,1499,2020-03-19 13:47:00,1,2976.0,2701.0,0.908,14.714,92,51,40,11,41,34,7,42,0.0,0.0
1005,1500,2020-03-19 13:50:00,1,2822.0,2549.0,0.903,13.939,2,2,1,1,0,0,0,21,0.0,0.0
1005,1501,2020-03-19 13:53:00,1,2749.0,2453.0,0.892,13.547,8,1,0,1,7,2,5,9,0.0,0.0
1005,1502,2020-03-19 13:56:00,1,2569.0,2372.0,0.923,12.747,28,6,0,6,22,7,15,18,0.0,0.0
1005,1503,2020-03-19 13:59:00,1,2572.0,2352.0,0.914,12.737,22,9,2,7,13,9,4,4,0.0,0.0
1005,1504,2020-03-19 14:02:00,1,2530.5,2296.0,0.907,12.5115,8,2,0,2,6,4,2,2,0.0,0.0
1005,1505,2020-03-19 14:05:00,1,2489.0,2240.0,0.9,12.286,0,0,0,0,0,0,0,1,0.0,0.0
1005,1506,2020-03-19 14:08:00,1,2324.0,2162.0,0.93,11.55,0,0,0,0,0,0,0,0,0.0,0.0
1005,1507,2020-03-19 14:11:00,1,2360.0,2022.0,0.857,11.536,0,0,0,0,0,0,0,0,0.0,0.0
1005,1508,2020-03-19 14:14:00,1,2345.0,2097.0,0.894,11.562,153,87,69,18,66,48,18,34,0.14,0.0
1005,1509,2020-03-19 14:17:00,1,3103.0,2623.0,0.845,15.13,250,150,108,42,100,71,29,90,0.01,0.0
1005,1510,2020-03-19 14:20:00,1,2775.0,2301.0,0.829,13.48,3,3,1,2,0,0,0,25,0.0,0.0
1005,1511,2020-03-19 14:23:00,1,2766.0,2397.0,0.867,13.553,2,2,1,1,0,0,0,44,0.01,0.0
1005,1512,2020-03-19 14:26:00,1,2754.0,2356.0,0.855,13.46,0,0,0,0,0,0,0,0,0.0,0.0
1005,1513,2020-03-19 14:29:00,1,2524.0,2178.0,0.863,12.356,0,0,0,0,0,0,0,3,0.0,0.0
1005,1514,2020-03-19 14:32:00,1,2354.0,1989.0,0.845,11.479,0,0,0,0,0,0,0,0,0.0,0.0
1005,1515,2020-03-19 14:35:00,1,2369.0,1947.0,0.822,11.491,0,0,0,0,0,0,0,2,0.0,0.0
1005,1516,2020-03-19 14:38:00,1,2397.0,1916.0,0.8,11.565,0,0,0,0,0,0,0,2,0.0,0.0
1005,1517,2020-03-19 14:41:00,1,2125.0,1781.0,0.838,10.346,0,0,0,0,0,0,0,3,0.04,0.0
1005,1518,2020-03-19 14:44:00,1,2208.0,1819.0,0.824,10.714,0,0,0,0,0,0,0,0,0.0,0.0
1005,1519,2020-03-19 14:47:00,1,2110.0,1783.0,0.845,10.289,0,0,0,0,0,0,0,0,0.0,0.0
1005,1520,2020-03-19 14:50:00,1,2140.0,1741.0,0.814,10.359,0,0,0,0,0,0,0,1,0.0,0.0
1005,1521,2020-03-19 14:53:00,1,2142.0,1723.0,0.804,10.348,0,0,0,0,0,0,0,0,0.0,0.0
1005,1522,2020-03-19 14:56:00,1,2147.0,1673.0,0.779,10.312,0,0,0,0,0,0,0,0,0.0,0.0
1005,1523,2020-03-19 14:59:00,1,2127.0,1718.0,0.808,10.282,72,40,35,5,32,27,5,10,0.06,0.0
1005,1524,2020-03-19 15:02:00,1,2376.0,1954.0,0.822,11.525,72,34,23,11,38,30,8,4,0.0,0.0
1005,1525,2020-03-19 15:05:00,1,2314.0,1836.0,0.794,11.149,1,1,1,0,0,0,0,0,0.0,0.0
1005,1526,2020-03-19 15:08:00,1,2134.0,1714.0,0.803,10.306,0,0,0,0,0,0,0,2,0.0,0.0
1005,1527,2020-03-19 15:11:00,1,2146.0,1715.0,0.799,10.354,0,0,0,0,0,0,0,0,0.0,0.0
1005,1528,2020-03-19 15:14:00,1,2050.0,1630.0,0.795,9.883,0,0,0,0,0,0,0,0,0.01,0.0
1005,1529,2020-03-19 15:17:00,1,1975.0,1555.0,0.787,9.505,0,0,0,0,0,0,0,1,0.04,0.0
1005,1530,2020-03-19 15:20:00,1,1979.0,1578.0,0.797,9.545,0,0,0,0,0,0,0,0,0.0,0.0
1005,1531,2020-03-19 15:23:00,1,1987.0,1537.0,0.774,9.529,0,0,0,0,0,0,0,0,0.01,0.0
1005,1532,2020-03-19 15:26:00,1,1992.0,1512.0,0.759,9.522,0,0,0,0,0,0,0,0,0.01,0.0
1005,1533,2020-03-19 15:29:00,1,1989.0,1544.0,0.776,9.548,0,0,0,0,0,0,0,0,0.03,0.0
1005,1534,2020-03-19 15:32:00,1,1988.0,1507.0,0.758,9.502,0,0,0,0,0,0,0,0,0.0,0.0
1005,1535,2020-03-19 15:35:00,1,1990.0,1526.0,0.767,9.529,0,0,0,0,0,0,0,1,0.0,0.0
1005,1536,2020-03-19 15:38:00,1,1981.0,1558.0,0.787,9.529,0,0,0,0,0,0,0,5,0.0,0.0
1005,1537,2020-03-19 15:41:00,1,2160.0,1626.0,0.753,10.31,0,0,0,0,0,0,0,0,0.0,0.0
1005,1538,2020-03-19 15:44:00,1,2135.0,1724.0,0.808,10.32,0,0,0,0,0,0,0,0,0.0,0.0
1005,1539,2020-03-19 15:47:00,1,2154.0,1635.0,0.759,10.297,0,0,0,0,0,0,0,1,0.0,0.0
1005,1540,2020-03-19 15:50:00,1,1982.0,1553.0,0.784,9.53,0,0,0,0,0,0,0,1,0.0,0.0
1005,1541,2020-03-19 15:53:00,1,1990.0,1511.0,0.759,9.514,0,0,0,0,0,0,0,33,0.04,0.0
1005,1542,2020-03-19 15:56:00,1,2140.0,1706.0,0.797,10.322,136,57,45,12,79,63,16,47,0.0,0.0
1005,1543,2020-03-19 15:59:00,1,2154.0,1674.0,0.777,10.34,7,5,1,4,2,1,1,30,0.0,0.0
1005,1544,2020-03-19 16:02:00,1,2315.0,1805.0,0.78,11.118,6,6,2,4,0,0,0,53,0.0,0.0
1005,1545,2020-03-19 16:05:00,1,2396.0,1846.0,0.77,11.486,0,0,0,0,0,0,0,14,0.0,0.0
1005,1546,2020-03-19 16:08:00,1,2121.0,1744.0,0.822,10.286,0,0,0,0,0,0,0,4,0.0,0.0
1005,1547,2020-03-19 16:11:00,1,2156.0,1626.0,0.754,10.296,0,0,0,0,0,0,0,0,0.03,0.0
1005,1548,2020-03-19 16:14:00,1,1974.0,1562.0,0.791,9.508,0,0,0,0,0,0,0,3,0.0,0.0
1005,1549,2020-03-19 16:17:00,1,1972.0,1591.0,0.807,9.531,0,0,0,0,0,0,0,0,0.01,0.0
1005,1550,2020-03-19 16:20:00,1,1972.0,1573.0,0.798,9.511,0,0,0,0,0,0,0,0,0.0,0.0
1005,1551,2020-03-19 16:23:00,1,1965.0,1561.0,0.795,9.47,0,0,0,0,0,0,0,4,0.02,0.0
1005,1552,2020-03-19 16:26:00,1,1992.0,1534.0,0.77,9.546,0,0,0,0,0,0,0,7,0.01,0.0
1005,1553,2020-03-19 16:29:00,1,1992.0,1494.0,0.75,9.505,0,0,0,0,0,0,0,0,0.0,0.0
1005,1554,2020-03-19 16:32:00,1,1997.0,1525.0,0.764,9.556,0,0,0,0,0,0,0,0,0.0,0.0
1005,1555,2020-03-19 16:35:00,1,1908.0,1482.0,0.777,9.157,0,0,0,0,0,0,0,0,0.0,0.0
1005,1556,2020-03-19 16:38:00,1,1904.0,1455.0,0.764,9.114,0,0,0,0,0,0,0,3,0.02,0.0
1005,1557,2020-03-19 16:41:00,1,2059.0,1600.0,0.777,9.883,0,0,0,0,0,0,0,1,0.0,0.0
1005,1558,2020-03-19 16:44:00,1,1969.0,1575.0,0.8,9.501,0,0,0,0,0,0,0,3,0.0,0.0
1005,1559,2020-03-19 16:47:00,1,1977.0,1556.0,0.787,9.513,0,0,0,0,0,0,0,7,0.0,0.0
1005,1560,2020-03-19 16:50:00,1,1998.0,1455.0,0.729,9.482,0,0,0,0,0,0,0,1,0.0,0.0
1005,1561,2020-03-19 16:53:00,1,1982.0,1502.0,0.758,9.473,0,0,0,0,0,0,0,5,0.0,0.0
1005,1562,2020-03-19 16:56:00,1,1977.0,1578.0,0.798,9.537,150,49,43,6,101,75,26,33,0.11,0.0
1005,1563,2020-03-19 16:59:00,1,2138.0,1721.0,0.805,10.329,154,84,66,18,70,52,18,26,0.0,0.0
1005,1564,2020-03-19 17:02:00,1,2061.5,1618.0,0.7845,9.913,0,0,0,0,0,0,0,4,0.0,0.0
1005,1565,2020-03-19 17:05:00,1,1985.0,1515.0,0.764,9.497,0,0,0,0,0,0,0,12,0.0,0.0
1005,1566,2020-03-19 17:08:00,1,1910.0,1436.0,0.752,9.115,0,0,0,0,0,0,0,2,0.0,0.0
1005,1567,2020-03-19 17:11:00,1,2006.0,1473.0,0.734,9.533,0,0,0,0,0,0,0,0,0.0,0.0
1005,1568,2020-03-19 17:14:00,1,1997.0,1482.0,0.742,9.509,0,0,0,0,0,0,0,0,0.0,0.0
1005,1569,2020-03-19 17:17:00,1,2020.0,1449.0,0.717,9.561,0,0,0,0,0,0,0,0,0.0,0.0
1005,1570,2020-03-19 17:20:00,1,2014.0,1434.0,0.712,9.524,0,0,0,0,0,0,0,0,0.0,0.0
1005,1571,2020-03-19 17:23:00,1,1999.0,1479.0,0.74,9.516,0,0,0,0,0,0,0,0,0.0,0.0
1005,1572,2020-03-19 17:26:00,1,2003.0,1469.0,0.734,9.519,0,0,0,0,0,0,0,0,0.0,0.0
1005,1573,2020-03-19 17:29:00,1,2012.0,1458.0,0.725,9.54,0,0,0,0,0,0,0,1,0.0,0.0
1005,1574,2020-03-19 17:32:00,1,1813.0,1397.0,0.771,8.692,0,0,0,0,0,0,0,0,0.0,0.0
1005,1575,2020-03-19 17:35:00,1,2002.0,1463.0,0.731,9.508,1,1,1,0,0,0,0,12,0.0,0.0
1005,1576,2020-03-19 17:38:00,1,2166.0,1625.0,0.75,10.335,11,9,0,9,2,0,2,12,0.0,0.0
1005,1577,2020-03-19 17:41:00,1,2132.0,1706.0,0.8,10.291,0,0,0,0,0,0,0,29,0.0,0.0
1005,1578,2020-03-19 17:44:00,1,2405.0,1843.0,0.766,11.518,157,91,76,15,66,51,15,77,0.0,0.0
1005,1579,2020-03-19 17:47:00,1,2564.0,2005.0,0.782,12.322,98,45,35,10,53,45,8,55,0.0,0.0
1005,1580,2020-03-19 17:50:00,1,2380.0,1892.0,0.795,11.471,0,0,0,0,0,0,0,15,0.0,0.0
1005,1581,2020-03-19 17:53:00,1,2312.0,1765.0,0.764,11.065,0,0,0,0,0,0,0,4,0.0,0.0
1005,1582,2020-03-19 17:56:00,1,2226.0,1719.0,0.772,10.673,0,0,0,0,0,0,0,0,0.0,0.0
1005,1583,2020-03-19 17:59:00,1,2156.0,1648.0,0.764,10.321,0,0,0,0,0,0,0,0,0.0,0.0
1005,1584,2020-03-19 18:02:00,0,2311.0,1781.0,0.771,11.076,313,111,87,24,202,159,43,56,0.02,0.0
1005,1585,2020-03-19 18:05:00,0,2904.0,2208.0,0.761,13.887,367,154,98,56,213,169,44,45,0.01,0.0
1005,1586,2020-03-19 18:08:00,0,2764.0,2024.0,0.732,13.133,251,88,38,50,163,105,58,12,0.07,0.0
1005,1587,2020-03-19 18:11:00,0,2809.0,2155.0,0.767,13.453,201,39,6,33,162,97,65,2,0.0,0.0
1005,1588,2020-03-19 18:14:00,0,2896.0,2229.0,0.769,13.88,179,35,10,25,144,86,58,1,0.17,0.0
1005,1589,2020-03-19 18:17:00,0,2663.0,2043.0,0.767,12.756,604,190,139,51,414,326,88,66,0.0,0.0
1005,1590,2020-03-19 18:20:00,0,2813.0,2172.0,0.772,13.49,202,61,35,26,141,99,42,35,0.0,0.0
1005,1591,2020-03-19 18:23:00,0,2820.0,2142.0,0.76,13.481,507,201,155,46,306,240,66,88,0.0,0.0
1005,1592,2020-03-19 18:26:00,0,2839.0,2087.0,0.735,13.497,320,146,100,46,174,116,58,64,0.0,0.0
1005,1593,2020-03-19 18:29:00,0,2593.0,1910.0,0.737,12.33,65,23,11,12,42,11,31,0,0.0,0.0
1005,1594,2020-03-19 18:32:00,0,2347.0,1716.0,0.731,11.147,52,5,1,4,47,13,34,0,0.0,0.0
1005,1595,2020-03-19 18:35:00,0,2172.0,1569.0,0.722,10.295,37,5,1,4,32,4,28,0,0.0,0.0
1005,1596,2020-03-19 18:38:00,0,2180.0,1544.0,0.708,10.298,64,10,7,3,54,18,36,1,0.0,0.0
1005,1597,2020-03-19 18:41:00,0,1999.0,1435.0,0.718,9.464,41,4,1,3,37,5,32,0,0.0,0.0
1005,1598,2020-03-19 18:44:00,0,2001.0,1459.0,0.729,9.499,74,17,8,9,57,19,38,1,0.0,0.0
1005,1599,2020-03-19 18:47:00,0,2088.0,1513.0,0.725,9.904,108,47,23,24,61,31,30,2,0.0,0.0
1005,1600,2020-03-19 18:50:00,0,2604.0,1890.0,0.726,12.351,176,62,21,41,114,75,39,5,0.0,0.0
1005,1601,2020-03-19 18:53:00,0,2845.0,2064.0,0.725,13.493,683,381,314,67,302,237,65,227,0.0,0.0
1005,1602,2020-03-19 18:56:00,0,2801.0,2167.0,0.774,13.434,780,354,286,68,426,333,93,168,0.0,0.0
1005,1603,2020-03-19 18:59:00,0,3161.0,2376.0,0.752,15.085,715,378,312,66,337,263,74,157,0.0,0.0
1005,1604,2020-03-19 19:02:00,0,3007.0,2222.0,0.739,14.307,243,112,66,46,131,77,54,47,0.07,0.0
1005,1605,2020-03-19 19:05:00,0,2988.0,2283.0,0.764,14.3,578,282,226,56,296,219,77,85,0.0,0.0
1005,1606,2020-03-19 19:08:00,0,3153.0,2355.0,0.747,15.032,1062,420,343,77,642,531,111,186,0.0,0.0
1005,1607,2020-03-19 19:11:00,0,3246.0,2421.0,0.746,15.47,456,234,170,64,222,161,61,77,0.0,0.0
1005,1608,2020-03-19 19:14:00,0,2993.0,2291.0,0.765,14.33,928,331,269,62,597,477,120,144,0.0,0.0
1005,1609,2020-03-19 19:17:00,0,3164.0,2356.0,0.745,15.076,804,289,231,58,515,399,116,124,0.0,0.0
1005,1610,2020-03-19 19:20:00,0,2995.0,2253.0,0.752,14.294,942,383,314,69,559,443,116,183,0.0,0.0
1005,1611,2020-03-19 19:23:00,0,2978.0,2268.0,0.762,14.246,409,123,83,40,286,214,72,93,0.0,0.0
1005,1612,2020-03-19 19:26:00,0,2989.0,2211.0,0.74,14.224,684,305,257,48,379,295,84,161,0.0,0.0
1005,1613,2020-03-19 19:29:00,0,3164.0,2392.0,0.756,15.115,515,208,162,46,307,225,82,95,0.0,0.0
1005,1614,2020-03-19 19:32:00,0,3028.0,2187.0,0.722,14.354,548,181,124,57,367,287,80,98,0.18,0.0
1005,1615,2020-03-19 19:35:00,0,2823.0,2105.0,0.746,13.453,152,61,22,39,91,44,47,18,0.0,0.0
1005,1616,2020-03-19 19:38:00,0,3000.0,2179.0,0.726,14.231,169,74,30,44,95,67,28,18,0.0,0.0
1005,1617,2020-03-19 19:41:00,0,2583.0,1881.0,0.728,12.259,69,26,0,26,43,11,32,0,0.0,0.0
1005,1618,2020-03-19 19:44:00,0,2601.0,1860.0,0.715,12.308,57,27,0,27,30,5,25,0,0.0,0.0
1005,1619,2020-03-19 19:47:00,0,2441.0,1740.0,0.713,11.543,34,0,0,0,34,2,32,0,0.0,0.0
1005,1620,2020-03-19 19:50:00,0,2158.0,1629.0,0.755,10.306,61,29,10,19,32,12,20,0,0.0,0.0
1005,1621,2020-03-19 19:53:00,0,2084.0,1520.0,0.729,9.894,34,14,0,14,20,0,20,0,0.0,0.0
1005,1622,2020-03-19 19:56:00,0,2006.0,1431.0,0.713,9.489,104,44,11,33,60,27,33,0,0.0,0.0
1005,1623,2020-03-19 19:59:00,0,2011.0,1450.0,0.721,9.528,45,6,2,4,39,8,31,0,0.0,0.0
1005,1624,2020-03-19 20:02:00,0,2015.5,1414.5,0.702,9.5065,69,30,0,30,39,6,33,0,0.0,0.0
1005,1625,2020-03-19 20:05:00,0,2020.0,1379.0,0.683,9.485,70,18,0,18,52,12,40,0,0.0,0.0
1005,1626,2020-03-19 20:08:00,0,2027.0,1384.0,0.683,9.52,98,54,2,52,44,15,29,0,0.0,0.0
1005,1627,2020-03-19 20:11:00,0,2027.0,1402.0,0.692,9.54,97,47,0,47,50,10,40,0,0.0,0.0
1005,1628,2020-03-19 20:14:00,0,2011.0,1404.0,0.698,9.477,67,33,0,33,34,2,32,0,0.0,0.0
1005,1629,2020-03-19 20:17:00,0,1930.0,1393.0,0.722,9.147,81,48,13,35,33,2,31,0,0.0,0.0
1005,1630,2020-03-19 20:20:00,0,1828.0,1362.0,0.745,8.712,104,27,18,9,77,32,45,4,0.0,0.0
1005,1631,2020-03-19 20:23:00,0,2178.0,1582.0,0.727,10.332,545,271,220,51,274,206,68,92,0.11,0.0
1005,1632,2020-03-19 20:26:00,0,2578.0,1900.0,0.737,12.262,437,183,139,44,254,193,61,76,0.0,0.0
1005,1633,2020-03-19 20:29:00,0,2661.0,1972.0,0.741,12.669,259,20,7,13,239,176,63,11,0.0,0.0
1005,1634,2020-03-19 20:32:00,0,2841.0,2089.0,0.735,13.508,675,264,214,50,411,321,90,147,0.0,0.0
1005,1635,2020-03-19 20:35:00,0,2839.0,2083.0,0.734,13.492,884,413,330,83,471,373,98,207,0.0,0.0
1005,1636,2020-03-19 20:38:00,0,3159.0,2345.0,0.742,15.044,658,282,209,73,376,286,90,101,0.0,0.0
1005,1637,2020-03-19 20:41:00,0,2999.0,2167.0,0.723,14.214,975,411,324,87,564,448,116,156,0.0,0.0
1005,1638,2020-03-19 20:44:00,0,3003.0,2219.0,0.739,14.29,774,338,279,59,436,339,97,183,0.0,0.0
1005,1639,2020-03-19 20:47:00,0,3000.0,2258.0,0.753,14.322,845,385,298,87,460,357,103,193,0.0,0.0
1005,1640,2020-03-19 20:50:00,0,2997.0,2261.0,0.754,14.314,780,314,251,63,466,370,96,159,0.0,0.0
1005,1641,2020-03-19 20:53:00,0,2977.0,2248.0,0.755,14.217,649,186,109,77,463,375,88,94,0.0,0.0
1005,1642,2020-03-19 20:56:00,0,2996.0,2280.0,0.761,14.331,557,247,176,71,310,235,75,105,0.0,0.0
1005,1643,2020-03-19 20:59:00,0,3165.0,2370.0,0.749,15.095,652,244,189,55,408,320,88,92,0.0,0.0
1005,1644,2020-03-19 21:02:00,0,2828.0,2104.0,0.744,13.473,362,177,141,36,185,134,51,72,0.0,0.0
1005,1645,2020-03-19 21:05:00,0,2835.0,2097.0,0.74,13.492,702,345,288,57,357,262,95,174,0.1,0.0
1005,1646,2020-03-19 21:08:00,0,2854.0,2027.0,0.71,13.491,458,176,116,60,282,228,54,38,0.0,0.0
1005,1647,2020-03-19 21:11:00,0,2861.0,2035.0,0.711,13.526,756,337,266,71,419,326,93,128,0.0,0.0
1005,1648,2020-03-19 21:14:00,0,2858.0,2012.0,0.704,13.488,523,218,175,43,305,242,63,123,0.0,0.0
1005,1649,2020-03-19 21:17:00,0,2759.0,1998.0,0.724,13.084,482,254,209,45,228,171,57,116,0.0,0.0
1005,1650,2020-03-19 21:20:00,0,2854.0,2021.0,0.708,13.483,497,216,166,50,281,207,74,88,0.0,0.0
1005,1651,2020-03-19 21:23:00,0,2683.0,1973.0,0.736,12.754,816,313,248,65,503,391,112,148,0.0,0.0
1005,1652,2020-03-19 21:26:00,0,2867.0,2012.0,0.702,13.524,436,175,122,53,261,201,60,52,0.0,0.0
1005,1653,2020-03-19 21:29:00,0,2404.0,1810.0,0.753,11.475,60,6,3,3,54,36,18,0,0.0,0.0
1005,1654,2020-03-19 21:32:00,0,2161.0,1611.0,0.745,10.299,21,2,2,0,19,0,19,0,0.0,0.0
1005,1655,2020-03-19 21:35:00,0,2000.0,1475.0,0.738,9.515,32,6,1,5,26,0,26,0,0.0,0.0
1005,1656,2020-03-19 21:38:00,0,2018.0,1386.0,0.687,9.484,39,14,3,11,25,0,25,0,0.0,0.0
1005,1657,2020-03-19 21:41:00,0,1742.0,1296.0,0.744,8.299,36,0,0,0,36,0,36,0,0.0,0.0
1005,1658,2020-03-19 21:44:00,0,1763.0,1218.0,0.691,8.294,67,9,5,4,58,13,45,0,0.0,0.0
1005,1659,2020-03-19 21:47:00,0,1745.0,1276.0,0.732,8.287,60,12,3,9,48,16,32,0,0.0,0.0
1005,1660,2020-03-19 21:50:00,0,1570.0,1213.0,0.773,7.531,55,3,0,3,52,8,44,0,0.0,0.0
1005,1661,2020-03-19 21:53:00,0,1597.0,1129.0,0.707,7.544,86,29,12,17,57,19,38,0,0.0,0.0
1005,1662,2020-03-19 21:56:00,0,1593.0,1144.0,0.718,7.544,39,2,0,2,37,8,29,0,0.0,0.0
1005,1663,2020-03-19 21:59:00,0,1580.0,1192.0,0.754,7.547,41,2,0,2,39,10,29,0,0.0,0.0
1005,1664,2020-03-19 22:02:00,0,1582.0,1194.0,0.755,7.557,30,1,0,1,29,4,25,0,0.0,0.0
1005,1665,2020-03-19 22:05:00,0,1583.0,1184.0,0.748,7.55,31,5,0,5,26,4,22,0,0.0,0.0
1005,1666,2020-03-19 22:08:00,0,1579.0,1182.0,0.749,7.531,35,0,0,0,35,0,35,0,0.0,0.0
1005,1667,2020-03-19 22:11:00,0,1667.0,1212.0,0.727,7.911,292,119,92,27,173,118,55,21,0.0,0.0
1005,1668,2020-03-19 22:14:00,0,2176.0,1611.0,0.74,10.357,358,132,102,30,226,157,69,77,0.0,0.0
1005,1669,2020-03-19 22:17:00,0,2425.0,1784.0,0.736,11.53,371,91,67,24,280,235,45,93,0.25,0.0
1005,1670,2020-03-19 22:20:00,0,2583.0,1922.0,0.744,12.305,534,244,185,59,290,219,71,94,0.0,0.0
1005,1671,2020-03-19 22:23:00,0,2833.0,2037.0,0.719,13.418,521,247,182,65,274,198,76,114,0.02,0.0
1005,1672,2020-03-19 22:26:00,0,2857.0,2039.0,0.714,13.514,746,369,300,69,377,292,85,149,0.0,0.0
1005,1673,2020-03-19 22:29:00,0,3014.0,2186.0,0.725,14.297,719,328,270,58,391,310,81,146,0.0,0.0
1005,1674,2020-03-19 22:32:00,0,3009.0,2143.0,0.712,14.229,1010,441,359,82,569,453,116,230,0.0,0.0
1005,1675,2020-03-19 22:35:00,0,3015.0,2200.0,0.73,14.314,680,284,219,65,396,309,87,120,0.01,0.0
1005,1676,2020-03-19 22:38:00,0,2834.0,2076.0,0.732,13.466,245,96,59,37,149,92,57,47,0.0,0.0
1005,1677,2020-03-19 22:41:00,0,2837.0,2073.0,0.731,13.474,550,225,176,49,325,240,85,48,0.0,0.0
1005,1678,2020-03-19 22:44:00,0,2829.0,2072.0,0.732,13.44,516,216,158,58,300,239,61,149,0.03,0.0
1005,1679,2020-03-19 22:47:00,0,2838.0,2086.0,0.735,13.494,321,147,106,41,174,116,58,58,0.1,0.0
1005,1680,2020-03-19 22:50:00,0,2847.0,2035.0,0.715,13.473,645,313,235,78,332,271,61,97,0.0,0.0
1005,1681,2020-03-19 22:53:00,0,2860.0,2005.0,0.701,13.49,792,256,204,52,536,420,116,70,0.0,0.0
1005,1682,2020-03-19 22:56:00,0,2606.0,1809.0,0.694,12.272,71,26,10,16,45,18,27,0,0.0,0.0
1005,1683,2020-03-19 22:59:00,0,2419.0,1723.0,0.712,11.438,23,1,0,1,22,4,18,0,0.0,0.0
1005,1684,2020-03-19 23:02:00,0,2256.0,1603.5,0.7105,10.664,26,5,1,4,21,4,17,0,0.0,0.0
1005,1685,2020-03-19 23:05:00,0,2093.0,1484.0,0.709,9.89,30,8,1,7,22,3,19,0,0.0,0.0
1005,1686,2020-03-19 23:08:00,0,2013.0,1434.0,0.712,9.521,47,3,0,3,44,11,33,0,0.0,0.0
1005,1687,2020-03-19 23:11:00,0,1840.0,1335.0,0.725,8.729,45,10,0,10,35,5,30,0,0.0,0.0
1005,1688,2020-03-19 23:14:00,0,1740.0,1312.0,0.754,8.31,257,124,94,30,133,93,40,102,0.0,0.0
1005,1689,2020-03-19 23:17:00,0,2093.0,1518.0,0.725,9.928,570,289,237,52,281,213,68,119,0.0,0.0
1005,1690,2020-03-19 23:20:00,0,2250.0,1674.0,0.744,10.718,170,48,21,27,122,76,46,61,0.0,0.0
1005,1691,2020-03-19 23:23:00,0,2422.0,1747.0,0.721,11.478,540,240,182,58,300,221,79,99,0.0,0.0
1005,1692,2020-03-19 23:26:00,0,2411.0,1833.0,0.76,11.528,549,271,221,50,278,208,70,125,0.0,0.0
1005,1693,2020-03-19 23:29:00,0,2771.0,1948.0,0.703,13.074,463,232,168,64,231,182,49,98,0.0,0.0
1005,1694,2020-03-19 23:32:00,0,2420.0,1780.0,0.735,11.508,239,80,52,28,159,120,39,51,0.0,0.0
1005,1695,2020-03-19 23:35:00,0,2423.0,1768.0,0.73,11.503,621,292,242,50,329,257,72,158,0.0,0.0
1005,1696,2020-03-19 23:38:00,0,2676.0,1944.0,0.726,12.695,488,194,158,36,294,220,74,68,0.0,0.0
1005,1697,2020-03-19 23:41:00,0,2430.0,1731.0,0.712,11.489,102,15,3,12,87,37,50,0,0.0,0.0
1005,1698,2020-03-19 23:44:00,0,2184.0,1531.0,0.701,10.3,34,5,2,3,29,0,29,0,0.0,0.0
1005,1699,2020-03-19 23:47:00,0,2020.0,1429.0,0.708,9.541,93,58,0,58,35,2,33,0,0.0,0.0
1005,1700,2020-03-19 23:50:00,0,1937.0,1337.0,0.691,9.112,74,36,0,36,38,4,34,0,0.0,0.0
1005,1701,2020-03-19 23:53:00,0,1849.0,1314.0,0.71,8.741,35,0,0,0,35,2,33,0,0.0,0.0
1005,1702,2020-03-19 23:56:00,0,1754.0,1266.0,0.722,8.313,161,77,44,33,84,36,48,28,0.0,0.0
1005,1703,2020-03-19 23:59:00,0,1989.0,1483.0,0.746,9.479,375,159,123,36,216,170,46,90,0.0,0.0
1005,1704,2020-03-20 00:02:00,0,2166.0,1608.0,0.742,10.315,410,170,135,35,240,174,66,63,0.0,0.0
1005,1705,2020-03-20 00:05:00,0,2171.0,1574.0,0.725,10.299,110,52,27,25,58,24,34,15,0.0,0.0
1005,1706,2020-03-20 00:08:00,0,2005.0,1435.0,0.716,9.488,41,14,2,12,27,0,27,0,0.0,0.0
1005,1707,2020-03-20 00:11:00,0,1844.0,1352.0,0.733,8.76,49,9,7,2,40,6,34,0,0.0,0.0
1005,1708,2020-03-20 00:14:00,0,1761.0,1279.0,0.727,8.355,38,5,0,5,33,2,31,0,0.0,0.0
1005,1709,2020-03-20 00:17:00,0,1674.0,1217.0,0.727,7.943,55,22,8,14,33,7,26,0,0.0,0.0
1005,1710,2020-03-20 00:20:00,0,1595.0,1162.0,0.728,7.571,43,8,2,6,35,9,26,0,0.0,0.0
1005,1711,2020-03-20 00:23:00,0,1605.0,1100.0,0.685,7.54,42,9,0,9,33,5,28,0,0.0,0.0
1005,1712,2020-03-20 00:26:00,0,1510.0,1073.0,0.711,7.138,79,15,6,9,64,32,32,0,0.0,0.0
1005,1713,2020-03-20 00:29:00,0,1505.0,1073.0,0.712,7.119,64,30,12,18,34,4,30,0,0.0,0.0
1005,1714,2020-03-20 00:32:00,0,1605.0,1117.0,0.696,7.561,58,27,8,19,31,4,27,0,0.0,0.0
1005,1715,2020-03-20 00:35:00,0,1595.0,1117.0,0.7,7.52,33,6,0,6,27,0,27,0,0.0,0.0
1005,1716,2020-03-20 00:38:00,0,1597.0,1114.0,0.698,7.524,38,11,2,9,27,2,25,0,0.0,0.0
1005,1717,2020-03-20 00:41:00,0,1594.0,1124.0,0.705,7.523,24,5,0,5,19,0,19,0,0.0,0.0
1005,1718,2020-03-20 00:44:00,0,1589.0,1152.0,0.725,7.536,37,9,3,6,28,0,28,0,0.0,0.0
1005,1719,2020-03-20 00:47:00,0,2000.0,1457.0,0.729,9.495,417,184,138,46,233,177,56,71,0.06,0.0
1005,1720,2020-03-20 00:50:00,0,2421.0,1787.0,0.738,11.518,109,76,27,49,33,21,12,3,0.0,0.0
1005,1721,2020-03-20 00:53:00,0,2338.0,1701.0,0.728,11.094,553,223,174,49,330,250,80,130,0.0,0.0
1005,1722,2020-03-20 00:56:00,0,2412.0,1786.0,0.741,11.479,412,216,151,65,196,148,48,81,0.0,0.0
1005,1723,2020-03-20 00:59:00,0,2580.0,1880.0,0.729,12.247,474,113,75,38,361,277,84,81,0.0,0.0
1005,1724,2020-03-20 01:02:00,0,2749.0,1985.0,0.722,13.031,561,258,209,49,303,219,84,113,0.0,0.0
1005,1725,2020-03-20 01:05:00,0,2760.0,1989.0,0.721,13.077,739,323,264,59,416,328,88,159,0.0,0.0
1005,1726,2020-03-20 01:08:00,0,2847.0,2044.0,0.718,13.483,674,353,290,63,321,244,77,182,0.0,0.0
1005,1727,2020-03-20 01:11:00,0,3017.0,2121.0,0.703,14.235,879,351,273,78,528,432,96,163,0.0,0.0
1005,1728,2020-03-20 01:14:00,0,3182.0,2258.0,0.71,15.036,490,236,197,39,254,202,52,113,0.0,0.0
1005,1729,2020-03-20 01:17:00,0,3186.0,2280.0,0.716,15.078,624,278,221,57,346,273,73,125,0.0,0.0
1005,1730,2020-03-20 01:20:00,0,2825.0,2064.0,0.731,13.417,660,306,236,70,354,274,80,160,0.0,0.0
1005,1731,2020-03-20 01:23:00,0,2845.0,2109.0,0.741,13.544,1056,433,359,74,623,506,117,168,0.0,0.0
1005,1732,2020-03-20 01:26:00,0,2845.0,2091.0,0.735,13.525,103,10,3,7,93,49,44,17,0.0,0.0
1005,1733,2020-03-20 01:29:00,0,2596.0,1902.0,0.733,12.334,100,26,9,17,74,32,42,1,0.0,0.0
1005,1734,2020-03-20 01:32:00,0,2436.0,1727.0,0.709,11.511,33,1,0,1,32,2,30,2,0.0,0.0
1005,1735,2020-03-20 01:35:00,0,2426.0,1708.0,0.704,11.45,249,72,34,38,177,105,72,20,0.0,0.0
1005,1736,2020-03-20 01:38:00,0,2426.0,1736.0,0.716,11.479,682,250,196,54,432,344,88,83,0.0,0.0
1005,1737,2020-03-20 01:41:00,0,2498.0,1828.0,0.732,11.867,591,268,209,59,323,244,79,47,0.0,0.0
1005,1738,2020-03-20 01:44:00,0,2428.0,1768.0,0.728,11.523,345,179,132,47,166,116,50,61,0.0,0.0
1005,1739,2020-03-20 01:47:00,0,2348.0,1686.0,0.718,11.118,70,37,2,35,33,9,24,0,0.0,0.0
1005,1740,2020-03-20 01:50:00,0,2174.0,1565.0,0.72,10.3,23,0,0,0,23,0,23,0,0.0,0.0
1005,1741,2020-03-20 01:53:00,0,2008.0,1471.0,0.733,9.54,26,0,0,0,26,0,26,0,0.0,0.0
1005,1742,2020-03-20 01:56:00,0,1927.0,1369.0,0.71,9.109,86,23,12,11,63,26,37,0,0.0,0.0
1005,1743,2020-03-20 01:59:00,0,1744.0,1326.0,0.76,8.34,79,45,0,45,34,8,26,0,0.0,0.0
1005,1744,2020-03-20 02:02:00,0,1664.0,1253.5,0.7525,7.945,69,36,0,36,33,4,29,0,0.0,0.0
1005,1745,2020-03-20 02:05:00,0,1584.0,1181.0,0.745,7.55,60,30,0,30,30,0,30,0,0.0,0.0
1005,1746,2020-03-20 02:08:00,0,1600.0,1107.0,0.691,7.531,101,50,19,31,51,22,29,0,0.0,0.0
1005,1747,2020-03-20 02:11:00,0,1580.0,1150.0,0.728,7.501,120,25,7,18,95,50,45,16,0.0,0.0
1005,1748,2020-03-20 02:14:00,0,1567.0,1222.0,0.78,7.525,508,210,173,37,298,213,85,70,0.0,0.0
1005,1749,2020-03-20 02:17:00,0,1750.0,1302.0,0.744,8.338,247,28,27,1,219,193,26,22,0.0,0.0
1005,1750,2020-03-20 02:20:00,0,1576.0,1190.0,0.755,7.528,56,0,0,0,56,48,8,0,0.0,0.0
1005,1751,2020-03-20 02:23:00,0,1603.0,1116.0,0.696,7.551,30,7,4,3,23,6,17,0,0.0,0.0
1005,1752,2020-03-20 02:26:00,0,1411.0,1053.0,0.746,6.725,31,0,0,0,31,0,31,0,0.0,0.0
1005,1753,2020-03-20 02:29:00,0,1424.0,1038.0,0.729,6.761,24,0,0,0,24,0,24,0,0.0,0.0
1005,1754,2020-03-20 02:32:00,0,1422.0,1008.0,0.709,6.72,26,8,0,8,18,4,14,0,0.0,0.0
1005,1755,2020-03-20 02:35:00,0,1430.0,995.0,0.696,6.735,51,24,2,22,27,6,21,0,0.0,0.0
1005,1756,2020-03-20 02:38:00,0,1416.0,1028.0,0.725,6.718,17,1,0,1,16,0,16,0,0.0,0.0
1005,1757,2020-03-20 02:41:00,0,1422.0,1021.0,0.718,6.734,22,4,3,1,18,2,16,0,0.0,0.0
1005,1758,2020-03-20 02:44:00,0,1424.0,1011.0,0.71,6.732,57,28,0,28,29,2,27,0,0.0,0.0
1005,1759,2020-03-20 02:47:00,0,1429.0,994.0,0.696,6.73,26,4,1,3,22,0,22,0,0.0,0.0
1005,1760,2020-03-20 02:50:00,0,1428.0,991.0,0.694,6.723,36,6,1,5,30,2,28,0,0.0,0.0
1005,1761,2020-03-20 02:53:00,0,1601.0,1090.0,0.68,7.516,58,6,0,6,52,14,38,0,0.0,0.0
1005,1762,2020-03-20 02:56:00,0,1607.0,1114.0,0.693,7.564,102,0,0,0,102,53,49,0,0.0,0.0
1005,1763,2020-03-20 02:59:00,0,1603.0,1108.0,0.691,7.543,92,5,0,5,87,37,50,0,0.0,0.0
1005,1764,2020-03-20 03:02:00,0,1761.0,1230.0,0.699,8.301,134,18,12,6,116,93,23,0,0.0,0.0
1005,1765,2020-03-20 03:05:00,0,1758.0,1238.0,0.704,8.295,87,4,1,3,83,69,14,0,0.0,0.0
1005,1766,2020-03-20 03:08:00,0,1753.0,1307.0,0.746,8.354,54,13,7,6,41,31,10,0,0.0,0.0
1005,1767,2020-03-20 03:11:00,0,2006.0,1503.0,0.749,9.57,149,24,7,17,125,76,49,13,0.0,0.0
1005,1768,2020-03-20 03:14:00,0,2144.0,1654.0,0.771,10.278,239,46,10,36,193,158,35,4,0.0,0.0
1005,1769,2020-03-20 03:17:00,0,2589.0,1876.0,0.725,12.278,617,299,235,64,318,250,68,155,0.0,0.0
1005,1770,2020-03-20 03:20:00,0,2746.0,2015.0,0.734,13.05,730,338,275,63,392,310,82,209,0.0,0.0
1005,1771,2020-03-20 03:23:00,0,2822.0,2113.0,0.749,13.459,837,369,293,76,468,375,93,175,0.0,0.0
1005,1772,2020-03-20 03:26:00,0,3005.0,2196.0,0.731,14.27,957,425,345,80,532,436,96,206,0.0,0.0
1005,1773,2020-03-20 03:29:00,0,2996.0,2195.0,0.733,14.233,645,346,278,68,299,223,76,93,0.0,0.0
1005,1774,2020-03-20 03:32:00,0,3171.0,2293.0,0.723,15.033,814,383,328,55,431,351,80,189,0.0,0.0
1005,1775,2020-03-20 03:35:00,0,2984.0,2234.0,0.749,14.232,1208,502,417,85,706,577,129,173,0.0,0.0
1005,1776,2020-03-20 03:38:00,0,3174.0,2302.0,0.725,15.054,826,336,275,61,490,386,104,139,0.0,0.0
1005,1777,2020-03-20 03:41:00,0,3009.0,2171.0,0.722,14.26,893,391,310,81,502,409,93,197,0.22,0.0
1005,1778,2020-03-20 03:44:00,0,2998.0,2218.0,0.74,14.268,527,214,163,51,313,251,62,118,0.0,0.0
1005,1779,2020-03-20 03:47:00,0,2992.0,2216.0,0.741,14.242,783,340,291,49,443,343,100,145,0.0,0.0
1005,1780,2020-03-20 03:50:00,0,2995.0,2216.0,0.74,14.255,852,339,277,62,513,408,105,146,0.0,0.0
1005,1781,2020-03-20 03:53:00,0,3008.0,2176.0,0.723,14.26,617,213,164,49,404,303,101,106,0.0,0.0
1005,1782,2020-03-20 03:56:00,0,2853.0,2021.0,0.708,13.481,69,9,1,8,60,29,31,0,0.0,0.0
1005,1783,2020-03-20 03:59:00,0,2689.0,1957.0,0.728,12.76,688,303,244,59,385,308,77,129,0.0,0.0
1005,1784,2020-03-20 04:02:00,0,2581.0,1915.0,0.742,12.288,576,210,166,44,366,271,95,76,0.0,0.0
1005,1785,2020-03-20 04:05:00,0,2508.0,1835.0,0.732,11.912,67,8,5,3,59,30,29,3,0.0,0.0
1005,1786,2020-03-20 04:08:00,0,2334.0,1688.0,0.723,11.067,33,10,2,8,23,7,16,2,0.0,0.0
1005,1787,2020-03-20 04:11:00,0,2169.0,1572.0,0.725,10.285,243,78,63,15,165,118,47,8,0.0,0.0
1005,1788,2020-03-20 04:14:00,0,2189.0,1549.0,0.708,10.339,151,19,8,11,132,79,53,3,0.0,0.0
1005,1789,2020-03-20 04:17:00,0,1980.0,1513.0,0.764,9.479,277,111,84,27,166,127,39,58,0.0,0.0
1005,1790,2020-03-20 04:20:00,0,2076.0,1529.0,0.736,9.873,136,48,23,25,88,51,37,13,0.0,0.0
1005,1791,2020-03-20 04:23:00,0,1837.0,1355.0,0.738,8.738,44,0,0,0,44,8,36,0,0.0,0.0
1005,1792,2020-03-20 04:26:00,0,1756.0,1278.0,0.728,8.335,102,17,6,11,85,39,46,0,0.0,0.0
1005,1793,2020-03-20 04:29:00,0,1747.0,1319.0,0.755,8.344,143,56,27,29,87,41,46,6,0.0,0.0
1005,1794,2020-03-20 04:32:00,0,1567.0,1214.0,0.775,7.519,38,0,0,0,38,0,38,0,0.0,0.0
1005,1795,2020-03-20 04:35:00,0,1584.0,1149.0,0.725,7.512,47,3,0,3,44,4,40,0,0.0,0.0
1005,1796,2020-03-20 04:38:00,0,1590.0,1116.0,0.702,7.498,65,8,0,8,57,14,43,0,0.0,0.0
1005,1797,2020-03-20 04:41:00,0,1412.0,1059.0,0.75,6.735,60,17,0,17,43,10,33,0,0.0,0.0
1005,1798,2020-03-20 04:44:00,0,1431.0,996.0,0.696,6.743,33,0,0,0,33,4,29,0,0.0,0.0
1005,1799,2020-03-20 04:47:00,0,1246.0,947.0,0.76,5.956,30,5,1,4,25,3,22,0,0.0,0.0
1005,1800,2020-03-20 04:50:00,0,1156.0,912.0,0.789,5.566,41,8,0,8,33,10,23,0,0.0,0.0
1005,1801,2020-03-20 04:53:00,0,1160.0,899.0,0.775,5.566,30,0,0,0,30,2,28,0,0.0,0.0
1005,1802,2020-03-20 04:56:00,0,1166.0,871.0,0.747,5.557,24,0,0,0,24,4,20,0,0.0,0.0
1005,1803,2020-03-20 04:59:00,0,1177.0,843.0,0.716,5.573,32,2,0,2,30,4,26,0,0.0,0.0
1005,1804,2020-03-20 05:02:00,0,1178.5,835.5,0.7085,5.5695,35,8,0,8,27,0,27,0,0.0,0.0
1005,1805,2020-03-20 05:05:00,0,1180.0,828.0,0.701,5.566,28,1,0,1,27,2,25,0,0.0,0.0
1005,1806,2020-03-20 05:08:00,0,1154.0,900.0,0.779,5.545,266,95,60,35,171,109,62,27,0.0,0.0
1005,1807,2020-03-20 05:11:00,0,1418.0,1055.0,0.744,6.755,296,139,98,41,157,114,43,125,0.0,0.0
1005,1808,2020-03-20 05:14:00,0,1582.0,1192.0,0.753,7.553,290,113,93,20,177,125,52,108,0.0,0.0
1005,1809,2020-03-20 05:17:00,0,2007.0,1411.0,0.703,9.47,258,63,37,26,195,118,77,62,0.0,0.0
1005,1810,2020-03-20 05:20:00,0,1994.0,1480.0,0.742,9.496,212,46,24,22,166,81,85,32,0.0,0.0
1005,1811,2020-03-20 05:23:00,0,2173.0,1540.0,0.709,10.266,193,20,2,18,173,88,85,4,0.0,0.0
1005,1812,2020-03-20 05:26:00,0,2165.0,1594.0,0.736,10.294,497,202,149,53,295,208,87,75,0.0,0.0
1005,1813,2020-03-20 05:29:00,0,2419.0,1802.0,0.745,11.527,731,334,279,55,397,305,92,187,0.0,0.0
1005,1814,2020-03-20 05:32:00,0,2665.0,1946.0,0.73,12.653,572,277,214,63,295,230,65,74,0.0,0.0
1005,1815,2020-03-20 05:35:00,0,2409.0,1780.0,0.739,11.463,208,37,6,31,171,89,82,6,0.0,0.0
1005,1816,2020-03-20 05:38:00,0,2421.0,1765.0,0.729,11.494,245,117,94,23,128,91,37,30,0.0,0.0
1005,1817,2020-03-20 05:41:00,0,2413.0,1830.0,0.758,11.534,709,339,280,59,370,290,80,132,0.0,0.0
1005,1818,2020-03-20 05:44:00,0,2606.0,1830.0,0.702,12.295,345,155,129,26,190,150,40,40,0.0,0.0
1005,1819,2020-03-20 05:47:00,0,2147.0,1639.0,0.763,10.274,702,296,240,56,406,314,92,112,0.01,0.0
1005,1820,2020-03-20 05:50:00,0,2173.0,1587.0,0.73,10.321,119,26,8,18,93,37,56,1,0.0,0.0
1005,1821,2020-03-20 05:53:00,0,2004.0,1484.0,0.74,9.539,146,16,9,7,130,55,75,0,0.0,0.0
1005,1822,2020-03-20 05:56:00,0,2019.0,1399.0,0.693,9.503,130,0,0,0,130,76,54,0,0.0,0.0
1005,1823,2020-03-20 05:59:00,0,1747.0,1322.0,0.757,8.346,165,2,1,1,163,106,57,2,0.0,0.0
1005,1824,2020-03-20 06:02:00,1,2079.0,1541.0,0.741,9.899,209,45,30,15,164,103,61,49,0.0,0.0
1005,1825,2020-03-20 06:05:00,1,2165.0,1608.0,0.743,10.309,121,46,24,22,75,31,44,76,0.0,0.0
1005,1826,2020-03-20 06:08:00,1,2410.0,1786.0,0.741,11.475,334,171,116,55,163,99,64,106,0.0,0.0
1005,1827,2020-03-20 06:11:00,1,2761.0,1988.0,0.72,13.079,267,146,83,63,121,71,50,120,0.0,0.0
1005,1828,2020-03-20 06:14:00,1,2832.0,2112.0,0.746,13.495,280,143,83,60,137,88,49,88,0.0,0.0
1005,1829,2020-03-20 06:17:00,1,3005.0,2202.0,0.733,14.279,266,142,75,67,124,68,56,102,0.0,0.0
1005,1830,2020-03-20 06:20:00,1,3055.0,2325.0,0.761,14.612,226,124,66,58,102,61,41,111,0.0,0.0
1005,1831,2020-03-20 06:23:00,1,3130.0,2477.0,0.791,15.076,610,347,280,67,263,216,47,188,0.0,0.01
1005,1832,2020-03-20 06:26:00,1,3118.0,2481.0,0.796,15.033,190,116,56,60,74,42,32,98,0.0,0.09
1005,1833,2020-03-20 06:29:00,1,2968.0,2328.0,0.784,14.27,431,230,160,70,201,147,54,121,0.0,0.1
1005,1834,2020-03-20 06:32:00,1,3211.0,2578.0,0.803,15.504,222,121,58,63,101,57,44,91,0.0,0.0
1005,1835,2020-03-20 06:35:00,1,3123.0,2520.0,0.807,15.094,207,112,61,51,95,53,42,70,0.0,0.0
1005,1836,2020-03-20 06:38:00,1,3085.0,2614.0,0.847,15.047,229,119,59,60,110,52,58,58,0.0,0.0
1005,1837,2020-03-20 06:41:00,1,3171.0,2676.0,0.844,15.457,254,149,81,68,105,69,36,60,0.0,0.0
1005,1838,2020-03-20 06:44:00,1,3177.0,2713.0,0.854,15.522,467,210,175,35,257,205,52,71,0.46,0.0
1005,1839,2020-03-20 06:47:00,1,3492.0,2979.0,0.853,17.056,434,203,148,55,231,187,44,119,0.0,0.1
1005,1840,2020-03-20 06:50:00,1,3097.0,2635.0,0.851,15.12,190,108,48,60,82,39,43,89,0.0,0.0
1005,1841,2020-03-20 06:53:00,1,3155.0,2755.0,0.873,15.482,216,137,67,70,79,37,42,89,0.0,0.0
1005,1842,2020-03-20 06:56:00,1,3051.0,2747.0,0.9,15.062,376,167,116,51,209,149,60,67,0.11,0.0
1005,1843,2020-03-20 06:59:00,1,3068.0,2707.0,0.882,15.087,233,116,58,58,117,63,54,67,0.0,0.0
1005,1844,2020-03-20 07:02:00,1,3056.0,2729.0,0.893,15.063,453,203,160,43,250,193,57,83,0.0,0.0
1005,1845,2020-03-20 07:05:00,1,3385.0,3020.0,0.892,16.679,291,131,96,35,160,120,40,64,0.0,0.0
1005,1846,2020-03-20 07:08:00,1,2973.0,2713.0,0.913,14.716,172,97,44,53,75,33,42,69,0.0,0.03
1005,1847,2020-03-20 07:11:00,1,3037.0,2809.0,0.925,15.075,192,118,56,62,74,40,34,57,0.0,0.03
1005,1848,2020-03-20 07:14:00,1,3325.0,2928.0,0.881,16.341,192,42,23,19,150,108,42,0,0.0,0.0
1005,1849,2020-03-20 07:17:00,1,3040.0,2784.0,0.916,15.059,460,227,177,50,233,175,58,74,0.0,0.0
1005,1850,2020-03-20 07:20:00,1,2877.0,2660.0,0.924,14.28,510,215,154,61,295,226,69,62,0.0,0.04
1005,1851,2020-03-20 07:23:00,1,2713.0,2531.0,0.933,13.491,583,304,239,65,279,222,57,149,0.0,0.0
1005,1852,2020-03-20 07:26:00,1,3302.0,3026.0,0.916,16.358,208,122,95,27,86,66,20,26,0.0,0.02
1005,1853,2020-03-20 07:29:00,1,3529.0,3277.0,0.929,17.53,11,11,3,8,0,0,0,0,0.0,0.0
1005,1854,2020-03-20 07:32:00,1,3317.0,2953.0,0.89,16.337,14,3,1,2,11,6,5,0,0.0,0.0
1005,1855,2020-03-20 07:35:00,1,2891.0,2651.0,0.917,14.323,146,41,16,25,105,67,38,1,0.0,0.0
1005,1856,2020-03-20 07:38:00,1,2675.0,2370.0,0.886,13.164,200,58,24,34,142,83,59,12,0.0,0.0
1005,1857,2020-03-20 07:41:00,1,2725.0,2534.0,0.93,13.541,234,118,44,74,116,59,57,86,0.0,0.0
1005,1858,2020-03-20 07:44:00,1,2876.0,2676.0,0.931,14.294,273,152,91,61,121,67,54,100,0.0,0.01
1005,1859,2020-03-20 07:47:00,1,3043.0,2791.0,0.917,15.08,224,107,66,41,117,67,50,65,0.0,0.08
1005,1860,2020-03-20 07:50:00,1,3133.0,2866.0,0.915,15.516,253,113,73,40,140,80,60,54,0.0,0.0
1005,1861,2020-03-20 07:53:00,1,2875.0,2730.0,0.949,14.352,180,72,41,31,108,71,37,12,0.0,0.02
1005,1862,2020-03-20 07:56:00,1,2862.0,2731.0,0.954,14.299,45,1,0,1,44,10,34,0,0.0,0.0
1005,1863,2020-03-20 07:59:00,1,2717.0,2548.0,0.938,13.526,53,11,4,7,42,10,32,0,0.0,0.02
1005,1864,2020-03-20 08:02:00,1,2515.0,2365.0,0.9405,12.5285,48,14,1,13,34,2,32,0,0.0,0.0
1005,1865,2020-03-20 08:05:00,1,2313.0,2182.0,0.943,11.531,92,27,13,14,65,30,35,3,0.0,0.0
1005,1866,2020-03-20 08:08:00,1,2726.0,2439.0,0.895,13.442,176,39,20,19,137,92,45,14,0.13,0.0
1005,1867,2020-03-20 08:11:00,1,2656.0,2390.0,0.9,13.112,187,90,36,54,97,41,56,3,0.0,0.0
1005,1868,2020-03-20 08:14:00,1,2716.0,2526.0,0.93,13.499,252,128,59,69,124,75,49,65,0.0,0.01
1005,1869,2020-03-20 08:17:00,1,2873.0,2696.0,0.938,14.304,238,114,65,49,124,69,55,48,0.0,0.01
1005,1870,2020-03-20 08:20:00,1,2741.0,2507.0,0.914,13.575,137,11,6,5,126,55,71,0,0.0,0.0
1005,1871,2020-03-20 08:23:00,1,2731.0,2466.0,0.903,13.491,107,0,0,0,107,38,69,0,0.0,0.0
1005,1872,2020-03-20 08:26:00,1,2472.0,2320.0,0.938,12.31,79,6,1,5,73,30,43,0,0.0,0.0
1005,1873,2020-03-20 08:29:00,1,2467.0,2329.0,0.944,12.3,135,22,4,18,113,50,63,7,0.0,0.01
1005,1874,2020-03-20 08:32:00,1,2723.0,2484.0,0.912,13.477,201,78,38,40,123,81,42,10,0.0,0.0
1005,1875,2020-03-20 08:35:00,1,2898.0,2600.0,0.897,14.298,549,266,196,70,283,228,55,97,0.0,0.0
1005,1876,2020-03-20 08:38:00,1,2871.0,2677.0,0.933,14.273,386,143,99,44,243,184,59,34,0.0,0.01
1005,1877,2020-03-20 08:41:00,1,2884.0,2627.0,0.911,14.27,42,2,0,2,40,2,38,0,0.0,0.0
1005,1878,2020-03-20 08:44:00,1,2746.0,2443.0,0.89,13.526,70,9,5,4,61,18,43,0,0.0,0.0
1005,1879,2020-03-20 08:47:00,1,2504.0,2206.0,0.881,12.308,32,0,0,0,32,4,28,0,0.0,0.0
1005,1880,2020-03-20 08:50:00,1,2473.0,2314.0,0.936,12.305,272,106,55,51,166,117,49,65,0.0,0.0
1005,1881,2020-03-20 08:53:00,1,2722.0,2515.0,0.924,13.507,211,121,66,55,90,49,41,83,0.0,0.0
1005,1882,2020-03-20 08:56:00,1,2889.0,2621.0,0.907,14.285,200,102,53,49,98,51,47,52,0.0,0.01
1005,1883,2020-03-20 08:59:00,1,3053.0,2785.0,0.912,15.112,213,123,60,63,90,38,52,77,0.0,0.02
1005,1884,2020-03-20 09:02:00,1,3228.0,2889.0,0.895,15.917,328,182,114,68,146,82,64,89,0.0,0.05
1005,1885,2020-03-20 09:05:00,1,3316.0,2902.0,0.875,16.278,341,142,82,60,199,138,61,47,0.0,0.0
1005,1886,2020-03-20 09:08:00,1,3296.0,2941.0,0.892,16.244,342,135,90,45,207,147,60,56,0.41,0.0
1005,1887,2020-03-20 09:11:00,1,3296.0,2955.0,0.896,16.258,478,196,155,41,282,218,64,76,0.0,0.0
1005,1888,2020-03-20 09:14:00,1,3136.0,2869.0,0.915,15.532,228,93,44,49,135,72,63,12,0.0,0.0
1005,1889,2020-03-20 09:17:00,1,3304.0,2948.0,0.892,16.282,209,88,36,52,121,69,52,9,0.0,0.0
1005,1890,2020-03-20 09:20:00,1,3043.0,2786.0,0.916,15.073,85,24,9,15,61,19,42,0,0.0,0.0
1005,1891,2020-03-20 09:23:00,1,2721.0,2472.0,0.908,13.459,65,4,2,2,61,15,46,0,0.0,0.0
1005,1892,2020-03-20 09:26:00,1,2732.0,2471.0,0.904,13.5,121,84,65,19,37,0,37,0,0.0,0.0
1005,1893,2020-03-20 09:29:00,1,2672.0,2368.0,0.886,13.152,65,20,5,15,45,11,34,0,0.0,0.0
1005,1894,2020-03-20 09:32:00,1,2325.0,2135.0,0.918,11.525,45,0,0,0,45,13,32,0,0.0,0.0
1005,1895,2020-03-20 09:35:00,1,2344.0,2037.0,0.869,11.493,40,0,0,0,40,0,40,0,0.0,0.0
1005,1896,2020-03-20 09:38:00,1,2330.0,2085.0,0.895,11.488,38,0,0,0,38,0,38,0,0.0,0.0
1005,1897,2020-03-20 09:41:00,1,2361.0,2026.0,0.858,11.546,41,0,0,0,41,0,41,0,0.0,0.0
1005,1898,2020-03-20 09:44:00,1,2089.0,1917.0,0.918,10.355,52,0,0,0,52,18,34,0,0.0,0.0
1005,1899,2020-03-20 09:47:00,1,2405.0,2155.0,0.896,11.861,202,50,15,35,152,96,56,4,0.0,0.0
1005,1900,2020-03-20 09:50:00,1,2501.0,2204.0,0.881,12.295,153,42,18,24,111,60,51,5,0.0,0.0
1005,1901,2020-03-20 09:53:00,1,2668.0,2376.0,0.89,13.143,567,233,186,47,334,255,79,50,0.0,0.0
1005,1902,2020-03-20 09:56:00,1,2319.0,2155.0,0.929,11.521,84,41,2,39,43,0,43,0,0.0,0.0
1005,1903,2020-03-20 09:59:00,1,2362.0,2017.0,0.854,11.539,244,205,171,34,39,0,39,0,0.0,0.01
1005,1904,2020-03-20 10:02:00,1,2167.0,1959.0,0.904,10.705,122,83,4,79,39,0,39,0,0.0,0.0
1005,1905,2020-03-20 10:05:00,1,2191.0,1946.0,0.888,10.786,144,93,6,87,51,10,41,0,0.0,0.0
1005,1906,2020-03-20 10:08:00,1,2177.0,1957.0,0.899,10.745,80,42,0,42,38,0,38,0,0.0,0.0
1005,1907,2020-03-20 10:11:00,1,2176.0,1955.0,0.899,10.738,100,44,2,42,56,20,36,0,0.0,0.0
1005,1908,2020-03-20 10:14:00,1,2096.0,1912.0,0.912,10.377,100,58,0,58,42,4,38,0,0.0,0.0
1005,1909,2020-03-20 10:17:00,1,2086.0,1876.0,0.899,10.297,99,62,0,62,37,0,37,0,0.0,0.0
1005,1910,2020-03-20 10:20:00,1,2093.0,1895.0,0.905,10.346,118,34,13,21,84,35,49,0,0.0,0.0
1005,1911,2020-03-20 10:23:00,1,2096.0,1840.0,0.878,10.294,107,52,0,52,55,15,40,0,0.0,0.0
1005,1912,2020-03-20 10:26:00,1,2091.0,1846.0,0.883,10.282,121,75,0,75,46,0,46,0,0.0,0.0
1005,1913,2020-03-20 10:29:00,1,2339.0,2060.0,0.881,11.499,249,96,20,76,153,84,69,0,0.0,0.0
1005,1914,2020-03-20 10:32:00,1,2363.0,2010.0,0.851,11.534,181,18,0,18,163,87,76,0,0.0,0.0
1005,1915,2020-03-20 10:35:00,1,2082.0,1914.0,0.919,10.323,71,0,0,0,71,32,39,0,0.0,0.0
1005,1916,2020-03-20 10:38:00,1,2069.0,1946.0,0.941,10.306,46,0,0,0,46,4,42,0,0.0,0.0
1005,1917,2020-03-20 10:41:00,1,2080.0,1900.0,0.913,10.3,81,0,0,0,81,36,45,0,0.0,0.0
1005,1918,2020-03-20 10:44:00,1,2097.0,1884.0,0.898,10.347,121,17,6,11,104,52,52,0,0.0,0.0
1005,1919,2020-03-20 10:47:00,1,2327.0,2149.0,0.924,11.548,308,55,26,29,253,172,81,2,0.0,0.0
1005,1920,2020-03-20 10:50:00,1,2550.0,2355.0,0.924,12.655,409,88,37,51,321,228,93,3,0.0,0.0
1005,1921,2020-03-20 10:53:00,1,2473.0,2331.0,0.943,12.323,229,61,29,32,168,109,59,14,0.0,0.0
1005,1922,2020-03-20 10:56:00,1,2509.0,2204.0,0.878,12.326,42,0,0,0,42,9,33,0,0.0,0.0
1005,1923,2020-03-20 10:59:00,1,2315.0,2164.0,0.935,11.517,41,1,0,1,40,17,23,0,0.0,0.0
1005,1924,2020-03-20 11:02:00,1,2284.5,2082.5,0.9115,11.306,126,37,18,19,89,46,43,7,0.0,0.0
1005,1925,2020-03-20 11:05:00,1,2254.0,2001.0,0.888,11.095,54,17,1,16,37,4,33,0,0.0,0.0
1005,1926,2020-03-20 11:08:00,1,2100.0,1887.0,0.899,10.362,63,22,3,19,41,2,39,0,0.0,0.0
1005,1927,2020-03-20 11:11:00,1,2102.0,1846.0,0.878,10.325,44,1,0,1,43,4,39,0,0.0,0.0
1005,1928,2020-03-20 11:14:00,1,2098.0,1857.0,0.885,10.321,60,4,1,3,56,16,40,0,0.0,0.0
1005,1929,2020-03-20 11:17:00,1,2102.0,1859.0,0.884,10.34,155,76,0,76,79,44,35,0,0.0,0.0
1005,1930,2020-03-20 11:20:00,1,2088.0,1867.0,0.894,10.294,228,48,2,46,180,128,52,0,0.0,0.0
1005,1931,2020-03-20 11:23:00,1,2085.0,1911.0,0.916,10.332,137,11,2,9,126,50,76,0,0.0,0.0
1005,1932,2020-03-20 11:26:00,1,2012.0,1788.0,0.889,9.905,239,63,14,49,176,94,82,0,0.0,0.0
1005,1933,2020-03-20 11:29:00,1,2024.0,1762.0,0.871,9.924,150,12,2,10,138,52,86,0,0.0,0.0
1005,1934,2020-03-20 11:32:00,1,1940.0,1671.0,0.861,9.495,296,81,37,44,215,135,80,0,0.0,0.0
1005,1935,2020-03-20 11:35:00,1,2336.0,2060.0,0.882,11.484,305,82,42,40,223,144,79,3,0.0,0.0
1005,1936,2020-03-20 11:38:00,1,2497.0,2195.0,0.879,12.269,336,146,74,72,190,145,45,47,0.0,0.0
1005,1937,2020-03-20 11:41:00,1,2747.0,2449.0,0.891,13.534,213,133,80,53,80,42,38,71,0.0,0.04
1005,1938,2020-03-20 11:44:00,1,2926.0,2522.0,0.862,14.321,222,140,68,72,82,50,32,81,0.0,0.0
1005,1939,2020-03-20 11:47:00,1,2895.0,2630.0,0.909,14.317,206,118,53,65,88,63,25,73,0.0,0.0
1005,1940,2020-03-20 11:50:00,1,3067.0,2742.0,0.894,15.119,139,79,30,49,60,24,36,39,0.0,0.0
1005,1941,2020-03-20 11:53:00,1,3232.0,2861.0,0.885,15.901,218,107,55,52,111,69,42,86,0.0,0.0
1005,1942,2020-03-20 11:56:00,1,3125.0,2832.0,0.906,15.448,154,98,43,55,56,26,30,78,0.0,0.08
1005,1943,2020-03-20 11:59:00,1,3307.0,2907.0,0.879,16.249,200,117,62,55,83,25,58,80,0.0,0.03
1005,1944,2020-03-20 12:02:00,1,3466.0,3082.0,0.889,17.067,204,87,49,38,117,60,57,69,0.0,0.1
1005,1945,2020-03-20 12:05:00,1,3530.0,3260.0,0.924,17.516,181,79,39,40,102,50,52,75,0.0,0.12
1005,1946,2020-03-20 12:08:00,1,3530.0,3283.0,0.93,17.541,739,360,285,75,379,304,75,124,0.0,0.02
1006,1,2020-03-16 10:53:00,1,4614.0,3597.0,0.78,22.164,551,348,274,74,203,146,57,19,0.01,0.02
1006,2,2020-03-16 10:56:00,1,4332.0,3314.0,0.765,20.739,542,364,285,79,178,135,43,39,0.0,0.0
1006,3,2020-03-16 10:59:00,1,4405.0,3357.0,0.762,21.073,653,408,330,78,245,178,67,47,0.0,0.0
1006,4,2020-03-16 11:02:00,1,4416.0,3333.0,0.755,21.089,600,294,230,64,306,241,65,66,0.07,0.02
1006,5,2020-03-16 11:05:00,1,4271.0,3229.5,0.7565,20.4045,110,41,29,12,69,44,25,30,0.0,0.0
1006,6,2020-03-16 11:08:00,1,4126.0,3126.0,0.758,19.72,76,36,10,26,40,6,34,18,0.0,0.0
1006,7,2020-03-16 11:11:00,1,3948.0,3046.0,0.772,18.929,80,60,43,17,20,2,18,6,0.0,0.0
1006,8,2020-03-16 11:14:00,1,3808.0,2888.0,0.758,18.202,69,37,22,15,32,9,23,1,0.0,0.0
1006,9,2020-03-16 11:17:00,1,3756.0,2858.0,0.761,17.963,16,8,5,3,8,3,5,0,0.06,0.0
1006,10,2020-03-16 11:20:00,1,3608.0,2720.0,0.754,17.226,4,2,1,1,2,0,2,0,0.0,0.0
1006,11,2020-03-16 11:23:00,1,3508.0,2645.0,0.754,16.752,72,47,33,14,25,8,17,19,0.0,0.0
1006,12,2020-03-16 11:26:00,1,3517.0,2662.0,0.757,16.806,30,20,14,6,10,5,5,6,0.0,0.0
1006,13,2020-03-16 11:29:00,1,3380.0,2531.0,0.749,16.119,1,0,0,0,1,0,1,0,0.0,0.0
1006,14,2020-03-16 11:32:00,1,3219.0,2417.0,0.751,15.358,5,2,0,2,3,0,3,0,0.0,0.0
1006,15,2020-03-16 11:35:00,1,3167.0,2299.0,0.726,15.024,2,1,0,1,1,0,1,0,0.0,0.0
1006,16,2020-03-16 11:38:00,1,3002.0,2258.0,0.752,14.328,0,0,0,0,0,0,0,0,0.0,0.0
1006,17,2020-03-16 11:41:00,1,3005.0,2230.0,0.742,14.31,4,0,0,0,4,0,4,0,0.0,0.0
1006,18,2020-03-16 11:44:00,1,3016.0,2190.0,0.726,14.309,4,1,1,0,3,0,3,0,0.0,0.0
1006,19,2020-03-16 11:47:00,1,3002.0,2221.0,0.74,14.286,8,1,0,1,7,0,7,0,0.04,0.0
1006,20,2020-03-16 11:50:00,1,2995.0,2290.0,0.765,14.335,0,0,0,0,0,0,0,0,0.0,0.0
1006,21,2020-03-16 11:53:00,1,3159.0,2337.0,0.74,15.033,310,138,101,37,172,128,44,18,0.0,0.0
1006,22,2020-03-16 11:56:00,1,3530.0,2643.0,0.749,16.834,382,162,119,43,220,159,61,5,0.0,0.0
1006,23,2020-03-16 11:59:00,1,3363.0,2568.0,0.764,16.094,123,71,53,18,52,34,18,8,0.0,0.0
1006,24,2020-03-16 12:02:00,1,3371.0,2587.0,0.767,16.146,420,193,140,53,227,168,59,33,0.0,0.0
1006,25,2020-03-16 12:05:00,1,3497.0,2673.0,0.764,16.74,440,163,122,41,277,208,69,12,0.02,0.0
1006,26,2020-03-16 12:08:00,1,3527.0,2653.0,0.752,16.835,264,124,79,45,140,93,47,3,0.0,0.0
1006,27,2020-03-16 12:11:00,1,3367.0,2573.0,0.764,16.116,99,41,20,21,58,27,31,0,0.0,0.0
1006,28,2020-03-16 12:14:00,1,3203.0,2485.0,0.776,15.371,240,110,68,42,130,91,39,1,0.0,0.0
1006,29,2020-03-16 12:17:00,1,3207.0,2479.0,0.773,15.38,216,96,63,33,120,78,42,10,0.0,0.0
1006,30,2020-03-16 12:20:00,1,3231.0,2460.0,0.761,15.454,185,87,52,35,98,65,33,0,0.0,0.0
1006,31,2020-03-16 12:23:00,1,3223.0,2366.0,0.734,15.318,115,41,22,19,74,19,55,2,0.0,0.0
1006,32,2020-03-16 12:26:00,1,3224.0,2373.0,0.736,15.329,92,61,25,36,31,16,15,0,0.0,0.0
1006,33,2020-03-16 12:29:00,1,3230.0,2388.0,0.739,15.372,88,47,12,35,41,10,31,0,0.0,0.0
1006,34,2020-03-16 12:32:00,1,3146.0,2377.0,0.756,15.027,44,15,8,7,29,13,16,0,0.0,0.0
1006,35,2020-03-16 12:35:00,1,2998.0,2274.0,0.759,14.331,6,6,4,2,0,0,0,0,0.02,0.0
1006,36,2020-03-16 12:38:00,1,2997.0,2256.0,0.753,14.305,11,1,0,1,10,4,6,0,0.0,0.0
1006,37,2020-03-16 12:41:00,1,3024.0,2148.0,0.71,14.294,21,12,4,8,9,5,4,0,0.0,0.0
1006,38,2020-03-16 12:44:00,1,2870.0,2048.0,0.714,13.575,33,5,0,5,28,6,22,0,0.0,0.0
1006,39,2020-03-16 12:47:00,1,2865.0,2064.0,0.72,13.575,43,21,2,19,22,10,12,0,0.0,0.0
1006,40,2020-03-16 12:50:00,1,2872.0,2074.0,0.722,13.611,19,5,0,5,14,0,14,0,0.01,0.0
1006,41,2020-03-16 12:53:00,1,2854.0,2108.0,0.739,13.578,23,18,1,17,5,3,2,0,0.0,0.0
1006,42,2020-03-16 12:56:00,1,2863.0,2040.0,0.713,13.537,16,13,1,12,3,2,1,0,0.0,0.0
1006,43,2020-03-16 12:59:00,1,2870.0,2070.0,0.721,13.6,57,28,11,17,29,4,25,0,0.0,0.0
1006,44,2020-03-16 13:02:00,1,2863.0,2037.0,0.712,13.537,52,30,16,14,22,5,17,0,0.0,0.0
1006,45,2020-03-16 13:05:00,1,2870.0,2057.0,0.717,13.588,96,27,16,11,69,50,19,0,0.0,0.0
1006,46,2020-03-16 13:08:00,1,2783.0,2041.0,0.733,13.225,18,8,0,8,10,4,6,0,0.0,0.0
1006,47,2020-03-16 13:11:00,1,2620.0,1973.0,0.753,12.508,62,36,11,25,26,12,14,0,0.0,0.0
1006,48,2020-03-16 13:14:00,1,2618.0,2012.0,0.769,12.544,210,83,61,22,127,82,45,14,0.0,0.0
1006,49,2020-03-16 13:17:00,1,2999.0,2227.0,0.743,14.281,188,93,67,26,95,70,25,6,0.0,0.0
1006,50,2020-03-16 13:20:00,1,3004.0,2242.0,0.746,14.32,241,110,80,30,131,90,41,13,0.0,0.0
1006,51,2020-03-16 13:23:00,1,3225.0,2380.0,0.738,15.341,386,204,146,58,182,122,60,3,0.0,0.0
1006,52,2020-03-16 13:26:00,1,2988.0,2310.0,0.773,14.33,181,66,48,18,115,70,45,7,0.0,0.0
1006,53,2020-03-16 13:29:00,1,3000.0,2248.0,0.749,14.311,140,55,40,15,85,50,35,2,0.0,0.0
1006,54,2020-03-16 13:32:00,1,3016.0,2195.0,0.728,14.315,11,2,2,0,9,5,4,0,0.0,0.0
1006,55,2020-03-16 13:35:00,1,2879.0,2063.0,0.717,13.626,21,2,0,2,19,6,13,0,0.0,0.0
1006,56,2020-03-16 13:38:00,1,2636.0,1948.0,0.739,12.545,29,0,0,0,29,2,27,0,0.0,0.0
1006,57,2020-03-16 13:41:00,1,2559.0,1869.0,0.73,12.153,34,1,0,1,33,15,18,0,0.0,0.0
1006,58,2020-03-16 13:44:00,1,2470.0,1853.0,0.75,11.784,4,0,0,0,4,0,4,0,0.01,0.0
1006,59,2020-03-16 13:47:00,1,2471.0,1855.0,0.751,11.791,50,21,13,8,29,21,8,0,0.0,0.0
1006,60,2020-03-16 13:50:00,1,2484.0,1828.0,0.736,11.812,0,0,0,0,0,0,0,0,0.0,0.0
1006,61,2020-03-16 13:53:00,1,2493.0,1809.0,0.726,11.825,11,3,1,2,8,1,7,0,0.0,0.0
1006,62,2020-03-16 13:56:00,1,2488.0,1802.0,0.724,11.797,38,15,9,6,23,9,14,0,0.0,0.0
1006,63,2020-03-16 13:59:00,1,2482.0,1834.0,0.739,11.81,27,0,0,0,27,1,26,0,0.0,0.0
1006,64,2020-03-16 14:02:00,1,2478.0,1833.0,0.74,11.793,82,7,3,4,75,36,39,0,0.0,0.0
1006,65,2020-03-16 14:05:00,1,2472.5,1851.0,0.749,11.7905,32,15,4,11,17,5,12,0,0.0,0.0
1006,66,2020-03-16 14:08:00,1,2467.0,1869.0,0.758,11.788,95,6,2,4,89,49,40,0,0.0,0.0
1006,67,2020-03-16 14:11:00,1,2469.0,1850.0,0.749,11.775,7,1,0,1,6,5,1,0,0.0,0.0
1006,68,2020-03-16 14:14:00,1,2488.0,1795.0,0.722,11.79,1,0,0,0,1,1,0,0,0.0,0.0
1006,69,2020-03-16 14:17:00,1,2490.0,1783.0,0.716,11.785,17,0,0,0,17,2,15,0,0.0,0.0
1006,70,2020-03-16 14:20:00,1,2494.0,1798.0,0.721,11.818,30,21,12,9,9,2,7,0,0.0,0.0
1006,71,2020-03-16 14:23:00,1,2401.0,1751.0,0.729,11.399,57,34,17,17,23,2,21,0,0.0,0.0
1006,72,2020-03-16 14:26:00,1,2330.0,1751.0,0.751,11.121,37,9,4,5,28,0,28,0,0.0,0.0
1006,73,2020-03-16 14:29:00,1,2482.0,1814.0,0.731,11.789,159,78,58,20,81,60,21,0,0.0,0.0
1006,74,2020-03-16 14:32:00,1,2410.0,1777.0,0.738,11.462,0,0,0,0,0,0,0,0,0.0,0.0
1006,75,2020-03-16 14:35:00,1,2307.0,1747.0,0.757,11.025,26,0,0,0,26,6,20,0,0.01,0.0
1006,76,2020-03-16 14:38:00,1,2326.0,1755.0,0.755,11.108,27,0,0,0,27,5,22,0,0.0,0.0
1006,77,2020-03-16 14:41:00,1,2342.0,1680.0,0.717,11.089,24,3,1,2,21,6,15,0,0.0,0.0
1006,78,2020-03-16 14:44:00,1,2329.0,1735.0,0.745,11.099,37,31,7,24,6,2,4,0,0.0,0.0
1006,79,2020-03-16 14:47:00,1,2338.0,1683.0,0.72,11.074,30,19,1,18,11,1,10,0,0.0,0.0
1006,80,2020-03-16 14:50:00,1,2260.0,1623.0,0.718,10.702,219,3,0,3,216,194,22,0,0.0,0.0
1006,81,2020-03-16 14:53:00,1,2180.0,1618.0,0.742,10.38,7,1,0,1,6,0,6,0,0.0,0.0
1006,82,2020-03-16 14:56:00,1,2340.0,1694.0,0.724,11.097,3,0,0,0,3,0,3,0,0.0,0.0
1006,83,2020-03-16 14:59:00,1,2331.0,1708.0,0.733,11.075,13,5,1,4,8,0,8,0,0.0,0.0
1006,84,2020-03-16 15:02:00,1,2331.0,1719.0,0.737,11.088,11,2,0,2,9,2,7,0,0.0,0.0
1006,85,2020-03-16 15:05:00,1,2341.0,1669.0,0.713,11.072,13,1,0,1,12,0,12,0,0.0,0.0
1006,86,2020-03-16 15:08:00,1,2266.0,1641.0,0.724,10.744,45,17,4,13,28,5,23,0,0.0,0.0
1006,87,2020-03-16 15:11:00,1,2309.0,1770.0,0.767,11.059,27,2,0,2,25,5,20,0,0.0,0.0
1006,88,2020-03-16 15:14:00,1,2311.0,1767.0,0.765,11.061,20,0,0,0,20,0,20,0,0.0,0.0
1006,89,2020-03-16 15:17:00,1,2315.0,1747.0,0.755,11.058,4,0,0,0,4,1,3,0,0.0,0.0
1006,90,2020-03-16 15:20:00,1,2318.0,1756.0,0.757,11.077,1,0,0,0,1,0,1,0,0.0,0.0
1006,91,2020-03-16 15:23:00,1,2483.0,1809.0,0.728,11.787,21,5,4,1,16,9,7,0,0.01,0.0
1006,92,2020-03-16 15:26:00,1,2398.0,1810.0,0.755,11.452,72,34,20,14,38,24,14,0,0.0,0.0
1006,93,2020-03-16 15:29:00,1,2478.0,1858.0,0.75,11.823,45,11,6,5,34,27,7,0,0.0,0.0
1006,94,2020-03-16 15:32:00,1,2485.0,1832.0,0.737,11.819,22,21,3,18,1,1,0,0,0.0,0.0
1006,95,2020-03-16 15:35:00,1,2481.0,1833.0,0.739,11.804,12,2,0,2,10,1,9,0,0.0,0.0
1006,96,2020-03-16 15:38:00,1,2481.0,1842.0,0.742,11.813,1,1,0,1,0,0,0,0,0.0,0.0
1006,97,2020-03-16 15:41:00,1,2490.0,1811.0,0.727,11.815,6,5,2,3,1,0,1,0,0.0,0.0
1006,98,2020-03-16 15:44:00,1,2483.0,1835.0,0.739,11.813,47,29,12,17,18,8,10,0,0.0,0.0
1006,99,2020-03-16 15:47:00,1,2489.0,1809.0,0.727,11.811,21,12,4,8,9,3,6,0,0.0,0.0
1006,100,2020-03-16 15:50:00,1,2321.0,1744.0,0.751,11.075,9,6,0,6,3,0,3,0,0.0,0.0
1006,101,2020-03-16 15:53:00,1,2329.0,1714.0,0.736,11.076,23,10,0,10,13,6,7,0,0.01,0.0
1006,102,2020-03-16 15:56:00,1,2345.0,1712.0,0.73,11.134,64,26,8,18,38,10,28,0,0.01,0.0
1006,103,2020-03-16 15:59:00,1,2483.0,1854.0,0.747,11.837,145,41,17,24,104,53,51,1,0.03,0.0
1006,104,2020-03-16 16:02:00,1,2611.0,2031.0,0.778,12.535,164,54,22,32,110,61,49,5,0.0,0.0
1006,105,2020-03-16 16:05:00,1,2992.0,2286.0,0.764,14.321,506,258,209,49,248,168,80,28,0.0,0.0
1006,106,2020-03-16 16:08:00,1,3344.0,2608.0,0.78,16.062,340,192,153,39,148,99,49,53,0.0,0.0
1006,107,2020-03-16 16:11:00,1,3352.0,2579.0,0.769,16.064,492,232,177,55,260,201,59,47,0.24,0.0
1006,108,2020-03-16 16:14:00,1,3432.0,2665.0,0.777,16.474,297,128,87,41,169,94,75,14,0.23,0.0
1006,109,2020-03-16 16:17:00,1,3344.0,2651.0,0.793,16.113,313,167,121,46,146,94,52,17,0.0,0.0
1006,110,2020-03-16 16:20:00,1,3193.0,2481.0,0.777,15.327,261,156,120,36,105,70,35,23,0.0,0.0
1006,111,2020-03-16 16:23:00,1,2975.0,2332.0,0.784,14.305,120,34,18,16,86,42,44,5,0.0,0.0
1006,112,2020-03-16 16:26:00,1,3219.0,2439.0,0.757,15.384,138,62,36,26,76,36,40,1,0.0,0.0
1006,113,2020-03-16 16:29:00,1,3139.0,2413.0,0.769,15.041,314,150,108,42,164,104,60,3,0.0,0.0
1006,114,2020-03-16 16:32:00,1,3130.0,2412.0,0.77,15.004,386,215,166,49,171,120,51,0,0.0,0.0
1006,115,2020-03-16 16:35:00,1,3189.0,2490.0,0.781,15.322,449,266,216,50,183,125,58,14,0.0,0.0
1006,116,2020-03-16 16:38:00,1,3211.0,2462.0,0.767,15.379,243,114,83,31,129,85,44,34,0.0,0.0
1006,117,2020-03-16 16:41:00,1,2995.0,2303.0,0.769,14.351,20,7,1,6,13,2,11,0,0.0,0.0
1006,118,2020-03-16 16:44:00,1,2833.0,2171.0,0.766,13.565,7,4,0,4,3,0,3,0,0.0,0.0
1006,119,2020-03-16 16:47:00,1,2857.0,2084.0,0.729,13.566,9,7,0,7,2,0,2,0,0.0,0.0
1006,120,2020-03-16 16:50:00,1,2606.0,2023.0,0.776,12.509,29,16,6,10,13,4,9,0,0.0,0.0
1006,121,2020-03-16 16:53:00,1,2611.0,1979.0,0.758,12.48,18,4,1,3,14,9,5,0,0.0,0.0
1006,122,2020-03-16 16:56:00,1,2463.0,1899.0,0.771,11.809,6,3,1,2,3,0,3,0,0.0,0.0
1006,123,2020-03-16 16:59:00,1,2478.0,1869.0,0.754,11.831,4,2,0,2,2,0,2,0,0.0,0.0
1006,124,2020-03-16 17:02:00,1,2493.0,1789.0,0.718,11.804,17,1,1,0,16,4,12,0,0.0,0.0
1006,125,2020-03-16 17:05:00,1,2491.0,1784.0,0.7165,11.7905,10,6,2,4,4,0,4,0,0.0,0.0
1006,126,2020-03-16 17:08:00,1,2489.0,1779.0,0.715,11.777,38,14,7,7,24,6,18,0,0.0,0.0
1006,127,2020-03-16 17:11:00,1,2584.0,1785.0,0.691,12.159,4,2,0,2,2,0,2,0,0.0,0.0
1006,128,2020-03-16 17:14:00,1,2503.0,1779.0,0.711,11.832,9,1,0,1,8,1,7,0,0.0,0.0
1006,129,2020-03-16 17:17:00,1,2584.0,1816.0,0.703,12.192,141,92,63,29,49,16,33,0,0.0,0.0
1006,130,2020-03-16 17:20:00,1,2718.0,1965.0,0.723,12.884,287,112,62,50,175,109,66,24,0.0,0.0
1006,131,2020-03-16 17:23:00,1,2935.0,2152.0,0.733,13.946,349,161,117,44,188,134,54,23,0.0,0.0
1006,132,2020-03-16 17:26:00,1,2933.0,2158.0,0.736,13.947,179,94,49,45,85,46,39,0,0.0,0.0
1006,133,2020-03-16 17:29:00,1,2940.0,2156.0,0.733,13.97,76,40,15,25,36,12,24,0,0.0,0.0
1006,134,2020-03-16 17:32:00,1,2931.0,2161.0,0.737,13.941,84,42,8,34,42,24,18,1,0.0,0.0
1006,135,2020-03-16 17:35:00,1,2923.0,2168.0,0.741,13.919,163,62,29,33,101,50,51,4,0.0,0.0
1006,136,2020-03-16 17:38:00,1,2684.0,2073.0,0.772,12.871,129,44,25,19,85,62,23,0,0.0,0.0
1006,137,2020-03-16 17:41:00,1,2689.0,2021.0,0.752,12.83,9,9,0,9,0,0,0,0,0.0,0.0
1006,138,2020-03-16 17:44:00,1,2700.0,1996.0,0.739,12.847,3,3,0,3,0,0,0,0,0.0,0.0
1006,139,2020-03-16 17:47:00,1,2627.0,1936.0,0.737,12.495,1,1,0,1,0,0,0,0,0.0,0.0
1006,140,2020-03-16 17:50:00,1,2551.0,1912.0,0.75,12.166,10,7,0,7,3,1,2,0,0.0,0.0
1006,141,2020-03-16 17:53:00,1,2557.0,1885.0,0.737,12.161,0,0,0,0,0,0,0,0,0.0,0.0
1006,142,2020-03-16 17:56:00,1,2553.0,1877.0,0.735,12.138,47,16,0,16,31,5,26,0,0.0,0.0
1006,143,2020-03-16 17:59:00,1,2566.0,1866.0,0.727,12.178,5,0,0,0,5,0,5,0,0.0,0.0
1006,144,2020-03-16 18:02:00,0,2573.0,1826.0,0.71,12.158,5,0,0,0,5,4,1,0,0.0,0.0
1006,145,2020-03-16 18:05:00,0,2480.0,1783.0,0.719,11.746,38,1,0,1,37,22,15,0,0.0,0.0
1006,146,2020-03-16 18:08:00,0,2578.0,1804.0,0.7,12.153,20,1,0,1,19,5,14,0,0.0,0.0
1006,147,2020-03-16 18:11:00,0,2573.0,1810.0,0.703,12.142,35,13,0,13,22,12,10,0,0.0,0.0
1006,148,2020-03-16 18:14:00,0,2551.0,1885.0,0.739,12.139,47,6,0,6,41,25,16,0,0.0,0.0
1006,149,2020-03-16 18:17:00,0,2564.0,1881.0,0.734,12.184,32,9,0,9,23,6,17,0,0.0,0.0
1006,150,2020-03-16 18:20:00,0,2562.0,1880.0,0.734,12.175,33,15,0,15,18,5,13,0,0.0,0.0
1006,151,2020-03-16 18:23:00,0,2549.0,1934.0,0.759,12.183,275,79,37,42,196,127,69,6,0.0,0.0
1006,152,2020-03-16 18:26:00,0,2934.0,2169.0,0.739,13.96,79,19,2,17,60,43,17,0,0.0,0.0
1006,153,2020-03-16 18:29:00,0,3070.0,2296.0,0.748,14.638,134,78,37,41,56,22,34,4,0.0,0.0
1006,154,2020-03-16 18:32:00,0,3220.0,2455.0,0.762,15.404,419,148,98,50,271,198,73,17,0.0,0.0
1006,155,2020-03-16 18:35:00,0,3433.0,2654.0,0.773,16.466,822,418,336,82,404,316,88,98,0.0,0.0
1006,156,2020-03-16 18:38:00,0,3580.0,2753.0,0.769,17.155,789,376,309,67,413,326,87,110,0.0,0.0
1006,157,2020-03-16 18:41:00,0,3740.0,2850.0,0.762,17.89,523,264,200,64,259,193,66,68,0.0,0.0
1006,158,2020-03-16 18:44:00,0,3411.0,2662.0,0.781,16.386,279,117,83,34,162,112,50,22,0.0,0.0
1006,159,2020-03-16 18:47:00,0,3426.0,2683.0,0.783,16.468,283,115,78,37,168,115,53,24,0.0,0.0
1006,160,2020-03-16 18:50:00,0,3443.0,2554.0,0.742,16.392,231,112,78,34,119,72,47,32,0.0,0.0
1006,161,2020-03-16 18:53:00,0,3373.0,2535.0,0.751,16.098,399,201,162,39,198,145,53,29,0.17,0.0
1006,162,2020-03-16 18:56:00,0,3224.0,2388.0,0.741,15.346,559,288,227,61,271,211,60,61,0.0,0.0
1006,163,2020-03-16 18:59:00,0,3439.0,2627.0,0.764,16.461,534,282,229,53,252,192,60,97,0.0,0.0
1006,164,2020-03-16 19:02:00,0,3454.0,2574.0,0.745,16.458,433,205,159,46,228,172,56,28,0.0,0.0
1006,165,2020-03-16 19:05:00,0,3137.0,2400.0,0.765,15.019,60,34,16,18,26,21,5,0,0.0,0.0
1006,166,2020-03-16 19:08:00,0,3078.0,2305.0,0.749,14.681,3,3,0,3,0,0,0,0,0.0,0.0
1006,167,2020-03-16 19:11:00,0,2926.0,2221.0,0.759,13.986,14,14,6,8,0,0,0,0,0.0,0.0
1006,168,2020-03-16 19:14:00,0,3089.0,2250.0,0.729,14.661,43,17,11,6,26,17,9,0,0.0,0.0
1006,169,2020-03-16 19:17:00,0,2923.0,2199.0,0.752,13.953,28,0,0,0,28,15,13,0,0.0,0.0
1006,170,2020-03-16 19:20:00,0,2937.0,2141.0,0.729,13.942,20,2,0,2,18,7,11,0,0.0,0.0
1006,171,2020-03-16 19:23:00,0,2938.0,2105.0,0.717,13.905,20,9,0,9,11,3,8,0,0.0,0.0
1006,172,2020-03-16 19:26:00,0,2770.0,2074.0,0.749,13.21,22,6,1,5,16,11,5,0,0.0,0.0
1006,173,2020-03-16 19:29:00,0,2857.0,2083.0,0.729,13.562,461,227,158,69,234,173,61,37,0.0,0.0
1006,174,2020-03-16 19:32:00,0,3060.0,2362.0,0.772,14.671,360,211,141,70,149,103,46,47,0.0,0.0
1006,175,2020-03-16 19:35:00,0,3044.0,2361.0,0.776,14.607,476,279,217,62,197,150,47,54,0.0,0.0
1006,176,2020-03-16 19:38:00,0,3055.0,2372.0,0.776,14.661,599,349,280,69,250,190,60,115,0.42,0.0
1006,177,2020-03-16 19:41:00,0,3303.0,2479.0,0.75,15.76,333,190,141,49,143,102,41,35,0.0,0.0
1006,178,2020-03-16 19:44:00,0,3299.0,2497.0,0.757,15.762,156,115,58,57,41,9,32,24,0.0,0.0
1006,179,2020-03-16 19:47:00,0,3367.0,2554.0,0.758,16.094,372,179,130,49,193,148,45,34,0.0,0.0
1006,180,2020-03-16 19:50:00,0,3843.0,2825.0,0.735,18.269,757,399,314,85,358,281,77,87,0.0,0.0
1006,181,2020-03-16 19:53:00,0,3459.0,2597.0,0.751,16.504,483,242,194,48,241,162,79,64,0.0,0.0
1006,182,2020-03-16 19:56:00,0,3442.0,2647.0,0.769,16.49,547,264,201,63,283,223,60,55,0.0,0.0
1006,183,2020-03-16 19:59:00,0,3377.0,2519.0,0.746,16.094,398,189,137,52,209,161,48,15,0.21,0.0
1006,184,2020-03-16 20:02:00,0,3283.0,2508.0,0.764,15.712,262,150,99,51,112,58,54,19,0.0,0.0
1006,185,2020-03-16 20:05:00,0,3412.5,2530.0,0.742,16.248,215,44,8,36,171,118,53,2,0.0,0.0
1006,186,2020-03-16 20:08:00,0,3542.0,2552.0,0.72,16.784,210,24,5,19,186,116,70,0,0.0,0.0
1006,187,2020-03-16 20:11:00,0,3476.0,2480.0,0.713,16.443,219,89,43,46,130,89,41,8,0.0,0.0
1006,188,2020-03-16 20:14:00,0,3393.0,2436.0,0.718,16.065,100,39,19,20,61,34,27,7,0.0,0.0
1006,189,2020-03-16 20:17:00,0,3231.0,2408.0,0.745,15.395,169,82,49,33,87,64,23,4,0.0,0.0
1006,190,2020-03-16 20:20:00,0,3270.0,2277.0,0.696,15.405,16,11,2,9,5,3,2,0,0.0,0.0
1006,191,2020-03-16 20:23:00,0,2951.0,2101.0,0.712,13.953,101,40,21,19,61,40,21,5,0.0,0.0
1006,192,2020-03-16 20:26:00,0,2869.0,2045.0,0.713,13.568,31,10,3,7,21,8,13,0,0.0,0.0
1006,193,2020-03-16 20:29:00,0,2890.0,1993.0,0.69,13.595,19,3,0,3,16,8,8,0,0.0,0.0
1006,194,2020-03-16 20:32:00,0,2722.0,1960.0,0.72,12.896,51,9,8,1,42,16,26,0,0.0,0.0
1006,195,2020-03-16 20:35:00,0,2739.0,1902.0,0.695,12.898,4,1,1,0,3,0,3,0,0.0,0.0
1006,196,2020-03-16 20:38:00,0,2746.0,1847.0,0.673,12.864,6,2,0,2,4,2,2,0,0.0,0.0
1006,197,2020-03-16 20:41:00,0,2755.0,1836.0,0.667,12.888,91,16,0,16,75,37,38,0,0.0,0.0
1006,198,2020-03-16 20:44:00,0,2671.0,1812.0,0.679,12.529,84,25,13,12,59,42,17,0,0.0,0.0
1006,199,2020-03-16 20:47:00,0,2578.0,1811.0,0.703,12.161,59,17,9,8,42,30,12,0,0.0,0.0
1006,200,2020-03-16 20:50:00,0,2596.0,1741.0,0.671,12.155,90,33,19,14,57,40,17,3,0.0,0.0
1006,201,2020-03-16 20:53:00,0,2716.0,1929.0,0.71,12.838,255,74,37,37,181,107,74,10,0.0,0.0
1006,202,2020-03-16 20:56:00,0,3121.0,2135.0,0.684,14.659,316,94,60,34,222,148,74,10,0.0,0.0
1006,203,2020-03-16 20:59:00,0,3379.0,2453.0,0.726,16.029,632,336,264,72,296,225,71,93,0.0,0.0
1006,204,2020-03-16 21:02:00,0,3546.0,2576.0,0.726,16.825,447,256,201,55,191,134,57,65,0.05,0.0
1006,205,2020-03-16 21:05:00,0,3476.0,2520.0,0.725,16.486,330,175,129,46,155,114,41,52,0.0,0.0
1006,206,2020-03-16 21:08:00,0,3243.0,2365.0,0.729,15.398,410,184,137,47,226,165,61,27,0.0,0.0
1006,207,2020-03-16 21:11:00,0,3485.0,2477.0,0.711,16.474,377,169,117,52,208,160,48,27,0.0,0.0
1006,208,2020-03-16 21:14:00,0,3466.0,2519.0,0.727,16.444,408,209,162,47,199,148,51,14,0.0,0.0
1006,209,2020-03-16 21:17:00,0,3474.0,2523.0,0.726,16.483,330,151,105,46,179,128,51,23,0.0,0.0
1006,210,2020-03-16 21:20:00,0,3237.0,2375.0,0.734,15.382,404,202,153,49,202,145,57,37,0.0,0.0
1006,211,2020-03-16 21:23:00,0,3244.0,2366.0,0.729,15.4,158,83,55,28,75,52,23,11,0.11,0.0
1006,212,2020-03-16 21:26:00,0,3257.0,2310.0,0.709,15.391,127,38,20,18,89,49,40,1,0.0,0.0
1006,213,2020-03-16 21:29:00,0,3264.0,2277.0,0.698,15.384,190,86,43,43,104,56,48,3,0.0,0.0
1006,214,2020-03-16 21:32:00,0,3083.0,2222.0,0.721,14.609,52,27,15,12,25,12,13,0,0.0,0.0
1006,215,2020-03-16 21:35:00,0,2942.0,2081.0,0.707,13.895,35,23,11,12,12,1,11,0,0.0,0.0
1006,216,2020-03-16 21:38:00,0,2890.0,1976.0,0.684,13.576,10,1,0,1,9,0,9,0,0.0,0.0
1006,217,2020-03-16 21:41:00,0,2725.0,1877.0,0.689,12.814,16,4,1,3,12,2,10,0,0.0,0.0
1006,218,2020-03-16 21:44:00,0,2665.0,1839.0,0.69,12.538,8,3,0,3,5,4,1,0,0.0,0.0
1006,219,2020-03-16 21:47:00,0,2589.0,1793.0,0.693,12.187,14,0,0,0,14,0,14,0,0.0,0.0
1006,220,2020-03-16 21:50:00,0,2668.0,1809.0,0.678,12.514,9,7,2,5,2,0,2,0,0.0,0.0
1006,221,2020-03-16 21:53:00,0,2594.0,1784.0,0.688,12.196,11,6,2,4,5,4,1,0,0.0,0.0
1006,222,2020-03-16 21:56:00,0,2593.0,1737.0,0.67,12.14,14,10,0,10,4,2,2,0,0.0,0.0
1006,223,2020-03-16 21:59:00,0,2601.0,1709.0,0.657,12.139,67,29,13,16,38,11,27,0,0.0,0.0
1006,224,2020-03-16 22:02:00,0,2347.0,1653.0,0.705,11.076,79,33,21,12,46,27,19,1,0.0,0.0
1006,225,2020-03-16 22:05:00,0,2342.0,1636.0,0.698,11.041,10,4,1,3,6,0,6,0,0.0,0.0
1006,226,2020-03-16 22:08:00,0,2351.0,1611.0,0.685,11.048,19,8,7,1,11,2,9,0,0.0,0.0
1006,227,2020-03-16 22:11:00,0,2378.0,1557.0,0.655,11.095,108,45,29,16,63,36,27,0,0.0,0.0
1006,228,2020-03-16 22:14:00,0,2587.0,1787.0,0.691,12.171,358,88,45,43,270,181,89,11,0.0,0.0
1006,229,2020-03-16 22:17:00,0,2871.0,2065.0,0.719,13.598,317,130,90,40,187,128,59,23,0.0,0.0
1006,230,2020-03-16 22:20:00,0,3260.0,2317.0,0.711,15.409,531,261,193,68,270,199,71,50,0.12,0.0
1006,231,2020-03-16 22:23:00,0,3241.0,2348.0,0.724,15.371,450,230,178,52,220,164,56,64,0.0,0.0
1006,232,2020-03-16 22:26:00,0,3477.0,2508.0,0.721,16.477,501,274,210,64,227,174,53,45,0.0,0.0
1006,233,2020-03-16 22:29:00,0,3403.0,2403.0,0.706,16.07,236,110,70,40,126,87,39,19,0.0,0.0
1006,234,2020-03-16 22:32:00,0,3237.0,2358.0,0.728,15.365,367,166,126,40,201,132,69,32,0.14,0.0
1006,235,2020-03-16 22:35:00,0,3105.0,2214.0,0.713,14.685,478,216,161,55,262,199,63,48,0.0,0.0
1006,236,2020-03-16 22:38:00,0,3260.0,2291.0,0.703,15.38,107,47,33,14,60,38,22,2,0.0,0.0
1006,237,2020-03-16 22:41:00,0,3103.0,2194.0,0.707,14.656,23,12,7,5,11,8,3,0,0.0,0.0
1006,238,2020-03-16 22:44:00,0,2861.0,2019.0,0.706,13.509,22,15,10,5,7,0,7,0,0.0,0.0
1006,239,2020-03-16 22:47:00,0,2734.0,1897.0,0.694,12.874,34,8,4,4,26,2,24,0,0.0,0.0
1006,240,2020-03-16 22:50:00,0,2582.0,1776.0,0.688,12.139,30,26,11,15,4,2,2,0,0.0,0.0
1006,241,2020-03-16 22:53:00,0,2674.0,1816.0,0.679,12.547,1,1,0,1,0,0,0,0,0.0,0.0
1006,242,2020-03-16 22:56:00,0,2580.0,1785.0,0.692,12.143,5,5,0,5,0,0,0,0,0.0,0.0
1006,243,2020-03-16 22:59:00,0,2589.0,1741.0,0.672,12.13,2,1,0,1,1,1,0,0,0.0,0.0
1006,244,2020-03-16 23:02:00,0,2519.0,1694.0,0.672,11.801,13,12,4,8,1,1,0,0,0.0,0.0
1006,245,2020-03-16 23:05:00,0,2437.0,1660.5,0.6815,11.4415,1,1,0,1,0,0,0,0,0.0,0.0
1006,246,2020-03-16 23:08:00,0,2355.0,1627.0,0.691,11.082,217,79,56,23,138,101,37,8,0.0,0.0
1006,247,2020-03-16 23:11:00,0,2712.0,1925.0,0.71,12.819,498,254,191,63,244,179,65,73,0.0,0.0
1006,248,2020-03-16 23:14:00,0,3113.0,2170.0,0.697,14.667,453,260,198,62,193,132,61,94,0.0,0.0
1006,249,2020-03-16 23:17:00,0,3078.0,2237.0,0.727,14.606,296,146,84,62,150,95,55,34,0.0,0.0
1006,250,2020-03-16 23:20:00,0,3262.0,2292.0,0.703,15.39,151,38,10,28,113,76,37,5,0.0,0.0
1006,251,2020-03-16 23:23:00,0,3264.0,2291.0,0.702,15.398,123,51,5,46,72,47,25,7,0.0,0.0
1006,252,2020-03-16 23:26:00,0,3256.0,2314.0,0.711,15.389,299,108,73,35,191,130,61,22,0.04,0.0
1006,253,2020-03-16 23:29:00,0,3627.0,2599.0,0.716,17.17,225,129,88,41,96,80,16,5,0.0,0.0
1006,254,2020-03-16 23:32:00,0,3779.0,2701.0,0.715,17.88,411,241,195,46,170,139,31,28,0.0,0.1
1006,255,2020-03-16 23:35:00,0,3464.0,2580.0,0.745,16.504,568,324,252,72,244,184,60,80,0.22,0.0
1006,256,2020-03-16 23:38:00,0,3603.0,2670.0,0.741,17.153,405,268,207,61,137,96,41,40,0.0,0.01
1006,257,2020-03-16 23:41:00,0,3010.0,2207.0,0.733,14.301,313,141,99,42,172,121,51,7,0.0,0.0
1006,258,2020-03-16 23:44:00,0,3420.0,2631.0,0.769,16.388,454,210,157,53,244,179,65,19,0.0,0.0
1006,259,2020-03-16 23:47:00,0,3494.0,2739.0,0.784,16.799,354,164,112,52,190,122,68,11,0.0,0.0
1006,260,2020-03-16 23:50:00,0,3394.0,2749.0,0.81,16.417,394,205,162,43,189,137,52,14,0.1,0.04
1006,261,2020-03-16 23:53:00,0,2899.0,2258.0,0.779,13.922,100,59,39,20,41,26,15,2,0.08,0.0
1006,262,2020-03-16 23:56:00,0,2984.0,2310.0,0.774,14.316,270,119,75,44,151,90,61,3,0.0,0.0
1006,263,2020-03-16 23:59:00,0,3938.0,3147.0,0.799,19.0,47,27,13,14,20,14,6,0,0.0,0.16
1006,264,2020-03-17 00:02:00,0,3154.0,2660.0,0.843,15.374,234,98,58,40,136,76,60,5,0.0,0.01
1006,265,2020-03-17 00:05:00,0,2822.0,2261.0,0.801,13.623,349,184,134,50,165,103,62,8,0.0,0.0
1006,266,2020-03-17 00:08:00,0,3546.0,2910.0,0.82,17.195,716,307,235,72,409,318,91,15,0.0,0.0
1006,267,2020-03-17 00:11:00,0,3524.0,2979.0,0.845,17.184,531,285,216,69,246,195,51,55,0.15,0.04
1006,268,2020-03-17 00:14:00,0,3503.0,3002.0,0.857,17.127,774,406,323,83,368,290,78,59,0.0,0.0
1006,269,2020-03-17 00:17:00,0,3385.0,2792.0,0.825,16.428,459,218,154,64,241,173,68,31,0.0,0.0
1006,270,2020-03-17 00:20:00,0,3508.0,3042.0,0.867,17.189,101,46,31,15,55,42,13,5,0.0,0.0
1006,271,2020-03-17 00:23:00,0,3307.0,2784.0,0.842,16.111,24,19,7,12,5,4,1,0,0.0,0.0
1006,272,2020-03-17 00:26:00,0,3021.0,2545.0,0.842,14.721,14,14,0,14,0,0,0,0,0.0,0.0
1006,273,2020-03-17 00:29:00,0,2954.0,2429.0,0.822,14.327,593,225,173,52,368,287,81,5,0.0,0.0
1006,274,2020-03-17 00:32:00,0,3399.0,2783.0,0.819,16.472,599,326,266,60,273,211,62,18,0.0,0.05
1006,275,2020-03-17 00:35:00,0,4054.0,3395.0,0.837,19.732,246,152,119,33,94,68,26,21,0.04,0.16
1006,276,2020-03-17 00:38:00,0,2957.0,2437.0,0.824,14.35,190,89,55,34,101,53,48,12,0.0,0.0
1006,277,2020-03-17 00:41:00,0,3529.0,2948.0,0.835,17.168,297,135,78,57,162,107,55,14,0.0,0.0
1006,278,2020-03-17 00:44:00,0,3595.0,3096.0,0.861,17.592,597,332,254,78,265,197,68,33,0.0,0.0
1006,279,2020-03-17 00:47:00,0,3501.0,3036.0,0.867,17.154,457,213,158,55,244,177,67,19,0.0,0.0
1006,280,2020-03-17 00:50:00,0,3529.0,2979.0,0.844,17.205,782,433,347,86,349,265,84,27,0.0,0.0
1006,281,2020-03-17 00:53:00,0,3140.0,2742.0,0.873,15.408,273,143,94,49,130,76,54,15,0.0,0.0
1006,282,2020-03-17 00:56:00,0,3387.0,2849.0,0.841,16.499,221,139,84,55,82,52,30,0,0.0,0.0
1006,283,2020-03-17 00:59:00,0,3375.0,2892.0,0.857,16.499,93,54,20,34,39,15,24,1,0.0,0.0
1006,284,2020-03-17 01:02:00,0,3353.0,2907.0,0.867,16.428,57,20,6,14,37,19,18,0,0.0,0.0
1006,285,2020-03-17 01:05:00,0,3146.0,2722.0,0.865,15.407,9,0,0,0,9,2,7,0,0.0,0.0
1006,286,2020-03-17 01:08:00,0,3013.0,2536.0,0.842,14.677,24,2,0,2,22,8,14,0,0.0,0.0
1006,287,2020-03-17 01:11:00,0,2857.0,2412.0,0.844,13.927,13,0,0,0,13,2,11,0,0.0,0.0
1006,288,2020-03-17 01:14:00,0,2806.0,2315.0,0.825,13.619,11,0,0,0,11,1,10,0,0.0,0.0
1006,289,2020-03-17 01:17:00,0,2712.0,2300.0,0.848,13.231,3,3,1,2,0,0,0,0,0.0,0.0
1006,290,2020-03-17 01:20:00,0,2791.0,2318.0,0.83,13.561,41,24,9,15,17,12,5,0,0.0,0.0
1006,291,2020-03-17 01:23:00,0,3004.0,2566.0,0.854,14.678,273,70,21,49,203,126,77,13,0.0,0.0
1006,292,2020-03-17 01:26:00,0,3150.0,2741.0,0.87,15.444,250,97,67,30,153,89,64,25,0.0,0.05
1006,293,2020-03-17 01:29:00,0,3494.0,3113.0,0.891,17.211,325,186,141,45,139,97,42,16,0.0,0.13
1006,294,2020-03-17 01:32:00,0,3293.0,2867.0,0.87,16.15,578,299,243,56,279,208,71,56,0.35,0.0
1006,295,2020-03-17 01:35:00,0,3370.0,2901.0,0.861,16.491,331,116,78,38,215,149,66,11,0.0,0.0
1006,296,2020-03-17 01:38:00,0,3360.0,2924.0,0.87,16.474,494,169,134,35,325,254,71,6,0.0,0.0
1006,297,2020-03-17 01:41:00,0,3506.0,3076.0,0.877,17.219,390,212,158,54,178,126,52,4,0.0,0.05
1006,298,2020-03-17 01:44:00,0,3367.0,2934.0,0.871,16.514,111,34,0,34,77,32,45,2,0.0,0.0
1006,299,2020-03-17 01:47:00,0,3373.0,2892.0,0.857,16.49,106,52,21,31,54,12,42,0,0.0,0.0
1006,300,2020-03-17 01:50:00,0,3132.0,2753.0,0.879,15.389,12,12,3,9,0,0,0,0,0.0,0.0
1006,301,2020-03-17 01:53:00,0,3011.0,2607.0,0.866,14.749,6,6,1,5,0,0,0,0,0.0,0.0
1006,302,2020-03-17 01:56:00,0,2759.0,2418.0,0.876,13.549,11,11,4,7,0,0,0,0,0.0,0.0
1006,303,2020-03-17 01:59:00,0,2755.0,2407.0,0.874,13.518,0,0,0,0,0,0,0,0,0.0,0.0
1006,304,2020-03-17 02:02:00,0,2849.0,2447.0,0.859,13.934,18,12,6,6,6,2,4,0,0.0,0.0
1006,305,2020-03-17 02:05:00,0,2781.5,2379.5,0.8555,13.5945,8,7,3,4,1,0,1,0,0.0,0.0
1006,306,2020-03-17 02:08:00,0,2714.0,2312.0,0.852,13.255,202,88,56,32,114,79,35,6,0.0,0.0
1006,307,2020-03-17 02:11:00,0,3357.0,2951.0,0.879,16.494,193,95,65,30,98,62,36,15,0.14,0.12
1006,308,2020-03-17 02:14:00,0,3013.0,2571.0,0.853,14.716,341,192,142,50,149,93,56,16,0.08,0.01
1006,309,2020-03-17 02:17:00,0,3138.0,2788.0,0.889,15.45,591,297,237,60,294,235,59,8,0.0,0.0
1006,310,2020-03-17 02:20:00,0,3328.0,3051.0,0.917,16.49,567,263,199,64,304,240,64,49,0.0,0.0
1006,311,2020-03-17 02:23:00,0,3273.0,2912.0,0.89,16.118,499,238,176,62,261,199,62,90,0.0,0.0
1006,312,2020-03-17 02:26:00,0,3370.0,2943.0,0.873,16.536,627,359,295,64,268,198,70,44,0.0,0.01
1006,313,2020-03-17 02:29:00,0,3560.0,3173.0,0.891,17.54,515,317,247,70,198,155,43,68,0.0,0.0
1006,314,2020-03-17 02:32:00,0,3348.0,2963.0,0.885,16.473,258,118,74,44,140,90,50,8,0.0,0.0
1006,315,2020-03-17 02:35:00,0,3337.0,2956.0,0.886,16.42,72,44,18,26,28,7,21,0,0.0,0.0
1006,316,2020-03-17 02:38:00,0,3381.0,2879.0,0.851,16.508,47,32,13,19,15,6,9,0,0.0,0.0
1006,317,2020-03-17 02:41:00,0,3132.0,2732.0,0.872,15.363,25,5,2,3,20,0,20,0,0.0,0.0
1006,318,2020-03-17 02:44:00,0,2995.0,2612.0,0.872,14.691,68,6,0,6,62,0,62,0,0.0,0.0
1006,319,2020-03-17 02:47:00,0,3011.0,2578.0,0.856,14.718,25,17,8,9,8,2,6,0,0.0,0.0
1006,320,2020-03-17 02:50:00,0,2932.0,2507.0,0.855,14.328,8,5,3,2,3,1,2,0,0.0,0.0
1006,321,2020-03-17 02:53:00,0,2847.0,2485.0,0.873,13.967,0,0,0,0,0,0,0,0,0.0,0.0
1006,322,2020-03-17 02:56:00,0,2855.0,2463.0,0.863,13.975,110,47,38,9,63,45,18,4,0.0,0.0
1006,323,2020-03-17 02:59:00,0,3433.0,3007.0,0.876,16.855,129,49,30,19,80,53,27,6,0.0,0.34
1006,324,2020-03-17 03:02:00,0,2996.0,2601.0,0.868,14.683,223,52,11,41,171,94,77,8,0.0,0.0
1006,325,2020-03-17 03:05:00,0,3298.0,2854.0,0.865,16.155,233,129,87,42,104,66,38,6,0.11,0.0
1006,326,2020-03-17 03:08:00,0,3113.0,2805.0,0.901,15.369,14,0,0,0,14,0,14,0,0.0,0.02
1006,327,2020-03-17 03:11:00,0,3142.0,2725.0,0.867,15.395,12,6,2,4,6,1,5,0,0.0,0.0
1006,328,2020-03-17 03:14:00,0,2992.0,2615.0,0.874,14.684,19,9,6,3,10,5,5,0,0.0,0.0
1006,329,2020-03-17 03:17:00,0,2917.0,2563.0,0.879,14.332,79,19,8,11,60,40,20,0,0.0,0.0
1006,330,2020-03-17 03:20:00,0,2921.0,2558.0,0.876,14.34,1,1,0,1,0,0,0,0,0.0,0.0
1006,331,2020-03-17 03:23:00,0,2918.0,2543.0,0.871,14.312,8,1,0,1,7,4,3,0,0.0,0.0
1006,332,2020-03-17 03:26:00,0,3010.0,2575.0,0.855,14.709,25,10,3,7,15,6,9,0,0.0,0.0
1006,333,2020-03-17 03:29:00,0,2766.0,2446.0,0.884,13.608,11,4,2,2,7,2,5,0,0.0,0.0
1006,334,2020-03-17 03:32:00,0,2846.0,2512.0,0.883,13.993,125,49,33,16,76,53,23,3,0.0,0.0
1006,335,2020-03-17 03:35:00,0,2999.0,2598.0,0.866,14.69,351,156,119,37,195,134,61,22,0.0,0.0
1006,336,2020-03-17 03:38:00,0,3277.0,2914.0,0.889,16.139,443,226,183,43,217,148,69,12,0.13,0.0
1006,337,2020-03-17 03:41:00,0,3412.0,3096.0,0.907,16.871,497,266,211,55,231,174,57,51,0.0,0.02
1006,338,2020-03-17 03:44:00,0,3265.0,2941.0,0.901,16.12,39,21,7,14,18,8,10,7,0.0,0.0
1006,339,2020-03-17 03:47:00,0,3307.0,3029.0,0.916,16.383,132,37,7,30,95,54,41,6,0.0,0.0
1006,340,2020-03-17 03:50:00,0,3319.0,3045.0,0.918,16.446,29,18,5,13,11,6,5,0,0.0,0.0
1006,341,2020-03-17 03:53:00,0,3095.0,2901.0,0.937,15.406,2,1,1,0,1,0,1,0,0.0,0.0
1006,342,2020-03-17 03:56:00,0,3133.0,2760.0,0.881,15.399,393,169,134,35,224,172,52,1,0.0,0.0
1006,343,2020-03-17 03:59:00,0,3110.0,2840.0,0.913,15.399,744,378,307,71,366,297,69,21,0.14,0.0
1006,344,2020-03-17 04:02:00,0,3106.0,2803.0,0.903,15.34,19,11,6,5,8,2,6,0,0.0,0.0
1006,345,2020-03-17 04:05:00,0,2994.0,2656.0,0.887,14.738,0,0,0,0,0,0,0,0,0.0,0.0
1006,346,2020-03-17 04:08:00,0,2991.0,2614.0,0.874,14.68,27,18,5,13,9,2,7,0,0.0,0.0
1006,347,2020-03-17 04:11:00,0,2760.0,2503.0,0.907,13.643,21,15,9,6,6,2,4,0,0.0,0.0
1006,348,2020-03-17 04:14:00,0,2759.0,2489.0,0.902,13.625,0,0,0,0,0,0,0,0,0.0,0.0
1006,349,2020-03-17 04:17:00,0,2771.0,2421.0,0.874,13.599,33,32,7,25,1,0,1,0,0.0,0.0
1006,350,2020-03-17 04:20:00,0,2761.0,2483.0,0.899,13.628,21,20,3,17,1,0,1,0,0.0,0.0
1006,351,2020-03-17 04:23:00,0,2756.0,2505.0,0.909,13.633,75,26,9,17,49,38,11,0,0.0,0.0
1006,352,2020-03-17 04:26:00,0,3005.0,2602.0,0.866,14.722,22,11,4,7,11,3,8,2,0.0,0.0
1006,353,2020-03-17 04:29:00,0,2764.0,2481.0,0.898,13.636,16,0,0,0,16,6,10,0,0.0,0.0
1006,354,2020-03-17 04:32:00,0,2773.0,2431.0,0.877,13.616,5,0,0,0,5,3,2,0,0.0,0.0
1006,355,2020-03-17 04:35:00,0,2773.0,2443.0,0.881,13.632,15,0,0,0,15,9,6,0,0.0,0.0
1006,356,2020-03-17 04:38:00,0,2773.0,2387.0,0.861,13.57,13,6,4,2,7,4,3,0,0.0,0.0
1006,357,2020-03-17 04:41:00,0,2765.0,2483.0,0.898,13.645,159,48,24,24,111,66,45,6,0.0,0.0
1006,358,2020-03-17 04:44:00,0,2995.0,2611.0,0.872,14.69,268,37,10,27,231,137,94,17,0.0,0.0
1006,359,2020-03-17 04:47:00,0,3115.0,2788.0,0.895,15.359,299,96,69,27,203,140,63,11,0.11,0.0
1006,360,2020-03-17 04:50:00,0,2988.0,2637.0,0.882,14.694,47,20,14,6,27,20,7,0,0.0,0.0
1006,361,2020-03-17 04:53:00,0,2837.0,2543.0,0.896,13.993,6,0,0,0,6,3,3,0,0.0,0.0
1006,362,2020-03-17 04:56:00,0,2774.0,2433.0,0.877,13.624,26,13,3,10,13,4,9,0,0.0,0.0
1006,363,2020-03-17 04:59:00,0,2703.0,2387.0,0.883,13.291,176,71,50,21,105,44,61,6,0.0,0.0
1006,364,2020-03-17 05:02:00,0,3479.0,3124.0,0.898,17.166,394,194,148,46,200,147,53,28,0.0,0.0
1006,365,2020-03-17 05:05:00,0,3233.5,2888.0,0.8925,15.9385,380,177,125,52,203,140,63,13,0.0,0.0
1006,366,2020-03-17 05:08:00,0,2988.0,2652.0,0.887,14.711,213,121,79,42,92,71,21,15,0.0,0.0
1006,367,2020-03-17 05:11:00,0,2844.0,2512.0,0.884,13.985,6,5,0,5,1,0,1,0,0.0,0.0
1006,368,2020-03-17 05:14:00,0,2758.0,2496.0,0.905,13.629,16,13,6,7,3,1,2,0,0.0,0.0
1006,369,2020-03-17 05:17:00,0,2766.0,2440.0,0.882,13.6,24,23,7,16,1,1,0,0,0.0,0.0
1006,370,2020-03-17 05:20:00,0,2846.0,2527.0,0.888,14.012,214,71,32,39,143,90,53,7,0.0,0.01
1006,371,2020-03-17 05:23:00,0,2996.0,2643.0,0.882,14.73,132,28,6,22,104,55,49,2,0.0,0.0
1006,372,2020-03-17 05:26:00,0,3133.0,2741.0,0.875,15.378,200,26,7,19,174,111,63,4,0.0,0.0
1006,373,2020-03-17 05:29:00,0,3115.0,2870.0,0.921,15.448,377,189,158,31,188,142,46,28,0.0,0.0
1006,374,2020-03-17 05:32:00,0,3138.0,2739.0,0.873,15.396,147,69,53,16,78,53,25,21,0.0,0.0
1006,375,2020-03-17 05:35:00,0,3003.0,2608.0,0.869,14.718,27,10,4,6,17,9,8,0,0.0,0.0
1006,376,2020-03-17 05:38:00,0,2768.0,2447.0,0.884,13.614,6,0,0,0,6,5,1,0,0.0,0.0
1006,377,2020-03-17 05:41:00,0,2708.0,2312.0,0.854,13.228,74,22,13,9,52,12,40,0,0.0,0.0
1006,378,2020-03-17 05:44:00,0,2787.0,2360.0,0.847,13.594,29,0,0,0,29,0,29,0,0.0,0.0
1006,379,2020-03-17 05:47:00,0,2781.0,2367.0,0.851,13.578,128,68,41,27,60,42,18,9,0.0,0.0
1006,380,2020-03-17 05:50:00,0,3362.0,2873.0,0.855,16.426,276,150,103,47,126,94,32,13,0.0,0.21
1006,381,2020-03-17 05:53:00,0,3342.0,2961.0,0.886,16.447,221,99,67,32,122,79,43,4,0.07,0.0
1006,382,2020-03-17 05:56:00,0,2493.0,2114.0,0.848,12.165,360,157,111,46,203,142,61,41,0.0,0.0
1006,383,2020-03-17 05:59:00,0,2856.0,2466.0,0.863,13.984,189,39,18,21,150,81,69,2,0.0,0.01
1006,384,2020-03-17 06:02:00,1,3359.0,2952.0,0.879,16.502,515,258,202,56,257,195,62,35,0.0,0.0
1006,385,2020-03-17 06:05:00,1,3135.0,2759.0,0.88,15.405,297,169,131,38,128,87,41,34,0.0,0.0
1006,386,2020-03-17 06:08:00,1,3495.0,3108.0,0.889,17.212,435,236,179,57,199,152,47,19,0.0,0.03
1006,387,2020-03-17 06:11:00,1,3352.0,2984.0,0.89,16.511,504,243,180,63,261,199,62,68,0.0,0.0
1006,388,2020-03-17 06:14:00,1,3434.0,3013.0,0.877,16.864,268,111,74,37,157,102,55,21,0.0,0.0
1006,389,2020-03-17 06:17:00,1,3420.0,2958.0,0.865,16.751,18,5,3,2,13,7,6,0,0.0,0.0
1006,390,2020-03-17 06:20:00,1,3223.0,2778.0,0.862,15.775,0,0,0,0,0,0,0,0,0.0,0.0
1006,391,2020-03-17 06:23:00,1,3006.0,2562.0,0.852,14.679,0,0,0,0,0,0,0,0,0.0,0.0
1006,392,2020-03-17 06:26:00,1,2784.0,2388.0,0.858,13.613,38,9,1,8,29,10,19,0,0.0,0.0
1006,393,2020-03-17 06:29:00,1,2634.0,2293.0,0.871,12.915,0,0,0,0,0,0,0,0,0.0,0.0
1006,394,2020-03-17 06:32:00,1,2636.0,2288.0,0.868,12.917,88,22,9,13,66,38,28,1,0.0,0.0
1006,395,2020-03-17 06:35:00,1,3016.0,2562.0,0.849,14.72,437,214,158,56,223,160,63,5,0.0,0.0
1006,396,2020-03-17 06:38:00,1,3014.0,2521.0,0.836,14.667,500,219,159,60,281,201,80,5,0.0,0.0
1006,397,2020-03-17 06:41:00,1,3176.0,2627.0,0.827,15.421,726,392,311,81,334,250,84,9,0.0,0.0
1006,398,2020-03-17 06:44:00,1,3164.0,2650.0,0.838,15.4,320,175,137,38,145,112,33,6,0.0,0.0
1006,399,2020-03-17 06:47:00,1,3154.0,2668.0,0.846,15.38,56,34,13,21,22,12,10,1,0.0,0.0
1006,400,2020-03-17 06:50:00,1,3172.0,2623.0,0.827,15.401,101,51,17,34,50,14,36,0,0.0,0.0
1006,401,2020-03-17 06:53:00,1,3030.0,2469.0,0.815,14.673,29,9,8,1,20,11,9,0,0.0,0.0
1006,402,2020-03-17 06:56:00,1,2787.0,2359.0,0.846,13.595,2,0,0,0,2,0,2,0,0.0,0.0
1006,403,2020-03-17 06:59:00,1,2663.0,2183.0,0.82,12.91,25,0,0,0,25,8,17,0,0.0,0.0
1006,404,2020-03-17 07:02:00,1,2600.0,2070.0,0.796,12.536,20,0,0,0,20,2,18,0,0.0,0.0
1006,405,2020-03-17 07:05:00,1,2518.0,2028.0,0.805,12.168,39,1,1,0,38,11,27,0,0.0,0.0
1006,406,2020-03-17 07:08:00,1,2677.0,2122.0,0.793,12.898,203,75,38,37,128,69,59,7,0.0,0.0
1006,407,2020-03-17 07:11:00,1,2811.0,2312.0,0.822,13.637,182,71,9,62,111,38,73,3,0.0,0.0
1006,408,2020-03-17 07:14:00,1,2797.0,2345.0,0.838,13.617,190,45,20,25,145,86,59,1,0.0,0.0
1006,409,2020-03-17 07:17:00,1,2866.0,2381.0,0.831,13.929,169,122,61,61,47,17,30,0,0.0,0.0
1006,410,2020-03-17 07:20:00,1,2805.0,2319.0,0.827,13.618,15,7,1,6,8,5,3,0,0.0,0.0
1006,411,2020-03-17 07:23:00,1,2661.0,2156.0,0.81,12.87,18,0,0,0,18,2,16,0,0.0,0.0
1006,412,2020-03-17 07:26:00,1,2515.0,2039.0,0.811,12.166,10,4,1,3,6,3,3,0,0.0,0.0
1006,413,2020-03-17 07:29:00,1,2547.0,1951.0,0.766,12.197,14,0,0,0,14,1,13,0,0.0,0.0
1006,414,2020-03-17 07:32:00,1,2392.0,1853.0,0.775,11.476,7,0,0,0,7,0,7,0,0.0,0.0
1006,415,2020-03-17 07:35:00,1,2551.0,1919.0,0.752,12.177,13,3,0,3,10,6,4,0,0.0,0.0
1006,416,2020-03-17 07:38:00,1,2536.0,1969.0,0.777,12.173,39,13,10,3,26,18,8,1,0.0,0.0
1006,417,2020-03-17 07:41:00,1,2615.0,2006.0,0.767,12.526,72,11,6,5,61,21,40,0,0.0,0.0
1006,418,2020-03-17 07:44:00,1,2535.0,1982.0,0.782,12.182,10,0,0,0,10,0,10,0,0.0,0.0
1006,419,2020-03-17 07:47:00,1,2525.0,1988.0,0.787,12.151,24,3,1,2,21,8,13,0,0.0,0.0
1006,420,2020-03-17 07:50:00,1,2692.0,2033.0,0.755,12.858,7,2,0,2,5,1,4,0,0.0,0.0
1006,421,2020-03-17 07:53:00,1,2544.0,1909.0,0.75,12.139,4,0,0,0,4,1,3,0,0.0,0.0
1006,422,2020-03-17 07:56:00,1,2479.0,1858.0,0.749,11.824,62,23,9,14,39,23,16,2,0.0,0.0
1006,423,2020-03-17 07:59:00,1,2813.0,2234.0,0.794,13.557,346,116,70,46,230,157,73,32,0.0,0.0
1006,424,2020-03-17 08:02:00,1,3054.0,2379.0,0.779,14.667,203,116,71,45,87,54,33,21,0.0,0.02
1006,425,2020-03-17 08:05:00,1,3103.0,2509.0,0.808,15.0035,262,144,114,30,118,76,42,45,0.37,0.01
1006,426,2020-03-17 08:08:00,1,3152.0,2639.0,0.837,15.34,373,225,176,49,148,113,35,60,0.0,0.0
1006,427,2020-03-17 08:11:00,1,3157.0,2668.0,0.845,15.394,157,81,59,22,76,55,21,10,0.0,0.0
1006,428,2020-03-17 08:14:00,1,3400.0,2756.0,0.811,16.449,53,31,14,17,22,3,19,0,0.0,0.0
1006,429,2020-03-17 08:17:00,1,3229.0,2711.0,0.839,15.723,292,182,133,49,110,81,29,30,0.0,0.0
1006,430,2020-03-17 08:20:00,1,3150.0,2673.0,0.849,15.372,350,179,133,46,171,122,49,11,0.0,0.0
1006,431,2020-03-17 08:23:00,1,3166.0,2666.0,0.842,15.424,673,380,318,62,293,221,72,18,0.0,0.0
1006,432,2020-03-17 08:26:00,1,3185.0,2580.0,0.81,15.405,447,205,134,71,242,166,76,21,0.0,0.0
1006,433,2020-03-17 08:29:00,1,3172.0,2640.0,0.832,15.421,671,371,270,101,300,220,80,3,0.0,0.0
1006,434,2020-03-17 08:32:00,1,3172.0,2630.0,0.829,15.408,733,400,322,78,333,242,91,11,0.0,0.0
1006,435,2020-03-17 08:35:00,1,3187.0,2599.0,0.815,15.436,509,269,205,64,240,171,69,18,0.0,0.0
1006,436,2020-03-17 08:38:00,1,3193.0,2543.0,0.796,15.397,212,144,101,43,68,47,21,1,0.0,0.0
1006,437,2020-03-17 08:41:00,1,3031.0,2455.0,0.81,14.66,187,147,88,59,40,2,38,1,0.0,0.01
1006,438,2020-03-17 08:44:00,1,3050.0,2436.0,0.799,14.715,76,50,25,25,26,4,22,4,0.0,0.0
1006,439,2020-03-17 08:47:00,1,2973.0,2366.0,0.796,14.332,46,27,8,19,19,0,19,0,0.0,0.0
1006,440,2020-03-17 08:50:00,1,2752.0,2176.0,0.791,13.252,10,4,1,3,6,0,6,0,0.0,0.0
1006,441,2020-03-17 08:53:00,1,2689.0,2050.0,0.762,12.867,11,10,4,6,1,0,1,0,0.0,0.0
1006,442,2020-03-17 08:56:00,1,2766.0,2126.0,0.768,13.251,1,1,0,1,0,0,0,0,0.0,0.0
1006,443,2020-03-17 08:59:00,1,2709.0,2028.0,0.749,12.918,6,6,4,2,0,0,0,0,0.0,0.0
1006,444,2020-03-17 09:02:00,1,2699.0,2030.0,0.752,12.883,10,5,2,3,5,2,3,0,0.0,0.0
1006,445,2020-03-17 09:05:00,1,2541.0,1961.0,0.772,12.184,3,1,0,1,2,0,2,0,0.0,0.0
1006,446,2020-03-17 09:08:00,1,2552.0,1941.0,0.76,12.205,4,0,0,0,4,0,4,0,0.0,0.0
1006,447,2020-03-17 09:11:00,1,2486.0,1827.0,0.735,11.819,18,1,0,1,17,0,17,0,0.0,0.0
1006,448,2020-03-17 09:14:00,1,2628.0,1939.0,0.738,12.503,72,22,15,7,50,34,16,0,0.0,0.0
1006,449,2020-03-17 09:17:00,1,2623.0,1967.0,0.75,12.513,2,2,0,2,0,0,0,0,0.0,0.0
1006,450,2020-03-17 09:20:00,1,2554.0,1898.0,0.743,12.165,2,1,0,1,1,0,1,0,0.0,0.0
1006,451,2020-03-17 09:23:00,1,2544.0,1893.0,0.744,12.119,8,5,0,5,3,1,2,0,0.0,0.0
1006,452,2020-03-17 09:26:00,1,2486.0,1824.0,0.734,11.814,18,17,2,15,1,0,1,0,0.0,0.0
1006,453,2020-03-17 09:29:00,1,2568.0,1845.0,0.719,12.162,16,9,1,8,7,1,6,0,0.0,0.0
1006,454,2020-03-17 09:32:00,1,2318.0,1764.0,0.761,11.085,3,0,0,0,3,0,3,0,0.0,0.01
1006,455,2020-03-17 09:35:00,1,2829.0,2161.0,0.764,13.539,127,53,33,20,74,51,23,0,0.0,0.0
1006,456,2020-03-17 09:38:00,1,3073.0,2328.0,0.758,14.683,143,82,66,16,61,45,16,11,0.0,0.0
1006,457,2020-03-17 09:41:00,1,2839.0,2146.0,0.756,13.564,0,0,0,0,0,0,0,0,0.0,0.0
1006,458,2020-03-17 09:44:00,1,2708.0,1980.0,0.731,12.861,28,12,5,7,16,7,9,0,0.0,0.0
1006,459,2020-03-17 09:47:00,1,2864.0,2137.0,0.746,13.649,96,86,35,51,10,2,8,3,0.0,0.0
1006,460,2020-03-17 09:50:00,1,2847.0,2187.0,0.768,13.64,128,106,54,52,22,4,18,1,0.0,0.0
1006,461,2020-03-17 09:53:00,1,2919.0,2218.0,0.76,13.958,120,107,54,53,13,5,8,3,0.0,0.0
1006,462,2020-03-17 09:56:00,1,2853.0,2152.0,0.754,13.624,2,2,0,2,0,0,0,0,0.0,0.0
1006,463,2020-03-17 09:59:00,1,2703.0,2031.0,0.752,12.899,15,13,6,7,2,2,0,0,0.0,0.0
1006,464,2020-03-17 10:02:00,1,2694.0,2043.0,0.758,12.876,0,0,0,0,0,0,0,0,0.0,0.0
1006,465,2020-03-17 10:05:00,1,2790.0,2070.0,0.742,13.284,12,8,4,4,4,1,3,0,0.0,0.0
1006,466,2020-03-17 10:08:00,1,2722.0,1960.0,0.72,12.895,11,8,6,2,3,0,3,0,0.0,0.0
1006,467,2020-03-17 10:11:00,1,2569.0,1854.0,0.722,12.176,10,6,4,2,4,0,4,0,0.0,0.0
1006,468,2020-03-17 10:14:00,1,2640.0,1897.0,0.719,12.503,3,0,0,0,3,0,3,0,0.0,0.0
1006,469,2020-03-17 10:17:00,1,2565.0,1873.0,0.73,12.178,29,0,0,0,29,0,29,0,0.0,0.0
1006,470,2020-03-17 10:20:00,1,2724.0,1932.0,0.709,12.873,0,0,0,0,0,0,0,0,0.0,0.0
1006,471,2020-03-17 10:23:00,1,2643.0,1924.0,0.728,12.543,0,0,0,0,0,0,0,0,0.0,0.0
1006,472,2020-03-17 10:26:00,1,2542.0,1906.0,0.75,12.127,0,0,0,0,0,0,0,0,0.0,0.0
1006,473,2020-03-17 10:29:00,1,2715.0,1954.0,0.72,12.86,0,0,0,0,0,0,0,0,0.0,0.0
1006,474,2020-03-17 10:32:00,1,2715.0,1962.0,0.723,12.87,63,16,5,11,47,12,35,5,0.0,0.0
1006,475,2020-03-17 10:35:00,1,2685.0,2090.0,0.778,12.894,160,88,66,22,72,56,16,1,0.0,0.0
1006,476,2020-03-17 10:38:00,1,2704.0,2012.0,0.744,12.88,0,0,0,0,0,0,0,0,0.0,0.0
1006,477,2020-03-17 10:41:00,1,2557.0,1879.0,0.735,12.157,6,1,1,0,5,2,3,0,0.0,0.0
1006,478,2020-03-17 10:44:00,1,2628.0,1945.0,0.74,12.507,476,252,196,56,224,169,55,6,0.0,0.0
1006,479,2020-03-17 10:47:00,1,3064.0,2369.0,0.773,14.694,270,132,97,35,138,89,49,14,0.0,0.0
1006,480,2020-03-17 10:50:00,1,2825.0,2179.0,0.771,13.545,526,352,283,69,174,109,65,9,0.0,0.0
1006,481,2020-03-17 10:53:00,1,2991.0,2287.0,0.765,14.318,576,316,271,45,260,199,61,29,0.0,0.0
1006,482,2020-03-17 10:56:00,1,2996.0,2275.0,0.759,14.323,2,0,0,0,2,0,2,7,0.0,0.0
1006,483,2020-03-17 10:59:00,1,3074.0,2306.0,0.75,14.663,166,55,34,21,111,76,35,1,0.0,0.0
1006,484,2020-03-17 11:02:00,1,2904.0,2256.0,0.777,13.94,39,22,1,21,17,1,16,0,0.0,0.0
1006,485,2020-03-17 11:05:00,1,2874.5,2206.5,0.7675,13.7685,46,34,1,33,12,0,12,0,0.0,0.0
1006,486,2020-03-17 11:08:00,1,2845.0,2157.0,0.758,13.597,127,114,60,54,13,5,8,1,0.0,0.0
1006,487,2020-03-17 11:11:00,1,2829.0,2185.0,0.772,13.565,51,42,13,29,9,0,9,0,0.0,0.0
1006,488,2020-03-17 11:14:00,1,2690.0,2047.0,0.761,12.865,0,0,0,0,0,0,0,0,0.0,0.0
1006,489,2020-03-17 11:17:00,1,2707.0,1998.0,0.738,12.88,20,14,8,6,6,0,6,0,0.0,0.0
1006,490,2020-03-17 11:20:00,1,2732.0,1928.0,0.706,12.9,2,0,0,0,2,0,2,0,0.0,0.0
1006,491,2020-03-17 11:23:00,1,2559.0,1871.0,0.731,12.154,0,0,0,0,0,0,0,0,0.0,0.0
1006,492,2020-03-17 11:26:00,1,2575.0,1815.0,0.705,12.154,0,0,0,0,0,0,0,0,0.0,0.0
1006,493,2020-03-17 11:29:00,1,2565.0,1833.0,0.715,12.135,11,9,4,5,2,0,2,0,0.0,0.0
1006,494,2020-03-17 11:32:00,1,2561.0,1862.0,0.727,12.152,9,4,2,2,5,0,5,0,0.0,0.0
1006,495,2020-03-17 11:35:00,1,2646.0,1903.0,0.719,12.533,19,8,5,3,11,4,7,0,0.0,0.0
1006,496,2020-03-17 11:38:00,1,2560.0,1859.0,0.726,12.143,5,0,0,0,5,0,5,0,0.0,0.0
1006,497,2020-03-17 11:41:00,1,2563.0,1825.0,0.712,12.12,2,1,1,0,1,0,1,0,0.0,0.0
1006,498,2020-03-17 11:44:00,1,2583.0,1771.0,0.686,12.14,9,1,1,0,8,0,8,0,0.0,0.0
1006,499,2020-03-17 11:47:00,1,2580.0,1784.0,0.691,12.143,10,4,2,2,6,0,6,0,0.0,0.0
1006,500,2020-03-17 11:50:00,1,2590.0,1783.0,0.688,12.179,0,0,0,0,0,0,0,0,0.0,0.0
1006,501,2020-03-17 11:53:00,1,2583.0,1772.0,0.686,12.139,7,3,2,1,4,2,2,0,0.0,0.0
1006,502,2020-03-17 11:56:00,1,2579.0,1786.0,0.693,12.139,162,92,73,19,70,50,20,5,0.0,0.0
1006,503,2020-03-17 11:59:00,1,2576.0,1801.0,0.699,12.145,19,15,0,15,4,0,4,0,0.0,0.0
1006,504,2020-03-17 12:02:00,1,2500.0,1754.0,0.701,11.792,14,11,0,11,3,0,3,0,0.0,0.0
1006,505,2020-03-17 12:05:00,1,2330.0,1717.0,0.737,11.082,28,22,13,9,6,0,6,0,0.0,0.0
1006,506,2020-03-17 12:08:00,1,2499.0,1767.0,0.707,11.802,5,5,0,5,0,0,0,0,0.0,0.0
1006,507,2020-03-17 12:11:00,1,2335.0,1683.0,0.721,11.065,7,5,0,5,2,1,1,0,0.0,0.0
1006,508,2020-03-17 12:14:00,1,2332.0,1697.0,0.728,11.068,1,0,0,0,1,0,1,0,0.0,0.0
1006,509,2020-03-17 12:17:00,1,2338.0,1715.0,0.733,11.11,0,0,0,0,0,0,0,0,0.0,0.0
1006,510,2020-03-17 12:20:00,1,2496.0,1756.0,0.704,11.778,0,0,0,0,0,0,0,0,0.0,0.0
1006,511,2020-03-17 12:23:00,1,2577.0,1827.0,0.709,12.177,78,46,12,34,32,12,20,7,0.0,0.0
1006,512,2020-03-17 12:26:00,1,2700.0,2002.0,0.742,12.854,170,89,68,21,81,47,34,5,0.0,0.0
1006,513,2020-03-17 12:29:00,1,2695.0,2053.0,0.762,12.892,1,0,0,0,1,0,1,0,0.0,0.0
1006,514,2020-03-17 12:32:00,1,2555.0,1894.0,0.741,12.165,0,0,0,0,0,0,0,0,0.0,0.0
1006,515,2020-03-17 12:35:00,1,2488.0,1782.0,0.716,11.777,3,1,1,0,2,0,2,0,0.0,0.0
1006,516,2020-03-17 12:38:00,1,2332.0,1717.0,0.736,11.089,0,0,0,0,0,0,0,0,0.0,0.0
1006,517,2020-03-17 12:41:00,1,2416.0,1746.0,0.723,11.452,33,15,8,7,18,8,10,0,0.0,0.0
1006,518,2020-03-17 12:44:00,1,2503.0,1755.0,0.701,11.806,0,0,0,0,0,0,0,0,0.0,0.0
1006,519,2020-03-17 12:47:00,1,2357.0,1638.0,0.695,11.101,2,1,1,0,1,0,1,0,0.0,0.0
1006,520,2020-03-17 12:50:00,1,2359.0,1624.0,0.689,11.091,2,0,0,0,2,0,2,0,0.0,0.0
1006,521,2020-03-17 12:53:00,1,2344.0,1707.0,0.728,11.124,0,0,0,0,0,0,0,0,0.0,0.0
1006,522,2020-03-17 12:56:00,1,2594.0,1762.0,0.679,12.171,18,4,2,2,14,7,7,0,0.0,0.0
1006,523,2020-03-17 12:59:00,1,2503.0,1737.0,0.694,11.784,4,0,0,0,4,0,4,0,0.0,0.0
1006,524,2020-03-17 13:02:00,1,2335.0,1708.0,0.731,11.089,0,0,0,0,0,0,0,0,0.0,0.0
1006,525,2020-03-17 13:05:00,1,2332.0,1690.0,0.725,11.06,1,0,0,0,1,0,1,0,0.0,0.0
1006,526,2020-03-17 13:08:00,1,2409.0,1730.0,0.718,11.408,4,1,0,1,3,1,2,0,0.0,0.0
1006,527,2020-03-17 13:11:00,1,2325.0,1724.0,0.742,11.071,3,0,0,0,3,1,2,0,0.0,0.0
1006,528,2020-03-17 13:14:00,1,2342.0,1642.0,0.701,11.047,32,12,7,5,20,6,14,0,0.0,0.0
1006,529,2020-03-17 13:17:00,1,2565.0,1828.0,0.713,12.131,279,140,100,40,139,91,48,11,0.0,0.0
1006,530,2020-03-17 13:20:00,1,2853.0,2116.0,0.742,13.586,389,168,129,39,221,164,57,32,0.18,0.0
1006,531,2020-03-17 13:23:00,1,2853.0,2157.0,0.756,13.627,99,74,46,28,25,12,13,8,0.0,0.0
1006,532,2020-03-17 13:26:00,1,2909.0,2183.0,0.75,13.878,876,515,424,91,361,285,76,34,0.0,0.0
1006,533,2020-03-17 13:29:00,1,2997.0,2239.0,0.747,14.286,981,619,516,103,362,268,94,6,0.0,0.0
1006,534,2020-03-17 13:32:00,1,3073.0,2333.0,0.759,14.691,731,480,394,86,251,180,71,27,0.0,0.0
1006,535,2020-03-17 13:35:00,1,3156.0,2357.0,0.747,15.045,661,405,321,84,256,204,52,45,0.0,0.08
1006,536,2020-03-17 13:38:00,1,3068.0,2331.0,0.76,14.669,358,187,133,54,171,118,53,9,0.0,0.0
1006,537,2020-03-17 13:41:00,1,3098.0,2273.0,0.734,14.723,736,346,274,72,390,282,108,5,0.0,0.0
1006,538,2020-03-17 13:44:00,1,3095.0,2238.0,0.723,14.673,832,425,352,73,407,315,92,30,0.0,0.0
1006,539,2020-03-17 13:47:00,1,3013.0,2201.0,0.731,14.309,190,112,79,33,78,45,33,2,0.0,0.0
1006,540,2020-03-17 13:50:00,1,3018.0,2198.0,0.728,14.325,338,237,175,62,101,79,22,4,0.0,0.0
1006,541,2020-03-17 13:53:00,1,2847.0,2150.0,0.755,13.598,65,62,18,44,3,1,2,7,0.0,0.0
1006,542,2020-03-17 13:56:00,1,2856.0,2079.0,0.728,13.556,49,35,12,23,14,3,11,0,0.0,0.0
1006,543,2020-03-17 13:59:00,1,2689.0,2035.0,0.757,12.848,86,58,15,43,28,3,25,1,0.0,0.0
1006,544,2020-03-17 14:02:00,1,2697.0,2060.0,0.764,12.908,49,39,16,23,10,0,10,0,0.0,0.0
1006,545,2020-03-17 14:05:00,1,2630.5,1933.0,0.734,12.5055,6,4,2,2,2,1,1,0,0.0,0.0
1006,546,2020-03-17 14:08:00,1,2564.0,1806.0,0.704,12.103,10,2,0,2,8,0,8,0,0.0,0.0
1006,547,2020-03-17 14:11:00,1,2591.0,1786.0,0.689,12.189,6,2,0,2,4,0,4,0,0.0,0.0
1006,548,2020-03-17 14:14:00,1,2590.0,1806.0,0.697,12.204,24,20,15,5,4,2,2,0,0.0,0.0
1006,549,2020-03-17 14:17:00,1,2585.0,1780.0,0.688,12.157,1,1,0,1,0,0,0,0,0.0,0.0
1006,550,2020-03-17 14:20:00,1,2584.0,1775.0,0.687,12.148,0,0,0,0,0,0,0,0,0.0,0.0
1006,551,2020-03-17 14:23:00,1,2590.0,1780.0,0.687,12.175,0,0,0,0,0,0,0,0,0.0,0.0
1006,552,2020-03-17 14:26:00,1,2509.0,1741.0,0.694,11.814,0,0,0,0,0,0,0,0,0.0,0.0
1006,553,2020-03-17 14:29:00,1,2424.0,1702.0,0.702,11.433,20,13,7,6,7,3,4,0,0.0,0.0
1006,554,2020-03-17 14:32:00,1,2432.0,1715.0,0.705,11.48,0,0,0,0,0,0,0,0,0.0,0.0
1006,555,2020-03-17 14:35:00,1,2340.0,1676.0,0.716,11.075,0,0,0,0,0,0,0,0,0.0,0.0
1006,556,2020-03-17 14:38:00,1,2342.0,1696.0,0.724,11.104,8,5,1,4,3,1,2,0,0.0,0.0
1006,557,2020-03-17 14:41:00,1,2351.0,1667.0,0.709,11.108,4,4,0,4,0,0,0,0,0.0,0.0
1006,558,2020-03-17 14:44:00,1,2352.0,1649.0,0.701,11.093,22,22,1,21,0,0,0,0,0.0,0.0
1006,559,2020-03-17 14:47:00,1,2339.0,1685.0,0.72,11.083,6,6,0,6,0,0,0,0,0.0,0.0
1006,560,2020-03-17 14:50:00,1,2343.0,1699.0,0.725,11.112,1,1,0,1,0,0,0,0,0.0,0.0
1006,561,2020-03-17 14:53:00,1,2423.0,1726.0,0.713,11.458,68,63,38,25,5,1,4,4,0.0,0.0
1006,562,2020-03-17 14:56:00,1,2717.0,1958.0,0.721,12.872,118,74,40,34,44,21,23,23,0.0,0.0
1006,563,2020-03-17 14:59:00,1,2561.0,1885.0,0.736,12.179,421,214,161,53,207,152,55,14,0.0,0.0
1006,564,2020-03-17 15:02:00,1,2858.0,2091.0,0.732,13.576,646,374,296,78,272,196,76,1,0.0,0.0
1006,565,2020-03-17 15:05:00,1,2823.0,2221.0,0.787,13.581,348,197,146,51,151,105,46,4,0.0,0.0
1006,566,2020-03-17 15:08:00,1,2901.0,2274.0,0.784,13.946,606,342,272,70,264,190,74,14,0.0,0.0
1006,567,2020-03-17 15:11:00,1,2819.0,2257.0,0.801,13.604,262,145,94,51,117,75,42,35,0.0,0.0
1006,568,2020-03-17 15:14:00,1,3045.0,2418.0,0.794,14.675,626,312,251,61,314,252,62,27,0.0,0.0
1006,569,2020-03-17 15:17:00,1,3045.0,2370.0,0.778,14.62,746,396,314,82,350,269,81,34,0.0,0.0
1006,570,2020-03-17 15:20:00,1,2806.0,2270.0,0.809,13.567,123,78,64,14,45,36,9,8,0.0,0.0
1006,571,2020-03-17 15:23:00,1,2823.0,2242.0,0.794,13.605,25,11,3,8,14,5,9,7,0.0,0.0
1006,572,2020-03-17 15:26:00,1,2829.0,2196.0,0.776,13.579,76,39,19,20,37,2,35,1,0.0,0.0
1006,573,2020-03-17 15:29:00,1,2669.0,2169.0,0.813,12.917,86,80,28,52,6,0,6,9,0.0,0.0
1006,574,2020-03-17 15:32:00,1,2662.0,2145.0,0.806,12.863,82,67,30,37,15,0,15,4,0.0,0.0
1006,575,2020-03-17 15:35:00,1,2683.0,2081.0,0.775,12.877,9,7,4,3,2,0,2,0,0.0,0.0
1006,576,2020-03-17 15:38:00,1,2542.0,1891.0,0.744,12.111,25,20,12,8,5,2,3,0,0.0,0.0
1006,577,2020-03-17 15:41:00,1,2302.0,1792.0,0.778,11.054,14,11,7,4,3,0,3,0,0.0,0.0
1006,578,2020-03-17 15:44:00,1,2337.0,1695.0,0.725,11.083,9,5,0,5,4,0,4,0,0.0,0.0
1006,579,2020-03-17 15:47:00,1,2340.0,1694.0,0.724,11.097,1,1,0,1,0,0,0,0,0.0,0.0
1006,580,2020-03-17 15:50:00,1,2339.0,1714.0,0.733,11.112,8,6,4,2,2,1,1,0,0.0,0.0
1006,581,2020-03-17 15:53:00,1,2413.0,1764.0,0.731,11.462,6,4,0,4,2,0,2,0,0.0,0.0
1006,582,2020-03-17 15:56:00,1,2328.0,1734.0,0.745,11.093,10,10,4,6,0,0,0,0,0.0,0.0
1006,583,2020-03-17 15:59:00,1,2338.0,1686.0,0.721,11.08,27,26,11,15,1,0,1,0,0.0,0.0
1006,584,2020-03-17 16:02:00,1,2337.0,1682.0,0.72,11.073,1,1,0,1,0,0,0,0,0.0,0.0
1006,585,2020-03-17 16:05:00,1,2347.0,1659.0,0.707,11.085,5,2,1,1,3,1,2,0,0.0,0.0
1006,586,2020-03-17 16:08:00,1,2348.0,1686.0,0.718,11.119,0,0,0,0,0,0,0,0,0.0,0.0
1006,587,2020-03-17 16:11:00,1,2342.0,1649.0,0.704,11.054,0,0,0,0,0,0,0,0,0.0,0.0
1006,588,2020-03-17 16:14:00,1,2342.0,1660.0,0.709,11.067,13,5,2,3,8,6,2,0,0.0,0.0
1006,589,2020-03-17 16:17:00,1,2343.0,1706.0,0.728,11.12,32,21,12,9,11,6,5,0,0.0,0.0
1006,590,2020-03-17 16:20:00,1,2349.0,1669.0,0.711,11.102,25,25,10,15,0,0,0,0,0.0,0.0
1006,591,2020-03-17 16:23:00,1,2351.0,1637.0,0.696,11.077,19,14,7,7,5,0,5,0,0.0,0.0
1006,592,2020-03-17 16:26:00,1,2369.0,1606.0,0.678,11.113,12,10,1,9,2,0,2,0,0.0,0.0
1006,593,2020-03-17 16:29:00,1,2365.0,1607.0,0.68,11.098,3,3,1,2,0,0,0,0,0.0,0.0
1006,594,2020-03-17 16:32:00,1,2501.0,1745.0,0.698,11.786,143,113,62,51,30,15,15,3,0.0,0.0
1006,595,2020-03-17 16:35:00,1,2564.0,1878.0,0.733,12.18,53,24,7,17,29,3,26,0,0.0,0.0
1006,596,2020-03-17 16:38:00,1,2631.0,1912.0,0.727,12.482,61,32,5,27,29,0,29,1,0.0,0.0
1006,597,2020-03-17 16:41:00,1,2556.0,1903.0,0.745,12.18,14,13,1,12,1,0,1,0,0.0,0.0
1006,598,2020-03-17 16:44:00,1,2565.0,1804.0,0.703,12.104,0,0,0,0,0,0,0,0,0.0,0.0
1006,599,2020-03-17 16:47:00,1,2402.0,1757.0,0.731,11.41,24,21,10,11,3,1,2,0,0.0,0.0
1006,600,2020-03-17 16:50:00,1,2330.0,1725.0,0.74,11.091,8,8,2,6,0,0,0,0,0.0,0.0
1006,601,2020-03-17 16:53:00,1,2330.0,1727.0,0.741,11.091,1,1,0,1,0,0,0,0,0.0,0.0
1006,602,2020-03-17 16:56:00,1,2327.0,1731.0,0.744,11.085,29,22,4,18,7,1,6,0,0.0,0.0
1006,603,2020-03-17 16:59:00,1,2585.0,1783.0,0.69,12.157,1,1,0,1,0,0,0,0,0.0,0.0
1006,604,2020-03-17 17:02:00,1,2587.0,1790.0,0.692,12.174,4,1,0,1,3,2,1,0,0.0,0.0
1006,605,2020-03-17 17:05:00,1,2579.0,1799.5,0.6975,12.1535,3,0,0,0,3,1,2,0,0.0,0.0
1006,606,2020-03-17 17:08:00,1,2571.0,1809.0,0.703,12.133,28,17,2,15,11,3,8,2,0.0,0.0
1006,607,2020-03-17 17:11:00,1,2575.0,1852.0,0.719,12.195,93,57,28,29,36,0,36,1,0.0,0.0
1006,608,2020-03-17 17:14:00,1,2555.0,1919.0,0.751,12.191,42,34,13,21,8,0,8,0,0.0,0.0
1006,609,2020-03-17 17:17:00,1,2707.0,1941.0,0.717,12.815,107,56,28,28,51,0,51,12,0.0,0.0
1006,610,2020-03-17 17:20:00,1,2722.0,1953.0,0.718,12.887,122,90,54,36,32,6,26,1,0.0,0.0
1006,611,2020-03-17 17:23:00,1,2691.0,2060.0,0.765,12.884,201,155,112,43,46,15,31,0,0.0,0.0
1006,612,2020-03-17 17:26:00,1,2998.0,2278.0,0.76,14.333,472,254,194,60,218,160,58,48,0.01,0.0
1006,613,2020-03-17 17:29:00,1,2914.0,2235.0,0.767,13.956,461,251,195,56,210,156,54,20,0.01,0.0
1006,614,2020-03-17 17:32:00,1,2988.0,2256.0,0.755,14.269,121,79,37,42,42,13,29,2,0.0,0.0
1006,615,2020-03-17 17:35:00,1,2849.0,2172.0,0.763,13.629,63,57,19,38,6,0,6,0,0.0,0.0
1006,616,2020-03-17 17:38:00,1,2770.0,2118.0,0.765,13.258,2,2,2,0,0,0,0,0,0.0,0.0
1006,617,2020-03-17 17:41:00,1,2708.0,1970.0,0.728,12.853,3,1,0,1,2,0,2,0,0.0,0.0
1006,618,2020-03-17 17:44:00,1,2563.0,1863.0,0.727,12.162,9,7,4,3,2,0,2,0,0.0,0.0
1006,619,2020-03-17 17:47:00,1,2568.0,1881.0,0.733,12.2,13,13,0,13,0,0,0,0,0.02,0.0
1006,620,2020-03-17 17:50:00,1,2644.0,1903.0,0.72,12.525,16,11,4,7,5,0,5,0,0.0,0.0
1006,621,2020-03-17 17:53:00,1,2576.0,1836.0,0.713,12.182,14,13,0,13,1,0,1,0,0.0,0.0
1006,622,2020-03-17 17:56:00,1,2500.0,1784.0,0.713,11.825,41,38,10,28,3,0,3,1,0.0,0.0
1006,623,2020-03-17 17:59:00,1,2576.0,1825.0,0.708,12.17,25,23,13,10,2,1,1,0,0.0,0.0
1006,624,2020-03-17 18:02:00,0,2575.0,1801.0,0.7,12.139,5,5,1,4,0,0,0,0,0.0,0.0
1006,625,2020-03-17 18:05:00,0,2583.0,1776.0,0.688,12.142,79,48,24,24,31,12,19,6,0.0,0.0
1006,626,2020-03-17 18:08:00,0,2714.0,1987.0,0.732,12.893,84,49,21,28,35,0,35,4,0.0,0.0
1006,627,2020-03-17 18:11:00,0,3102.0,2268.0,0.731,14.732,621,313,251,62,308,245,63,80,0.0,0.0
1006,628,2020-03-17 18:14:00,0,3228.0,2409.0,0.746,15.385,587,329,258,71,258,196,62,99,0.0,0.1
1006,629,2020-03-17 18:17:00,0,4124.0,3063.0,0.743,19.64,473,204,142,62,269,204,65,54,0.03,0.01
1006,630,2020-03-17 18:20:00,0,3234.0,2413.0,0.746,15.415,446,223,172,51,223,171,52,85,0.3,0.11
1006,631,2020-03-17 18:23:00,0,3199.0,2523.0,0.789,15.397,695,348,280,68,347,277,70,124,0.1,0.0
1006,632,2020-03-17 18:26:00,0,2915.0,2267.0,0.778,13.995,199,109,88,21,90,67,23,42,0.0,0.0
1006,633,2020-03-17 18:29:00,0,3401.0,2775.0,0.816,16.473,265,134,92,42,131,87,44,52,0.0,0.0
1006,634,2020-03-17 18:32:00,0,3541.0,2870.0,0.811,17.127,242,111,72,39,131,86,45,14,0.13,0.0
1006,635,2020-03-17 18:35:00,0,3522.0,2995.0,0.85,17.193,640,376,303,73,264,201,63,139,0.0,0.0
1006,636,2020-03-17 18:38:00,0,3366.0,2884.0,0.857,16.455,321,192,143,49,129,93,36,138,0.0,0.0
1006,637,2020-03-17 18:41:00,0,3373.0,2820.0,0.836,16.413,249,139,96,43,110,82,28,8,0.0,0.0
1006,638,2020-03-17 18:44:00,0,3506.0,3029.0,0.864,17.167,93,64,42,22,29,4,25,1,0.0,0.0
1006,639,2020-03-17 18:47:00,0,3368.0,2931.0,0.87,16.515,22,19,13,6,3,0,3,0,0.0,0.0
1006,640,2020-03-17 18:50:00,0,3138.0,2745.0,0.875,15.405,3,3,0,3,0,0,0,0,0.0,0.0
1006,641,2020-03-17 18:53:00,0,3003.0,2621.0,0.873,14.734,28,17,9,8,11,6,5,0,0.0,0.0
1006,642,2020-03-17 18:56:00,0,2994.0,2588.0,0.865,14.661,5,5,3,2,0,0,0,0,0.0,0.0
1006,643,2020-03-17 18:59:00,0,2949.0,2481.0,0.841,14.365,1,1,0,1,0,0,0,0,0.0,0.0
1006,644,2020-03-17 19:02:00,0,2865.0,2425.0,0.846,13.974,7,0,0,0,7,1,6,0,0.0,0.0
1006,645,2020-03-17 19:05:00,0,3035.0,2489.0,0.82,14.714,85,57,23,34,28,6,22,16,0.0,0.0
1006,646,2020-03-17 19:08:00,0,3166.0,2641.0,0.834,15.398,243,134,81,53,109,74,35,28,0.0,0.0
1006,647,2020-03-17 19:11:00,0,3398.0,2805.0,0.826,16.494,594,293,224,69,301,238,63,125,0.0,0.0
1006,648,2020-03-17 19:14:00,0,3677.0,3116.0,0.847,17.937,399,212,149,63,187,149,38,46,0.0,0.0
1006,649,2020-03-17 19:17:00,0,3929.0,3111.0,0.792,18.926,727,345,269,76,382,306,76,52,0.0,0.0
1006,650,2020-03-17 19:20:00,0,3163.0,2653.0,0.839,15.398,104,55,42,13,49,29,20,24,0.0,0.0
1006,651,2020-03-17 19:23:00,0,3238.0,2656.0,0.82,15.698,590,312,211,101,278,207,71,68,0.0,0.0
1006,652,2020-03-17 19:26:00,0,3047.0,2416.0,0.793,14.679,347,166,111,55,181,134,47,7,0.19,0.0
1006,653,2020-03-17 19:29:00,0,3028.0,2459.0,0.812,14.651,344,197,133,64,147,96,51,44,0.0,0.02
1006,654,2020-03-17 19:32:00,0,3163.0,2631.0,0.832,15.376,281,169,128,41,112,81,31,40,0.0,0.0
1006,655,2020-03-17 19:35:00,0,3900.0,3276.0,0.84,18.993,262,124,82,42,138,105,33,18,0.0,0.0
1006,656,2020-03-17 19:38:00,0,3238.0,2692.0,0.831,15.739,225,112,69,43,113,67,46,35,0.0,0.0
1006,657,2020-03-17 19:41:00,0,3551.0,2949.0,0.83,17.256,196,106,67,39,90,63,27,15,0.0,0.0
1006,658,2020-03-17 19:44:00,0,3188.0,2566.0,0.805,15.401,71,52,16,36,19,4,15,0,0.0,0.0
1006,659,2020-03-17 19:47:00,0,3030.0,2484.0,0.82,14.689,128,78,42,36,50,26,24,12,0.0,0.0
1006,660,2020-03-17 19:50:00,0,3191.0,2543.0,0.797,15.389,3,3,0,3,0,0,0,0,0.0,0.0
1006,661,2020-03-17 19:53:00,0,2800.0,2333.0,0.833,13.614,10,9,0,9,1,0,1,0,0.0,0.0
1006,662,2020-03-17 19:56:00,0,2666.0,2146.0,0.805,12.881,0,0,0,0,0,0,0,0,0.0,0.0
1006,663,2020-03-17 19:59:00,0,2693.0,2064.0,0.766,12.898,23,13,6,7,10,3,7,0,0.0,0.0
1006,664,2020-03-17 20:02:00,0,2300.0,1810.0,0.787,11.066,11,11,1,10,0,0,0,0,0.0,0.0
1006,665,2020-03-17 20:05:00,0,2933.5,2286.0,0.7805,14.0885,49,36,13,23,13,3,10,4,0.0,0.0
1006,666,2020-03-17 20:08:00,0,3567.0,2762.0,0.774,17.111,498,242,189,53,256,197,59,50,0.0,0.0
1006,667,2020-03-17 20:11:00,0,3719.0,2902.0,0.78,17.866,336,180,128,52,156,117,39,42,0.0,0.0
1006,668,2020-03-17 20:14:00,0,3570.0,2847.0,0.798,17.219,238,123,90,33,115,90,25,20,0.0,0.0
1006,669,2020-03-17 20:17:00,0,3063.0,2408.0,0.786,14.735,62,31,7,24,31,4,27,6,0.0,0.0
1006,670,2020-03-17 20:20:00,0,3075.0,2305.0,0.75,14.668,70,40,12,28,30,4,26,1,0.0,0.0
1006,671,2020-03-17 20:23:00,0,3042.0,2417.0,0.795,14.661,258,129,83,46,129,94,35,9,0.0,0.03
1006,672,2020-03-17 20:26:00,0,3712.0,2942.0,0.793,17.884,323,139,88,51,184,133,51,14,0.0,0.05
1006,673,2020-03-17 20:29:00,0,3339.0,2633.0,0.789,16.071,343,181,138,43,162,121,41,39,0.24,0.0
1006,674,2020-03-17 20:32:00,0,3201.0,2493.0,0.779,15.372,389,188,138,50,201,147,54,15,0.0,0.0
1006,675,2020-03-17 20:35:00,0,2707.0,2016.0,0.745,12.899,478,228,156,72,250,192,58,5,0.0,0.0
1006,676,2020-03-17 20:38:00,0,3181.0,2560.0,0.805,15.367,263,158,118,40,105,76,29,8,0.0,0.0
1006,677,2020-03-17 20:41:00,0,2807.0,2275.0,0.811,13.578,110,97,52,45,13,7,6,4,0.0,0.0
1006,678,2020-03-17 20:44:00,0,2540.0,1943.0,0.765,12.158,135,113,64,49,22,7,15,0,0.0,0.0
1006,679,2020-03-17 20:47:00,0,3195.0,2550.0,0.798,15.413,24,8,0,8,16,8,8,0,0.0,0.0
1006,680,2020-03-17 20:50:00,0,2705.0,2033.0,0.752,12.908,3,0,0,0,3,0,3,0,0.0,0.0
1006,681,2020-03-17 20:53:00,0,2333.0,1714.0,0.735,11.09,3,1,1,0,2,0,2,0,0.0,0.0
1006,682,2020-03-17 20:56:00,0,2336.0,1701.0,0.728,11.088,3,2,0,2,1,0,1,0,0.0,0.0
1006,683,2020-03-17 20:59:00,0,2566.0,1816.0,0.708,12.123,94,43,31,12,51,36,15,3,0.0,0.0
1006,684,2020-03-17 21:02:00,0,3595.0,2707.0,0.753,17.163,235,113,66,47,122,93,29,45,0.0,0.0
1006,685,2020-03-17 21:05:00,0,3962.0,2959.0,0.747,18.889,195,78,42,36,117,89,28,25,0.0,0.0
1006,686,2020-03-17 21:08:00,0,3953.0,3088.0,0.781,18.993,293,134,96,38,159,109,50,31,0.21,0.0
1006,687,2020-03-17 21:11:00,0,3188.0,2561.0,0.803,15.397,483,261,205,56,222,162,60,115,0.0,0.0
1006,688,2020-03-17 21:14:00,0,3541.0,2935.0,0.829,17.202,464,232,186,46,232,173,59,24,0.0,0.01
1006,689,2020-03-17 21:17:00,0,3050.0,2391.0,0.784,14.667,154,55,28,27,99,51,48,6,0.0,0.0
1006,690,2020-03-17 21:20:00,0,3188.0,2558.0,0.803,15.392,130,71,39,32,59,18,41,2,0.0,0.0
1006,691,2020-03-17 21:23:00,0,3175.0,2626.0,0.827,15.416,146,42,8,34,104,48,56,0,0.0,0.0
1006,692,2020-03-17 21:26:00,0,3313.0,2739.0,0.827,16.086,48,0,0,0,48,14,34,0,0.0,0.0
1006,693,2020-03-17 21:29:00,0,3018.0,2452.0,0.813,14.605,35,6,3,3,29,2,27,0,0.0,0.0
1006,694,2020-03-17 21:32:00,0,3187.0,2517.0,0.79,15.342,174,82,55,27,92,62,30,8,0.0,0.0
1006,695,2020-03-17 21:35:00,0,3768.0,3044.0,0.808,18.215,206,102,60,42,104,79,25,15,0.0,0.02
1006,696,2020-03-17 21:38:00,0,3397.0,2720.0,0.801,16.396,442,181,140,41,261,192,69,13,0.16,0.02
1006,697,2020-03-17 21:41:00,0,3159.0,2641.0,0.836,15.37,266,102,72,30,164,109,55,12,0.0,0.0
1006,698,2020-03-17 21:44:00,0,2800.0,2333.0,0.833,13.617,139,84,49,35,55,22,33,2,0.0,0.0
1006,699,2020-03-17 21:47:00,0,3030.0,2475.0,0.817,14.68,109,34,16,18,75,34,41,0,0.0,0.0
1006,700,2020-03-17 21:50:00,0,3050.0,2407.0,0.789,14.683,37,3,2,1,34,0,34,0,0.0,0.0
1006,701,2020-03-17 21:53:00,0,2815.0,2248.0,0.799,13.579,50,17,9,8,33,0,33,0,0.0,0.0
1006,702,2020-03-17 21:56:00,0,2655.0,2172.0,0.818,12.865,78,27,16,11,51,6,45,0,0.0,0.0
1006,703,2020-03-17 21:59:00,0,3416.0,2722.0,0.797,16.473,501,252,190,62,249,192,57,26,0.0,0.0
1006,704,2020-03-17 22:02:00,0,3550.0,2854.0,0.804,17.146,419,135,88,47,284,221,63,68,0.0,0.01
1006,705,2020-03-17 22:05:00,0,3705.0,2983.0,0.805,17.9,169,81,33,48,88,59,29,14,0.0,0.13
1006,706,2020-03-17 22:08:00,0,3941.0,3145.0,0.798,19.01,149,84,46,38,65,36,29,37,0.0,0.06
1006,707,2020-03-17 22:11:00,0,3173.0,2634.0,0.83,15.417,185,94,60,34,91,43,48,20,0.0,0.0
1006,708,2020-03-17 22:14:00,0,3551.0,2865.0,0.807,17.165,411,236,187,49,175,130,45,88,0.0,0.02
1006,709,2020-03-17 22:17:00,0,3157.0,2641.0,0.836,15.364,575,281,215,66,294,213,81,69,0.0,0.0
1006,710,2020-03-17 22:20:00,0,3165.0,2604.0,0.823,15.354,506,208,150,58,298,212,86,20,0.0,0.01
1006,711,2020-03-17 22:23:00,0,3174.0,2604.0,0.82,15.39,242,128,71,57,114,53,61,5,0.0,0.0
1006,712,2020-03-17 22:26:00,0,3183.0,2637.0,0.829,15.459,127,39,15,24,88,39,49,0,0.0,0.0
1006,713,2020-03-17 22:29:00,0,3166.0,2623.0,0.829,15.378,205,59,16,43,146,70,76,0,0.0,0.0
1006,714,2020-03-17 22:32:00,0,3181.0,2590.0,0.814,15.399,285,235,175,60,50,0,50,0,0.0,0.0
1006,715,2020-03-17 22:35:00,0,2866.0,2410.0,0.841,13.961,107,35,4,31,72,11,61,0,0.0,0.0
1006,716,2020-03-17 22:38:00,0,2802.0,2280.0,0.814,13.563,114,31,20,11,83,8,75,0,0.0,0.0
1006,717,2020-03-17 22:41:00,0,2655.0,2195.0,0.827,12.893,64,0,0,0,64,2,62,0,0.0,0.0
1006,718,2020-03-17 22:44:00,0,2801.0,2336.0,0.834,13.623,83,0,0,0,83,10,73,0,0.0,0.0
1006,719,2020-03-17 22:47:00,0,2815.0,2280.0,0.81,13.615,75,3,1,2,72,10,62,0,0.0,0.0
1006,720,2020-03-17 22:50:00,0,2816.0,2280.0,0.81,13.621,62,3,0,3,59,0,59,0,0.0,0.0
1006,721,2020-03-17 22:53:00,0,2953.0,2425.0,0.821,14.322,304,123,79,44,181,114,67,23,0.0,0.0
1006,722,2020-03-17 22:56:00,0,3900.0,3265.0,0.837,18.982,345,135,88,47,210,157,53,27,0.0,0.03
1006,723,2020-03-17 22:59:00,0,3388.0,2846.0,0.84,16.501,208,90,44,46,118,66,52,46,0.0,0.01
1006,724,2020-03-17 23:02:00,0,3514.0,2997.0,0.853,17.164,443,214,167,47,229,172,57,74,0.0,0.0
1006,725,2020-03-17 23:05:00,0,3405.0,2893.5,0.8495,16.62,217,79,51,28,138,79,59,19,0.0,0.0
1006,726,2020-03-17 23:08:00,0,3296.0,2790.0,0.846,16.076,68,3,2,1,65,9,56,0,0.0,0.01
1006,727,2020-03-17 23:11:00,0,3169.0,2630.0,0.83,15.398,97,14,10,4,83,23,60,0,0.0,0.0
1006,728,2020-03-17 23:14:00,0,3148.0,2737.0,0.87,15.432,61,0,0,0,61,0,61,0,0.0,0.0
1006,729,2020-03-17 23:17:00,0,3180.0,2648.0,0.833,15.462,83,13,3,10,70,4,66,0,0.0,0.0
1006,730,2020-03-17 23:20:00,0,3149.0,2675.0,0.849,15.37,167,65,43,22,102,46,56,4,0.0,0.06
1006,731,2020-03-17 23:23:00,0,3744.0,3177.0,0.849,18.268,219,66,30,36,153,99,54,28,0.0,0.23
1006,732,2020-03-17 23:26:00,0,3674.0,3131.0,0.852,17.942,346,123,74,49,223,155,68,13,0.16,0.09
1006,733,2020-03-17 23:29:00,0,3162.0,2669.0,0.844,15.411,244,77,55,22,167,98,69,7,0.0,0.0
1006,734,2020-03-17 23:32:00,0,3164.0,2664.0,0.842,15.415,148,54,23,31,94,25,69,16,0.0,0.0
1006,735,2020-03-17 23:35:00,0,3135.0,2765.0,0.882,15.413,263,68,47,21,195,119,76,26,0.0,0.0
1006,736,2020-03-17 23:38:00,0,2935.0,2481.0,0.845,14.311,77,9,6,3,68,5,63,0,0.0,0.0
1006,737,2020-03-17 23:41:00,0,3015.0,2561.0,0.85,14.715,72,2,1,1,70,0,70,0,0.0,0.0
1006,738,2020-03-17 23:44:00,0,3009.0,2570.0,0.854,14.7,68,1,1,0,67,0,67,0,0.0,0.0
1006,739,2020-03-17 23:47:00,0,3162.0,2658.0,0.841,15.4,70,0,0,0,70,0,70,0,0.0,0.0
1006,740,2020-03-17 23:50:00,0,3347.0,2963.0,0.885,16.468,67,0,0,0,67,8,59,0,0.0,0.0
1006,741,2020-03-17 23:53:00,0,3473.0,3150.0,0.907,17.169,557,231,189,42,326,232,94,17,0.33,0.0
1006,742,2020-03-17 23:56:00,0,3464.0,3167.0,0.914,17.154,595,241,176,65,354,270,84,10,0.0,0.01
1006,743,2020-03-17 23:59:00,0,2981.0,2655.0,0.891,14.684,111,20,10,10,91,33,58,4,0.0,0.0
1006,744,2020-03-18 00:02:00,0,3479.0,3159.0,0.908,17.204,85,18,7,11,67,22,45,1,0.0,0.0
1006,745,2020-03-18 00:05:00,0,3494.0,3117.0,0.892,17.218,150,29,8,21,121,57,64,6,0.0,0.0
1006,746,2020-03-18 00:08:00,0,3483.0,3086.0,0.886,17.141,139,32,18,14,107,45,62,1,0.0,0.0
1006,747,2020-03-18 00:11:00,0,3366.0,2936.0,0.872,16.513,55,4,0,4,51,0,51,0,0.0,0.0
1006,748,2020-03-18 00:14:00,0,3128.0,2735.0,0.874,15.352,83,10,3,7,73,8,65,0,0.0,0.0
1006,749,2020-03-18 00:17:00,0,2978.0,2657.0,0.892,14.674,63,5,3,2,58,2,56,0,0.0,0.0
1006,750,2020-03-18 00:20:00,0,2986.0,2587.0,0.866,14.631,66,6,3,3,60,4,56,0,0.0,0.0
1006,751,2020-03-18 00:23:00,0,2997.0,2649.0,0.884,14.739,63,5,1,4,58,0,58,0,0.0,0.0
1006,752,2020-03-18 00:26:00,0,3012.0,2576.0,0.855,14.718,85,7,5,2,78,8,70,0,0.0,0.0
1006,753,2020-03-18 00:29:00,0,2839.0,2513.0,0.885,13.966,110,19,8,11,91,33,58,1,0.0,0.0
1006,754,2020-03-18 00:32:00,0,3000.0,2616.0,0.872,14.718,176,39,12,27,137,70,67,14,0.0,0.0
1006,755,2020-03-18 00:35:00,0,3156.0,2671.0,0.846,15.392,138,38,10,28,100,43,57,6,0.0,0.0
1006,756,2020-03-18 00:38:00,0,3137.0,2748.0,0.876,15.404,195,101,43,58,94,34,60,0,0.0,0.0
1006,757,2020-03-18 00:41:00,0,3207.0,2823.0,0.88,15.759,169,47,10,37,122,54,68,6,0.0,0.0
1006,758,2020-03-18 00:44:00,0,3379.0,2881.0,0.853,16.503,481,211,154,57,270,190,80,41,0.0,0.0
1006,759,2020-03-18 00:47:00,0,3732.0,3220.0,0.863,18.271,307,117,65,52,190,134,56,53,0.15,0.0
1006,760,2020-03-18 00:50:00,0,2936.0,2530.0,0.862,14.369,562,279,217,62,283,202,81,61,0.0,0.0
1006,761,2020-03-18 00:53:00,0,3516.0,2994.0,0.851,17.169,750,288,224,64,462,356,106,90,0.0,0.0
1006,762,2020-03-18 00:56:00,0,3492.0,3092.0,0.886,17.18,678,304,250,54,374,312,62,134,0.0,0.04
1006,763,2020-03-18 00:59:00,0,3450.0,2962.0,0.859,16.873,643,214,156,58,429,363,66,17,0.0,0.0
1006,764,2020-03-18 01:02:00,0,3066.0,2642.0,0.862,15.004,274,83,49,34,191,176,15,5,0.0,0.0
1006,765,2020-03-18 01:05:00,0,3082.0,2587.0,0.839,15.006,23,4,2,2,19,18,1,0,0.0,0.0
1006,766,2020-03-18 01:08:00,0,3387.0,2825.0,0.834,16.475,94,0,0,0,94,84,10,0,0.0,0.0
1006,767,2020-03-18 01:11:00,0,3133.0,2739.0,0.874,15.375,205,26,15,11,179,165,14,0,0.0,0.0
1006,768,2020-03-18 01:14:00,0,3017.0,2580.0,0.855,14.746,40,12,7,5,28,26,2,0,0.0,0.0
1006,769,2020-03-18 01:17:00,0,2865.0,2431.0,0.848,13.981,33,11,0,11,22,17,5,0,0.0,0.0
1006,770,2020-03-18 01:20:00,0,3028.0,2436.0,0.805,14.629,157,75,47,28,82,67,15,33,0.0,0.04
1006,771,2020-03-18 01:23:00,0,3900.0,3289.0,0.843,19.008,132,31,12,19,101,81,20,4,0.0,0.14
1006,772,2020-03-18 01:26:00,0,3362.0,2882.0,0.857,16.436,496,121,81,40,375,339,36,41,0.0,0.0
1006,773,2020-03-18 01:29:00,0,3138.0,2777.0,0.885,15.438,526,231,177,54,295,254,41,86,0.0,0.01
1006,774,2020-03-18 01:32:00,0,3125.0,2798.0,0.895,15.411,429,183,135,48,246,216,30,172,0.3,0.0
1006,775,2020-03-18 01:35:00,0,3664.0,3188.0,0.87,17.964,664,246,190,56,418,354,64,122,0.0,0.0
1006,776,2020-03-18 01:38:00,0,3354.0,2941.0,0.877,16.471,956,386,285,101,570,441,129,12,0.0,0.01
1006,777,2020-03-18 01:41:00,0,3515.0,3014.0,0.857,17.185,673,173,117,56,500,396,104,9,0.0,0.0
1006,778,2020-03-18 01:44:00,0,3509.0,3067.0,0.874,17.22,280,27,4,23,253,172,81,1,0.0,0.0
1006,779,2020-03-18 01:47:00,0,3514.0,3050.0,0.868,17.221,116,2,0,2,114,74,40,1,0.0,0.0
1006,780,2020-03-18 01:50:00,0,3527.0,2993.0,0.848,17.211,90,39,13,26,51,31,20,0,0.0,0.0
1006,781,2020-03-18 01:53:00,0,3381.0,2888.0,0.854,16.52,407,131,80,51,276,218,58,15,0.0,0.0
1006,782,2020-03-18 01:56:00,0,3888.0,3324.0,0.855,18.998,216,41,16,25,175,118,57,15,0.0,0.15
1006,783,2020-03-18 01:59:00,0,3001.0,2569.0,0.856,14.666,632,200,148,52,432,323,109,9,0.0,0.0
1006,784,2020-03-18 02:02:00,0,3342.0,2960.0,0.886,16.443,345,133,105,28,212,140,72,8,0.0,0.0
1006,785,2020-03-18 02:05:00,0,3094.5,2711.5,0.8755,15.1935,166,35,4,31,131,53,78,1,0.0,0.0
1006,786,2020-03-18 02:08:00,0,2847.0,2463.0,0.865,13.944,54,0,0,0,54,0,54,0,0.0,0.0
1006,787,2020-03-18 02:11:00,0,2771.0,2391.0,0.863,13.566,65,4,2,2,61,4,57,0,0.0,0.0
1006,788,2020-03-18 02:14:00,0,2634.0,2272.0,0.862,12.894,69,4,2,2,65,4,61,0,0.0,0.0
1006,789,2020-03-18 02:17:00,0,2568.0,2171.0,0.845,12.521,79,8,4,4,71,3,68,0,0.0,0.01
1006,790,2020-03-18 02:20:00,0,2646.0,2255.0,0.852,12.921,115,13,4,9,102,32,70,0,0.0,0.0
1006,791,2020-03-18 02:23:00,0,3119.0,2831.0,0.908,15.423,115,16,11,5,99,33,66,0,0.0,0.0
1006,792,2020-03-18 02:26:00,0,3281.0,2899.0,0.884,16.137,95,16,7,9,79,6,73,0,0.0,0.0
1006,793,2020-03-18 02:29:00,0,3109.0,2814.0,0.905,15.365,123,5,1,4,118,49,69,0,0.0,0.0
1006,794,2020-03-18 02:32:00,0,2980.0,2660.0,0.893,14.686,111,29,14,15,82,4,78,0,0.0,0.0
1006,795,2020-03-18 02:35:00,0,2919.0,2548.0,0.873,14.321,114,33,21,12,81,9,72,0,0.0,0.0
1006,796,2020-03-18 02:38:00,0,2935.0,2544.0,0.867,14.38,68,0,0,0,68,3,65,0,0.0,0.0
1006,797,2020-03-18 02:41:00,0,2936.0,2539.0,0.865,14.377,67,0,0,0,67,0,67,0,0.0,0.0
1006,798,2020-03-18 02:44:00,0,2990.0,2612.0,0.874,14.673,142,33,15,18,109,54,55,0,0.0,0.0
1006,799,2020-03-18 02:47:00,0,3002.0,2611.0,0.87,14.717,130,13,6,7,117,60,57,0,0.0,0.0
1006,800,2020-03-18 02:50:00,0,3147.0,2764.0,0.878,15.458,110,23,9,14,87,20,67,3,0.0,0.0
1006,801,2020-03-18 02:53:00,0,3285.0,2824.0,0.86,16.068,251,33,6,27,218,133,85,5,0.0,0.0
1006,802,2020-03-18 02:56:00,0,3351.0,2931.0,0.875,16.449,269,100,48,52,169,102,67,29,0.0,0.0
1006,803,2020-03-18 02:59:00,0,3661.0,3114.0,0.851,17.872,298,114,75,39,184,146,38,47,0.21,0.13
1006,804,2020-03-18 03:02:00,0,3388.0,2832.0,0.836,16.484,458,191,138,53,267,200,67,62,0.13,0.0
1006,805,2020-03-18 03:05:00,0,3338.0,2939.0,0.88,16.407,593,187,131,56,406,306,100,85,0.0,0.0
1006,806,2020-03-18 03:08:00,0,2938.0,2475.0,0.842,14.317,456,161,117,44,295,220,75,8,0.0,0.0
1006,807,2020-03-18 03:11:00,0,3500.0,3101.0,0.886,17.223,359,166,109,57,193,122,71,53,0.0,0.0
1006,808,2020-03-18 03:14:00,0,3524.0,3017.0,0.856,17.227,164,16,6,10,148,77,71,0,0.0,0.0
1006,809,2020-03-18 03:17:00,0,3293.0,2816.0,0.855,16.091,101,9,5,4,92,27,65,0,0.0,0.0
1006,810,2020-03-18 03:20:00,0,3073.0,2625.0,0.854,15.015,87,13,0,13,74,14,60,0,0.0,0.0
1006,811,2020-03-18 03:23:00,0,2936.0,2502.0,0.852,14.338,74,15,2,13,59,8,51,0,0.0,0.0
1006,812,2020-03-18 03:26:00,0,3007.0,2525.0,0.84,14.643,89,21,14,7,68,10,58,0,0.0,0.0
1006,813,2020-03-18 03:29:00,0,2857.0,2472.0,0.865,13.994,64,5,1,4,59,2,57,0,0.0,0.0
1006,814,2020-03-18 03:32:00,0,2770.0,2450.0,0.884,13.627,69,5,0,5,64,8,56,0,0.0,0.0
1006,815,2020-03-18 03:35:00,0,2862.0,2458.0,0.859,13.997,241,53,32,21,188,116,72,24,0.0,0.0
1006,816,2020-03-18 03:38:00,0,3366.0,2910.0,0.865,16.483,293,55,19,36,238,160,78,41,0.0,0.11
1006,817,2020-03-18 03:41:00,0,3300.0,2864.0,0.868,16.173,446,126,90,36,320,234,86,10,0.0,0.0
1006,818,2020-03-18 03:44:00,0,3015.0,2553.0,0.847,14.707,363,161,129,32,202,147,55,9,0.09,0.01
1006,819,2020-03-18 03:47:00,0,3128.0,2735.0,0.874,15.353,317,147,98,49,170,126,44,44,0.0,0.0
1006,820,2020-03-18 03:50:00,0,3363.0,2901.0,0.863,16.461,348,31,14,17,317,228,89,0,0.0,0.0
1006,821,2020-03-18 03:53:00,0,3366.0,2928.0,0.87,16.503,154,23,17,6,131,69,62,0,0.0,0.0
1006,822,2020-03-18 03:56:00,0,3130.0,2798.0,0.894,15.429,66,3,0,3,63,0,63,0,0.0,0.0
1006,823,2020-03-18 03:59:00,0,2984.0,2643.0,0.886,14.681,76,9,0,9,67,0,67,0,0.0,0.0
1006,824,2020-03-18 04:02:00,0,3147.0,2724.0,0.866,15.415,74,0,0,0,74,0,74,0,0.0,0.0
1006,825,2020-03-18 04:05:00,0,3155.0,2682.0,0.85,15.401,76,1,1,0,75,4,71,0,0.0,0.0
1006,826,2020-03-18 04:08:00,0,2999.0,2583.0,0.861,14.677,60,0,0,0,60,0,60,0,0.0,0.0
1006,827,2020-03-18 04:11:00,0,3011.0,2513.0,0.835,14.646,57,0,0,0,57,0,57,0,0.0,0.0
1006,828,2020-03-18 04:14:00,0,3017.0,2548.0,0.845,14.706,61,0,0,0,61,0,61,0,0.0,0.0
1006,829,2020-03-18 04:17:00,0,3016.0,2521.0,0.836,14.673,222,56,28,28,166,91,75,5,0.0,0.0
1006,830,2020-03-18 04:20:00,0,3087.0,2621.0,0.849,15.063,148,20,5,15,128,58,70,8,0.0,0.0
1006,831,2020-03-18 04:23:00,0,3162.0,2715.0,0.859,15.466,219,54,33,21,165,101,64,11,0.0,0.0
1006,832,2020-03-18 04:26:00,0,3370.0,2882.0,0.855,16.469,303,67,29,38,236,204,32,24,0.17,0.08
1006,833,2020-03-18 04:29:00,0,3143.0,2681.0,0.853,15.353,658,255,206,49,403,345,58,87,0.0,0.1
1006,834,2020-03-18 04:32:00,0,3358.0,2863.0,0.853,16.401,623,248,204,44,375,326,49,209,0.03,0.0
1006,835,2020-03-18 04:35:00,0,3372.0,2928.0,0.868,16.526,538,203,162,41,335,295,40,97,0.0,0.0
1006,836,2020-03-18 04:38:00,0,3353.0,2930.0,0.874,16.454,628,152,99,53,476,425,51,5,0.0,0.0
1006,837,2020-03-18 04:41:00,0,3368.0,2909.0,0.864,16.49,224,86,49,37,138,122,16,0,0.0,0.0
1006,838,2020-03-18 04:44:00,0,3366.0,2905.0,0.863,16.479,400,136,103,33,264,237,27,11,0.0,0.0
1006,839,2020-03-18 04:47:00,0,3360.0,2908.0,0.865,16.458,142,70,25,45,72,69,3,0,0.0,0.0
1006,840,2020-03-18 04:50:00,0,3366.0,2876.0,0.855,16.446,175,46,25,21,129,117,12,1,0.0,0.0
1006,841,2020-03-18 04:53:00,0,3150.0,2734.0,0.868,15.437,111,15,9,6,96,89,7,0,0.0,0.0
1006,842,2020-03-18 04:56:00,0,3078.0,2581.0,0.839,14.984,2,0,0,0,2,2,0,0,0.0,0.0
1006,843,2020-03-18 04:59:00,0,3030.0,2498.0,0.825,14.703,27,4,2,2,23,23,0,0,0.0,0.0
1006,844,2020-03-18 05:02:00,0,3035.0,2462.0,0.811,14.682,0,0,0,0,0,0,0,0,0.0,0.0
1006,845,2020-03-18 05:05:00,0,3037.0,2468.0,0.8125,14.6965,0,0,0,0,0,0,0,0,0.0,0.0
1006,846,2020-03-18 05:08:00,0,3039.0,2474.0,0.814,14.711,0,0,0,0,0,0,0,0,0.0,0.0
1006,847,2020-03-18 05:11:00,0,2958.0,2434.0,0.823,14.348,197,37,30,7,160,142,18,10,0.0,0.0
1006,848,2020-03-18 05:14:00,0,3178.0,2636.0,0.829,15.439,212,59,27,32,153,147,6,72,0.0,0.14
1006,849,2020-03-18 05:17:00,0,2789.0,2344.0,0.84,13.584,441,94,56,38,347,299,48,10,0.0,0.0
1006,850,2020-03-18 05:20:00,0,3401.0,2781.0,0.818,16.478,488,204,149,55,284,244,40,16,0.0,0.0
1006,851,2020-03-18 05:23:00,0,3151.0,2701.0,0.857,15.403,236,57,37,20,179,159,20,26,0.0,0.0
1006,852,2020-03-18 05:26:00,0,3129.0,2758.0,0.882,15.38,16,16,1,15,0,0,0,0,0.0,0.03
1006,853,2020-03-18 05:29:00,0,3077.0,2609.0,0.848,15.013,2,2,0,2,0,0,0,0,0.0,0.0
1006,854,2020-03-18 05:32:00,0,3013.0,2560.0,0.85,14.707,12,6,0,6,6,6,0,0,0.0,0.0
1006,855,2020-03-18 05:35:00,0,3010.0,2558.0,0.85,14.691,47,23,15,8,24,23,1,0,0.0,0.0
1006,856,2020-03-18 05:38:00,0,3031.0,2508.0,0.827,14.72,62,1,0,1,61,55,6,0,0.0,0.0
1006,857,2020-03-18 05:41:00,0,2781.0,2425.0,0.872,13.641,6,3,1,2,3,2,1,0,0.0,0.0
1006,858,2020-03-18 05:44:00,0,2788.0,2375.0,0.852,13.612,38,6,2,4,32,28,4,0,0.0,0.0
1006,859,2020-03-18 05:47:00,0,2785.0,2328.0,0.836,13.552,26,11,6,5,15,13,2,0,0.0,0.0
1006,860,2020-03-18 05:50:00,0,2723.0,2322.0,0.853,13.3,69,34,16,18,35,30,5,0,0.0,0.0
1006,861,2020-03-18 05:53:00,0,2642.0,2278.0,0.862,12.93,39,7,2,5,32,29,3,0,0.0,0.0
1006,862,2020-03-18 05:56:00,0,2625.0,2287.0,0.871,12.875,1,1,0,1,0,0,0,0,0.0,0.0
1006,863,2020-03-18 05:59:00,0,2706.0,2310.0,0.853,13.22,3,3,2,1,0,0,0,0,0.0,0.0
1006,864,2020-03-18 06:02:00,1,2942.0,2444.0,0.831,14.299,292,91,51,40,201,181,20,11,0.0,0.06
1006,865,2020-03-18 06:05:00,1,3501.0,3047.0,0.87,17.166,277,95,64,31,182,155,27,24,0.0,0.01
1006,866,2020-03-18 06:08:00,1,2513.0,2062.0,0.821,12.185,160,49,26,23,111,100,11,1,0.0,0.0
1006,867,2020-03-18 06:11:00,1,3019.0,2504.0,0.829,14.669,65,15,4,11,50,47,3,0,0.0,0.0
1006,868,2020-03-18 06:14:00,1,2650.0,2228.0,0.841,12.91,19,13,1,12,6,6,0,0,0.0,0.0
1006,869,2020-03-18 06:17:00,1,2998.0,2560.0,0.854,14.647,32,1,0,1,31,26,5,0,0.0,0.0
1006,870,2020-03-18 06:20:00,1,2855.0,2498.0,0.875,14.012,12,9,0,9,3,3,0,0,0.0,0.0
1006,871,2020-03-18 06:23:00,1,3001.0,2578.0,0.859,14.677,47,20,5,15,27,24,3,0,0.0,0.01
1006,872,2020-03-18 06:26:00,1,3008.0,2525.0,0.839,14.647,0,0,0,0,0,0,0,0,0.0,0.0
1006,873,2020-03-18 06:29:00,1,2860.0,2458.0,0.859,13.991,3,3,0,3,0,0,0,0,0.0,0.0
1006,874,2020-03-18 06:32:00,1,2778.0,2436.0,0.877,13.641,144,51,37,14,93,83,10,0,0.0,0.0
1006,875,2020-03-18 06:35:00,1,3376.0,2858.0,0.846,16.467,161,78,53,25,83,45,38,13,0.0,0.02
1006,876,2020-03-18 06:38:00,1,2857.0,2464.0,0.862,13.983,81,31,4,27,50,8,42,2,0.0,0.0
1006,877,2020-03-18 06:41:00,1,3000.0,2582.0,0.861,14.679,273,148,100,48,125,71,54,39,0.0,0.02
1006,878,2020-03-18 06:44:00,1,3155.0,2645.0,0.839,15.359,109,55,38,17,54,47,7,7,0.0,0.0
1006,879,2020-03-18 06:47:00,1,3016.0,2529.0,0.839,14.684,16,9,1,8,7,6,1,0,0.0,0.0
1006,880,2020-03-18 06:50:00,1,2763.0,2428.0,0.879,13.573,3,2,1,1,1,1,0,0,0.0,0.0
1006,881,2020-03-18 06:53:00,1,2808.0,2317.0,0.825,13.627,0,0,0,0,0,0,0,0,0.0,0.0
1006,882,2020-03-18 06:56:00,1,2721.0,2276.0,0.836,13.242,40,10,7,3,30,29,1,0,0.0,0.0
1006,883,2020-03-18 06:59:00,1,3331.0,2703.0,0.811,16.119,331,115,78,37,216,189,27,8,0.23,0.0
1006,884,2020-03-18 07:02:00,1,2858.0,2420.0,0.847,13.942,229,40,24,16,189,173,16,8,0.0,0.0
1006,885,2020-03-18 07:05:00,1,3019.0,2529.0,0.838,14.694,28,1,0,1,27,23,4,0,0.0,0.0
1006,886,2020-03-18 07:08:00,1,3176.0,2580.0,0.812,15.371,371,187,134,53,184,159,25,4,0.0,0.0
1006,887,2020-03-18 07:11:00,1,3165.0,2584.0,0.817,15.33,440,183,132,51,257,224,33,18,0.0,0.06
1006,888,2020-03-18 07:14:00,1,3462.0,2897.0,0.837,16.846,274,106,58,48,168,135,33,9,0.0,0.0
1006,889,2020-03-18 07:17:00,1,2521.0,2039.0,0.809,12.188,388,82,28,54,306,276,30,0,0.0,0.0
1006,890,2020-03-18 07:20:00,1,3038.0,2430.0,0.8,14.66,111,24,11,13,87,79,8,0,0.0,0.0
1006,891,2020-03-18 07:23:00,1,2825.0,2253.0,0.798,13.624,31,12,4,8,19,18,1,0,0.0,0.0
1006,892,2020-03-18 07:26:00,1,2663.0,2143.0,0.805,12.863,7,7,3,4,0,0,0,0,0.0,0.0
1006,893,2020-03-18 07:29:00,1,2602.0,2027.0,0.779,12.497,4,4,1,3,0,0,0,0,0.0,0.0
1006,894,2020-03-18 07:32:00,1,2693.0,2070.0,0.769,12.902,0,0,0,0,0,0,0,0,0.0,0.0
1006,895,2020-03-18 07:35:00,1,2688.0,2066.0,0.769,12.877,0,0,0,0,0,0,0,0,0.0,0.0
1006,896,2020-03-18 07:38:00,1,2524.0,1995.0,0.79,12.153,6,2,1,1,4,4,0,0,0.0,0.0
1006,897,2020-03-18 07:41:00,1,2532.0,1992.0,0.787,12.18,17,9,4,5,8,8,0,0,0.0,0.0
1006,898,2020-03-18 07:44:00,1,2690.0,2080.0,0.773,12.901,23,23,0,23,0,0,0,0,0.0,0.0
1006,899,2020-03-18 07:47:00,1,2676.0,2091.0,0.782,12.857,101,31,10,21,70,64,6,0,0.0,0.0
1006,900,2020-03-18 07:50:00,1,2683.0,2076.0,0.774,12.871,9,9,1,8,0,0,0,0,0.0,0.0
1006,901,2020-03-18 07:53:00,1,2670.0,2092.0,0.784,12.836,24,1,0,1,23,21,2,0,0.0,0.0
1006,902,2020-03-18 07:56:00,1,2688.0,2061.0,0.767,12.874,325,8,1,7,317,284,33,0,0.0,0.0
1006,903,2020-03-18 07:59:00,1,2759.0,2120.0,0.768,13.217,98,25,6,19,73,66,7,0,0.0,0.0
1006,904,2020-03-18 08:02:00,1,2685.0,2077.0,0.774,12.879,20,18,2,16,2,2,0,0,0.0,0.0
1006,905,2020-03-18 08:05:00,1,2687.0,2048.0,0.7625,12.8545,6,6,0,6,0,0,0,0,0.0,0.0
1006,906,2020-03-18 08:08:00,1,2689.0,2019.0,0.751,12.83,32,18,12,6,14,13,1,0,0.0,0.0
1006,907,2020-03-18 08:11:00,1,2707.0,1984.0,0.733,12.861,2,2,2,0,0,0,0,0,0.0,0.0
1006,908,2020-03-18 08:14:00,1,2616.0,1969.0,0.752,12.488,83,2,0,2,81,74,7,0,0.0,0.0
1006,909,2020-03-18 08:17:00,1,2697.0,1993.0,0.739,12.835,131,27,14,13,104,97,7,0,0.0,0.0
1006,910,2020-03-18 08:20:00,1,2696.0,1982.0,0.735,12.818,116,43,22,21,73,55,18,6,0.35,0.02
1006,911,2020-03-18 08:23:00,1,3412.0,2693.0,0.789,16.426,432,182,128,54,250,204,46,17,0.09,0.02
1006,912,2020-03-18 08:26:00,1,3579.0,2793.0,0.78,17.193,550,195,149,46,355,303,52,33,0.02,0.0
1006,913,2020-03-18 08:29:00,1,3407.0,2713.0,0.796,16.429,63,21,6,15,42,37,5,0,0.0,0.0
1006,914,2020-03-18 08:32:00,1,3367.0,2584.0,0.767,16.129,278,48,24,24,230,213,17,8,0.0,0.01
1006,915,2020-03-18 08:35:00,1,3350.0,2630.0,0.785,16.11,378,118,81,37,260,232,28,16,0.0,0.0
1006,916,2020-03-18 08:38:00,1,3200.0,2499.0,0.781,15.377,424,150,111,39,274,233,41,5,0.31,0.18
1006,917,2020-03-18 08:41:00,1,2833.0,2217.0,0.782,13.618,65,11,2,9,54,32,22,0,0.0,0.0
1006,918,2020-03-18 08:44:00,1,2995.0,2279.0,0.761,14.324,95,25,5,20,70,54,16,0,0.0,0.0
1006,919,2020-03-18 08:47:00,1,3058.0,2354.0,0.77,14.657,244,3,0,3,241,221,20,0,0.0,0.0
1006,920,2020-03-18 08:50:00,1,3074.0,2318.0,0.754,14.678,21,4,2,2,17,14,3,0,0.0,0.0
1006,921,2020-03-18 08:53:00,1,2825.0,2225.0,0.788,13.594,5,2,0,2,3,2,1,0,0.0,0.0
1006,922,2020-03-18 08:56:00,1,2828.0,2201.0,0.778,13.578,6,0,0,0,6,6,0,0,0.0,0.0
1006,923,2020-03-18 08:59:00,1,2852.0,2130.0,0.747,13.597,17,5,4,1,12,10,2,1,0.0,0.0
1006,924,2020-03-18 09:02:00,1,2850.0,2173.0,0.763,13.635,187,173,145,28,14,13,1,0,0.0,0.0
1006,925,2020-03-18 09:05:00,1,2849.0,2107.0,0.739,13.557,3,3,0,3,0,0,0,0,0.0,0.0
1006,926,2020-03-18 09:08:00,1,2704.0,2002.0,0.74,12.869,46,43,23,20,3,2,1,0,0.0,0.0
1006,927,2020-03-18 09:11:00,1,2718.0,1950.0,0.718,12.87,317,5,2,3,312,284,28,0,0.0,0.0
1006,928,2020-03-18 09:14:00,1,2713.0,2000.0,0.737,12.904,92,15,9,6,77,73,4,0,0.0,0.0
1006,929,2020-03-18 09:17:00,1,2695.0,2031.0,0.754,12.866,0,0,0,0,0,0,0,0,0.0,0.0
1006,930,2020-03-18 09:20:00,1,2716.0,1976.0,0.728,12.888,28,0,0,0,28,24,4,0,0.0,0.0
1006,931,2020-03-18 09:23:00,1,2560.0,1897.0,0.741,12.187,101,5,1,4,96,83,13,0,0.0,0.0
1006,932,2020-03-18 09:26:00,1,2719.0,1964.0,0.723,12.887,6,2,2,0,4,3,1,0,0.0,0.0
1006,933,2020-03-18 09:29:00,1,2711.0,1978.0,0.73,12.871,3,0,0,0,3,0,3,0,0.0,0.0
1006,934,2020-03-18 09:32:00,1,2701.0,2040.0,0.755,12.901,26,4,3,1,22,20,2,0,0.0,0.0
1006,935,2020-03-18 09:35:00,1,2710.0,2000.0,0.738,12.892,94,13,8,5,81,77,4,1,0.0,0.0
1006,936,2020-03-18 09:38:00,1,2704.0,1998.0,0.739,12.866,11,11,1,10,0,0,0,0,0.0,0.0
1006,937,2020-03-18 09:41:00,1,2638.0,1944.0,0.737,12.546,9,4,1,3,5,4,1,0,0.0,0.0
1006,938,2020-03-18 09:44:00,1,2721.0,1954.0,0.718,12.884,42,5,3,2,37,32,5,0,0.0,0.0
1006,939,2020-03-18 09:47:00,1,2729.0,1960.0,0.718,12.925,257,4,0,4,253,234,19,0,0.0,0.0
1006,940,2020-03-18 09:50:00,1,2708.0,1942.0,0.717,12.819,89,35,15,20,54,49,5,5,0.0,0.0
1006,941,2020-03-18 09:53:00,1,3080.0,2297.0,0.746,14.678,159,33,12,21,126,111,15,8,0.0,0.0
1006,942,2020-03-18 09:56:00,1,3196.0,2502.0,0.783,15.361,337,99,67,32,238,217,21,22,0.05,0.0
1006,943,2020-03-18 09:59:00,1,4021.0,3101.0,0.771,19.276,425,130,92,38,295,259,36,20,0.0,0.0
1006,944,2020-03-18 10:02:00,1,3000.0,2261.0,0.754,14.321,428,171,124,47,257,231,26,7,0.06,0.0
1006,945,2020-03-18 10:05:00,1,3049.0,2367.0,0.776,14.635,791,213,154,59,578,535,43,0,0.0,0.0
1006,946,2020-03-18 10:08:00,1,3194.0,2552.0,0.799,15.409,832,326,246,80,506,447,59,6,0.0,0.0
1006,947,2020-03-18 10:11:00,1,3179.0,2572.0,0.809,15.372,180,35,21,14,145,129,16,6,0.0,0.0
1006,948,2020-03-18 10:14:00,1,3197.0,2570.0,0.804,15.443,207,32,16,16,175,157,18,1,0.0,0.0
1006,949,2020-03-18 10:17:00,1,3193.0,2575.0,0.806,15.433,148,7,2,5,141,127,14,0,0.0,0.0
1006,950,2020-03-18 10:20:00,1,2965.0,2391.0,0.807,14.329,21,12,6,6,9,9,0,0,0.0,0.0
1006,951,2020-03-18 10:23:00,1,2749.0,2239.0,0.814,13.308,8,1,1,0,7,6,1,0,0.0,0.0
1006,952,2020-03-18 10:26:00,1,2666.0,2172.0,0.815,12.908,1,0,0,0,1,0,1,0,0.0,0.0
1006,953,2020-03-18 10:29:00,1,2652.0,2193.0,0.827,12.876,206,0,0,0,206,186,20,0,0.0,0.0
1006,954,2020-03-18 10:32:00,1,2677.0,2112.0,0.789,12.887,184,0,0,0,184,168,16,0,0.0,0.0
1006,955,2020-03-18 10:35:00,1,2670.0,2131.0,0.798,12.879,5,2,0,2,3,1,2,0,0.0,0.0
1006,956,2020-03-18 10:38:00,1,2694.0,2055.0,0.763,12.89,22,18,0,18,4,0,4,0,0.0,0.0
1006,957,2020-03-18 10:41:00,1,2688.0,2073.0,0.771,12.885,1,0,0,0,1,0,1,0,0.0,0.0
1006,958,2020-03-18 10:44:00,1,2686.0,2047.0,0.762,12.85,47,16,5,11,31,27,4,0,0.0,0.0
1006,959,2020-03-18 10:47:00,1,2612.0,2011.0,0.77,12.516,14,5,1,4,9,9,0,0,0.0,0.0
1006,960,2020-03-18 10:50:00,1,2658.0,2106.0,0.792,12.806,58,28,14,14,30,28,2,0,0.0,0.0
1006,961,2020-03-18 10:53:00,1,2684.0,2029.0,0.756,12.823,33,24,12,12,9,8,1,0,0.0,0.0
1006,962,2020-03-18 10:56:00,1,2556.0,1874.0,0.733,12.146,39,9,4,5,30,23,7,0,0.0,0.0
1006,963,2020-03-18 10:59:00,1,2556.0,1876.0,0.734,12.148,35,24,19,5,11,8,3,0,0.0,0.0
1006,964,2020-03-18 11:02:00,1,2541.0,1912.0,0.752,12.128,7,0,0,0,7,0,7,0,0.0,0.0
1006,965,2020-03-18 11:05:00,1,2694.0,2036.0,0.7555,12.8675,43,20,7,13,23,20,3,4,0.0,0.0
1006,966,2020-03-18 11:08:00,1,2847.0,2160.0,0.759,13.607,63,21,14,7,42,38,4,2,0.0,0.0
1006,967,2020-03-18 11:11:00,1,2829.0,2175.0,0.769,13.557,188,95,46,49,93,82,11,4,0.0,0.0
1006,968,2020-03-18 11:14:00,1,3072.0,2326.0,0.757,14.679,398,172,127,45,226,189,37,50,0.0,0.0
1006,969,2020-03-18 11:17:00,1,3073.0,2325.0,0.757,14.681,951,410,303,107,541,466,75,4,0.0,0.0
1006,970,2020-03-18 11:20:00,1,3231.0,2380.0,0.737,15.364,1290,580,465,115,710,635,75,3,0.0,0.0
1006,971,2020-03-18 11:23:00,1,3218.0,2414.0,0.75,15.353,729,373,297,76,356,324,32,99,0.0,0.0
1006,972,2020-03-18 11:26:00,1,3224.0,2415.0,0.749,15.376,731,271,211,60,460,405,55,5,0.04,0.0
1006,973,2020-03-18 11:29:00,1,3241.0,2371.0,0.732,15.394,612,248,169,79,364,314,50,17,0.0,0.0
1006,974,2020-03-18 11:32:00,1,2931.0,2179.0,0.744,13.961,1017,439,342,97,578,491,87,4,0.0,0.0
1006,975,2020-03-18 11:35:00,1,3084.0,2313.0,0.75,14.711,167,69,33,36,98,79,19,0,0.0,0.0
1006,976,2020-03-18 11:38:00,1,3016.0,2241.0,0.743,14.363,192,100,54,46,92,82,10,0,0.0,0.0
1006,977,2020-03-18 11:41:00,1,2926.0,2202.0,0.752,13.967,48,7,4,3,41,34,7,2,0.0,0.0
1006,978,2020-03-18 11:44:00,1,2851.0,2151.0,0.754,13.616,127,88,46,42,39,32,7,0,0.0,0.0
1006,979,2020-03-18 11:47:00,1,2686.0,2062.0,0.768,12.866,66,36,24,12,30,22,8,0,0.0,0.0
1006,980,2020-03-18 11:50:00,1,2718.0,1952.0,0.718,12.872,17,17,6,11,0,0,0,0,0.0,0.0
1006,981,2020-03-18 11:53:00,1,2570.0,1855.0,0.722,12.18,16,16,6,10,0,0,0,0,0.0,0.0
1006,982,2020-03-18 11:56:00,1,2735.0,1897.0,0.694,12.877,11,8,1,7,3,2,1,0,0.0,0.0
1006,983,2020-03-18 11:59:00,1,2655.0,1870.0,0.704,12.531,14,11,2,9,3,0,3,0,0.0,0.0
1006,984,2020-03-18 12:02:00,1,2741.0,1878.0,0.685,12.88,49,25,12,13,24,19,5,0,0.0,0.0
1006,985,2020-03-18 12:05:00,1,2576.0,1833.0,0.711,12.18,8,1,0,1,7,4,3,0,0.0,0.0
1006,986,2020-03-18 12:08:00,1,2582.0,1777.0,0.688,12.14,7,0,0,0,7,2,5,0,0.0,0.0
1006,987,2020-03-18 12:11:00,1,2577.0,1791.0,0.695,12.136,7,0,0,0,7,2,5,0,0.0,0.0
1006,988,2020-03-18 12:14:00,1,2562.0,1859.0,0.726,12.154,5,1,1,0,4,0,4,0,0.0,0.0
1006,989,2020-03-18 12:17:00,1,2567.0,1856.0,0.723,12.17,2,2,0,2,0,0,0,0,0.0,0.0
1006,990,2020-03-18 12:20:00,1,2745.0,1877.0,0.684,12.894,9,9,0,9,0,0,0,0,0.0,0.0
1006,991,2020-03-18 12:23:00,1,2722.0,1922.0,0.706,12.853,0,0,0,0,0,0,0,0,0.0,0.0
1006,992,2020-03-18 12:26:00,1,2559.0,1847.0,0.722,12.129,2,0,0,0,2,0,2,0,0.0,0.0
1006,993,2020-03-18 12:29:00,1,2573.0,1793.0,0.697,12.122,6,2,0,2,4,3,1,0,0.0,0.0
1006,994,2020-03-18 12:32:00,1,2568.0,1828.0,0.712,12.144,5,0,0,0,5,3,2,0,0.0,0.0
1006,995,2020-03-18 12:35:00,1,2576.0,1840.0,0.714,12.186,28,7,3,4,21,17,4,0,0.0,0.0
1006,996,2020-03-18 12:38:00,1,2573.0,1857.0,0.722,12.194,29,13,8,5,16,13,3,0,0.0,0.0
1006,997,2020-03-18 12:41:00,1,2411.0,1731.0,0.718,11.416,23,14,9,5,9,7,2,0,0.0,0.0
1006,998,2020-03-18 12:44:00,1,2325.0,1707.0,0.734,11.051,6,3,1,2,3,1,2,0,0.0,0.0
1006,999,2020-03-18 12:47:00,1,2332.0,1730.0,0.742,11.104,2,0,0,0,2,0,2,0,0.0,0.0
1006,1000,2020-03-18 12:50:00,1,2503.0,1758.0,0.702,11.808,0,0,0,0,0,0,0,0,0.0,0.0
1006,1001,2020-03-18 12:53:00,1,2586.0,1799.0,0.696,12.18,31,4,2,2,27,25,2,0,0.0,0.0
1006,1002,2020-03-18 12:56:00,1,2713.0,1987.0,0.733,12.889,158,62,22,40,96,90,6,12,0.0,0.0
1006,1003,2020-03-18 12:59:00,1,2842.0,2127.0,0.748,13.554,184,36,13,23,148,130,18,1,0.0,0.0
1006,1004,2020-03-18 13:02:00,1,3083.0,2268.0,0.736,14.66,357,132,92,40,225,196,29,63,0.0,0.0
1006,1005,2020-03-18 13:05:00,1,2865.0,2099.0,0.732,13.612,937,370,286,84,567,510,57,11,0.0,0.0
1006,1006,2020-03-18 13:08:00,1,3073.0,2292.0,0.746,14.647,241,136,88,48,105,96,9,4,0.0,0.0
1006,1007,2020-03-18 13:11:00,1,3069.0,2311.0,0.753,14.651,85,51,20,31,34,33,1,0,0.0,0.0
1006,1008,2020-03-18 13:14:00,1,2830.0,2190.0,0.774,13.575,34,14,7,7,20,19,1,0,0.0,0.0
1006,1009,2020-03-18 13:17:00,1,2701.0,2019.0,0.747,12.876,5,0,0,0,5,5,0,0,0.0,0.0
1006,1010,2020-03-18 13:20:00,1,2574.0,1839.0,0.714,12.179,31,0,0,0,31,27,4,0,0.0,0.0
1006,1011,2020-03-18 13:23:00,1,2399.0,1786.0,0.745,11.43,17,7,3,4,10,9,1,0,0.0,0.0
1006,1012,2020-03-18 13:26:00,1,2567.0,1850.0,0.721,12.163,24,22,6,16,2,2,0,0,0.0,0.0
1006,1013,2020-03-18 13:29:00,1,2565.0,1813.0,0.707,12.114,5,5,3,2,0,0,0,0,0.0,0.0
1006,1014,2020-03-18 13:32:00,1,2565.0,1811.0,0.706,12.113,29,25,7,18,4,4,0,0,0.0,0.0
1006,1015,2020-03-18 13:35:00,1,2572.0,1831.0,0.712,12.161,0,0,0,0,0,0,0,0,0.0,0.0
1006,1016,2020-03-18 13:38:00,1,2574.0,1816.0,0.705,12.152,43,27,13,14,16,16,0,0,0.0,0.0
1006,1017,2020-03-18 13:41:00,1,2575.0,1803.0,0.7,12.142,0,0,0,0,0,0,0,0,0.0,0.0
1006,1018,2020-03-18 13:44:00,1,2584.0,1815.0,0.702,12.189,0,0,0,0,0,0,0,0,0.0,0.0
1006,1019,2020-03-18 13:47:00,1,2580.0,1787.0,0.693,12.146,39,12,5,7,27,26,1,0,0.0,0.0
1006,1020,2020-03-18 13:50:00,1,2579.0,1821.0,0.706,12.178,41,21,6,15,20,19,1,0,0.0,0.0
1006,1021,2020-03-18 13:53:00,1,2506.0,1735.0,0.692,11.796,132,79,41,38,53,51,2,1,0.0,0.0
1006,1022,2020-03-18 13:56:00,1,2720.0,1920.0,0.706,12.842,123,20,9,11,103,99,4,6,0.0,0.0
1006,1023,2020-03-18 13:59:00,1,2711.0,1973.0,0.728,12.868,62,29,6,23,33,28,5,0,0.0,0.0
1006,1024,2020-03-18 14:02:00,1,2780.0,2056.0,0.739,13.23,342,65,41,24,277,262,15,3,0.0,0.0
1006,1025,2020-03-18 14:05:00,1,2821.5,2078.5,0.7365,13.4175,97,15,2,13,82,74,8,1,0.0,0.0
1006,1026,2020-03-18 14:08:00,1,2863.0,2101.0,0.734,13.605,257,78,53,25,179,166,13,30,0.0,0.0
1006,1027,2020-03-18 14:11:00,1,3159.0,2345.0,0.742,15.044,324,107,71,36,217,188,29,34,0.0,0.06
1006,1028,2020-03-18 14:14:00,1,2704.0,1985.0,0.734,12.852,38,21,10,11,17,16,1,0,0.0,0.0
1006,1029,2020-03-18 14:17:00,1,2683.0,2034.0,0.758,12.825,18,7,5,2,11,11,0,0,0.0,0.0
1006,1030,2020-03-18 14:20:00,1,2699.0,2017.0,0.747,12.867,21,4,1,3,17,17,0,0,0.0,0.0
1006,1031,2020-03-18 14:23:00,1,2546.0,1932.0,0.759,12.172,9,2,2,0,7,7,0,0,0.0,0.0
1006,1032,2020-03-18 14:26:00,1,2566.0,1897.0,0.74,12.21,72,2,1,1,70,66,4,0,0.0,0.0
1006,1033,2020-03-18 14:29:00,1,2538.0,1959.0,0.772,12.168,0,0,0,0,0,0,0,0,0.0,0.0
1006,1034,2020-03-18 14:32:00,1,2618.0,1994.0,0.762,12.524,26,25,12,13,1,1,0,0,0.0,0.01
1006,1035,2020-03-18 14:35:00,1,2809.0,2269.0,0.808,13.582,234,88,50,38,146,141,5,3,0.0,0.01
1006,1036,2020-03-18 14:38:00,1,2887.0,2355.0,0.816,13.981,223,103,71,32,120,109,11,1,0.14,0.0
1006,1037,2020-03-18 14:41:00,1,2801.0,2309.0,0.824,13.591,32,24,14,10,8,8,0,0,0.0,0.0
1006,1038,2020-03-18 14:44:00,1,2643.0,2200.0,0.832,12.849,0,0,0,0,0,0,0,0,0.0,0.0
1006,1039,2020-03-18 14:47:00,1,2509.0,2065.0,0.823,12.174,28,11,6,5,17,15,2,0,0.0,0.0
1006,1040,2020-03-18 14:50:00,1,2512.0,2036.0,0.81,12.152,0,0,0,0,0,0,0,0,0.0,0.0
1006,1041,2020-03-18 14:53:00,1,2514.0,2040.0,0.811,12.165,25,3,0,3,22,20,2,0,0.0,0.0
1006,1042,2020-03-18 14:56:00,1,2527.0,2002.0,0.792,12.173,15,5,3,2,10,9,1,0,0.0,0.0
1006,1043,2020-03-18 14:59:00,1,2534.0,1990.0,0.785,12.188,10,10,1,9,0,0,0,0,0.0,0.0
1006,1044,2020-03-18 15:02:00,1,2525.0,1974.0,0.782,12.136,25,19,11,8,6,6,0,0,0.0,0.0
1006,1045,2020-03-18 15:05:00,1,2456.0,1924.0,0.783,11.806,197,0,0,0,197,177,20,0,0.0,0.0
1006,1046,2020-03-18 15:08:00,1,2511.0,2019.0,0.804,12.131,101,21,13,8,80,73,7,0,0.0,0.0
1006,1047,2020-03-18 15:11:00,1,2598.0,2020.0,0.778,12.472,15,5,0,5,10,9,1,0,0.0,0.0
1006,1048,2020-03-18 15:14:00,1,2820.0,2244.0,0.796,13.596,322,71,47,24,251,232,19,12,0.0,0.01
1006,1049,2020-03-18 15:17:00,1,2543.0,1957.0,0.77,12.185,39,36,23,13,3,3,0,1,0.0,0.01
1006,1050,2020-03-18 15:20:00,1,2526.0,1955.0,0.774,12.118,17,4,3,1,13,12,1,0,0.0,0.01
1006,1051,2020-03-18 15:23:00,1,2595.0,2047.0,0.789,12.489,272,0,0,0,272,248,24,0,0.0,0.0
1006,1052,2020-03-18 15:26:00,1,2676.0,2110.0,0.788,12.88,42,2,0,2,40,38,2,0,0.0,0.0
1006,1053,2020-03-18 15:29:00,1,2577.0,2084.0,0.809,12.46,22,0,0,0,22,19,3,0,0.0,0.0
1006,1054,2020-03-18 15:32:00,1,2513.0,2040.0,0.812,12.161,0,0,0,0,0,0,0,0,0.0,0.0
1006,1055,2020-03-18 15:35:00,1,2506.0,2081.0,0.831,12.177,0,0,0,0,0,0,0,0,0.0,0.0
1006,1056,2020-03-18 15:38:00,1,2661.0,2115.0,0.795,12.827,1,1,1,0,0,0,0,0,0.0,0.0
1006,1057,2020-03-18 15:41:00,1,2685.0,2081.0,0.775,12.885,0,0,0,0,0,0,0,0,0.0,0.0
1006,1058,2020-03-18 15:44:00,1,2508.0,2043.0,0.815,12.145,50,7,3,4,43,39,4,0,0.0,0.0
1006,1059,2020-03-18 15:47:00,1,2687.0,2115.0,0.787,12.928,254,104,54,50,150,134,16,3,0.0,0.0
1006,1060,2020-03-18 15:50:00,1,2832.0,2234.0,0.789,13.632,296,20,3,17,276,252,24,3,0.0,0.0
1006,1061,2020-03-18 15:53:00,1,2797.0,2313.0,0.827,13.582,141,63,19,44,78,73,5,1,0.0,0.0
1006,1062,2020-03-18 15:56:00,1,3209.0,2482.0,0.773,15.391,344,174,130,44,170,148,22,7,0.1,0.07
1006,1063,2020-03-18 15:59:00,1,2590.0,2047.0,0.79,12.471,772,275,196,79,497,458,39,18,0.0,0.0
1006,1064,2020-03-18 16:02:00,1,3054.0,2432.0,0.796,14.727,833,362,291,71,471,418,53,18,0.22,0.0
1006,1065,2020-03-18 16:05:00,1,3045.0,2430.0,0.798,14.689,661,318,254,64,343,317,26,5,0.0,0.0
1006,1066,2020-03-18 16:08:00,1,3107.0,2508.0,0.807,15.02,499,214,159,55,285,264,21,21,0.0,0.01
1006,1067,2020-03-18 16:11:00,1,3106.0,2526.0,0.813,15.034,338,30,5,25,308,279,29,0,0.0,0.0
1006,1068,2020-03-18 16:14:00,1,3105.0,2545.0,0.82,15.052,234,60,26,34,174,163,11,0,0.0,0.01
1006,1069,2020-03-18 16:17:00,1,2886.0,2378.0,0.824,14.004,25,25,0,25,0,0,0,0,0.0,0.0
1006,1070,2020-03-18 16:20:00,1,2658.0,2169.0,0.816,12.875,16,6,2,4,10,9,1,0,0.0,0.0
1006,1071,2020-03-18 16:23:00,1,2509.0,2052.0,0.818,12.157,40,27,8,19,13,12,1,0,0.0,0.0
1006,1072,2020-03-18 16:26:00,1,2448.0,1949.0,0.796,11.805,272,8,0,8,264,250,14,0,0.0,0.0
1006,1073,2020-03-18 16:29:00,1,2370.0,1902.0,0.803,11.443,342,0,0,0,342,309,33,0,0.0,0.0
1006,1074,2020-03-18 16:32:00,1,2456.0,1913.0,0.779,11.795,194,1,0,1,193,180,13,0,0.0,0.0
1006,1075,2020-03-18 16:35:00,1,2288.0,1890.0,0.826,11.107,22,6,3,3,16,15,1,0,0.0,0.0
1006,1076,2020-03-18 16:38:00,1,2548.0,1939.0,0.761,12.184,19,14,0,14,5,5,0,0,0.0,0.0
1006,1077,2020-03-18 16:41:00,1,2615.0,2024.0,0.774,12.546,25,18,11,7,7,7,0,0,0.0,0.0
1006,1078,2020-03-18 16:44:00,1,2606.0,2035.0,0.781,12.519,7,7,4,3,0,0,0,0,0.0,0.0
1006,1079,2020-03-18 16:47:00,1,2699.0,2040.0,0.756,12.891,3,0,0,0,3,3,0,0,0.0,0.0
1006,1080,2020-03-18 16:50:00,1,2677.0,2100.0,0.784,12.873,23,23,3,20,0,0,0,0,0.0,0.0
1006,1081,2020-03-18 16:53:00,1,2617.0,1997.0,0.763,12.524,66,57,3,54,9,9,0,0,0.0,0.0
1006,1082,2020-03-18 16:56:00,1,2683.0,2092.0,0.78,12.888,22,15,7,8,7,6,1,0,0.0,0.0
1006,1083,2020-03-18 16:59:00,1,2694.0,2048.0,0.76,12.882,3,1,0,1,2,1,1,0,0.0,0.0
1006,1084,2020-03-18 17:02:00,1,2764.0,2117.0,0.766,13.234,65,1,0,1,64,61,3,0,0.0,0.0
1006,1085,2020-03-18 17:05:00,1,2719.5,2103.0,0.7735,13.043,57,0,0,0,57,50,7,0,0.0,0.0
1006,1086,2020-03-18 17:08:00,1,2675.0,2089.0,0.781,12.852,46,21,13,8,25,23,2,3,0.0,0.0
1006,1087,2020-03-18 17:11:00,1,2839.0,2142.0,0.755,13.559,387,119,65,54,268,244,24,23,0.0,0.0
1006,1088,2020-03-18 17:14:00,1,3577.0,2762.0,0.772,17.153,315,84,61,23,231,204,27,6,0.0,0.09
1006,1089,2020-03-18 17:17:00,1,2697.0,2012.0,0.746,12.856,230,56,32,24,174,154,20,2,0.0,0.0
1006,1090,2020-03-18 17:20:00,1,3115.0,2449.0,0.786,14.985,115,90,55,35,25,25,0,0,0.0,0.0
1006,1091,2020-03-18 17:23:00,1,3167.0,2622.0,0.828,15.38,301,153,114,39,148,129,19,77,0.0,0.0
1006,1092,2020-03-18 17:26:00,1,3238.0,2692.0,0.831,15.74,432,176,143,33,256,212,44,160,0.0,0.01
1006,1093,2020-03-18 17:29:00,1,3610.0,3047.0,0.844,17.597,227,104,75,29,123,92,31,48,0.0,0.0
1006,1094,2020-03-18 17:32:00,1,3175.0,2630.0,0.828,15.42,119,27,15,12,92,38,54,1,0.0,0.0
1006,1095,2020-03-18 17:35:00,1,3233.0,2751.0,0.851,15.783,88,31,11,20,57,27,30,0,0.0,0.0
1006,1096,2020-03-18 17:38:00,1,3147.0,2720.0,0.864,15.409,78,40,21,19,38,11,27,0,0.0,0.0
1006,1097,2020-03-18 17:41:00,1,3087.0,2598.0,0.841,15.041,50,14,10,4,36,5,31,0,0.0,0.0
1006,1098,2020-03-18 17:44:00,1,2790.0,2375.0,0.851,13.622,38,13,0,13,25,0,25,0,0.0,0.0
1006,1099,2020-03-18 17:47:00,1,2644.0,2228.0,0.842,12.885,33,3,0,3,30,2,28,0,0.0,0.0
1006,1100,2020-03-18 17:50:00,1,2664.0,2156.0,0.809,12.885,33,2,0,2,31,2,29,0,0.0,0.0
1006,1101,2020-03-18 17:53:00,1,2663.0,2122.0,0.797,12.842,60,9,4,5,51,10,41,0,0.0,0.0
1006,1102,2020-03-18 17:56:00,1,2673.0,2138.0,0.8,12.898,43,0,0,0,43,8,35,0,0.0,0.0
1006,1103,2020-03-18 17:59:00,1,2666.0,2149.0,0.806,12.881,59,10,1,9,49,16,33,0,0.0,0.0
1006,1104,2020-03-18 18:02:00,0,2797.0,2254.0,0.806,13.517,70,0,0,0,70,30,40,2,0.0,0.0
1006,1105,2020-03-18 18:05:00,0,2817.0,2246.0,0.797,13.584,78,26,15,11,52,19,33,0,0.0,0.0
1006,1106,2020-03-18 18:08:00,0,2802.0,2307.0,0.823,13.594,71,33,15,18,38,16,22,1,0.0,0.0
1006,1107,2020-03-18 18:11:00,0,3037.0,2451.0,0.807,14.681,87,15,2,13,72,36,36,0,0.0,0.0
1006,1108,2020-03-18 18:14:00,0,3335.0,2667.0,0.8,16.092,675,301,239,62,374,315,59,110,0.0,0.0
1006,1109,2020-03-18 18:17:00,0,3423.0,2692.0,0.786,16.467,418,146,101,45,272,254,18,55,0.17,0.0
1006,1110,2020-03-18 18:20:00,0,3191.0,2570.0,0.805,15.419,1,1,0,1,0,0,0,0,0.0,0.0
1006,1111,2020-03-18 18:23:00,0,3046.0,2428.0,0.797,14.689,227,45,24,21,182,165,17,3,0.0,0.0
1006,1112,2020-03-18 18:26:00,0,3209.0,2482.0,0.774,15.391,337,142,88,54,195,182,13,3,0.0,0.0
1006,1113,2020-03-18 18:29:00,0,3269.0,2603.0,0.796,15.76,361,116,79,37,245,223,22,5,0.0,0.0
1006,1114,2020-03-18 18:32:00,0,3575.0,2813.0,0.787,17.199,342,76,44,32,266,250,16,49,0.0,0.14
1006,1115,2020-03-18 18:35:00,0,3053.0,2376.0,0.778,14.659,545,246,198,48,299,255,44,162,0.0,0.0
1006,1116,2020-03-18 18:38:00,0,3557.0,2813.0,0.791,17.13,713,273,221,52,440,391,49,136,0.0,0.0
1006,1117,2020-03-18 18:41:00,0,3694.0,3030.0,0.82,17.91,565,221,176,45,344,279,65,49,0.06,0.01
1006,1118,2020-03-18 18:44:00,0,3186.0,2592.0,0.814,15.423,563,128,100,28,435,393,42,19,0.0,0.0
1006,1119,2020-03-18 18:47:00,0,3398.0,2780.0,0.818,16.465,0,0,0,0,0,0,0,0,0.0,0.0
1006,1120,2020-03-18 18:50:00,0,3327.0,2724.0,0.819,16.125,18,5,1,4,13,12,1,0,0.0,0.0
1006,1121,2020-03-18 18:53:00,0,3163.0,2646.0,0.836,15.392,131,15,0,15,116,107,9,0,0.0,0.0
1006,1122,2020-03-18 18:56:00,0,3018.0,2559.0,0.848,14.725,8,3,1,2,5,4,1,0,0.0,0.0
1006,1123,2020-03-18 18:59:00,0,3096.0,2598.0,0.839,15.074,16,5,1,4,11,11,0,0,0.0,0.0
1006,1124,2020-03-18 19:02:00,0,3171.0,2621.0,0.826,15.398,19,7,4,3,12,11,1,0,0.0,0.0
1006,1125,2020-03-18 19:05:00,0,3006.0,2572.0,0.856,14.691,293,73,52,21,220,202,18,32,0.0,0.03
1006,1126,2020-03-18 19:08:00,0,3449.0,2933.0,0.85,16.837,401,101,57,44,300,272,28,49,0.26,0.13
1006,1127,2020-03-18 19:11:00,0,2936.0,2476.0,0.843,14.311,256,29,12,17,227,203,24,6,0.0,0.0
1006,1128,2020-03-18 19:14:00,0,3373.0,2883.0,0.855,16.482,153,61,18,43,92,84,8,18,0.0,0.0
1006,1129,2020-03-18 19:17:00,0,3432.0,2996.0,0.873,16.84,400,111,67,44,289,255,34,53,0.0,0.0
1006,1130,2020-03-18 19:20:00,0,3501.0,3087.0,0.882,17.212,575,189,136,53,386,337,49,88,0.0,0.1
1006,1131,2020-03-18 19:23:00,0,3495.0,3094.0,0.885,17.196,524,161,111,50,363,311,52,13,0.16,0.0
1006,1132,2020-03-18 19:26:00,0,3343.0,2965.0,0.887,16.453,263,81,55,26,182,168,14,23,0.0,0.0
1006,1133,2020-03-18 19:29:00,0,3129.0,2794.0,0.893,15.421,208,36,10,26,172,155,17,0,0.0,0.0
1006,1134,2020-03-18 19:32:00,0,3421.0,3007.0,0.879,16.809,128,16,3,13,112,102,10,0,0.0,0.0
1006,1135,2020-03-18 19:35:00,0,3283.0,2872.0,0.875,16.114,8,0,0,0,8,8,0,0,0.0,0.0
1006,1136,2020-03-18 19:38:00,0,3069.0,2672.0,0.87,15.052,5,0,0,0,5,5,0,0,0.0,0.0
1006,1137,2020-03-18 19:41:00,0,3018.0,2582.0,0.855,14.749,15,5,1,4,10,10,0,0,0.0,0.0
1006,1138,2020-03-18 19:44:00,0,2755.0,2499.0,0.907,13.622,33,14,1,13,19,18,1,0,0.0,0.0
1006,1139,2020-03-18 19:47:00,0,2767.0,2435.0,0.88,13.599,55,24,12,12,31,27,4,0,0.0,0.0
1006,1140,2020-03-18 19:50:00,0,2775.0,2454.0,0.884,13.653,0,0,0,0,0,0,0,0,0.0,0.0
1006,1141,2020-03-18 19:53:00,0,3010.0,2545.0,0.846,14.679,271,98,54,44,173,165,8,58,0.0,0.03
1006,1142,2020-03-18 19:56:00,0,3353.0,2909.0,0.868,16.429,310,117,69,48,193,171,22,45,0.0,0.13
1006,1143,2020-03-18 19:59:00,0,2933.0,2521.0,0.859,14.348,39,28,6,22,11,10,1,0,0.0,0.0
1006,1144,2020-03-18 20:02:00,0,3147.0,2741.0,0.871,15.435,110,30,3,27,80,73,7,0,0.0,0.0
1006,1145,2020-03-18 20:05:00,0,3171.0,2795.0,0.8815,15.588,236,95,36,59,141,131,10,5,0.0,0.0
1006,1146,2020-03-18 20:08:00,0,3195.0,2849.0,0.892,15.741,319,24,7,17,295,271,24,2,0.0,0.0
1006,1147,2020-03-18 20:11:00,0,3412.0,3063.0,0.898,16.833,362,132,97,35,230,193,37,82,0.25,0.0
1006,1148,2020-03-18 20:14:00,0,3345.0,3024.0,0.904,16.528,524,185,151,34,339,306,33,99,0.0,0.0
1006,1149,2020-03-18 20:17:00,0,3610.0,3264.0,0.904,17.838,603,151,97,54,452,398,54,61,0.05,0.06
1006,1150,2020-03-18 20:20:00,0,2922.0,2555.0,0.874,14.343,324,113,76,37,211,168,43,13,0.0,0.0
1006,1151,2020-03-18 20:23:00,0,3059.0,2705.0,0.884,15.047,235,79,50,29,156,89,67,49,0.0,0.0
1006,1152,2020-03-18 20:26:00,0,3124.0,2796.0,0.895,15.405,124,22,7,15,102,40,62,0,0.0,0.0
1006,1153,2020-03-18 20:29:00,0,3489.0,3125.0,0.896,17.207,134,20,9,11,114,43,71,0,0.0,0.01
1006,1154,2020-03-18 20:32:00,0,3410.0,3093.0,0.907,16.858,33,6,1,5,27,0,27,0,0.0,0.0
1006,1155,2020-03-18 20:35:00,0,3102.0,2905.0,0.937,15.437,23,9,1,8,14,0,14,0,0.0,0.0
1006,1156,2020-03-18 20:38:00,0,3137.0,2764.0,0.881,15.42,37,15,0,15,22,4,18,0,0.0,0.0
1006,1157,2020-03-18 20:41:00,0,2982.0,2630.0,0.882,14.662,173,3,1,2,170,140,30,0,0.0,0.0
1006,1158,2020-03-18 20:44:00,0,2976.0,2656.0,0.893,14.665,15,2,0,2,13,0,13,0,0.0,0.0
1006,1159,2020-03-18 20:47:00,0,3001.0,2597.0,0.865,14.699,20,7,1,6,13,5,8,0,0.0,0.0
1006,1160,2020-03-18 20:50:00,0,2994.0,2621.0,0.875,14.7,51,19,10,9,32,16,16,0,0.0,0.0
1006,1161,2020-03-18 20:53:00,0,2770.0,2475.0,0.893,13.655,53,2,0,2,51,16,35,0,0.0,0.0
1006,1162,2020-03-18 20:56:00,0,2740.0,2505.0,0.914,13.568,46,0,0,0,46,2,44,0,0.0,0.0
1006,1163,2020-03-18 20:59:00,0,2743.0,2534.0,0.924,13.615,79,11,7,4,68,26,42,0,0.0,0.0
1006,1164,2020-03-18 21:02:00,0,2827.0,2574.0,0.911,13.989,126,32,11,21,94,56,38,0,0.0,0.0
1006,1165,2020-03-18 21:05:00,0,2982.0,2670.0,0.895,14.705,348,25,3,22,323,258,65,1,0.0,0.0
1006,1166,2020-03-18 21:08:00,0,3113.0,2792.0,0.897,15.356,266,88,47,41,178,145,33,20,0.0,0.0
1006,1167,2020-03-18 21:11:00,0,3477.0,3150.0,0.906,17.188,397,102,67,35,295,251,44,47,0.13,0.13
1006,1168,2020-03-18 21:14:00,0,3100.0,2881.0,0.929,15.401,417,189,144,45,228,189,39,100,0.0,0.0
1006,1169,2020-03-18 21:17:00,0,3461.0,3217.0,0.929,17.199,593,306,233,73,287,215,72,59,0.0,0.0
1006,1170,2020-03-18 21:20:00,0,3187.0,2894.0,0.908,15.759,115,69,33,36,46,27,19,3,0.07,0.0
1006,1171,2020-03-18 21:23:00,0,2990.0,2615.0,0.875,14.676,89,36,4,32,53,30,23,0,0.0,0.0
1006,1172,2020-03-18 21:26:00,0,3481.0,3140.0,0.902,17.192,82,21,3,18,61,56,5,0,0.0,0.0
1006,1173,2020-03-18 21:29:00,0,3329.0,3016.0,0.906,16.455,2,2,0,2,0,0,0,0,0.0,0.0
1006,1174,2020-03-18 21:32:00,0,3116.0,2843.0,0.913,15.424,15,12,7,5,3,3,0,0,0.0,0.0
1006,1175,2020-03-18 21:35:00,0,2966.0,2674.0,0.901,14.647,18,12,7,5,6,6,0,0,0.0,0.0
1006,1176,2020-03-18 21:38:00,0,3002.0,2613.0,0.87,14.722,83,17,10,7,66,61,5,0,0.0,0.0
1006,1177,2020-03-18 21:41:00,0,2970.0,2682.0,0.903,14.669,18,18,1,17,0,0,0,0,0.0,0.0
1006,1178,2020-03-18 21:44:00,0,2983.0,2643.0,0.886,14.68,20,10,2,8,10,8,2,0,0.0,0.0
1006,1179,2020-03-18 21:47:00,0,2830.0,2560.0,0.904,13.986,2,2,0,2,0,0,0,0,0.0,0.0
1006,1180,2020-03-18 21:50:00,0,2754.0,2521.0,0.915,13.641,11,8,0,8,3,3,0,0,0.0,0.0
1006,1181,2020-03-18 21:53:00,0,3135.0,2774.0,0.885,15.423,338,131,85,46,207,188,19,60,0.13,0.1
1006,1182,2020-03-18 21:56:00,0,3151.0,2719.0,0.863,15.425,299,78,39,39,221,194,27,12,0.0,0.02
1006,1183,2020-03-18 21:59:00,0,3118.0,2827.0,0.907,15.414,689,84,44,40,605,546,59,11,0.0,0.0
1006,1184,2020-03-18 22:02:00,0,3461.0,3258.0,0.941,17.244,360,128,103,25,232,209,23,77,0.0,0.0
1006,1185,2020-03-18 22:05:00,0,3338.0,3018.0,0.904,16.491,90,33,16,17,57,51,6,23,0.0,0.27
1006,1186,2020-03-18 22:08:00,0,2912.0,2603.0,0.894,14.354,256,105,65,40,151,120,31,2,0.0,0.0
1006,1187,2020-03-18 22:11:00,0,2981.0,2638.0,0.885,14.664,110,37,21,16,73,64,9,4,0.0,0.0
1006,1188,2020-03-18 22:14:00,0,3179.0,2926.0,0.92,15.764,10,10,1,9,0,0,0,0,0.0,0.0
1006,1189,2020-03-18 22:17:00,0,3177.0,2937.0,0.924,15.769,178,19,10,9,159,150,9,0,0.0,0.0
1006,1190,2020-03-18 22:20:00,0,3120.0,2828.0,0.906,15.424,1003,5,3,2,998,909,89,0,0.0,0.0
1006,1191,2020-03-18 22:23:00,0,3113.0,2798.0,0.899,15.362,192,6,5,1,186,171,15,0,0.0,0.0
1006,1192,2020-03-18 22:26:00,0,3047.0,2746.0,0.901,15.044,21,19,5,14,2,2,0,0,0.0,0.0
1006,1193,2020-03-18 22:29:00,0,3115.0,2761.0,0.886,15.329,261,87,64,23,174,157,17,8,0.34,0.0
1006,1194,2020-03-18 22:32:00,0,3197.0,2922.0,0.914,15.83,475,240,167,73,235,186,49,71,0.0,0.0
1006,1195,2020-03-18 22:35:00,0,3309.0,3092.0,0.934,16.459,464,190,147,43,274,235,39,111,0.0,0.01
1006,1196,2020-03-18 22:38:00,0,3322.0,3083.0,0.928,16.503,430,142,110,32,288,235,53,35,0.0,0.05
1006,1197,2020-03-18 22:41:00,0,3318.0,3065.0,0.924,16.466,451,178,127,51,273,221,52,21,0.0,0.0
1006,1198,2020-03-18 22:44:00,0,2990.0,2647.0,0.885,14.713,144,59,28,31,85,61,24,5,0.0,0.0
1006,1199,2020-03-18 22:47:00,0,3329.0,3036.0,0.912,16.478,166,43,10,33,123,91,32,4,0.0,0.0
1006,1200,2020-03-18 22:50:00,0,3359.0,2955.0,0.88,16.506,44,14,1,13,30,27,3,0,0.0,0.0
1006,1201,2020-03-18 22:53:00,0,3169.0,2900.0,0.915,15.696,18,6,2,4,12,8,4,0,0.0,0.0
1006,1202,2020-03-18 22:56:00,0,3102.0,2878.0,0.928,15.409,11,0,0,0,11,4,7,0,0.0,0.0
1006,1203,2020-03-18 22:59:00,0,3116.0,2818.0,0.904,15.396,83,26,15,11,57,47,10,0,0.0,0.0
1006,1204,2020-03-18 23:02:00,0,3117.0,2873.0,0.922,15.462,125,20,2,18,105,91,14,0,0.0,0.0
1006,1205,2020-03-18 23:05:00,0,3124.5,2842.0,0.91,15.457,39,12,1,11,27,18,9,0,0.0,0.0
1006,1206,2020-03-18 23:08:00,0,3132.0,2811.0,0.898,15.452,5,1,1,0,4,0,4,0,0.0,0.0
1006,1207,2020-03-18 23:11:00,0,3061.0,2740.0,0.895,15.093,54,15,0,15,39,27,12,0,0.0,0.0
1006,1208,2020-03-18 23:14:00,0,3136.0,2777.0,0.886,15.43,115,38,21,17,77,58,19,1,0.0,0.0
1006,1209,2020-03-18 23:17:00,0,3120.0,2845.0,0.912,15.443,430,91,41,50,339,270,69,18,0.0,0.0
1006,1210,2020-03-18 23:20:00,0,3321.0,3001.0,0.904,16.406,64,25,3,22,39,13,26,8,0.0,0.0
1006,1211,2020-03-18 23:23:00,0,3488.0,3102.0,0.889,17.177,456,49,8,41,407,334,73,9,0.0,0.0
1006,1212,2020-03-18 23:26:00,0,3596.0,3319.0,0.923,17.843,771,248,184,64,523,426,97,95,0.0,0.03
1006,1213,2020-03-18 23:29:00,0,3467.0,3154.0,0.91,17.153,280,88,53,35,192,146,46,57,0.0,0.01
1006,1214,2020-03-18 23:32:00,0,3856.0,3444.0,0.893,19.007,752,245,190,55,507,415,92,133,0.0,0.07
1006,1215,2020-03-18 23:35:00,0,3993.0,3564.0,0.892,19.679,618,193,145,48,425,341,84,17,0.0,0.0
1006,1216,2020-03-18 23:38:00,0,3636.0,3293.0,0.906,17.972,477,161,108,53,316,246,70,43,0.0,0.0
1006,1217,2020-03-18 23:41:00,0,3290.0,2896.0,0.88,16.169,522,149,115,34,373,280,93,105,0.0,0.0
1006,1218,2020-03-18 23:44:00,0,3697.0,3340.0,0.903,18.266,378,130,87,43,248,180,68,17,0.0,0.0
1006,1219,2020-03-18 23:47:00,0,3606.0,3275.0,0.908,17.833,309,137,101,36,172,127,45,70,0.0,0.0
1006,1220,2020-03-18 23:50:00,0,3374.0,2932.0,0.869,16.538,505,179,128,51,326,234,92,55,0.29,0.0
1006,1221,2020-03-18 23:53:00,0,2790.0,2384.0,0.855,13.631,239,66,36,30,173,109,64,6,0.0,0.0
1006,1222,2020-03-18 23:56:00,0,2982.0,2623.0,0.88,14.653,111,22,11,11,89,25,64,3,0.0,0.01
1006,1223,2020-03-18 23:59:00,0,3149.0,2717.0,0.863,15.415,166,23,17,6,143,84,59,0,0.0,0.0
1006,1224,2020-03-19 00:02:00,0,3493.0,3093.0,0.886,17.188,38,0,0,0,38,7,31,0,0.0,0.0
1006,1225,2020-03-19 00:05:00,0,3341.0,2992.0,0.896,16.476,25,4,3,1,21,16,5,0,0.0,0.0
1006,1226,2020-03-19 00:08:00,0,3098.0,2831.0,0.914,15.339,21,7,4,3,14,8,6,0,0.0,0.0
1006,1227,2020-03-19 00:11:00,0,2973.0,2657.0,0.893,14.657,19,5,2,3,14,6,8,0,0.0,0.0
1006,1228,2020-03-19 00:14:00,0,2602.0,2375.0,0.913,12.88,0,0,0,0,0,0,0,0,0.0,0.0
1006,1229,2020-03-19 00:17:00,0,2501.0,2113.0,0.845,12.195,5,5,0,5,0,0,0,0,0.0,0.0
1006,1230,2020-03-19 00:20:00,0,2350.0,1997.0,0.85,11.469,6,4,0,4,2,0,2,0,0.0,0.0
1006,1231,2020-03-19 00:23:00,0,2357.0,1984.0,0.842,11.483,8,5,1,4,3,0,3,0,0.0,0.0
1006,1232,2020-03-19 00:26:00,0,2630.0,2231.0,0.848,12.834,39,26,7,19,13,4,9,0,0.0,0.0
1006,1233,2020-03-19 00:29:00,0,3424.0,3036.0,0.887,16.852,312,91,48,43,221,141,80,48,0.0,0.05
1006,1234,2020-03-19 00:32:00,0,3850.0,3491.0,0.907,19.035,503,195,143,52,308,240,68,131,0.07,0.03
1006,1235,2020-03-19 00:35:00,0,3767.0,3394.0,0.901,18.599,465,175,129,46,290,221,69,100,0.0,0.0
1006,1236,2020-03-19 00:38:00,0,3122.0,2804.0,0.898,15.405,470,148,115,33,322,236,86,135,0.0,0.0
1006,1237,2020-03-19 00:41:00,0,3831.0,3506.0,0.915,18.977,492,166,125,41,326,247,79,32,0.0,0.07
1006,1238,2020-03-19 00:44:00,0,3843.0,3494.0,0.909,19.011,385,150,102,48,235,156,79,21,0.0,0.02
1006,1239,2020-03-19 00:47:00,0,3266.0,2919.0,0.894,16.098,459,201,143,58,258,188,70,57,0.0,0.01
1006,1240,2020-03-19 00:50:00,0,3625.0,3322.0,0.916,17.961,483,194,149,45,289,214,75,107,0.0,0.0
1006,1241,2020-03-19 00:53:00,0,3626.0,3245.0,0.895,17.877,227,36,15,21,191,113,78,12,0.0,0.0
1006,1242,2020-03-19 00:56:00,0,3698.0,3348.0,0.905,18.277,317,77,35,42,240,167,73,7,0.0,0.0
1006,1243,2020-03-19 00:59:00,0,3692.0,3334.0,0.903,18.239,218,39,19,20,179,106,73,1,0.0,0.0
1006,1244,2020-03-19 01:02:00,0,3648.0,3219.0,0.882,17.939,117,46,28,18,71,32,39,0,0.0,0.0
1006,1245,2020-03-19 01:05:00,0,3490.0,3127.0,0.896,17.213,137,50,23,27,87,37,50,0,0.0,0.0
1006,1246,2020-03-19 01:08:00,0,3333.0,3006.0,0.902,16.458,253,64,29,35,189,120,69,7,0.0,0.0
1006,1247,2020-03-19 01:11:00,0,3341.0,2971.0,0.889,16.452,421,138,107,31,283,204,79,9,0.06,0.0
1006,1248,2020-03-19 01:14:00,0,3334.0,3008.0,0.902,16.467,295,116,77,39,179,136,43,16,0.04,0.0
1006,1249,2020-03-19 01:17:00,0,3482.0,3123.0,0.897,17.178,415,113,68,45,302,214,88,67,0.0,0.04
1006,1250,2020-03-19 01:20:00,0,2779.0,2397.0,0.863,13.604,277,111,56,55,166,100,66,3,0.0,0.02
1006,1251,2020-03-19 01:23:00,0,3147.0,2689.0,0.855,15.378,180,83,41,42,97,44,53,0,0.0,0.0
1006,1252,2020-03-19 01:26:00,0,3358.0,2919.0,0.869,16.461,50,1,0,1,49,2,47,0,0.0,0.0
1006,1253,2020-03-19 01:29:00,0,3145.0,2764.0,0.879,15.451,42,0,0,0,42,8,34,0,0.0,0.0
1006,1254,2020-03-19 01:32:00,0,2995.0,2599.0,0.868,14.678,58,10,2,8,48,2,46,0,0.0,0.0
1006,1255,2020-03-19 01:35:00,0,2830.0,2497.0,0.883,13.913,67,20,6,14,47,4,43,0,0.0,0.0
1006,1256,2020-03-19 01:38:00,0,2783.0,2393.0,0.86,13.616,37,6,1,5,31,2,29,0,0.0,0.0
1006,1257,2020-03-19 01:41:00,0,2786.0,2343.0,0.841,13.572,57,8,1,7,49,2,47,0,0.0,0.0
1006,1258,2020-03-19 01:44:00,0,2700.0,2341.0,0.867,13.23,64,18,11,7,46,8,38,0,0.0,0.0
1006,1259,2020-03-19 01:47:00,0,2774.0,2416.0,0.871,13.606,52,3,2,1,49,7,42,0,0.0,0.0
1006,1260,2020-03-19 01:50:00,0,3025.0,2524.0,0.834,14.712,137,40,18,22,97,47,50,3,0.0,0.0
1006,1261,2020-03-19 01:53:00,0,3141.0,2741.0,0.873,15.409,214,84,38,46,130,78,52,34,0.0,0.02
1006,1262,2020-03-19 01:56:00,0,3726.0,3215.0,0.863,18.242,344,111,65,46,233,162,71,69,0.13,0.08
1006,1263,2020-03-19 01:59:00,0,3299.0,2838.0,0.86,16.139,550,243,193,50,307,236,71,88,0.23,0.0
1006,1264,2020-03-19 02:02:00,0,3349.0,2944.0,0.879,16.454,310,136,103,33,174,126,48,7,0.0,0.0
1006,1265,2020-03-19 02:05:00,0,3237.0,2870.0,0.887,15.931,50,7,5,2,43,6,37,0,0.0,0.0
1006,1266,2020-03-19 02:08:00,0,3125.0,2796.0,0.895,15.408,44,0,0,0,44,2,42,0,0.0,0.0
1006,1267,2020-03-19 02:11:00,0,3067.0,2676.0,0.873,15.049,52,0,0,0,52,12,40,0,0.0,0.0
1006,1268,2020-03-19 02:14:00,0,2999.0,2613.0,0.871,14.709,57,0,0,0,57,10,47,0,0.0,0.0
1006,1269,2020-03-19 02:17:00,0,2835.0,2512.0,0.886,13.949,50,4,2,2,46,7,39,0,0.0,0.0
1006,1270,2020-03-19 02:20:00,0,2931.0,2559.0,0.873,14.38,55,12,1,11,43,0,43,0,0.0,0.0
1006,1271,2020-03-19 02:23:00,0,2773.0,2449.0,0.883,13.638,43,2,0,2,41,3,38,0,0.0,0.0
1006,1272,2020-03-19 02:26:00,0,2697.0,2395.0,0.888,13.279,60,11,8,3,49,9,40,2,0.0,0.0
1006,1273,2020-03-19 02:29:00,0,2705.0,2389.0,0.883,13.302,40,0,0,0,40,0,40,0,0.0,0.0
1006,1274,2020-03-19 02:32:00,0,2767.0,2420.0,0.874,13.581,45,2,2,0,43,6,37,0,0.0,0.0
1006,1275,2020-03-19 02:35:00,0,2648.0,2207.0,0.833,12.875,122,43,25,18,79,41,38,5,0.0,0.0
1006,1276,2020-03-19 02:38:00,0,2796.0,2387.0,0.854,13.659,104,19,0,19,85,43,42,4,0.0,0.0
1006,1277,2020-03-19 02:41:00,0,2747.0,2461.0,0.896,13.547,91,34,12,22,57,25,32,0,0.0,0.0
1006,1278,2020-03-19 02:44:00,0,3150.0,2667.0,0.847,15.364,212,67,36,31,145,94,51,44,0.0,0.05
1006,1279,2020-03-19 02:47:00,0,3070.0,2667.0,0.869,15.049,362,169,123,46,193,131,62,50,0.0,0.02
1006,1280,2020-03-19 02:50:00,0,3211.0,2793.0,0.87,15.744,472,237,172,65,235,172,63,23,0.0,0.06
1006,1281,2020-03-19 02:53:00,0,3199.0,2851.0,0.891,15.76,439,155,117,38,284,208,76,83,0.04,0.0
1006,1282,2020-03-19 02:56:00,0,2754.0,2444.0,0.887,13.555,309,106,71,35,203,149,54,10,0.0,0.0
1006,1283,2020-03-19 02:59:00,0,3059.0,2651.0,0.867,14.989,163,85,61,24,78,45,33,62,0.05,0.0
1006,1284,2020-03-19 03:02:00,0,3151.0,2669.0,0.847,15.37,215,72,47,25,143,109,34,82,0.0,0.0
1006,1285,2020-03-19 03:05:00,0,3561.0,3145.0,0.883,17.512,219,70,36,34,149,86,63,45,0.0,0.04
1006,1286,2020-03-19 03:08:00,0,2762.0,2429.0,0.88,13.572,109,62,26,36,47,16,31,5,0.0,0.0
1006,1287,2020-03-19 03:11:00,0,3064.0,2617.0,0.854,14.969,63,16,6,10,47,17,30,0,0.0,0.0
1006,1288,2020-03-19 03:14:00,0,3501.0,3090.0,0.883,17.213,65,12,2,10,53,19,34,0,0.0,0.0
1006,1289,2020-03-19 03:17:00,0,3364.0,2947.0,0.876,16.518,39,3,2,1,36,10,26,0,0.0,0.0
1006,1290,2020-03-19 03:20:00,0,3143.0,2726.0,0.867,15.403,43,10,5,5,33,0,33,0,0.0,0.0
1006,1291,2020-03-19 03:23:00,0,3011.0,2569.0,0.853,14.707,48,18,3,15,30,0,30,0,0.0,0.01
1006,1292,2020-03-19 03:26:00,0,2985.0,2647.0,0.887,14.69,60,24,8,16,36,0,36,0,0.0,0.0
1006,1293,2020-03-19 03:29:00,0,3078.0,2654.0,0.862,15.066,55,10,1,9,45,0,45,0,0.0,0.0
1006,1294,2020-03-19 03:32:00,0,2997.0,2591.0,0.865,14.677,56,13,7,6,43,0,43,0,0.0,0.0
1006,1295,2020-03-19 03:35:00,0,3020.0,2534.0,0.839,14.703,69,16,7,9,53,0,53,0,0.0,0.0
1006,1296,2020-03-19 03:38:00,0,2989.0,2554.0,0.855,14.606,81,13,5,8,68,8,60,0,0.0,0.0
1006,1297,2020-03-19 03:41:00,0,3018.0,2515.0,0.833,14.676,112,46,32,14,66,17,49,0,0.0,0.0
1006,1298,2020-03-19 03:44:00,0,2795.0,2357.0,0.843,13.621,46,9,4,5,37,4,33,0,0.0,0.0
1006,1299,2020-03-19 03:47:00,0,2803.0,2316.0,0.826,13.608,53,9,6,3,44,16,28,0,0.0,0.0
1006,1300,2020-03-19 03:50:00,0,2788.0,2356.0,0.845,13.594,81,25,11,14,56,16,40,0,0.0,0.0
1006,1301,2020-03-19 03:53:00,0,2798.0,2372.0,0.847,13.651,93,4,2,2,89,43,46,0,0.0,0.0
1006,1302,2020-03-19 03:56:00,0,2730.0,2254.0,0.825,13.253,100,23,6,17,77,26,51,3,0.0,0.0
1006,1303,2020-03-19 03:59:00,0,3044.0,2404.0,0.79,14.657,145,47,10,37,98,41,57,12,0.0,0.0
1006,1304,2020-03-19 04:02:00,0,3174.0,2593.0,0.817,15.376,178,55,23,32,123,71,52,5,0.0,0.0
1006,1305,2020-03-19 04:05:00,0,3400.0,2820.0,0.829,16.517,285,88,51,37,197,135,62,60,0.13,0.08
1006,1306,2020-03-19 04:08:00,0,2778.0,2369.0,0.853,13.57,144,63,37,26,81,36,45,2,0.0,0.01
1006,1307,2020-03-19 04:11:00,0,3316.0,2757.0,0.831,16.119,70,30,17,13,40,19,21,1,0.0,0.0
1006,1308,2020-03-19 04:14:00,0,3229.0,2735.0,0.847,15.75,108,6,5,1,102,55,47,0,0.0,0.01
1006,1309,2020-03-19 04:17:00,0,3169.0,2636.0,0.832,15.403,217,6,3,3,211,125,86,0,0.0,0.0
1006,1310,2020-03-19 04:20:00,0,3011.0,2552.0,0.848,14.69,221,4,1,3,217,118,99,0,0.0,0.0
1006,1311,2020-03-19 04:23:00,0,3009.0,2592.0,0.861,14.725,237,79,51,28,158,95,63,26,0.0,0.01
1006,1312,2020-03-19 04:26:00,0,3348.0,2905.0,0.868,16.408,246,109,69,40,137,81,56,96,0.11,0.06
1006,1313,2020-03-19 04:29:00,0,3006.0,2587.0,0.861,14.709,385,159,100,59,226,170,56,56,0.06,0.01
1006,1314,2020-03-19 04:32:00,0,3371.0,2856.0,0.847,16.444,541,291,231,60,250,181,69,35,0.02,0.0
1006,1315,2020-03-19 04:35:00,0,3196.0,2870.0,0.898,15.77,418,191,137,54,227,163,64,26,0.01,0.0
1006,1316,2020-03-19 04:38:00,0,3357.0,2943.0,0.877,16.484,151,89,50,39,62,52,10,23,0.0,0.16
1006,1317,2020-03-19 04:41:00,0,3497.0,3111.0,0.89,17.224,252,125,90,35,127,89,38,31,0.15,0.0
1006,1318,2020-03-19 04:44:00,0,2851.0,2509.0,0.88,14.012,487,196,132,64,291,209,82,1,0.0,0.0
1006,1319,2020-03-19 04:47:00,0,2929.0,2522.0,0.861,14.332,175,125,75,50,50,20,30,37,0.0,0.02
1006,1320,2020-03-19 04:50:00,0,3495.0,3076.0,0.88,17.177,149,85,52,33,64,42,22,6,0.0,0.0
1006,1321,2020-03-19 04:53:00,0,3409.0,3055.0,0.896,16.815,102,91,43,48,11,3,8,0,0.0,0.0
1006,1322,2020-03-19 04:56:00,0,3348.0,2988.0,0.893,16.498,18,11,0,11,7,2,5,0,0.0,0.0
1006,1323,2020-03-19 04:59:00,0,3122.0,2826.0,0.905,15.43,11,5,3,2,6,1,5,0,0.0,0.0
1006,1324,2020-03-19 05:02:00,0,2981.0,2648.0,0.888,14.675,2,1,0,1,1,0,1,0,0.0,0.0
1006,1325,2020-03-19 05:05:00,0,2867.0,2575.0,0.8985,14.145,7,4,1,3,3,0,3,0,0.0,0.0
1006,1326,2020-03-19 05:08:00,0,2753.0,2502.0,0.909,13.615,6,2,0,2,4,0,4,0,0.0,0.0
1006,1327,2020-03-19 05:11:00,0,2776.0,2435.0,0.877,13.635,61,47,29,18,14,8,6,0,0.0,0.0
1006,1328,2020-03-19 05:14:00,0,2762.0,2478.0,0.897,13.626,12,6,3,3,6,2,4,0,0.0,0.0
1006,1329,2020-03-19 05:17:00,0,2610.0,2375.0,0.91,12.914,31,6,0,6,25,1,24,0,0.0,0.0
1006,1330,2020-03-19 05:20:00,0,2624.0,2320.0,0.884,12.909,5,4,0,4,1,1,0,0,0.0,0.0
1006,1331,2020-03-19 05:23:00,0,2772.0,2449.0,0.884,13.634,9,4,1,3,5,2,3,0,0.0,0.0
1006,1332,2020-03-19 05:26:00,0,2609.0,2373.0,0.909,12.906,7,3,0,3,4,3,1,0,0.0,0.0
1006,1333,2020-03-19 05:29:00,0,2692.0,2392.0,0.889,13.254,29,10,4,6,19,6,13,0,0.0,0.0
1006,1334,2020-03-19 05:32:00,0,2834.0,2507.0,0.885,13.941,225,111,78,33,114,68,46,12,0.0,0.0
1006,1335,2020-03-19 05:35:00,0,3493.0,3094.0,0.886,17.189,204,81,57,24,123,85,38,6,0.0,0.12
1006,1336,2020-03-19 05:38:00,0,2988.0,2647.0,0.886,14.703,491,255,207,48,236,183,53,157,0.35,0.0
1006,1337,2020-03-19 05:41:00,0,3196.0,2874.0,0.899,15.773,348,190,139,51,158,115,43,58,0.0,0.0
1006,1338,2020-03-19 05:44:00,0,2780.0,2399.0,0.863,13.61,240,99,50,49,141,88,53,1,0.0,0.0
1006,1339,2020-03-19 05:47:00,0,3121.0,2805.0,0.899,15.401,9,2,1,1,7,4,3,0,0.0,0.0
1006,1340,2020-03-19 05:50:00,0,3060.0,2733.0,0.893,15.082,0,0,0,0,0,0,0,0,0.0,0.0
1006,1341,2020-03-19 05:53:00,0,2986.0,2667.0,0.893,14.717,0,0,0,0,0,0,0,0,0.0,0.0
1006,1342,2020-03-19 05:56:00,0,2980.0,2652.0,0.89,14.679,1,0,0,0,1,0,1,0,0.0,0.0
1006,1343,2020-03-19 05:59:00,0,2740.0,2501.0,0.913,13.563,0,0,0,0,0,0,0,0,0.0,0.0
1006,1344,2020-03-19 06:02:00,1,2625.0,2327.0,0.887,12.919,219,104,75,29,115,74,41,27,0.0,0.0
1006,1345,2020-03-19 06:05:00,1,3628.0,3260.0,0.899,17.904,201,90,59,31,111,83,28,14,0.0,0.09
1006,1346,2020-03-19 06:08:00,1,3845.0,3431.0,0.892,18.946,163,72,49,23,91,64,27,33,0.0,0.0
1006,1347,2020-03-19 06:11:00,1,3191.0,2901.0,0.909,15.784,345,171,121,50,174,127,47,98,0.0,0.08
1006,1348,2020-03-19 06:14:00,1,3058.0,2721.0,0.89,15.06,232,102,66,36,130,96,34,3,0.21,0.0
1006,1349,2020-03-19 06:17:00,1,3618.0,3338.0,0.923,17.951,520,238,177,61,282,202,80,24,0.0,0.0
1006,1350,2020-03-19 06:20:00,1,2984.0,2582.0,0.865,14.615,281,118,72,46,163,109,54,2,0.0,0.0
1006,1351,2020-03-19 06:23:00,1,3109.0,2854.0,0.918,15.408,266,151,101,50,115,80,35,7,0.0,0.0
1006,1352,2020-03-19 06:26:00,1,3407.0,3078.0,0.903,16.832,78,53,23,30,25,6,19,0,0.0,0.0
1006,1353,2020-03-19 06:29:00,1,3489.0,3068.0,0.879,17.142,167,107,56,51,60,39,21,0,0.0,0.0
1006,1354,2020-03-19 06:32:00,1,3339.0,2996.0,0.897,16.474,14,13,1,12,1,1,0,0,0.0,0.0
1006,1355,2020-03-19 06:35:00,1,3278.0,2852.0,0.87,16.071,20,20,8,12,0,0,0,0,0.0,0.0
1006,1356,2020-03-19 06:38:00,1,3124.0,2812.0,0.9,15.421,21,15,7,8,6,3,3,1,0.0,0.0
1006,1357,2020-03-19 06:41:00,1,2997.0,2592.0,0.865,14.68,2,1,0,1,1,1,0,0,0.0,0.0
1006,1358,2020-03-19 06:44:00,1,2769.0,2447.0,0.884,13.62,1,0,0,0,1,1,0,0,0.0,0.0
1006,1359,2020-03-19 06:47:00,1,2708.0,2331.0,0.861,13.251,0,0,0,0,0,0,0,0,0.0,0.0
1006,1360,2020-03-19 06:50:00,1,2773.0,2371.0,0.855,13.551,3,0,0,0,3,2,1,0,0.0,0.0
1006,1361,2020-03-19 06:53:00,1,2711.0,2318.0,0.855,13.246,13,0,0,0,13,2,11,0,0.0,0.0
1006,1362,2020-03-19 06:56:00,1,2624.0,2246.0,0.856,12.824,0,0,0,0,0,0,0,0,0.0,0.0
1006,1363,2020-03-19 06:59:00,1,2640.0,2247.0,0.851,12.89,22,13,8,5,9,4,5,0,0.0,0.0
1006,1364,2020-03-19 07:02:00,1,2653.0,2204.0,0.831,12.894,2,0,0,0,2,1,1,0,0.0,0.0
1006,1365,2020-03-19 07:05:00,1,2659.0,2127.0,0.8,12.83,9,3,0,3,6,1,5,0,0.0,0.0
1006,1366,2020-03-19 07:08:00,1,2592.0,2125.0,0.82,12.565,6,4,0,4,2,1,1,0,0.0,0.0
1006,1367,2020-03-19 07:11:00,1,2645.0,2240.0,0.847,12.903,54,36,22,14,18,5,13,1,0.0,0.0
1006,1368,2020-03-19 07:14:00,1,2666.0,2107.0,0.79,12.838,4,0,0,0,4,1,3,0,0.0,0.0
1006,1369,2020-03-19 07:17:00,1,2379.0,1905.0,0.801,11.483,22,4,0,4,18,6,12,0,0.0,0.0
1006,1370,2020-03-19 07:20:00,1,2289.0,1883.0,0.823,11.103,10,4,2,2,6,1,5,0,0.0,0.0
1006,1371,2020-03-19 07:23:00,1,2301.0,1833.0,0.797,11.095,31,15,10,5,16,7,9,0,0.0,0.0
1006,1372,2020-03-19 07:26:00,1,2293.0,1881.0,0.82,11.117,7,3,0,3,4,1,3,0,0.0,0.0
1006,1373,2020-03-19 07:29:00,1,2534.0,1959.0,0.773,12.152,70,49,19,30,21,8,13,0,0.0,0.0
1006,1374,2020-03-19 07:32:00,1,2672.0,2125.0,0.795,12.88,20,2,0,2,18,10,8,0,0.0,0.0
1006,1375,2020-03-19 07:35:00,1,2592.0,2093.0,0.807,12.531,72,40,1,39,32,11,21,0,0.0,0.0
1006,1376,2020-03-19 07:38:00,1,2805.0,2238.0,0.798,13.531,108,59,23,36,49,18,31,1,0.0,0.0
1006,1377,2020-03-19 07:41:00,1,3547.0,2879.0,0.812,17.164,174,90,62,28,84,53,31,24,0.0,0.0
1006,1378,2020-03-19 07:44:00,1,3032.0,2493.0,0.822,14.706,93,58,38,20,35,9,26,0,0.0,0.0
1006,1379,2020-03-19 07:47:00,1,3113.0,2523.0,0.811,15.058,445,206,156,50,239,158,81,2,0.0,0.01
1006,1380,2020-03-19 07:50:00,1,3189.0,2582.0,0.81,15.425,247,138,98,40,109,70,39,4,0.04,0.0
1006,1381,2020-03-19 07:53:00,1,2793.0,2352.0,0.842,13.611,142,122,76,46,20,2,18,0,0.0,0.0
1006,1382,2020-03-19 07:56:00,1,2796.0,2363.0,0.845,13.634,54,33,8,25,21,0,21,0,0.0,0.0
1006,1383,2020-03-19 07:59:00,1,2783.0,2375.0,0.853,13.595,108,76,30,46,32,3,29,0,0.0,0.0
1006,1384,2020-03-19 08:02:00,1,2855.0,2432.0,0.852,13.943,114,99,55,44,15,3,12,0,0.0,0.0
1006,1385,2020-03-19 08:05:00,1,2824.5,2386.0,0.8445,13.7705,59,58,33,25,1,1,0,0,0.0,0.0
1006,1386,2020-03-19 08:08:00,1,2794.0,2340.0,0.837,13.598,0,0,0,0,0,0,0,0,0.0,0.0
1006,1387,2020-03-19 08:11:00,1,2658.0,2183.0,0.821,12.888,20,13,8,5,7,1,6,0,0.0,0.0
1006,1388,2020-03-19 08:14:00,1,2654.0,2160.0,0.814,12.847,0,0,0,0,0,0,0,0,0.0,0.0
1006,1389,2020-03-19 08:17:00,1,2674.0,2122.0,0.794,12.887,1,0,0,0,1,0,1,0,0.0,0.0
1006,1390,2020-03-19 08:20:00,1,2528.0,1995.0,0.789,12.17,0,0,0,0,0,0,0,0,0.0,0.0
1006,1391,2020-03-19 08:23:00,1,2528.0,1987.0,0.786,12.162,27,15,4,11,12,0,12,0,0.0,0.0
1006,1392,2020-03-19 08:26:00,1,2535.0,1982.0,0.782,12.182,0,0,0,0,0,0,0,0,0.0,0.0
1006,1393,2020-03-19 08:29:00,1,2524.0,1996.0,0.791,12.157,2,1,0,1,1,0,1,0,0.0,0.0
1006,1394,2020-03-19 08:32:00,1,2683.0,2101.0,0.783,12.896,5,3,0,3,2,0,2,0,0.0,0.0
1006,1395,2020-03-19 08:35:00,1,2507.0,2020.0,0.806,12.113,0,0,0,0,0,0,0,0,0.0,0.0
1006,1396,2020-03-19 08:38:00,1,2521.0,2032.0,0.806,12.183,0,0,0,0,0,0,0,0,0.0,0.0
1006,1397,2020-03-19 08:41:00,1,2510.0,2004.0,0.798,12.11,0,0,0,0,0,0,0,0,0.0,0.0
1006,1398,2020-03-19 08:44:00,1,2527.0,2037.0,0.806,12.213,0,0,0,0,0,0,0,0,0.0,0.0
1006,1399,2020-03-19 08:47:00,1,2527.0,2017.0,0.798,12.189,0,0,0,0,0,0,0,0,0.0,0.0
1006,1400,2020-03-19 08:50:00,1,2604.0,2014.0,0.774,12.488,0,0,0,0,0,0,0,0,0.0,0.0
1006,1401,2020-03-19 08:53:00,1,2674.0,2124.0,0.794,12.886,0,0,0,0,0,0,0,0,0.0,0.0
1006,1402,2020-03-19 08:56:00,1,2667.0,2153.0,0.807,12.891,0,0,0,0,0,0,0,0,0.0,0.0
1006,1403,2020-03-19 08:59:00,1,2696.0,2041.0,0.757,12.882,1,0,0,0,1,1,0,0,0.0,0.0
1006,1404,2020-03-19 09:02:00,1,2613.0,2011.0,0.77,12.524,70,50,35,15,20,11,9,3,0.0,0.04
1006,1405,2020-03-19 09:05:00,1,3479.0,2795.0,0.803,16.8,182,89,52,37,93,65,28,10,0.0,0.03
1006,1406,2020-03-19 09:08:00,1,2542.0,1951.0,0.768,12.177,16,10,9,1,6,2,4,0,0.0,0.0
1006,1407,2020-03-19 09:11:00,1,2539.0,1962.0,0.773,12.177,0,0,0,0,0,0,0,0,0.0,0.0
1006,1408,2020-03-19 09:14:00,1,2687.0,2075.0,0.772,12.886,0,0,0,0,0,0,0,0,0.0,0.0
1006,1409,2020-03-19 09:17:00,1,2508.0,2031.0,0.81,12.132,0,0,0,0,0,0,0,0,0.0,0.0
1006,1410,2020-03-19 09:20:00,1,2507.0,2062.0,0.822,12.16,0,0,0,0,0,0,0,0,0.0,0.0
1006,1411,2020-03-19 09:23:00,1,2661.0,2144.0,0.806,12.857,0,0,0,0,0,0,0,0,0.0,0.0
1006,1412,2020-03-19 09:26:00,1,2656.0,2169.0,0.817,12.865,4,2,1,1,2,1,1,0,0.0,0.0
1006,1413,2020-03-19 09:29:00,1,2642.0,2254.0,0.853,12.903,0,0,0,0,0,0,0,0,0.0,0.0
1006,1414,2020-03-19 09:32:00,1,2657.0,2187.0,0.823,12.892,38,12,9,3,26,14,12,0,0.0,0.0
1006,1415,2020-03-19 09:35:00,1,2498.0,2101.0,0.841,12.17,6,0,0,0,6,0,6,0,0.0,0.0
1006,1416,2020-03-19 09:38:00,1,2718.0,2298.0,0.846,13.254,53,36,14,22,17,0,17,0,0.0,0.0
1006,1417,2020-03-19 09:41:00,1,2717.0,2306.0,0.849,13.259,124,87,41,46,37,18,19,0,0.0,0.0
1006,1418,2020-03-19 09:44:00,1,3002.0,2586.0,0.861,14.692,214,97,77,20,117,76,41,25,0.0,0.52
1006,1419,2020-03-19 09:47:00,1,3021.0,2502.0,0.828,14.672,308,173,128,45,135,94,41,4,0.27,0.02
1006,1420,2020-03-19 09:50:00,1,3169.0,2630.0,0.83,15.398,572,238,177,61,334,244,90,2,0.0,0.0
1006,1421,2020-03-19 09:53:00,1,3149.0,2705.0,0.859,15.402,373,260,202,58,113,76,37,16,0.0,0.0
1006,1422,2020-03-19 09:56:00,1,3138.0,2740.0,0.873,15.398,221,164,122,42,57,31,26,1,0.0,0.0
1006,1423,2020-03-19 09:59:00,1,3135.0,2770.0,0.884,15.417,8,7,0,7,1,1,0,0,0.0,0.0
1006,1424,2020-03-19 10:02:00,1,3145.0,2733.0,0.869,15.417,88,76,21,55,12,4,8,0,0.0,0.0
1006,1425,2020-03-19 10:05:00,1,3058.0,2670.0,0.873,15.003,96,72,24,48,24,1,23,3,0.0,0.0
1006,1426,2020-03-19 10:08:00,1,2989.0,2623.0,0.878,14.681,42,2,0,2,40,0,40,0,0.0,0.0
1006,1427,2020-03-19 10:11:00,1,2831.0,2516.0,0.889,13.94,9,1,0,1,8,0,8,0,0.0,0.0
1006,1428,2020-03-19 10:14:00,1,2614.0,2374.0,0.908,12.928,0,0,0,0,0,0,0,0,0.0,0.0
1006,1429,2020-03-19 10:17:00,1,2606.0,2353.0,0.903,12.872,17,13,7,6,4,0,4,0,0.0,0.0
1006,1430,2020-03-19 10:20:00,1,2646.0,2253.0,0.851,12.92,7,7,1,6,0,0,0,0,0.0,0.0
1006,1431,2020-03-19 10:23:00,1,2486.0,2174.0,0.875,12.201,12,8,5,3,4,2,2,0,0.0,0.0
1006,1432,2020-03-19 10:26:00,1,2484.0,2169.0,0.873,12.188,10,7,4,3,3,1,2,0,0.0,0.0
1006,1433,2020-03-19 10:29:00,1,2491.0,2131.0,0.856,12.173,1,1,0,1,0,0,0,0,0.0,0.0
1006,1434,2020-03-19 10:32:00,1,2504.0,2103.0,0.84,12.195,7,5,1,4,2,0,2,0,0.0,0.0
1006,1435,2020-03-19 10:35:00,1,2556.0,2188.0,0.856,12.491,3,0,0,0,3,0,3,0,0.0,0.0
1006,1436,2020-03-19 10:38:00,1,2479.0,2168.0,0.875,12.167,4,4,0,4,0,0,0,0,0.0,0.0
1006,1437,2020-03-19 10:41:00,1,2506.0,2051.0,0.818,12.145,7,5,2,3,2,0,2,0,0.0,0.0
1006,1438,2020-03-19 10:44:00,1,2519.0,2068.0,0.821,12.213,3,3,1,2,0,0,0,0,0.0,0.0
1006,1439,2020-03-19 10:47:00,1,2505.0,2085.0,0.832,12.177,0,0,0,0,0,0,0,0,0.0,0.0
1006,1440,2020-03-19 10:50:00,1,2634.0,2247.0,0.853,12.866,38,22,15,7,16,13,3,0,0.0,0.0
1006,1441,2020-03-19 10:53:00,1,2802.0,2318.0,0.827,13.606,116,75,38,37,41,17,24,5,0.0,0.0
1006,1442,2020-03-19 10:56:00,1,2786.0,2397.0,0.861,13.629,122,77,27,50,45,6,39,2,0.0,0.0
1006,1443,2020-03-19 10:59:00,1,3012.0,2491.0,0.827,14.625,120,53,29,24,67,29,38,0,0.0,0.0
1006,1444,2020-03-19 11:02:00,1,2796.0,2348.0,0.84,13.616,4,2,1,1,2,1,1,0,0.0,0.0
1006,1445,2020-03-19 11:05:00,1,2717.0,2286.0,0.8415,13.236,0,0,0,0,0,0,0,0,0.0,0.0
1006,1446,2020-03-19 11:08:00,1,2638.0,2224.0,0.843,12.856,0,0,0,0,0,0,0,0,0.0,0.0
1006,1447,2020-03-19 11:11:00,1,2650.0,2259.0,0.852,12.94,41,22,14,8,19,8,11,0,0.0,0.0
1006,1448,2020-03-19 11:14:00,1,2986.0,2604.0,0.872,14.65,129,66,48,18,63,41,22,0,0.25,0.0
1006,1449,2020-03-19 11:17:00,1,2747.0,2513.0,0.915,13.607,1,0,0,0,1,1,0,0,0.0,0.0
1006,1450,2020-03-19 11:20:00,1,2588.0,2419.0,0.935,12.874,5,2,0,2,3,0,3,0,0.0,0.0
1006,1451,2020-03-19 11:23:00,1,2599.0,2438.0,0.938,12.939,7,4,0,4,3,1,2,0,0.0,0.0
1006,1452,2020-03-19 11:26:00,1,2670.0,2438.0,0.913,13.22,12,9,0,9,3,2,1,0,0.0,0.0
1006,1453,2020-03-19 11:29:00,1,2634.0,2285.0,0.868,12.907,3,3,0,3,0,0,0,0,0.0,0.0
1006,1454,2020-03-19 11:32:00,1,2638.0,2296.0,0.871,12.935,2,1,1,0,1,1,0,0,0.0,0.0
1006,1455,2020-03-19 11:35:00,1,2546.0,2246.0,0.882,12.519,7,4,1,3,3,0,3,0,0.0,0.0
1006,1456,2020-03-19 11:38:00,1,2627.0,2311.0,0.88,12.909,47,27,15,12,20,12,8,0,0.0,0.0
1006,1457,2020-03-19 11:41:00,1,2596.0,2404.0,0.926,12.891,174,69,43,26,105,59,46,6,0.0,0.0
1006,1458,2020-03-19 11:44:00,1,2834.0,2554.0,0.901,13.995,100,85,47,38,15,3,12,0,0.0,0.0
1006,1459,2020-03-19 11:47:00,1,2824.0,2569.0,0.91,13.972,66,38,5,33,28,3,25,1,0.0,0.0
1006,1460,2020-03-19 11:50:00,1,2909.0,2618.0,0.9,14.362,555,255,201,54,300,228,72,11,0.0,0.01
1006,1461,2020-03-19 11:53:00,1,2943.0,2741.0,0.931,14.63,473,261,187,74,212,146,66,34,0.0,0.0
1006,1462,2020-03-19 11:56:00,1,3303.0,3049.0,0.923,16.389,552,180,114,66,372,279,93,7,0.0,0.06
1006,1463,2020-03-19 11:59:00,1,3124.0,2822.0,0.903,15.431,669,287,211,76,382,286,96,22,0.0,0.0
1006,1464,2020-03-19 12:02:00,1,2675.0,2446.0,0.914,13.247,738,243,170,73,495,390,105,5,0.0,0.0
1006,1465,2020-03-19 12:05:00,1,3099.0,2839.0,0.916,15.354,522,209,161,48,313,237,76,0,0.07,0.0
1006,1466,2020-03-19 12:08:00,1,2971.0,2708.0,0.911,14.706,98,31,9,22,67,26,41,8,0.0,0.0
1006,1467,2020-03-19 12:11:00,1,2976.0,2692.0,0.905,14.704,59,16,6,10,43,18,25,0,0.0,0.0
1006,1468,2020-03-19 12:14:00,1,2966.0,2712.0,0.914,14.688,246,67,34,33,179,136,43,0,0.0,0.0
1006,1469,2020-03-19 12:17:00,1,2976.0,2636.0,0.886,14.644,165,65,49,16,100,57,43,0,0.0,0.0
1006,1470,2020-03-19 12:20:00,1,2992.0,2618.0,0.875,14.688,47,25,7,18,22,9,13,0,0.0,0.0
1006,1471,2020-03-19 12:23:00,1,2996.0,2605.0,0.87,14.689,44,21,3,18,23,6,17,1,0.0,0.0
1006,1472,2020-03-19 12:26:00,1,2773.0,2451.0,0.884,13.638,20,0,0,0,20,0,20,0,0.0,0.0
1006,1473,2020-03-19 12:29:00,1,2611.0,2321.0,0.889,12.859,20,0,0,0,20,2,18,0,0.0,0.0
1006,1474,2020-03-19 12:32:00,1,2546.0,2214.0,0.87,12.482,23,0,0,0,23,4,19,0,0.0,0.0
1006,1475,2020-03-19 12:35:00,1,2566.0,2203.0,0.859,12.549,22,0,0,0,22,4,18,0,0.0,0.0
1006,1476,2020-03-19 12:38:00,1,2491.0,2138.0,0.859,12.18,12,0,0,0,12,0,12,0,0.0,0.0
1006,1477,2020-03-19 12:41:00,1,2488.0,2147.0,0.863,12.181,15,0,0,0,15,2,13,0,0.0,0.0
1006,1478,2020-03-19 12:44:00,1,2640.0,2256.0,0.855,12.897,15,0,0,0,15,0,15,0,0.0,0.0
1006,1479,2020-03-19 12:47:00,1,2559.0,2180.0,0.852,12.497,15,0,0,0,15,0,15,0,0.0,0.0
1006,1480,2020-03-19 12:50:00,1,2477.0,2162.0,0.873,12.152,24,2,1,1,22,0,22,0,0.0,0.0
1006,1481,2020-03-19 12:53:00,1,2483.0,2139.0,0.862,12.15,23,0,0,0,23,0,23,0,0.0,0.0
1006,1482,2020-03-19 12:56:00,1,2493.0,2137.0,0.857,12.19,17,0,0,0,17,0,17,0,0.0,0.0
1006,1483,2020-03-19 12:59:00,1,2509.0,2069.0,0.825,12.178,24,0,0,0,24,0,24,0,0.0,0.0
1006,1484,2020-03-19 13:02:00,1,2505.0,2065.0,0.824,12.156,22,2,0,2,20,2,18,0,0.0,0.0
1006,1485,2020-03-19 13:05:00,1,2495.0,2116.0,0.848,12.171,21,0,0,0,21,0,21,0,0.0,0.0
1006,1486,2020-03-19 13:08:00,1,2513.0,2074.0,0.825,12.197,24,1,0,1,23,0,23,0,0.0,0.0
1006,1487,2020-03-19 13:11:00,1,2504.0,2081.0,0.831,12.168,63,20,12,8,43,27,16,0,0.0,0.0
1006,1488,2020-03-19 13:14:00,1,2425.0,2022.0,0.834,11.792,25,3,0,3,22,2,20,0,0.0,0.0
1006,1489,2020-03-19 13:17:00,1,2345.0,2015.0,0.859,11.472,23,5,0,5,18,1,17,0,0.0,0.0
1006,1490,2020-03-19 13:20:00,1,2493.0,2116.0,0.849,12.165,32,4,0,4,28,9,19,0,0.0,0.0
1006,1491,2020-03-19 13:23:00,1,2507.0,2081.0,0.83,12.182,34,0,0,0,34,2,32,0,0.0,0.0
1006,1492,2020-03-19 13:26:00,1,2656.0,2186.0,0.823,12.884,46,1,1,0,45,10,35,0,0.0,0.0
1006,1493,2020-03-19 13:29:00,1,2515.0,2065.0,0.821,12.195,71,2,1,1,69,28,41,0,0.0,0.0
1006,1494,2020-03-19 13:32:00,1,2443.0,1973.0,0.808,11.81,37,2,0,2,35,4,31,0,0.0,0.0
1006,1495,2020-03-19 13:35:00,1,2440.0,1966.0,0.806,11.792,44,7,4,3,37,8,29,0,0.0,0.0
1006,1496,2020-03-19 13:38:00,1,2526.0,1993.0,0.789,12.16,37,0,0,0,37,4,33,0,0.0,0.0
1006,1497,2020-03-19 13:41:00,1,2528.0,1989.0,0.787,12.163,32,2,1,1,30,10,20,0,0.0,0.0
1006,1498,2020-03-19 13:44:00,1,2523.0,2017.0,0.8,12.173,25,0,0,0,25,4,21,0,0.0,0.0
1006,1499,2020-03-19 13:47:00,1,2516.0,2036.0,0.81,12.166,90,37,23,14,53,27,26,5,0.0,0.0
1006,1500,2020-03-19 13:50:00,1,2583.0,2084.0,0.807,12.486,55,17,3,14,38,10,28,3,0.0,0.0
1006,1501,2020-03-19 13:53:00,1,2663.0,2169.0,0.814,12.893,82,34,6,28,48,21,27,0,0.0,0.0
1006,1502,2020-03-19 13:56:00,1,2642.0,2250.0,0.852,12.901,53,17,2,15,36,9,27,1,0.0,0.0
1006,1503,2020-03-19 13:59:00,1,2637.0,2256.0,0.855,12.888,37,15,4,11,22,7,15,2,0.0,0.0
1006,1504,2020-03-19 14:02:00,1,2659.0,2165.0,0.814,12.875,34,7,4,3,27,10,17,0,0.0,0.0
1006,1505,2020-03-19 14:05:00,1,2554.5,2056.0,0.8045,12.341,23,3,0,3,20,0,20,0,0.0,0.0
1006,1506,2020-03-19 14:08:00,1,2450.0,1947.0,0.795,11.807,25,3,1,2,22,0,22,0,0.0,0.0
1006,1507,2020-03-19 14:11:00,1,2456.0,1951.0,0.794,11.838,27,6,0,6,21,0,21,0,0.0,0.0
1006,1508,2020-03-19 14:14:00,1,2293.0,1859.0,0.811,11.093,90,9,1,8,81,64,17,2,0.0,0.0
1006,1509,2020-03-19 14:17:00,1,2812.0,2272.0,0.808,13.594,495,147,105,42,348,296,52,25,0.16,0.0
1006,1510,2020-03-19 14:20:00,1,3181.0,2539.0,0.798,15.346,399,126,92,34,273,234,39,47,0.01,0.0
1006,1511,2020-03-19 14:23:00,1,3181.0,2510.0,0.789,15.312,99,14,7,7,85,71,14,0,0.0,0.0
1006,1512,2020-03-19 14:26:00,1,3022.0,2474.0,0.819,14.646,79,31,12,19,48,40,8,1,0.0,0.0
1006,1513,2020-03-19 14:29:00,1,3029.0,2431.0,0.802,14.626,155,42,24,18,113,91,22,6,0.0,0.0
1006,1514,2020-03-19 14:32:00,1,3035.0,2456.0,0.809,14.679,108,43,18,25,65,51,14,1,0.0,0.0
1006,1515,2020-03-19 14:35:00,1,3042.0,2459.0,0.808,14.71,196,30,4,26,166,132,34,0,0.0,0.0
1006,1516,2020-03-19 14:38:00,1,3115.0,2501.0,0.803,15.042,33,7,1,6,26,9,17,0,0.0,0.0
1006,1517,2020-03-19 14:41:00,1,3022.0,2520.0,0.834,14.696,77,21,4,17,56,38,18,0,0.06,0.0
1006,1518,2020-03-19 14:44:00,1,2856.0,2419.0,0.847,13.931,22,0,0,0,22,0,22,0,0.03,0.0
1006,1519,2020-03-19 14:47:00,1,2815.0,2327.0,0.827,13.668,35,0,0,0,35,0,35,0,0.0,0.0
1006,1520,2020-03-19 14:50:00,1,2727.0,2281.0,0.837,13.269,68,0,0,0,68,19,49,0,0.01,0.0
1006,1521,2020-03-19 14:53:00,1,2802.0,2355.0,0.84,13.649,26,0,0,0,26,0,26,0,0.0,0.0
1006,1522,2020-03-19 14:56:00,1,2863.0,2427.0,0.848,13.969,73,2,0,2,71,37,34,0,0.01,0.0
1006,1523,2020-03-19 14:59:00,1,2861.0,2420.0,0.846,13.952,283,64,35,29,219,159,60,1,0.07,0.0
1006,1524,2020-03-19 15:02:00,1,2773.0,2404.0,0.867,13.589,48,0,0,0,48,12,36,0,0.0,0.0
1006,1525,2020-03-19 15:05:00,1,2712.0,2302.0,0.849,13.234,182,9,3,6,173,121,52,0,0.0,0.0
1006,1526,2020-03-19 15:08:00,1,2634.0,2263.0,0.859,12.882,40,0,0,0,40,0,40,0,0.01,0.0
1006,1527,2020-03-19 15:11:00,1,2725.0,2276.0,0.835,13.255,68,9,0,9,59,4,55,0,0.07,0.0
1006,1528,2020-03-19 15:14:00,1,2805.0,2312.0,0.824,13.612,73,21,9,12,52,4,48,0,0.01,0.0
1006,1529,2020-03-19 15:17:00,1,2804.0,2330.0,0.831,13.628,118,33,8,25,85,26,59,0,0.01,0.0
1006,1530,2020-03-19 15:20:00,1,2664.0,2157.0,0.81,12.886,63,5,0,5,58,2,56,0,0.0,0.0
1006,1531,2020-03-19 15:23:00,1,2589.0,2101.0,0.812,12.529,55,8,1,7,47,5,42,0,0.0,0.0
1006,1532,2020-03-19 15:26:00,1,2512.0,2074.0,0.826,12.193,49,2,0,2,47,0,47,0,0.06,0.0
1006,1533,2020-03-19 15:29:00,1,2664.0,2146.0,0.806,12.87,51,12,0,12,39,0,39,0,0.01,0.0
1006,1534,2020-03-19 15:32:00,1,2669.0,2135.0,0.8,12.878,75,12,4,8,63,13,50,0,0.0,0.0
1006,1535,2020-03-19 15:35:00,1,2582.0,2069.0,0.801,12.464,50,1,0,1,49,0,49,0,0.02,0.0
1006,1536,2020-03-19 15:38:00,1,2681.0,2100.0,0.783,12.888,33,0,0,0,33,2,31,0,0.01,0.0
1006,1537,2020-03-19 15:41:00,1,2656.0,2116.0,0.797,12.806,32,6,4,2,26,6,20,0,0.0,0.0
1006,1538,2020-03-19 15:44:00,1,2677.0,2095.0,0.783,12.865,38,0,0,0,38,2,36,0,0.0,0.0
1006,1539,2020-03-19 15:47:00,1,2691.0,2117.0,0.787,12.944,42,0,0,0,42,8,34,0,0.0,0.0
1006,1540,2020-03-19 15:50:00,1,2680.0,2110.0,0.787,12.897,213,35,14,21,178,105,73,4,0.0,0.0
1006,1541,2020-03-19 15:53:00,1,2805.0,2292.0,0.817,13.591,83,10,2,8,73,29,44,1,0.09,0.0
1006,1542,2020-03-19 15:56:00,1,2872.0,2347.0,0.817,13.916,191,28,14,14,163,122,41,13,0.0,0.0
1006,1543,2020-03-19 15:59:00,1,3160.0,2579.0,0.816,15.307,347,123,88,35,224,180,44,37,0.0,0.02
1006,1544,2020-03-19 16:02:00,1,3542.0,2928.0,0.826,17.199,760,266,206,60,494,396,98,73,0.03,0.06
1006,1545,2020-03-19 16:05:00,1,3165.0,2636.0,0.833,15.39,594,206,156,50,388,312,76,45,0.13,0.0
1006,1546,2020-03-19 16:08:00,1,3168.0,2646.0,0.835,15.412,336,100,63,37,236,199,37,3,0.0,0.0
1006,1547,2020-03-19 16:11:00,1,3165.0,2683.0,0.848,15.443,381,97,60,37,284,219,65,1,0.0,0.0
1006,1548,2020-03-19 16:14:00,1,3157.0,2678.0,0.848,15.403,401,152,106,46,249,176,73,7,0.12,0.01
1006,1549,2020-03-19 16:17:00,1,3155.0,2685.0,0.851,15.402,135,69,32,37,66,41,25,0,0.0,0.0
1006,1550,2020-03-19 16:20:00,1,3166.0,2635.0,0.832,15.393,38,9,4,5,29,11,18,0,0.0,0.0
1006,1551,2020-03-19 16:23:00,1,2852.0,2483.0,0.871,13.988,32,5,3,2,27,4,23,0,0.0,0.0
1006,1552,2020-03-19 16:26:00,1,2800.0,2356.0,0.841,13.64,15,0,0,0,15,0,15,0,0.0,0.0
1006,1553,2020-03-19 16:29:00,1,2786.0,2393.0,0.859,13.628,51,22,14,8,29,12,17,0,0.0,0.0
1006,1554,2020-03-19 16:32:00,1,2615.0,2292.0,0.876,12.842,30,17,5,12,13,0,13,0,0.0,0.0
1006,1555,2020-03-19 16:35:00,1,2650.0,2231.0,0.842,12.911,28,8,3,5,20,8,12,0,0.0,0.0
1006,1556,2020-03-19 16:38:00,1,2568.0,2170.0,0.845,12.52,28,12,1,11,16,0,16,0,0.0,0.0
1006,1557,2020-03-19 16:41:00,1,2648.0,2240.0,0.846,12.914,14,3,2,1,11,0,11,0,0.0,0.0
1006,1558,2020-03-19 16:44:00,1,2637.0,2267.0,0.86,12.898,16,0,0,0,16,2,14,0,0.0,0.0
1006,1559,2020-03-19 16:47:00,1,2809.0,2329.0,0.829,13.644,131,82,38,44,49,26,23,1,0.0,0.0
1006,1560,2020-03-19 16:50:00,1,2771.0,2399.0,0.866,13.575,168,127,71,56,41,16,25,9,0.0,0.0
1006,1561,2020-03-19 16:53:00,1,2858.0,2422.0,0.848,13.941,157,27,15,12,130,91,39,0,0.0,0.0
1006,1562,2020-03-19 16:56:00,1,2710.0,2318.0,0.856,13.242,16,2,2,0,14,0,14,0,0.0,0.0
1006,1563,2020-03-19 16:59:00,1,2660.0,2204.0,0.829,12.92,15,1,0,1,14,0,14,0,0.0,0.0
1006,1564,2020-03-19 17:02:00,1,2662.0,2158.0,0.811,12.876,57,46,10,36,11,4,7,0,0.0,0.0
1006,1565,2020-03-19 17:05:00,1,2669.5,2125.5,0.7965,12.871,21,12,7,5,9,2,7,0,0.01,0.0
1006,1566,2020-03-19 17:08:00,1,2677.0,2093.0,0.782,12.866,27,17,4,13,10,0,10,0,0.0,0.0
1006,1567,2020-03-19 17:11:00,1,2674.0,2143.0,0.801,12.908,24,8,6,2,16,6,10,0,0.0,0.0
1006,1568,2020-03-19 17:14:00,1,2827.0,2218.0,0.785,13.595,284,73,47,26,211,174,37,36,0.01,0.07
1006,1569,2020-03-19 17:17:00,1,2884.0,2346.0,0.814,13.959,179,74,37,37,105,67,38,1,0.02,0.01
1006,1570,2020-03-19 17:20:00,1,3032.0,2454.0,0.809,14.663,171,34,10,24,137,95,42,0,0.01,0.0
1006,1571,2020-03-19 17:23:00,1,3012.0,2539.0,0.843,14.68,242,81,42,39,161,112,49,1,0.0,0.0
1006,1572,2020-03-19 17:26:00,1,3090.0,2575.0,0.833,15.025,113,37,20,17,76,42,34,0,0.0,0.0
1006,1573,2020-03-19 17:29:00,1,3026.0,2489.0,0.823,14.679,33,4,2,2,29,11,18,0,0.0,0.0
1006,1574,2020-03-19 17:32:00,1,2767.0,2448.0,0.885,13.611,231,66,51,15,165,127,38,16,0.25,0.12
1006,1575,2020-03-19 17:35:00,1,2921.0,2488.0,0.852,14.265,247,3,2,1,244,185,59,4,0.0,0.0
1006,1576,2020-03-19 17:38:00,1,3130.0,2723.0,0.87,15.348,164,17,2,15,147,88,59,5,0.0,0.0
1006,1577,2020-03-19 17:41:00,1,3197.0,2864.0,0.896,15.766,120,36,8,28,84,35,49,0,0.0,0.0
1006,1578,2020-03-19 17:44:00,1,3121.0,2797.0,0.896,15.392,51,13,11,2,38,17,21,0,0.0,0.0
1006,1579,2020-03-19 17:47:00,1,3050.0,2730.0,0.895,15.041,11,0,0,0,11,0,11,0,0.0,0.0
1006,1580,2020-03-19 17:50:00,1,2982.0,2616.0,0.877,14.644,22,4,3,1,18,4,14,0,0.0,0.0
1006,1581,2020-03-19 17:53:00,1,3131.0,2746.0,0.877,15.376,10,0,0,0,10,0,10,0,0.0,0.0
1006,1582,2020-03-19 17:56:00,1,3140.0,2764.0,0.88,15.433,24,7,1,6,17,0,17,0,0.0,0.0
1006,1583,2020-03-19 17:59:00,1,3116.0,2826.0,0.907,15.406,347,97,69,28,250,199,51,27,0.01,0.02
1006,1584,2020-03-19 18:02:00,0,3400.0,3122.0,0.918,16.852,706,404,341,63,302,238,64,29,0.0,0.0
1006,1585,2020-03-19 18:05:00,0,3450.0,3235.0,0.938,17.177,804,294,245,49,510,413,97,90,0.0,0.0
1006,1586,2020-03-19 18:08:00,0,3466.0,3184.0,0.919,17.182,268,60,14,46,208,122,86,9,0.0,0.0
1006,1587,2020-03-19 18:11:00,0,3563.0,3229.0,0.906,17.613,277,50,22,28,227,144,83,3,0.0,0.0
1006,1588,2020-03-19 18:14:00,0,3642.0,3256.0,0.894,17.955,431,133,96,37,298,205,93,28,0.0,0.0
1006,1589,2020-03-19 18:17:00,0,3853.0,3466.0,0.9,19.019,738,306,240,66,432,331,101,78,0.26,0.06
1006,1590,2020-03-19 18:20:00,0,3343.0,3044.0,0.911,16.542,458,204,158,46,254,175,79,51,0.0,0.0
1006,1591,2020-03-19 18:23:00,0,3419.0,3055.0,0.894,16.853,597,190,138,52,407,324,83,21,0.0,0.0
1006,1592,2020-03-19 18:26:00,0,3423.0,3071.0,0.897,16.888,333,79,41,38,254,207,47,35,0.0,0.0
1006,1593,2020-03-19 18:29:00,0,3338.0,2970.0,0.89,16.442,35,12,0,12,23,0,23,0,0.0,0.0
1006,1594,2020-03-19 18:32:00,0,3201.0,2854.0,0.892,15.77,85,27,12,15,58,30,28,0,0.0,0.0
1006,1595,2020-03-19 18:35:00,0,3145.0,2733.0,0.869,15.418,23,0,0,0,23,0,23,0,0.0,0.0
1006,1596,2020-03-19 18:38:00,0,3004.0,2607.0,0.868,14.722,40,0,0,0,40,0,40,0,0.0,0.0
1006,1597,2020-03-19 18:41:00,0,2991.0,2625.0,0.878,14.691,57,5,2,3,52,0,52,0,0.0,0.0
1006,1598,2020-03-19 18:44:00,0,3004.0,2596.0,0.864,14.708,145,59,35,24,86,10,76,3,0.0,0.0
1006,1599,2020-03-19 18:47:00,0,3214.0,2816.0,0.876,15.781,749,285,222,63,464,367,97,68,0.0,0.0
1006,1600,2020-03-19 18:50:00,0,3588.0,3117.0,0.869,17.587,580,245,187,58,335,259,76,92,0.0,0.0
1006,1601,2020-03-19 18:53:00,0,3382.0,2881.0,0.852,16.514,369,108,70,38,261,216,45,22,0.0,0.0
1006,1602,2020-03-19 18:56:00,0,3010.0,2592.0,0.861,14.731,537,268,214,54,269,215,54,112,0.0,0.0
1006,1603,2020-03-19 18:59:00,0,3383.0,2814.0,0.832,16.444,338,96,62,34,242,192,50,12,0.0,0.0
1006,1604,2020-03-19 19:02:00,0,3177.0,2585.0,0.814,15.379,347,72,31,41,275,224,51,4,0.0,0.0
1006,1605,2020-03-19 19:05:00,0,3417.0,2743.0,0.803,16.501,169,49,25,24,120,83,37,0,0.0,0.0
1006,1606,2020-03-19 19:08:00,0,3313.0,2687.0,0.811,16.028,273,24,3,21,249,181,68,1,0.0,0.0
1006,1607,2020-03-19 19:11:00,0,3244.0,2638.0,0.813,15.701,364,128,91,37,236,173,63,8,0.02,0.0
1006,1608,2020-03-19 19:14:00,0,3171.0,2561.0,0.807,15.329,189,26,15,11,163,96,67,10,0.0,0.0
1006,1609,2020-03-19 19:17:00,0,3048.0,2401.0,0.788,14.667,52,0,0,0,52,0,52,0,0.0,0.0
1006,1610,2020-03-19 19:20:00,0,2830.0,2227.0,0.787,13.617,86,35,9,26,51,6,45,0,0.0,0.0
1006,1611,2020-03-19 19:23:00,0,2668.0,2153.0,0.807,12.895,65,6,3,3,59,6,53,0,0.0,0.0
1006,1612,2020-03-19 19:26:00,0,2693.0,2051.0,0.762,12.882,58,5,1,4,53,2,51,0,0.0,0.0
1006,1613,2020-03-19 19:29:00,0,2698.0,2012.0,0.746,12.857,48,2,0,2,46,0,46,0,0.0,0.0
1006,1614,2020-03-19 19:32:00,0,2699.0,1990.0,0.737,12.838,58,5,0,5,53,0,53,0,0.0,0.0
1006,1615,2020-03-19 19:35:00,0,2711.0,1967.0,0.726,12.86,82,9,2,7,73,20,53,0,0.0,0.0
1006,1616,2020-03-19 19:38:00,0,2696.0,2006.0,0.744,12.845,63,0,0,0,63,2,61,0,0.0,0.0
1006,1617,2020-03-19 19:41:00,0,2702.0,1950.0,0.722,12.804,72,6,3,3,66,4,62,0,0.0,0.0
1006,1618,2020-03-19 19:44:00,0,2635.0,1932.0,0.733,12.521,247,55,15,40,192,113,79,4,0.0,0.0
1006,1619,2020-03-19 19:47:00,0,2842.0,2118.0,0.745,13.544,134,33,8,25,101,33,68,1,0.0,0.0
1006,1620,2020-03-19 19:50:00,0,2905.0,2252.0,0.775,13.939,119,25,2,23,94,24,70,4,0.0,0.0
1006,1621,2020-03-19 19:53:00,0,3068.0,2350.0,0.766,14.69,226,80,42,38,146,67,79,14,0.0,0.0
1006,1622,2020-03-19 19:56:00,0,3436.0,2644.0,0.77,16.465,626,214,160,54,412,317,95,30,0.0,0.0
1006,1623,2020-03-19 19:59:00,0,3285.0,2553.0,0.777,15.77,572,222,168,54,350,256,94,38,0.0,0.0
1006,1624,2020-03-19 20:02:00,0,2918.0,2238.0,0.767,13.975,352,120,75,45,232,156,76,22,0.01,0.0
1006,1625,2020-03-19 20:05:00,0,3073.0,2318.0,0.755,14.6745,247,64,38,26,183,114,69,29,0.0,0.0
1006,1626,2020-03-19 20:08:00,0,3228.0,2398.0,0.743,15.374,368,116,79,37,252,169,83,16,0.06,0.0
1006,1627,2020-03-19 20:11:00,0,3064.0,2320.0,0.757,14.643,282,92,61,31,190,117,73,13,0.1,0.0
1006,1628,2020-03-19 20:14:00,0,3068.0,2340.0,0.763,14.677,152,35,11,24,117,49,68,0,0.0,0.0
1006,1629,2020-03-19 20:17:00,0,3082.0,2266.0,0.735,14.651,195,30,8,22,165,84,81,0,0.0,0.0
1006,1630,2020-03-19 20:20:00,0,3010.0,2249.0,0.747,14.349,166,57,32,25,109,44,65,0,0.0,0.0
1006,1631,2020-03-19 20:23:00,0,2852.0,2117.0,0.742,13.58,87,14,1,13,73,18,55,0,0.0,0.0
1006,1632,2020-03-19 20:26:00,0,2714.0,1979.0,0.729,12.884,82,13,2,11,69,8,61,0,0.0,0.0
1006,1633,2020-03-19 20:29:00,0,2565.0,1859.0,0.725,12.165,58,0,0,0,58,0,58,0,0.0,0.0
1006,1634,2020-03-19 20:32:00,0,2322.0,1756.0,0.756,11.095,50,0,0,0,50,0,50,0,0.0,0.0
1006,1635,2020-03-19 20:35:00,0,2324.0,1738.0,0.748,11.083,55,0,0,0,55,0,55,0,0.0,0.0
1006,1636,2020-03-19 20:38:00,0,2328.0,1731.0,0.744,11.091,49,0,0,0,49,0,49,0,0.0,0.0
1006,1637,2020-03-19 20:41:00,0,2553.0,1896.0,0.743,12.159,88,30,13,17,58,5,53,0,0.0,0.0
1006,1638,2020-03-19 20:44:00,0,2711.0,1992.0,0.735,12.888,72,1,1,0,71,10,61,0,0.0,0.0
1006,1639,2020-03-19 20:47:00,0,2709.0,1971.0,0.728,12.854,85,15,9,6,70,6,64,0,0.0,0.0
1006,1640,2020-03-19 20:50:00,0,2728.0,1919.0,0.704,12.875,53,3,0,3,50,0,50,0,0.0,0.0
1006,1641,2020-03-19 20:53:00,0,2731.0,1932.0,0.708,12.9,77,0,0,0,77,6,71,0,0.0,0.0
1006,1642,2020-03-19 20:56:00,0,2716.0,1923.0,0.708,12.832,322,97,69,28,225,137,88,14,0.0,0.0
1006,1643,2020-03-19 20:59:00,0,3214.0,2437.0,0.758,15.36,538,180,123,57,358,275,83,31,0.0,0.0
1006,1644,2020-03-19 21:02:00,0,3075.0,2236.0,0.727,14.591,321,112,66,46,209,131,78,44,0.0,0.0
1006,1645,2020-03-19 21:05:00,0,3234.0,2365.0,0.731,15.362,222,103,59,44,119,59,60,26,0.0,0.0
1006,1646,2020-03-19 21:08:00,0,3223.0,2417.0,0.75,15.376,232,76,35,41,156,78,78,24,0.0,0.0
1006,1647,2020-03-19 21:11:00,0,3452.0,2613.0,0.757,16.496,606,277,219,58,329,253,76,127,0.0,0.0
1006,1648,2020-03-19 21:14:00,0,3296.0,2492.0,0.756,15.745,504,191,136,55,313,218,95,41,0.21,0.0
1006,1649,2020-03-19 21:17:00,0,3456.0,2584.0,0.748,16.478,575,151,90,61,424,321,103,11,0.0,0.03
1006,1650,2020-03-19 21:20:00,0,3450.0,2607.0,0.756,16.481,600,141,84,57,459,356,103,0,0.0,0.0
1006,1651,2020-03-19 21:23:00,0,3436.0,2599.0,0.756,16.416,898,271,192,79,627,498,129,20,0.0,0.01
1006,1652,2020-03-19 21:26:00,0,3449.0,2571.0,0.745,16.438,739,251,180,71,488,361,127,17,0.0,0.0
1006,1653,2020-03-19 21:29:00,0,3228.0,2398.0,0.743,15.375,583,258,187,71,325,237,88,25,0.0,0.0
1006,1654,2020-03-19 21:32:00,0,2857.0,2128.0,0.745,13.612,446,165,122,43,281,181,100,26,0.0,0.02
1006,1655,2020-03-19 21:35:00,0,3235.0,2384.0,0.737,15.388,354,105,76,29,249,166,83,43,0.08,0.0
1006,1656,2020-03-19 21:38:00,0,3301.0,2463.0,0.746,15.733,377,152,107,45,225,163,62,23,0.0,0.0
1006,1657,2020-03-19 21:41:00,0,3156.0,2334.0,0.739,15.018,458,196,139,57,262,163,99,60,0.0,0.0
1006,1658,2020-03-19 21:44:00,0,3089.0,2267.0,0.734,14.68,205,56,23,33,149,63,86,2,0.0,0.0
1006,1659,2020-03-19 21:47:00,0,3156.0,2297.0,0.728,14.978,169,55,28,27,114,35,79,8,0.0,0.0
1006,1660,2020-03-19 21:50:00,0,3085.0,2265.0,0.734,14.662,190,27,13,14,163,86,77,0,0.0,0.0
1006,1661,2020-03-19 21:53:00,0,2862.0,2110.0,0.737,13.612,69,0,0,0,69,4,65,0,0.0,0.0
1006,1662,2020-03-19 21:56:00,0,2722.0,1943.0,0.714,12.877,70,2,1,1,68,4,64,0,0.0,0.0
1006,1663,2020-03-19 21:59:00,0,2581.0,1825.0,0.707,12.19,125,7,1,6,118,52,66,0,0.0,0.0
1006,1664,2020-03-19 22:02:00,0,2332.0,1725.0,0.74,11.099,90,10,0,10,80,18,62,0,0.0,0.0
1006,1665,2020-03-19 22:05:00,0,2340.0,1687.0,0.721,11.09,160,34,16,18,126,63,63,13,0.0,0.0
1006,1666,2020-03-19 22:08:00,0,2873.0,2083.0,0.725,13.626,625,275,194,81,350,259,91,60,0.0,0.03
1006,1667,2020-03-19 22:11:00,0,3083.0,2248.0,0.729,14.635,746,307,212,95,439,326,113,38,0.0,0.0
1006,1668,2020-03-19 22:14:00,0,3256.0,2354.0,0.723,15.436,775,353,245,108,422,317,105,19,0.0,0.0
1006,1669,2020-03-19 22:17:00,0,2700.0,2037.0,0.755,12.893,386,194,134,60,192,132,60,42,0.0,0.0
1006,1670,2020-03-19 22:20:00,0,3070.0,2275.0,0.741,14.614,263,91,62,29,172,98,74,9,0.0,0.0
1006,1671,2020-03-19 22:23:00,0,3065.0,2273.0,0.742,14.592,220,65,32,33,155,79,76,9,0.0,0.0
1006,1672,2020-03-19 22:26:00,0,3096.0,2245.0,0.725,14.686,133,16,11,5,117,58,59,0,0.0,0.0
1006,1673,2020-03-19 22:29:00,0,2844.0,2135.0,0.751,13.568,379,187,136,51,192,117,75,36,0.0,0.0
1006,1674,2020-03-19 22:32:00,0,2935.0,2183.0,0.744,13.981,464,237,178,59,227,152,75,73,0.04,0.0
1006,1675,2020-03-19 22:35:00,0,3086.0,2237.0,0.725,14.637,264,150,104,46,114,62,52,69,0.01,0.0
1006,1676,2020-03-19 22:38:00,0,2844.0,2146.0,0.755,13.579,506,220,162,58,286,195,91,67,0.01,0.0
1006,1677,2020-03-19 22:41:00,0,3075.0,2306.0,0.75,14.667,541,246,173,73,295,227,68,105,0.0,0.02
1006,1678,2020-03-19 22:44:00,0,3209.0,2405.0,0.749,15.305,456,227,153,74,229,153,76,7,0.16,0.0
1006,1679,2020-03-19 22:47:00,0,2576.0,1814.0,0.704,12.158,139,64,34,30,75,38,37,0,0.0,0.0
1006,1680,2020-03-19 22:50:00,0,3098.0,2228.0,0.719,14.673,526,235,181,54,291,212,79,101,0.0,0.0
1006,1681,2020-03-19 22:53:00,0,3174.0,2310.0,0.728,15.064,348,165,118,47,183,125,58,114,0.0,0.0
1006,1682,2020-03-19 22:56:00,0,3025.0,2174.0,0.719,14.324,325,142,92,50,183,107,76,23,0.0,0.0
1006,1683,2020-03-19 22:59:00,0,3107.0,2212.0,0.712,14.692,149,71,36,35,78,11,67,0,0.0,0.0
1006,1684,2020-03-19 23:02:00,0,3103.0,2212.0,0.713,14.673,240,118,68,50,122,53,69,2,0.0,0.0
1006,1685,2020-03-19 23:05:00,0,3004.0,2222.0,0.7405,14.296,404,153,120,33,251,168,83,7,0.0,0.0
1006,1686,2020-03-19 23:08:00,0,2905.0,2232.0,0.768,13.919,415,145,91,54,270,182,88,23,0.13,0.0
1006,1687,2020-03-19 23:11:00,0,2825.0,2198.0,0.778,13.565,484,163,111,52,321,225,96,19,0.0,0.0
1006,1688,2020-03-19 23:14:00,0,3076.0,2263.0,0.736,14.627,212,44,15,29,168,98,70,2,0.0,0.0
1006,1689,2020-03-19 23:17:00,0,2841.0,2208.0,0.777,13.638,425,98,73,25,327,225,102,18,0.0,0.0
1006,1690,2020-03-19 23:20:00,0,2857.0,2158.0,0.755,13.647,315,153,106,47,162,88,74,19,0.08,0.01
1006,1691,2020-03-19 23:23:00,0,2833.0,2201.0,0.777,13.601,390,143,95,48,247,166,81,40,0.0,0.0
1006,1692,2020-03-19 23:26:00,0,3001.0,2281.0,0.76,14.35,201,34,2,32,167,88,79,31,0.0,0.0
1006,1693,2020-03-19 23:29:00,0,3060.0,2365.0,0.773,14.675,479,195,139,56,284,182,102,41,0.03,0.0
1006,1694,2020-03-19 23:32:00,0,2981.0,2331.0,0.782,14.328,539,266,195,71,273,195,78,54,0.0,0.0
1006,1695,2020-03-19 23:35:00,0,2905.0,2304.0,0.793,13.997,560,228,163,65,332,250,82,136,0.02,0.0
1006,1696,2020-03-19 23:38:00,0,2834.0,2194.0,0.774,13.594,439,188,119,69,251,160,91,4,0.0,0.0
1006,1697,2020-03-19 23:41:00,0,2698.0,2055.0,0.762,12.905,249,79,43,36,170,99,71,3,0.0,0.0
1006,1698,2020-03-19 23:44:00,0,2903.0,2252.0,0.776,13.932,463,160,113,47,303,215,88,5,0.0,0.0
1006,1699,2020-03-19 23:47:00,0,2832.0,2214.0,0.782,13.609,278,136,87,49,142,71,71,2,0.0,0.0
1006,1700,2020-03-19 23:50:00,0,2772.0,2096.0,0.756,13.243,320,93,46,47,227,134,93,5,0.0,0.0
1006,1701,2020-03-19 23:53:00,0,2686.0,2031.0,0.756,12.833,281,65,29,36,216,132,84,0,0.08,0.0
1006,1702,2020-03-19 23:56:00,0,2681.0,2080.0,0.776,12.868,266,121,74,47,145,74,71,5,0.0,0.0
1006,1703,2020-03-19 23:59:00,0,2683.0,2075.0,0.774,12.868,523,128,74,54,395,307,88,8,0.0,0.0
1006,1704,2020-03-20 00:02:00,0,2673.0,2123.0,0.794,12.881,375,115,53,62,260,187,73,0,0.0,0.0
1006,1705,2020-03-20 00:05:00,0,2837.0,2187.0,0.771,13.6,471,136,83,53,335,253,82,21,0.0,0.0
1006,1706,2020-03-20 00:08:00,0,2683.0,2073.0,0.773,12.867,187,66,31,35,121,55,66,19,0.0,0.0
1006,1707,2020-03-20 00:11:00,0,2764.0,2151.0,0.778,13.271,192,31,3,28,161,84,77,4,0.0,0.0
1006,1708,2020-03-20 00:14:00,0,2761.0,2149.0,0.778,13.256,148,54,24,30,94,27,67,2,0.0,0.0
1006,1709,2020-03-20 00:17:00,0,2675.0,2123.0,0.794,12.89,194,32,3,29,162,82,80,0,0.0,0.0
1006,1710,2020-03-20 00:20:00,0,2681.0,2080.0,0.776,12.865,72,5,4,1,67,0,67,0,0.0,0.0
1006,1711,2020-03-20 00:23:00,0,2538.0,1916.0,0.755,12.122,72,4,0,4,68,0,68,0,0.0,0.0
1006,1712,2020-03-20 00:26:00,0,2318.0,1778.0,0.767,11.102,69,1,0,1,68,0,68,0,0.0,0.0
1006,1713,2020-03-20 00:29:00,0,2167.0,1672.0,0.771,10.39,83,4,0,4,79,0,79,0,0.0,0.0
1006,1714,2020-03-20 00:32:00,0,2190.0,1570.0,0.717,10.366,66,0,0,0,66,4,62,0,0.0,0.0
1006,1715,2020-03-20 00:35:00,0,2017.0,1537.0,0.762,9.651,68,0,0,0,68,2,66,0,0.0,0.0
1006,1716,2020-03-20 00:38:00,0,2186.0,1593.0,0.729,10.377,84,1,0,1,83,15,68,0,0.0,0.0
1006,1717,2020-03-20 00:41:00,0,2338.0,1700.0,0.727,11.093,73,0,0,0,73,0,73,0,0.0,0.0
1006,1718,2020-03-20 00:44:00,0,2498.0,1790.0,0.716,11.825,67,1,0,1,66,2,64,0,0.0,0.0
1006,1719,2020-03-20 00:47:00,0,2559.0,1887.0,0.737,12.172,300,84,48,36,216,135,81,18,0.0,0.0
1006,1720,2020-03-20 00:50:00,0,2852.0,2130.0,0.747,13.594,723,336,251,85,387,298,89,54,0.0,0.0
1006,1721,2020-03-20 00:53:00,0,2690.0,2060.0,0.766,12.881,389,180,123,57,209,120,89,14,0.11,0.0
1006,1722,2020-03-20 00:56:00,0,2861.0,2101.0,0.734,13.598,100,14,2,12,86,19,67,1,0.0,0.0
1006,1723,2020-03-20 00:59:00,0,2722.0,1955.0,0.718,12.889,100,27,0,27,73,0,73,0,0.0,0.0
1006,1724,2020-03-20 01:02:00,0,2575.0,1810.0,0.703,12.15,56,0,0,0,56,0,56,0,0.0,0.0
1006,1725,2020-03-20 01:05:00,0,2338.0,1702.0,0.728,11.098,61,0,0,0,61,0,61,0,0.0,0.0
1006,1726,2020-03-20 01:08:00,0,2267.0,1615.0,0.712,10.722,58,0,0,0,58,2,56,0,0.0,0.0
1006,1727,2020-03-20 01:11:00,0,2329.0,1734.0,0.744,11.098,66,0,0,0,66,4,62,0,0.0,0.0
1006,1728,2020-03-20 01:14:00,0,2327.0,1701.0,0.731,11.053,100,16,1,15,84,18,66,0,0.0,0.0
1006,1729,2020-03-20 01:17:00,0,2264.0,1629.0,0.719,10.723,73,6,0,6,67,0,67,0,0.0,0.0
1006,1730,2020-03-20 01:20:00,0,2195.0,1575.0,0.717,10.394,66,0,0,0,66,2,64,0,0.0,0.0
1006,1731,2020-03-20 01:23:00,0,2347.0,1667.0,0.71,11.094,149,30,16,14,119,51,68,2,0.0,0.0
1006,1732,2020-03-20 01:26:00,0,2414.0,1746.0,0.723,11.445,197,47,8,39,150,76,74,11,0.0,0.0
1006,1733,2020-03-20 01:29:00,0,2716.0,1972.0,0.726,12.884,397,147,109,38,250,172,78,42,0.0,0.0
1006,1734,2020-03-20 01:32:00,0,2771.0,2087.0,0.753,13.23,320,130,97,33,190,126,64,54,0.0,0.0
1006,1735,2020-03-20 01:35:00,0,3223.0,2421.0,0.751,15.379,400,133,94,39,267,191,76,33,0.0,0.0
1006,1736,2020-03-20 01:38:00,0,3211.0,2455.0,0.765,15.369,604,329,233,96,275,191,84,26,0.0,0.0
1006,1737,2020-03-20 01:41:00,0,3226.0,2384.0,0.739,15.348,478,262,181,81,216,164,52,22,0.03,0.0
1006,1738,2020-03-20 01:44:00,0,3301.0,2462.0,0.746,15.731,514,224,152,72,290,217,73,18,0.04,0.0
1006,1739,2020-03-20 01:47:00,0,2553.0,1894.0,0.742,12.156,286,90,61,29,196,140,56,18,0.0,0.0
1006,1740,2020-03-20 01:50:00,0,2850.0,2106.0,0.739,13.559,72,30,15,15,42,23,19,8,0.0,0.0
1006,1741,2020-03-20 01:53:00,0,3077.0,2323.0,0.755,14.694,496,266,208,58,230,166,64,82,0.2,0.0
1006,1742,2020-03-20 01:56:00,0,2853.0,2154.0,0.755,13.625,282,104,82,22,178,117,61,22,0.0,0.0
1006,1743,2020-03-20 01:59:00,0,3090.0,2235.0,0.723,14.648,248,96,60,36,152,98,54,4,0.0,0.0
1006,1744,2020-03-20 02:02:00,0,3090.0,2249.0,0.728,14.667,366,172,137,35,194,130,64,35,0.0,0.0
1006,1745,2020-03-20 02:05:00,0,2905.5,2104.5,0.724,13.7795,82,27,12,15,55,21,34,4,0.0,0.0
1006,1746,2020-03-20 02:08:00,0,2721.0,1960.0,0.72,12.892,60,10,2,8,50,26,24,1,0.0,0.0
1006,1747,2020-03-20 02:11:00,0,2858.0,2125.0,0.743,13.614,83,34,22,12,49,19,30,1,0.0,0.0
1006,1748,2020-03-20 02:14:00,0,2695.0,2034.0,0.755,12.871,35,0,0,0,35,0,35,0,0.0,0.0
1006,1749,2020-03-20 02:17:00,0,2555.0,1881.0,0.736,12.15,74,40,3,37,34,0,34,0,0.0,0.0
1006,1750,2020-03-20 02:20:00,0,2411.0,1766.0,0.733,11.454,58,9,4,5,49,6,43,0,0.0,0.0
1006,1751,2020-03-20 02:23:00,0,2261.0,1635.0,0.723,10.717,42,4,1,3,38,8,30,0,0.0,0.0
1006,1752,2020-03-20 02:26:00,0,2200.0,1555.0,0.707,10.391,38,0,0,0,38,0,38,0,0.0,0.0
1006,1753,2020-03-20 02:29:00,0,2043.0,1462.0,0.716,9.668,35,0,0,0,35,0,35,0,0.0,0.0
1006,1754,2020-03-20 02:32:00,0,1944.0,1465.0,0.754,9.284,35,0,0,0,35,2,33,0,0.0,0.0
1006,1755,2020-03-20 02:35:00,0,2041.0,1447.0,0.709,9.643,36,0,0,0,36,0,36,0,0.0,0.0
1006,1756,2020-03-20 02:38:00,0,1969.0,1398.0,0.71,9.308,31,0,0,0,31,0,31,0,0.0,0.0
1006,1757,2020-03-20 02:41:00,0,1798.0,1362.0,0.757,8.593,35,0,0,0,35,0,35,0,0.0,0.0
1006,1758,2020-03-20 02:44:00,0,1966.0,1387.0,0.705,9.282,32,3,0,3,29,0,29,0,0.0,0.0
1006,1759,2020-03-20 02:47:00,0,1947.0,1441.0,0.741,9.266,36,0,0,0,36,0,36,0,0.0,0.0
1006,1760,2020-03-20 02:50:00,0,2041.0,1478.0,0.724,9.678,35,0,0,0,35,0,35,0,0.0,0.0
1006,1761,2020-03-20 02:53:00,0,2190.0,1552.0,0.709,10.346,83,15,7,8,68,20,48,7,0.0,0.0
1006,1762,2020-03-20 02:56:00,0,2571.0,1805.0,0.702,12.128,429,170,130,40,259,175,84,55,0.0,0.0
1006,1763,2020-03-20 02:59:00,0,2696.0,1986.0,0.737,12.821,375,156,108,48,219,147,72,52,0.0,0.0
1006,1764,2020-03-20 03:02:00,0,2860.0,2085.0,0.729,13.576,139,62,14,48,77,27,50,9,0.0,0.0
1006,1765,2020-03-20 03:05:00,0,2830.0,2148.0,0.759,13.527,442,238,190,48,204,153,51,196,0.0,0.0
1006,1766,2020-03-20 03:08:00,0,2931.0,2223.0,0.758,14.011,461,234,192,42,227,174,53,189,0.0,0.0
1006,1767,2020-03-20 03:11:00,0,3081.0,2300.0,0.747,14.688,296,160,123,37,136,92,44,18,0.0,0.0
1006,1768,2020-03-20 03:14:00,0,2927.0,2172.0,0.742,13.936,220,119,71,48,101,48,53,41,0.0,0.0
1006,1769,2020-03-20 03:17:00,0,2851.0,2117.0,0.743,13.578,211,68,39,29,143,86,57,0,0.0,0.0
1006,1770,2020-03-20 03:20:00,0,2933.0,2164.0,0.738,13.951,308,145,95,50,163,117,46,3,0.0,0.0
1006,1771,2020-03-20 03:23:00,0,2855.0,2122.0,0.743,13.597,399,217,165,52,182,123,59,12,0.0,0.0
1006,1772,2020-03-20 03:26:00,0,2858.0,2114.0,0.739,13.602,353,164,114,50,189,132,57,41,0.0,0.0
1006,1773,2020-03-20 03:29:00,0,2875.0,2064.0,0.718,13.612,513,109,56,53,404,338,66,9,0.0,0.0
1006,1774,2020-03-20 03:32:00,0,2913.0,2213.0,0.76,13.928,399,163,122,41,236,179,57,18,0.07,0.0
1006,1775,2020-03-20 03:35:00,0,2562.0,1862.0,0.727,12.155,164,79,41,38,85,40,45,5,0.01,0.0
1006,1776,2020-03-20 03:38:00,0,2700.0,1965.0,0.728,12.813,133,34,14,20,99,48,51,2,0.0,0.0
1006,1777,2020-03-20 03:41:00,0,2856.0,2134.0,0.747,13.614,191,70,35,35,121,69,52,8,0.0,0.0
1006,1778,2020-03-20 03:44:00,0,2861.0,2131.0,0.745,13.631,399,200,152,48,199,149,50,61,0.0,0.0
1006,1779,2020-03-20 03:47:00,0,2771.0,2089.0,0.754,13.231,442,208,151,57,234,162,72,7,0.0,0.0
1006,1780,2020-03-20 03:50:00,0,2697.0,2053.0,0.761,12.899,185,32,14,18,153,74,79,39,0.0,0.0
1006,1781,2020-03-20 03:53:00,0,2706.0,2011.0,0.743,12.889,120,26,12,14,94,28,66,9,0.0,0.0
1006,1782,2020-03-20 03:56:00,0,2710.0,1980.0,0.731,12.868,129,52,26,26,77,18,59,5,0.0,0.0
1006,1783,2020-03-20 03:59:00,0,2555.0,1873.0,0.733,12.143,83,19,10,9,64,0,64,0,0.0,0.0
1006,1784,2020-03-20 04:02:00,0,2337.0,1722.0,0.737,11.117,87,18,8,10,69,11,58,0,0.0,0.0
1006,1785,2020-03-20 04:05:00,0,2191.0,1599.0,0.73,10.405,105,33,1,32,72,11,61,0,0.0,0.0
1006,1786,2020-03-20 04:08:00,0,2191.0,1580.0,0.721,10.383,628,303,232,71,325,240,85,12,0.03,0.0
1006,1787,2020-03-20 04:11:00,0,2159.0,1633.0,0.756,10.314,246,84,54,30,162,112,50,10,0.0,0.0
1006,1788,2020-03-20 04:14:00,0,2178.0,1627.0,0.747,10.381,64,6,4,2,58,5,53,0,0.0,0.0
1006,1789,2020-03-20 04:17:00,0,2023.0,1506.0,0.744,9.64,51,0,0,0,51,2,49,0,0.0,0.0
1006,1790,2020-03-20 04:20:00,0,1871.0,1394.0,0.745,8.914,58,0,0,0,58,2,56,0,0.0,0.0
1006,1791,2020-03-20 04:23:00,0,1965.0,1428.0,0.727,9.324,82,4,1,3,78,26,52,0,0.03,0.0
1006,1792,2020-03-20 04:26:00,0,2033.0,1471.0,0.724,9.64,125,0,0,0,125,78,47,0,0.01,0.0
1006,1793,2020-03-20 04:29:00,0,2035.0,1474.0,0.724,9.652,178,8,3,5,170,104,66,0,0.0,0.0
1006,1794,2020-03-20 04:32:00,0,2022.0,1498.0,0.741,9.626,94,19,9,10,75,14,61,0,0.0,0.0
1006,1795,2020-03-20 04:35:00,0,1965.0,1417.0,0.721,9.312,119,4,0,4,115,53,62,0,0.01,0.0
1006,1796,2020-03-20 04:38:00,0,1949.0,1469.0,0.754,9.307,109,1,0,1,108,37,71,0,0.0,0.0
1006,1797,2020-03-20 04:41:00,0,1957.0,1438.0,0.735,9.303,59,2,1,1,57,0,57,0,0.01,0.0
1006,1798,2020-03-20 04:44:00,0,1957.0,1399.0,0.715,9.262,58,0,0,0,58,0,58,0,0.02,0.0
1006,1799,2020-03-20 04:47:00,0,1884.0,1386.0,0.736,8.957,61,2,1,1,59,0,59,0,0.0,0.0
1006,1800,2020-03-20 04:50:00,0,1890.0,1371.0,0.725,8.965,71,18,3,15,53,0,53,0,0.0,0.0
1006,1801,2020-03-20 04:53:00,0,1792.0,1348.0,0.752,8.555,62,1,0,1,61,2,59,0,0.0,0.0
1006,1802,2020-03-20 04:56:00,0,1802.0,1319.0,0.732,8.562,61,0,0,0,61,0,61,0,0.0,0.0
1006,1803,2020-03-20 04:59:00,0,1818.0,1280.0,0.704,8.582,97,13,8,5,84,30,54,0,0.0,0.0
1006,1804,2020-03-20 05:02:00,0,1820.0,1288.0,0.708,8.595,56,0,0,0,56,4,52,0,0.0,0.0
1006,1805,2020-03-20 05:05:00,0,1858.5,1292.5,0.696,8.7525,53,3,0,3,50,0,50,0,0.0,0.0
1006,1806,2020-03-20 05:08:00,0,1897.0,1297.0,0.684,8.91,85,32,23,9,53,0,53,0,0.01,0.0
1006,1807,2020-03-20 05:11:00,0,2055.0,1414.0,0.688,9.662,182,62,20,42,120,52,68,18,0.02,0.0
1006,1808,2020-03-20 05:14:00,0,2441.0,1688.0,0.692,11.486,171,29,6,23,142,68,74,12,0.0,0.0
1006,1809,2020-03-20 05:17:00,0,2647.0,1878.0,0.709,12.51,370,140,87,53,230,152,78,17,0.14,0.0
1006,1810,2020-03-20 05:20:00,0,2857.0,2081.0,0.729,13.56,526,230,180,50,296,214,82,87,0.0,0.0
1006,1811,2020-03-20 05:23:00,0,2864.0,2078.0,0.726,13.584,458,204,151,53,254,188,66,63,0.0,0.0
1006,1812,2020-03-20 05:26:00,0,2954.0,2095.0,0.709,13.958,207,61,48,13,146,74,72,8,0.0,0.0
1006,1813,2020-03-20 05:29:00,0,2788.0,2045.0,0.733,13.251,128,22,1,21,106,30,76,2,0.0,0.0
1006,1814,2020-03-20 05:32:00,0,2789.0,2030.0,0.728,13.236,168,13,4,9,155,74,81,6,0.0,0.0
1006,1815,2020-03-20 05:35:00,0,2647.0,1895.0,0.716,12.527,61,0,0,0,61,2,59,0,0.0,0.0
1006,1816,2020-03-20 05:38:00,0,2406.0,1751.0,0.728,11.419,79,0,0,0,79,11,68,0,0.0,0.0
1006,1817,2020-03-20 05:41:00,0,2273.0,1622.0,0.714,10.752,220,68,43,25,152,75,77,5,0.0,0.0
1006,1818,2020-03-20 05:44:00,0,2423.0,1684.0,0.695,11.413,508,212,166,46,296,211,85,31,0.12,0.0
1006,1819,2020-03-20 05:47:00,0,2431.0,1683.0,0.692,11.443,226,62,35,27,164,86,78,3,0.0,0.0
1006,1820,2020-03-20 05:50:00,0,2419.0,1713.0,0.708,11.429,107,18,2,16,89,29,60,4,0.0,0.0
1006,1821,2020-03-20 05:53:00,0,2274.0,1607.0,0.707,10.74,68,4,1,3,64,4,60,0,0.0,0.0
1006,1822,2020-03-20 05:56:00,0,2119.0,1505.0,0.71,10.017,61,0,0,0,61,0,61,0,0.0,0.0
1006,1823,2020-03-20 05:59:00,0,2049.0,1413.0,0.69,9.638,98,36,1,35,62,2,60,0,0.0,0.0
1006,1824,2020-03-20 06:02:00,1,2106.0,1561.0,0.741,10.027,321,142,103,39,179,108,71,23,0.0,0.0
1006,1825,2020-03-20 06:05:00,1,3162.0,2329.0,0.737,15.038,347,70,47,23,277,192,85,37,0.0,0.06
1006,1826,2020-03-20 06:08:00,1,3533.0,2613.0,0.74,16.814,215,67,34,33,148,103,45,24,0.0,0.24
1006,1827,2020-03-20 06:11:00,1,3536.0,2638.0,0.746,16.852,397,129,91,38,268,231,37,80,0.0,0.29
1006,1828,2020-03-20 06:14:00,1,3227.0,2405.0,0.745,15.377,518,227,167,60,291,251,40,116,0.25,0.03
1006,1829,2020-03-20 06:17:00,1,3423.0,2635.0,0.77,16.404,187,102,79,23,85,60,25,35,0.15,0.0
1006,1830,2020-03-20 06:20:00,1,3635.0,2903.0,0.799,17.538,69,34,2,32,35,10,25,0,0.0,0.0
1006,1831,2020-03-20 06:23:00,1,2873.0,2358.0,0.821,13.931,474,207,153,54,267,218,49,40,0.0,0.0
1006,1832,2020-03-20 06:26:00,1,3312.0,2729.0,0.824,16.072,188,82,53,29,106,76,30,23,0.0,0.0
1006,1833,2020-03-20 06:29:00,1,2895.0,2310.0,0.798,13.964,519,306,222,84,213,148,65,14,0.0,0.0
1006,1834,2020-03-20 06:32:00,1,3111.0,2503.0,0.805,15.029,394,241,170,71,153,98,55,11,0.0,0.0
1006,1835,2020-03-20 06:35:00,1,3248.0,2682.0,0.826,15.766,200,118,70,48,82,50,32,6,0.0,0.0
1006,1836,2020-03-20 06:38:00,1,3474.0,2809.0,0.809,16.799,115,28,15,13,87,63,24,22,0.15,0.03
1006,1837,2020-03-20 06:41:00,1,2857.0,2428.0,0.85,13.944,222,113,75,38,109,61,48,20,0.0,0.01
1006,1838,2020-03-20 06:44:00,1,3086.0,2601.0,0.843,15.04,96,39,2,37,57,18,39,3,0.0,0.0
1006,1839,2020-03-20 06:47:00,1,3079.0,2637.0,0.857,15.05,127,46,25,21,81,41,40,1,0.0,0.0
1006,1840,2020-03-20 06:50:00,1,3151.0,2689.0,0.853,15.393,84,18,5,13,66,30,36,1,0.0,0.0
1006,1841,2020-03-20 06:53:00,1,3092.0,2586.0,0.836,15.044,44,3,2,1,41,11,30,0,0.0,0.0
1006,1842,2020-03-20 06:56:00,1,2859.0,2472.0,0.865,13.999,30,0,0,0,30,8,22,0,0.0,0.0
1006,1843,2020-03-20 06:59:00,1,2738.0,2243.0,0.819,13.274,21,5,2,3,16,3,13,0,0.0,0.0
1006,1844,2020-03-20 07:02:00,1,2645.0,2234.0,0.845,12.895,10,0,0,0,10,0,10,0,0.0,0.0
1006,1845,2020-03-20 07:05:00,1,2571.0,2175.0,0.846,12.538,97,47,38,9,50,33,17,2,0.0,0.01
1006,1846,2020-03-20 07:08:00,1,3438.0,2979.0,0.866,16.843,96,28,12,16,68,45,23,15,0.24,0.15
1006,1847,2020-03-20 07:11:00,1,2717.0,2343.0,0.862,13.297,245,121,88,33,124,78,46,16,0.0,0.0
1006,1848,2020-03-20 07:14:00,1,3055.0,2705.0,0.886,15.03,369,202,144,58,167,111,56,12,0.02,0.02
1006,1849,2020-03-20 07:17:00,1,2835.0,2555.0,0.901,14.0,45,14,6,8,31,5,26,0,0.0,0.0
1006,1850,2020-03-20 07:20:00,1,2855.0,2507.0,0.878,14.023,37,11,5,6,26,5,21,0,0.0,0.0
1006,1851,2020-03-20 07:23:00,1,2691.0,2370.0,0.881,13.225,68,0,0,0,68,24,44,0,0.0,0.0
1006,1852,2020-03-20 07:26:00,1,2677.0,2438.0,0.911,13.246,97,22,8,14,75,29,46,1,0.0,0.0
1006,1853,2020-03-20 07:29:00,1,2844.0,2519.0,0.886,13.994,61,35,6,29,26,8,18,0,0.0,0.0
1006,1854,2020-03-20 07:32:00,1,2841.0,2488.0,0.876,13.949,27,4,0,4,23,2,21,0,0.0,0.0
1006,1855,2020-03-20 07:35:00,1,2703.0,2380.0,0.881,13.284,24,0,0,0,24,0,24,0,0.0,0.0
1006,1856,2020-03-20 07:38:00,1,2564.0,2171.0,0.846,12.506,32,1,0,1,31,4,27,0,0.0,0.0
1006,1857,2020-03-20 07:41:00,1,2572.0,2203.0,0.857,12.573,43,23,9,14,20,2,18,0,0.0,0.0
1006,1858,2020-03-20 07:44:00,1,2559.0,2211.0,0.864,12.532,19,2,0,2,17,0,17,0,0.0,0.0
1006,1859,2020-03-20 07:47:00,1,2564.0,2194.0,0.856,12.533,18,2,0,2,16,0,16,0,0.0,0.0
1006,1860,2020-03-20 07:50:00,1,2565.0,2187.0,0.853,12.529,18,0,0,0,18,0,18,0,0.0,0.0
1006,1861,2020-03-20 07:53:00,1,2920.0,2605.0,0.892,14.388,119,43,24,19,76,57,19,3,0.0,0.17
1006,1862,2020-03-20 07:56:00,1,3348.0,2994.0,0.894,16.507,142,58,38,20,84,48,36,23,0.18,0.06
1006,1863,2020-03-20 07:59:00,1,2757.0,2493.0,0.904,13.624,62,34,20,14,28,19,9,0,0.0,0.0
1006,1864,2020-03-20 08:02:00,1,2747.0,2512.0,0.914,13.604,7,3,0,3,4,0,4,0,0.0,0.01
1006,1865,2020-03-20 08:05:00,1,2604.0,2381.5,0.9145,12.897,23,14,5,9,9,4,5,0,0.0,0.0
1006,1866,2020-03-20 08:08:00,1,2461.0,2251.0,0.915,12.19,19,6,2,4,13,3,10,0,0.0,0.0
1006,1867,2020-03-20 08:11:00,1,2457.0,2266.0,0.922,12.191,6,4,0,4,2,1,1,0,0.0,0.0
1006,1868,2020-03-20 08:14:00,1,2430.0,2307.0,0.95,12.128,30,25,12,13,5,3,2,0,0.0,0.0
1006,1869,2020-03-20 08:17:00,1,2461.0,2283.0,0.928,12.222,22,8,3,5,14,10,4,0,0.0,0.0
1006,1870,2020-03-20 08:20:00,1,2460.0,2225.0,0.905,12.155,0,0,0,0,0,0,0,0,0.0,0.0
1006,1871,2020-03-20 08:23:00,1,2626.0,2330.0,0.887,12.927,2,2,1,1,0,0,0,0,0.0,0.0
1006,1872,2020-03-20 08:26:00,1,2534.0,2307.0,0.911,12.538,47,24,2,22,23,6,17,2,0.0,0.0
1006,1873,2020-03-20 08:29:00,1,2673.0,2459.0,0.92,13.255,118,71,38,33,47,18,29,1,0.0,0.0
1006,1874,2020-03-20 08:32:00,1,3098.0,2902.0,0.937,15.419,137,39,19,20,98,56,42,12,0.0,0.12
1006,1875,2020-03-20 08:35:00,1,2727.0,2553.0,0.936,13.572,112,70,47,23,42,18,24,3,0.0,0.0
1006,1876,2020-03-20 08:38:00,1,2965.0,2740.0,0.924,14.714,397,150,109,41,247,180,67,4,0.0,0.04
1006,1877,2020-03-20 08:41:00,1,3328.0,3062.0,0.92,16.5,431,195,143,52,236,176,60,13,0.0,0.0
1006,1878,2020-03-20 08:44:00,1,2600.0,2424.0,0.932,12.926,365,145,100,45,220,145,75,0,0.0,0.0
1006,1879,2020-03-20 08:47:00,1,2621.0,2334.0,0.891,12.909,386,136,93,43,250,203,47,10,0.0,0.0
1006,1880,2020-03-20 08:50:00,1,2889.0,2681.0,0.928,14.35,79,47,20,27,32,30,2,0,0.0,0.0
1006,1881,2020-03-20 08:53:00,1,3113.0,2865.0,0.92,15.437,1,1,0,1,0,0,0,0,0.0,0.0
1006,1882,2020-03-20 08:56:00,1,2965.0,2700.0,0.911,14.672,22,9,6,3,13,13,0,0,0.0,0.0
1006,1883,2020-03-20 08:59:00,1,2735.0,2591.0,0.947,13.644,11,3,1,2,8,8,0,0,0.0,0.0
1006,1884,2020-03-20 09:02:00,1,2578.0,2473.0,0.959,12.895,0,0,0,0,0,0,0,0,0.0,0.0
1006,1885,2020-03-20 09:05:00,1,2442.0,2310.0,0.946,12.177,10,4,0,4,6,5,1,0,0.0,0.0
1006,1886,2020-03-20 09:08:00,1,2584.0,2387.0,0.924,12.824,14,0,0,0,14,13,1,0,0.0,0.0
1006,1887,2020-03-20 09:11:00,1,2612.0,2376.0,0.91,12.921,36,12,1,11,24,22,2,0,0.0,0.0
1006,1888,2020-03-20 09:14:00,1,2603.0,2391.0,0.919,12.903,61,6,0,6,55,51,4,0,0.0,0.0
1006,1889,2020-03-20 09:17:00,1,2598.0,2371.0,0.913,12.862,16,16,1,15,0,0,0,0,0.0,0.0
1006,1890,2020-03-20 09:20:00,1,2605.0,2392.0,0.918,12.913,84,48,34,14,36,32,4,0,0.0,0.0
1006,1891,2020-03-20 09:23:00,1,2602.0,2438.0,0.937,12.95,95,3,1,2,92,74,18,0,0.0,0.0
1006,1892,2020-03-20 09:26:00,1,2448.0,2300.0,0.939,12.191,9,0,0,0,9,3,6,0,0.0,0.0
1006,1893,2020-03-20 09:29:00,1,2611.0,2362.0,0.905,12.903,71,8,5,3,63,26,37,0,0.0,0.0
1006,1894,2020-03-20 09:32:00,1,2608.0,2379.0,0.912,12.909,9,1,1,0,8,6,2,0,0.0,0.0
1006,1895,2020-03-20 09:35:00,1,2610.0,2362.0,0.905,12.898,334,29,19,10,305,273,32,0,0.0,0.0
1006,1896,2020-03-20 09:38:00,1,2435.0,2325.0,0.955,12.168,238,57,32,25,181,143,38,18,0.0,0.01
1006,1897,2020-03-20 09:41:00,1,3101.0,2860.0,0.922,15.385,212,67,39,28,145,117,28,16,0.0,0.09
1006,1898,2020-03-20 09:44:00,1,2380.0,2219.0,0.932,11.833,468,222,171,51,246,232,14,23,0.25,0.0
1006,1899,2020-03-20 09:47:00,1,2723.0,2630.0,0.966,13.639,368,169,133,36,199,158,41,3,0.0,0.0
1006,1900,2020-03-20 09:50:00,1,2944.0,2798.0,0.951,14.695,44,18,10,8,26,2,24,0,0.0,0.0
1006,1901,2020-03-20 09:53:00,1,3014.0,2859.0,0.949,15.039,152,68,30,38,84,43,41,6,0.0,0.0
1006,1902,2020-03-20 09:56:00,1,2949.0,2804.0,0.951,14.724,150,19,6,13,131,124,7,1,0.0,0.0
1006,1903,2020-03-20 09:59:00,1,2936.0,2834.0,0.965,14.705,325,16,6,10,309,293,16,0,0.0,0.0
1006,1904,2020-03-20 10:02:00,1,2950.0,2810.0,0.952,14.736,73,71,36,35,2,2,0,0,0.0,0.0
1006,1905,2020-03-20 10:05:00,1,2785.0,2680.0,0.962,13.941,23,3,2,1,20,0,20,0,0.0,0.0
1006,1906,2020-03-20 10:08:00,1,2652.0,2516.0,0.949,13.235,60,4,2,2,56,4,52,0,0.0,0.0
1006,1907,2020-03-20 10:11:00,1,2600.0,2424.0,0.932,12.929,90,17,6,11,73,12,61,0,0.0,0.0
1006,1908,2020-03-20 10:14:00,1,2517.0,2355.0,0.935,12.525,70,0,0,0,70,0,70,0,0.0,0.0
1006,1909,2020-03-20 10:17:00,1,2441.0,2342.0,0.96,12.21,82,0,0,0,82,0,82,0,0.0,0.0
1006,1910,2020-03-20 10:20:00,1,2597.0,2381.0,0.917,12.869,82,0,0,0,82,0,82,0,0.0,0.0
1006,1911,2020-03-20 10:23:00,1,2438.0,2321.0,0.952,12.174,84,0,0,0,84,0,84,0,0.0,0.0
1006,1912,2020-03-20 10:26:00,1,2469.0,2219.0,0.899,12.185,92,15,8,7,77,21,56,0,0.0,0.0
1006,1913,2020-03-20 10:29:00,1,2459.0,2270.0,0.923,12.199,95,5,2,3,90,42,48,0,0.0,0.0
1006,1914,2020-03-20 10:32:00,1,2435.0,2311.0,0.949,12.151,100,52,36,16,48,4,44,0,0.0,0.0
1006,1915,2020-03-20 10:35:00,1,2438.0,2365.0,0.97,12.223,98,35,7,28,63,0,63,0,0.0,0.0
1006,1916,2020-03-20 10:38:00,1,2525.0,2381.0,0.943,12.584,111,20,12,8,91,15,76,1,0.0,0.0
1006,1917,2020-03-20 10:41:00,1,2524.0,2373.0,0.94,12.572,81,0,0,0,81,3,78,0,0.0,0.0
1006,1918,2020-03-20 10:44:00,1,2457.0,2237.0,0.911,12.156,51,0,0,0,51,0,51,0,0.0,0.0
1006,1919,2020-03-20 10:47:00,1,2458.0,2253.0,0.917,12.18,73,5,1,4,68,10,58,0,0.0,0.0
1006,1920,2020-03-20 10:50:00,1,2444.0,2319.0,0.949,12.197,47,0,0,0,47,0,47,0,0.0,0.0
1006,1921,2020-03-20 10:53:00,1,2729.0,2621.0,0.96,13.653,180,57,28,29,123,58,65,3,0.0,0.14
1006,1922,2020-03-20 10:56:00,1,3057.0,3041.0,0.995,15.411,241,55,31,24,186,108,78,18,0.0,0.0
1006,1923,2020-03-20 10:59:00,1,2599.0,2402.0,0.924,12.897,209,26,5,21,183,148,35,1,0.0,0.0
1006,1924,2020-03-20 11:02:00,1,2577.0,2496.0,0.969,12.914,74,9,6,3,65,7,58,0,0.0,0.0
1006,1925,2020-03-20 11:05:00,1,2630.5,2471.5,0.9405,13.098,79,0,0,0,79,0,79,0,0.0,0.0
1006,1926,2020-03-20 11:08:00,1,2684.0,2447.0,0.912,13.282,73,0,0,0,73,0,73,0,0.0,0.0
1006,1927,2020-03-20 11:11:00,1,2513.0,2344.0,0.933,12.494,73,13,1,12,60,10,50,0,0.0,0.0
1006,1928,2020-03-20 11:14:00,1,2609.0,2379.0,0.912,12.913,97,32,0,32,65,0,65,0,0.0,0.0
1006,1929,2020-03-20 11:17:00,1,2675.0,2440.0,0.912,13.24,58,2,0,2,56,1,55,0,0.0,0.0
1006,1930,2020-03-20 11:20:00,1,2665.0,2506.0,0.94,13.276,70,1,0,1,69,5,64,0,0.0,0.0
1006,1931,2020-03-20 11:23:00,1,2688.0,2426.0,0.903,13.278,66,1,0,1,65,10,55,0,0.0,0.0
1006,1932,2020-03-20 11:26:00,1,2536.0,2280.0,0.899,12.518,61,3,1,2,58,6,52,0,0.0,0.0
1006,1933,2020-03-20 11:29:00,1,2724.0,2539.0,0.932,13.545,291,88,58,30,203,165,38,18,0.0,0.05
1006,1934,2020-03-20 11:32:00,1,2297.0,2193.0,0.955,11.477,35,9,1,8,26,24,2,0,0.0,0.0
1006,1935,2020-03-20 11:35:00,1,2524.0,2367.0,0.938,12.567,5,1,1,0,4,4,0,0,0.0,0.0
1006,1936,2020-03-20 11:38:00,1,2665.0,2520.0,0.946,13.289,126,26,9,17,100,94,6,0,0.0,0.0
1006,1937,2020-03-20 11:41:00,1,2528.0,2331.0,0.922,12.541,8,5,3,2,3,3,0,0,0.0,0.0
1006,1938,2020-03-20 11:44:00,1,2658.0,2493.0,0.938,13.232,10,10,4,6,0,0,0,0,0.0,0.0
1006,1939,2020-03-20 11:47:00,1,2653.0,2471.0,0.931,13.189,0,0,0,0,0,0,0,0,0.0,0.0
1006,1940,2020-03-20 11:50:00,1,2672.0,2466.0,0.923,13.259,0,0,0,0,0,0,0,0,0.0,0.0
1006,1941,2020-03-20 11:53:00,1,2669.0,2509.0,0.94,13.293,0,0,0,0,0,0,0,0,0.0,0.0
1006,1942,2020-03-20 11:56:00,1,2670.0,2475.0,0.927,13.26,0,0,0,0,0,0,0,0,0.0,0.0
1006,1943,2020-03-20 11:59:00,1,2666.0,2494.0,0.935,13.266,4,4,1,3,0,0,0,0,0.01,0.01
1006,1944,2020-03-20 12:02:00,1,2646.0,2560.0,0.967,13.261,9,9,0,9,0,0,0,0,0.0,0.0
1006,1945,2020-03-20 12:05:00,1,2733.0,2585.0,0.946,13.631,329,32,10,22,297,270,27,2,0.0,0.0
1006,1946,2020-03-20 12:08:00,1,2797.0,2682.0,0.959,13.989,252,79,44,35,173,158,15,3,0.0,0.0
1007,1,2020-03-16 10:53:00,1,4038.0,3158.0,0.782,19.405,535,218,170,48,317,268,49,2,0.0,0.0
1007,2,2020-03-16 10:56:00,1,4043.0,3100.0,0.767,19.36,582,169,122,47,413,353,60,14,0.0,0.0
1007,3,2020-03-16 10:59:00,1,3985.0,3058.0,0.767,19.088,434,186,142,44,248,200,48,10,0.0,0.0
1007,4,2020-03-16 11:02:00,1,3832.0,2913.0,0.76,18.323,191,42,30,12,149,88,61,0,0.0,0.0
1007,5,2020-03-16 11:05:00,1,3592.0,2737.0,0.762,17.183,312,84,43,41,228,142,86,8,0.06,0.0
1007,6,2020-03-16 11:08:00,1,3475.0,2676.5,0.7705,16.6555,444,148,110,38,296,216,80,12,0.0,0.0
1007,7,2020-03-16 11:11:00,1,3358.0,2616.0,0.779,16.128,143,18,7,11,125,51,74,0,0.0,0.0
1007,8,2020-03-16 11:14:00,1,3138.0,2415.0,0.77,15.037,58,0,0,0,58,0,58,0,0.0,0.0
1007,9,2020-03-16 11:17:00,1,2990.0,2262.0,0.756,14.284,110,16,11,5,94,38,56,2,0.0,0.0
1007,10,2020-03-16 11:20:00,1,3058.0,2357.0,0.771,14.658,61,0,0,0,61,2,59,0,0.01,0.0
1007,11,2020-03-16 11:23:00,1,2837.0,2143.0,0.755,13.551,217,49,35,14,168,99,69,1,0.0,0.0
1007,12,2020-03-16 11:26:00,1,2684.0,2042.0,0.761,12.835,74,11,0,11,63,0,63,0,0.0,0.0
1007,13,2020-03-16 11:29:00,1,2445.0,1879.0,0.769,11.713,82,20,0,20,62,0,62,0,0.0,0.0
1007,14,2020-03-16 11:32:00,1,2450.0,1874.0,0.765,11.728,62,2,1,1,60,0,60,0,0.0,0.0
1007,15,2020-03-16 11:35:00,1,2454.0,1896.0,0.773,11.768,68,0,0,0,68,2,66,0,0.0,0.0
1007,16,2020-03-16 11:38:00,1,2458.0,1853.0,0.754,11.736,60,0,0,0,60,0,60,0,0.0,0.0
1007,17,2020-03-16 11:41:00,1,2374.0,1838.0,0.774,11.386,69,5,1,4,64,4,60,0,0.0,0.0
1007,18,2020-03-16 11:44:00,1,2286.0,1815.0,0.794,11.015,261,91,64,27,170,98,72,4,0.0,0.0
1007,19,2020-03-16 11:47:00,1,2666.0,2108.0,0.791,12.838,303,110,79,31,193,132,61,12,0.05,0.0
1007,20,2020-03-16 11:50:00,1,3050.0,2363.0,0.775,14.632,144,83,31,52,61,6,55,1,0.0,0.0
1007,21,2020-03-16 11:53:00,1,2984.0,2306.0,0.773,14.312,357,116,76,40,241,164,77,8,0.01,0.0
1007,22,2020-03-16 11:56:00,1,2980.0,2340.0,0.785,14.332,238,58,38,20,180,119,61,3,0.0,0.0
1007,23,2020-03-16 11:59:00,1,2448.0,1868.0,0.763,11.716,101,5,0,5,96,25,71,0,0.0,0.0
1007,24,2020-03-16 12:02:00,1,2453.0,1879.0,0.766,11.744,60,1,0,1,59,0,59,0,0.0,0.0
1007,25,2020-03-16 12:05:00,1,2443.0,1879.0,0.769,11.705,92,13,11,2,79,17,62,0,0.0,0.0
1007,26,2020-03-16 12:08:00,1,2451.0,1879.0,0.767,11.738,54,0,0,0,54,0,54,0,0.0,0.0
1007,27,2020-03-16 12:11:00,1,2369.0,1810.0,0.764,11.338,128,22,18,4,106,57,49,0,0.0,0.0
1007,28,2020-03-16 12:14:00,1,2143.0,1656.0,0.773,10.277,50,0,0,0,50,0,50,0,0.0,0.0
1007,29,2020-03-16 12:17:00,1,2314.0,1700.0,0.735,11.001,38,1,1,0,37,0,37,0,0.0,0.0
1007,30,2020-03-16 12:20:00,1,2302.0,1733.0,0.753,10.988,43,2,1,1,41,6,35,0,0.0,0.0
1007,31,2020-03-16 12:23:00,1,2295.0,1756.0,0.765,10.989,85,24,18,6,61,29,32,0,0.0,0.0
1007,32,2020-03-16 12:26:00,1,2422.0,1966.0,0.812,11.719,141,35,25,10,106,63,43,0,0.0,0.0
1007,33,2020-03-16 12:29:00,1,2431.0,1937.0,0.797,11.724,29,0,0,0,29,0,29,0,0.0,0.0
1007,34,2020-03-16 12:32:00,1,2352.0,1884.0,0.801,11.354,30,3,0,3,27,0,27,0,0.0,0.0
1007,35,2020-03-16 12:35:00,1,2294.0,1728.0,0.753,10.951,55,25,2,23,30,2,28,0,0.01,0.0
1007,36,2020-03-16 12:38:00,1,2141.0,1672.0,0.781,10.286,51,5,4,1,46,0,46,0,0.0,0.0
1007,37,2020-03-16 12:41:00,1,2136.0,1652.0,0.773,10.244,91,58,22,36,33,0,33,0,0.0,0.0
1007,38,2020-03-16 12:44:00,1,2058.0,1623.0,0.789,9.905,123,79,24,55,44,0,44,0,0.0,0.0
1007,39,2020-03-16 12:47:00,1,2063.0,1604.0,0.778,9.904,59,8,2,6,51,4,47,0,0.0,0.0
1007,40,2020-03-16 12:50:00,1,2049.0,1628.0,0.794,9.875,45,2,1,1,43,0,43,0,0.0,0.0
1007,41,2020-03-16 12:53:00,1,2063.0,1615.0,0.783,9.917,66,28,5,23,38,0,38,0,0.0,0.0
1007,42,2020-03-16 12:56:00,1,2071.0,1569.0,0.758,9.896,47,0,0,0,47,0,47,0,0.0,0.0
1007,43,2020-03-16 12:59:00,1,2059.0,1593.0,0.773,9.877,163,48,36,12,115,74,41,4,0.0,0.0
1007,44,2020-03-16 13:02:00,1,2368.0,1868.0,0.789,11.399,283,93,69,24,190,127,63,6,0.0,0.0
1007,45,2020-03-16 13:05:00,1,2657.0,2119.0,0.798,12.816,201,43,28,15,158,101,57,2,0.0,0.0
1007,46,2020-03-16 13:08:00,1,3540.0,2929.0,0.827,17.192,582,190,155,35,392,310,82,18,0.0,0.0
1007,47,2020-03-16 13:11:00,1,3775.0,3100.0,0.821,18.308,238,119,90,29,119,85,34,3,0.0,0.0
1007,48,2020-03-16 13:14:00,1,2432.0,1955.0,0.804,11.747,42,20,3,17,22,2,20,0,0.0,0.0
1007,49,2020-03-16 13:17:00,1,2442.0,1917.0,0.785,11.745,29,1,0,1,28,0,28,0,0.0,0.0
1007,50,2020-03-16 13:20:00,1,2266.0,1878.0,0.829,11.006,85,16,12,4,69,29,40,0,0.0,0.0
1007,51,2020-03-16 13:23:00,1,2278.0,1822.0,0.8,10.992,21,4,3,1,17,0,17,0,0.01,0.0
1007,52,2020-03-16 13:26:00,1,2076.0,1574.0,0.758,9.921,28,6,0,6,22,0,22,0,0.0,0.0
1007,53,2020-03-16 13:29:00,1,1985.0,1537.0,0.775,9.522,36,11,0,11,25,0,25,0,0.0,0.0
1007,54,2020-03-16 13:32:00,1,1985.0,1543.0,0.778,9.53,28,0,0,0,28,0,28,0,0.0,0.0
1007,55,2020-03-16 13:35:00,1,2072.0,1565.0,0.755,9.898,61,33,0,33,28,0,28,0,0.0,0.0
1007,56,2020-03-16 13:38:00,1,2049.0,1661.0,0.811,9.913,80,0,0,0,80,37,43,0,0.0,0.0
1007,57,2020-03-16 13:41:00,1,2307.0,1727.0,0.749,11.001,71,35,9,26,36,5,31,0,0.0,0.0
1007,58,2020-03-16 13:44:00,1,2295.0,1763.0,0.769,10.993,121,90,33,57,31,0,31,0,0.0,0.0
1007,59,2020-03-16 13:47:00,1,2132.0,1679.0,0.788,10.258,57,25,5,20,32,0,32,0,0.0,0.0
1007,60,2020-03-16 13:50:00,1,2064.0,1611.0,0.78,9.915,76,48,12,36,28,0,28,0,0.0,0.0
1007,61,2020-03-16 13:53:00,1,1896.0,1544.0,0.814,9.18,35,5,0,5,30,0,30,0,0.0,0.0
1007,62,2020-03-16 13:56:00,1,2065.0,1580.0,0.765,9.884,63,37,5,32,26,0,26,0,0.0,0.0
1007,63,2020-03-16 13:59:00,1,2058.0,1600.0,0.777,9.881,105,83,11,72,22,0,22,0,0.0,0.0
1007,64,2020-03-16 14:02:00,1,1974.0,1578.0,0.799,9.526,108,81,9,72,27,0,27,0,0.01,0.0
1007,65,2020-03-16 14:05:00,1,2072.0,1583.0,0.764,9.915,94,71,7,64,23,0,23,0,0.0,0.0
1007,66,2020-03-16 14:08:00,1,2122.5,1560.0,0.7355,10.0885,109,96,21,75,13,0,13,0,0.0,0.0
1007,67,2020-03-16 14:11:00,1,2173.0,1537.0,0.707,10.262,24,0,0,0,24,0,24,0,0.0,0.0
1007,68,2020-03-16 14:14:00,1,2170.0,1533.0,0.707,10.246,56,43,1,42,13,0,13,0,0.0,0.0
1007,69,2020-03-16 14:17:00,1,2170.0,1531.0,0.706,10.247,42,3,1,2,39,16,23,0,0.0,0.0
1007,70,2020-03-16 14:20:00,1,2341.0,1611.0,0.688,11.008,133,54,36,18,79,57,22,0,0.0,0.0
1007,71,2020-03-16 14:23:00,1,2546.0,1845.0,0.725,12.074,52,25,1,24,27,2,25,0,0.0,0.0
1007,72,2020-03-16 14:26:00,1,2928.0,2175.0,0.743,13.944,142,41,10,31,101,68,33,4,0.0,0.0
1007,73,2020-03-16 14:29:00,1,3461.0,2577.0,0.745,16.489,339,117,91,26,222,169,53,5,0.0,0.0
1007,74,2020-03-16 14:32:00,1,4036.0,3178.0,0.787,19.423,529,186,158,28,343,281,62,3,0.0,0.0
1007,75,2020-03-16 14:35:00,1,3588.0,2807.0,0.782,17.246,93,30,20,10,63,50,13,0,0.0,0.0
1007,76,2020-03-16 14:38:00,1,3431.0,2650.0,0.772,16.453,302,85,61,24,217,181,36,0,0.0,0.0
1007,77,2020-03-16 14:41:00,1,3051.0,2393.0,0.785,14.669,42,21,4,17,21,4,17,0,0.0,0.0
1007,78,2020-03-16 14:44:00,1,3053.0,2345.0,0.768,14.626,135,27,20,7,108,79,29,0,0.0,0.0
1007,79,2020-03-16 14:47:00,1,3648.0,2926.0,0.802,17.613,239,66,48,18,173,140,33,4,0.0,0.0
1007,80,2020-03-16 14:50:00,1,2981.0,2277.0,0.764,14.266,12,1,1,0,11,0,11,0,0.0,0.0
1007,81,2020-03-16 14:53:00,1,2695.0,1996.0,0.741,12.827,33,14,0,14,19,0,19,0,0.0,0.0
1007,82,2020-03-16 14:56:00,1,2599.0,1993.0,0.767,12.447,42,27,0,27,15,0,15,0,0.0,0.0
1007,83,2020-03-16 14:59:00,1,2525.0,1970.0,0.78,12.129,13,1,1,0,12,0,12,0,0.0,0.0
1007,84,2020-03-16 15:02:00,1,2703.0,1998.0,0.739,12.86,12,0,0,0,12,0,12,0,0.0,0.0
1007,85,2020-03-16 15:05:00,1,2693.0,1990.0,0.739,12.815,14,0,0,0,14,0,14,0,0.0,0.0
1007,86,2020-03-16 15:08:00,1,2690.0,2003.0,0.745,12.818,16,0,0,0,16,0,16,0,0.02,0.0
1007,87,2020-03-16 15:11:00,1,2533.0,1917.0,0.757,12.105,27,11,0,11,16,0,16,0,0.0,0.0
1007,88,2020-03-16 15:14:00,1,2554.0,1855.0,0.727,12.117,20,3,0,3,17,0,17,0,0.0,0.0
1007,89,2020-03-16 15:17:00,1,2472.0,1785.0,0.722,11.717,108,39,34,5,69,45,24,1,0.0,0.0
1007,90,2020-03-16 15:20:00,1,2692.0,1997.0,0.742,12.819,18,0,0,0,18,0,18,0,0.0,0.0
1007,91,2020-03-16 15:23:00,1,2612.0,1975.0,0.756,12.48,12,0,0,0,12,0,12,0,0.0,0.0
1007,92,2020-03-16 15:26:00,1,2552.0,1833.0,0.718,12.083,16,0,0,0,16,0,16,0,0.0,0.0
1007,93,2020-03-16 15:29:00,1,2564.0,1799.0,0.702,12.093,20,1,1,0,19,0,19,0,0.0,0.0
1007,94,2020-03-16 15:32:00,1,2548.0,1853.0,0.727,12.091,59,37,1,36,22,0,22,0,0.0,0.0
1007,95,2020-03-16 15:35:00,1,2547.0,1879.0,0.738,12.115,26,9,2,7,17,0,17,0,0.0,0.0
1007,96,2020-03-16 15:38:00,1,2563.0,1825.0,0.712,12.119,47,38,2,36,9,0,9,0,0.0,0.0
1007,97,2020-03-16 15:41:00,1,2548.0,1858.0,0.729,12.097,13,5,0,5,8,0,8,0,0.0,0.0
1007,98,2020-03-16 15:44:00,1,2541.0,1899.0,0.747,12.116,20,0,0,0,20,0,20,0,0.0,0.0
1007,99,2020-03-16 15:47:00,1,2562.0,1784.0,0.696,12.069,17,3,1,2,14,0,14,0,0.0,0.0
1007,100,2020-03-16 15:50:00,1,2323.0,1677.0,0.722,11.011,15,0,0,0,15,0,15,0,0.0,0.0
1007,101,2020-03-16 15:53:00,1,2320.0,1670.0,0.72,10.99,20,0,0,0,20,0,20,0,0.0,0.0
1007,102,2020-03-16 15:56:00,1,2336.0,1618.0,0.693,10.994,9,0,0,0,9,0,9,0,0.0,0.0
1007,103,2020-03-16 15:59:00,1,2322.0,1649.0,0.71,10.974,25,21,1,20,4,0,4,0,0.0,0.0
1007,104,2020-03-16 16:02:00,1,2334.0,1644.0,0.704,11.016,24,11,2,9,13,2,11,0,0.0,0.0
1007,105,2020-03-16 16:05:00,1,2471.0,1824.0,0.738,11.755,74,54,1,53,20,0,20,0,0.0,0.0
1007,106,2020-03-16 16:08:00,1,2301.0,1747.0,0.759,11.0,18,0,0,0,18,0,18,0,0.0,0.0
1007,107,2020-03-16 16:11:00,1,2313.0,1693.0,0.732,10.988,26,6,1,5,20,0,20,0,0.0,0.0
1007,108,2020-03-16 16:14:00,1,2479.0,1806.0,0.728,11.769,31,2,0,2,29,6,23,0,0.0,0.0
1007,109,2020-03-16 16:17:00,1,2529.0,1939.0,0.767,12.112,124,33,25,8,91,54,37,1,0.0,0.0
1007,110,2020-03-16 16:20:00,1,2751.0,2133.0,0.776,13.201,183,59,41,18,124,97,27,0,0.0,0.0
1007,111,2020-03-16 16:23:00,1,2537.0,1858.0,0.733,12.053,16,0,0,0,16,0,16,0,0.0,0.0
1007,112,2020-03-16 16:26:00,1,2397.0,1770.0,0.739,11.404,21,0,0,0,21,0,21,0,0.0,0.0
1007,113,2020-03-16 16:29:00,1,2395.0,1741.0,0.727,11.363,27,4,2,2,23,4,19,0,0.0,0.0
1007,114,2020-03-16 16:32:00,1,2551.0,1851.0,0.726,12.102,21,0,0,0,21,0,21,0,0.0,0.0
1007,115,2020-03-16 16:35:00,1,2557.0,1834.0,0.717,12.106,30,3,2,1,27,0,27,0,0.0,0.0
1007,116,2020-03-16 16:38:00,1,2543.0,1859.0,0.731,12.076,53,15,5,10,38,8,30,4,0.0,0.0
1007,117,2020-03-16 16:41:00,1,2560.0,1807.0,0.706,12.087,33,20,1,19,13,0,13,0,0.0,0.0
1007,118,2020-03-16 16:44:00,1,2305.0,1742.0,0.756,11.012,15,0,0,0,15,0,15,0,0.0,0.0
1007,119,2020-03-16 16:47:00,1,2560.0,1789.0,0.699,12.067,18,0,0,0,18,0,18,0,0.0,0.0
1007,120,2020-03-16 16:50:00,1,2391.0,1758.0,0.735,11.366,56,44,0,44,12,0,12,0,0.0,0.0
1007,121,2020-03-16 16:53:00,1,2322.0,1675.0,0.721,11.002,18,3,0,3,15,0,15,0,0.0,0.0
1007,122,2020-03-16 16:56:00,1,2382.0,1791.0,0.752,11.37,14,1,1,0,13,0,13,0,0.0,0.0
1007,123,2020-03-16 16:59:00,1,2322.0,1672.0,0.72,11.001,11,0,0,0,11,0,11,0,0.0,0.0
1007,124,2020-03-16 17:02:00,1,2152.0,1581.0,0.735,10.228,13,0,0,0,13,0,13,0,0.0,0.0
1007,125,2020-03-16 17:05:00,1,2333.0,1636.0,0.701,11.002,43,21,0,21,22,2,20,0,0.0,0.0
1007,126,2020-03-16 17:08:00,1,2323.5,1672.0,0.7195,11.005,23,7,0,7,16,0,16,0,0.0,0.0
1007,127,2020-03-16 17:11:00,1,2314.0,1708.0,0.738,11.008,15,0,0,0,15,0,15,0,0.0,0.0
1007,128,2020-03-16 17:14:00,1,2317.0,1693.0,0.73,11.004,17,5,0,5,12,0,12,0,0.0,0.0
1007,129,2020-03-16 17:17:00,1,2151.0,1619.0,0.753,10.266,18,1,0,1,17,0,17,0,0.0,0.0
1007,130,2020-03-16 17:20:00,1,2322.0,1668.0,0.718,10.997,29,15,0,15,14,0,14,0,0.0,0.0
1007,131,2020-03-16 17:23:00,1,2232.0,1660.0,0.744,10.634,43,28,0,28,15,0,15,0,0.0,0.0
1007,132,2020-03-16 17:26:00,1,2318.0,1678.0,0.724,10.991,16,2,0,2,14,0,14,0,0.0,0.0
1007,133,2020-03-16 17:29:00,1,2312.0,1681.0,0.727,10.97,22,8,2,6,14,0,14,0,0.0,0.0
1007,134,2020-03-16 17:32:00,1,2540.0,1913.0,0.753,12.126,264,59,40,19,205,173,32,10,0.0,0.0
1007,135,2020-03-16 17:35:00,1,2589.0,2030.0,0.784,12.447,275,128,94,34,147,112,35,3,0.0,0.0
1007,136,2020-03-16 17:38:00,1,2520.0,1950.0,0.774,12.09,130,10,5,5,120,83,37,0,0.0,0.0
1007,137,2020-03-16 17:41:00,1,2664.0,2144.0,0.805,12.868,121,48,20,28,73,45,28,0,0.0,0.0
1007,138,2020-03-16 17:44:00,1,2661.0,2115.0,0.795,12.824,338,132,95,37,206,161,45,2,0.0,0.0
1007,139,2020-03-16 17:47:00,1,2599.0,2016.0,0.775,12.472,33,5,4,1,28,2,26,0,0.0,0.0
1007,140,2020-03-16 17:50:00,1,2670.0,2109.0,0.79,12.857,83,22,13,9,61,39,22,0,0.0,0.0
1007,141,2020-03-16 17:53:00,1,1915.0,1459.0,0.762,9.159,285,6,0,6,279,227,52,0,0.0,0.0
1007,142,2020-03-16 17:56:00,1,2905.0,2229.0,0.767,13.913,408,20,13,7,388,328,60,1,0.0,0.0
1007,143,2020-03-16 17:59:00,1,2824.0,2202.0,0.78,13.565,112,36,21,15,76,63,13,0,0.0,0.0
1007,144,2020-03-16 18:02:00,0,2149.0,1606.0,0.747,10.246,1,1,0,1,0,0,0,0,0.0,0.0
1007,145,2020-03-16 18:05:00,0,2156.0,1607.0,0.745,10.274,4,2,0,2,2,1,1,0,0.0,0.0
1007,146,2020-03-16 18:08:00,0,2678.0,2048.0,0.765,12.818,12,3,1,2,9,4,5,0,0.0,0.0
1007,147,2020-03-16 18:11:00,0,2525.0,1979.0,0.784,12.138,109,23,17,6,86,68,18,0,0.0,0.0
1007,148,2020-03-16 18:14:00,0,2523.0,1946.0,0.771,12.097,28,15,10,5,13,4,9,0,0.0,0.0
1007,149,2020-03-16 18:17:00,0,2544.0,1840.0,0.723,12.062,166,61,37,24,105,79,26,2,0.0,0.0
1007,150,2020-03-16 18:20:00,0,2903.0,2251.0,0.776,13.929,353,120,92,28,233,178,55,14,0.0,0.0
1007,151,2020-03-16 18:23:00,0,3223.0,2452.0,0.761,15.415,313,101,62,39,212,156,56,5,0.0,0.0
1007,152,2020-03-16 18:26:00,0,3297.0,2512.0,0.762,15.773,540,95,73,22,445,366,79,8,0.0,0.0
1007,153,2020-03-16 18:29:00,0,3308.0,2499.0,0.755,15.802,216,70,27,43,146,109,37,4,0.0,0.0
1007,154,2020-03-16 18:32:00,0,3297.0,2471.0,0.749,15.726,233,53,25,28,180,132,48,0,0.0,0.0
1007,155,2020-03-16 18:35:00,0,3056.0,2362.0,0.773,14.656,425,39,9,30,386,310,76,0,0.0,0.0
1007,156,2020-03-16 18:38:00,0,3038.0,2447.0,0.805,14.679,474,41,14,27,433,355,78,3,0.0,0.0
1007,157,2020-03-16 18:41:00,0,3223.0,2495.0,0.774,15.462,400,35,15,20,365,294,71,2,0.0,0.0
1007,158,2020-03-16 18:44:00,0,3062.0,2374.0,0.775,14.692,196,2,1,1,194,164,30,0,0.0,0.0
1007,159,2020-03-16 18:47:00,0,2644.0,2163.0,0.818,12.811,21,5,2,3,16,8,8,0,0.0,0.0
1007,160,2020-03-16 18:50:00,0,2499.0,2017.0,0.807,12.079,10,0,0,0,10,0,10,0,0.0,0.0
1007,161,2020-03-16 18:53:00,0,2510.0,1985.0,0.791,12.089,37,0,0,0,37,20,17,0,0.0,0.0
1007,162,2020-03-16 18:56:00,0,2510.0,2000.0,0.797,12.103,213,55,43,12,158,123,35,3,0.0,0.0
1007,163,2020-03-16 18:59:00,0,2913.0,2229.0,0.765,13.946,244,51,31,20,193,153,40,1,0.0,0.0
1007,164,2020-03-16 19:02:00,0,3071.0,2375.0,0.774,14.729,664,223,178,45,441,373,68,25,0.0,0.0
1007,165,2020-03-16 19:05:00,0,3204.0,2491.0,0.778,15.383,382,163,126,37,219,169,50,8,0.0,0.0
1007,166,2020-03-16 19:08:00,0,3211.0,2460.0,0.766,15.374,200,88,58,30,112,88,24,0,0.0,0.0
1007,167,2020-03-16 19:11:00,0,2827.0,2184.0,0.773,13.555,20,7,2,5,13,3,10,0,0.0,0.0
1007,168,2020-03-16 19:14:00,0,2676.0,2066.0,0.772,12.832,20,11,4,7,9,3,6,0,0.0,0.0
1007,169,2020-03-16 19:17:00,0,2672.0,2079.0,0.778,12.831,1,1,0,1,0,0,0,0,0.0,0.0
1007,170,2020-03-16 19:20:00,0,2918.0,2200.0,0.754,13.933,437,174,132,42,263,198,65,2,0.0,0.0
1007,171,2020-03-16 19:23:00,0,3065.0,2341.0,0.764,14.668,367,146,105,41,221,169,52,8,0.0,0.0
1007,172,2020-03-16 19:26:00,0,3142.0,2407.0,0.766,15.047,298,108,67,41,190,141,49,1,0.0,0.0
1007,173,2020-03-16 19:29:00,0,3295.0,2488.0,0.755,15.739,551,214,167,47,337,265,72,14,0.0,0.0
1007,174,2020-03-16 19:32:00,0,3297.0,2502.0,0.759,15.76,394,178,137,41,216,178,38,16,0.0,0.0
1007,175,2020-03-16 19:35:00,0,3284.0,2562.0,0.78,15.775,410,147,116,31,263,224,39,11,0.0,0.0
1007,176,2020-03-16 19:38:00,0,3300.0,2471.0,0.749,15.737,272,68,35,33,204,147,57,11,0.0,0.0
1007,177,2020-03-16 19:41:00,0,3433.0,2655.0,0.774,16.464,582,247,197,50,335,266,69,4,0.0,0.0
1007,178,2020-03-16 19:44:00,0,3446.0,2621.0,0.761,16.48,157,49,33,16,108,84,24,0,0.0,0.0
1007,179,2020-03-16 19:47:00,0,3311.0,2449.0,0.74,15.757,331,27,13,14,304,245,59,0,0.0,0.0
1007,180,2020-03-16 19:50:00,0,3308.0,2466.0,0.746,15.766,527,110,90,20,417,343,74,2,0.0,0.0
1007,181,2020-03-16 19:53:00,0,3071.0,2303.0,0.75,14.651,30,0,0,0,30,0,30,0,0.0,0.0
1007,182,2020-03-16 19:56:00,0,2664.0,2106.0,0.79,12.829,33,3,1,2,30,0,30,0,0.0,0.0
1007,183,2020-03-16 19:59:00,0,2526.0,1938.0,0.767,12.097,26,3,1,2,23,0,23,0,0.0,0.0
1007,184,2020-03-16 20:02:00,0,2542.0,1883.0,0.741,12.102,31,4,1,3,27,0,27,0,0.0,0.0
1007,185,2020-03-16 20:05:00,0,2459.0,1843.0,0.749,11.727,28,10,2,8,18,0,18,0,0.0,0.0
1007,186,2020-03-16 20:08:00,0,2469.0,1810.0,0.733,11.732,31,10,1,9,21,0,21,0,0.0,0.0
1007,187,2020-03-16 20:11:00,0,2479.0,1777.0,0.717,11.737,38,5,0,5,33,4,29,0,0.0,0.0
1007,188,2020-03-16 20:14:00,0,2490.0,1730.0,0.695,11.727,55,8,2,6,47,20,27,0,0.0,0.0
1007,189,2020-03-16 20:17:00,0,2483.0,1763.0,0.71,11.737,31,7,0,7,24,0,24,0,0.0,0.0
1007,190,2020-03-16 20:20:00,0,2557.0,1822.0,0.713,12.091,229,92,69,23,137,101,36,0,0.0,0.0
1007,191,2020-03-16 20:23:00,0,2781.0,2001.0,0.719,13.173,409,122,93,29,287,225,62,6,0.0,0.0
1007,192,2020-03-16 20:26:00,0,3090.0,2259.0,0.731,14.675,191,71,47,24,120,83,37,1,0.0,0.0
1007,193,2020-03-16 20:29:00,0,3259.0,2305.0,0.707,15.392,641,117,80,37,524,436,88,7,0.0,0.0
1007,194,2020-03-16 20:32:00,0,3246.0,2386.0,0.735,15.433,232,46,28,18,186,133,53,1,0.0,0.0
1007,195,2020-03-16 20:35:00,0,3229.0,2411.0,0.747,15.392,499,196,149,47,303,244,59,4,0.0,0.0
1007,196,2020-03-16 20:38:00,0,3240.0,2399.0,0.74,15.424,171,33,14,19,138,97,41,0,0.0,0.0
1007,197,2020-03-16 20:41:00,0,3244.0,2385.0,0.735,15.423,497,105,72,33,392,323,69,10,0.0,0.0
1007,198,2020-03-16 20:44:00,0,3240.0,2368.0,0.731,15.386,51,30,11,19,21,7,14,0,0.0,0.0
1007,199,2020-03-16 20:47:00,0,3080.0,2266.0,0.736,14.645,208,53,31,22,155,102,53,0,0.0,0.0
1007,200,2020-03-16 20:50:00,0,3257.0,2306.0,0.708,15.384,427,100,67,33,327,252,75,11,0.0,0.0
1007,201,2020-03-16 20:53:00,0,3248.0,2328.0,0.717,15.374,132,40,34,6,92,51,41,0,0.0,0.0
1007,202,2020-03-16 20:56:00,0,2918.0,2177.0,0.746,13.909,35,6,1,5,29,0,29,0,0.0,0.0
1007,203,2020-03-16 20:59:00,0,2700.0,1983.0,0.734,12.836,25,3,1,2,22,2,20,0,0.0,0.0
1007,204,2020-03-16 21:02:00,0,2556.0,1828.0,0.715,12.096,20,2,1,1,18,0,18,0,0.0,0.0
1007,205,2020-03-16 21:05:00,0,2497.0,1718.0,0.688,11.741,24,12,2,10,12,0,12,0,0.0,0.0
1007,206,2020-03-16 21:08:00,0,2488.0,1761.0,0.708,11.752,33,5,2,3,28,1,27,0,0.0,0.0
1007,207,2020-03-16 21:11:00,0,2488.0,1748.0,0.703,11.738,23,2,1,1,21,0,21,0,0.0,0.0
1007,208,2020-03-16 21:14:00,0,2331.0,1662.0,0.713,11.025,146,42,27,15,104,66,38,2,0.0,0.0
1007,209,2020-03-16 21:17:00,0,2691.0,2025.0,0.753,12.846,489,179,137,42,310,247,63,10,0.0,0.0
1007,210,2020-03-16 21:20:00,0,3250.0,2313.0,0.712,15.366,133,50,42,8,83,61,22,10,0.0,0.0
1007,211,2020-03-16 21:23:00,0,2932.0,2166.0,0.739,13.95,261,79,61,18,182,138,44,4,0.0,0.0
1007,212,2020-03-16 21:26:00,0,3251.0,2300.0,0.707,15.354,517,171,131,40,346,273,73,9,0.0,0.0
1007,213,2020-03-16 21:29:00,0,3317.0,2426.0,0.732,15.755,449,166,125,41,283,221,62,19,0.0,0.0
1007,214,2020-03-16 21:32:00,0,3479.0,2510.0,0.721,16.488,470,173,141,32,297,241,56,20,0.0,0.0
1007,215,2020-03-16 21:35:00,0,3479.0,2504.0,0.72,16.482,296,133,83,50,163,105,58,9,0.0,0.0
1007,216,2020-03-16 21:38:00,0,3478.0,2475.0,0.712,16.445,208,62,31,31,146,95,51,4,0.0,0.0
1007,217,2020-03-16 21:41:00,0,3410.0,2443.0,0.716,16.141,249,46,35,11,203,168,35,5,0.0,0.0
1007,218,2020-03-16 21:44:00,0,3161.0,2285.0,0.723,14.984,240,60,45,15,180,146,34,9,0.0,0.0
1007,219,2020-03-16 21:47:00,0,3093.0,2273.0,0.735,14.702,322,31,6,25,291,239,52,0,0.0,0.0
1007,220,2020-03-16 21:50:00,0,3166.0,2283.0,0.721,15.003,202,60,39,21,142,108,34,5,0.0,0.0
1007,221,2020-03-16 21:53:00,0,3089.0,2244.0,0.726,14.656,367,74,56,18,293,245,48,9,0.0,0.0
1007,222,2020-03-16 21:56:00,0,3091.0,2220.0,0.718,14.636,123,41,21,20,82,63,19,5,0.0,0.0
1007,223,2020-03-16 21:59:00,0,3174.0,2310.0,0.728,15.062,253,95,72,23,158,128,30,4,0.0,0.0
1007,224,2020-03-16 22:02:00,0,2839.0,2113.0,0.744,13.525,6,1,1,0,5,1,4,0,0.0,0.0
1007,225,2020-03-16 22:05:00,0,2718.0,1904.0,0.7,12.819,31,13,9,4,18,11,7,0,0.0,0.0
1007,226,2020-03-16 22:08:00,0,2479.0,1770.0,0.714,11.729,156,6,1,5,150,129,21,0,0.0,0.0
1007,227,2020-03-16 22:11:00,0,2410.0,1686.0,0.699,11.364,218,1,0,1,217,164,53,0,0.0,0.0
1007,228,2020-03-16 22:14:00,0,2497.0,1708.0,0.684,11.732,442,3,1,2,439,367,72,0,0.0,0.0
1007,229,2020-03-16 22:17:00,0,2497.0,1707.0,0.684,11.73,390,5,2,3,385,315,70,0,0.0,0.0
1007,230,2020-03-16 22:20:00,0,2328.0,1645.0,0.707,10.992,22,6,2,4,16,7,9,0,0.0,0.0
1007,231,2020-03-16 22:23:00,0,2346.0,1585.0,0.676,10.997,32,7,0,7,25,13,12,0,0.0,0.0
1007,232,2020-03-16 22:26:00,0,2327.0,1630.0,0.701,10.974,27,8,2,6,19,4,15,0,0.0,0.0
1007,233,2020-03-16 22:29:00,0,2327.0,1651.0,0.709,10.997,74,2,1,1,72,52,20,0,0.0,0.0
1007,234,2020-03-16 22:32:00,0,2169.0,1557.0,0.718,10.272,192,29,18,11,163,141,22,0,0.0,0.0
1007,235,2020-03-16 22:35:00,0,2084.0,1501.0,0.72,9.873,5,5,0,5,0,0,0,0,0.0,0.0
1007,236,2020-03-16 22:38:00,0,2083.0,1519.0,0.729,9.887,13,6,0,6,7,0,7,0,0.0,0.0
1007,237,2020-03-16 22:41:00,0,2253.0,1577.0,0.7,10.624,13,5,2,3,8,2,6,0,0.0,0.0
1007,238,2020-03-16 22:44:00,0,2415.0,1693.0,0.701,11.391,380,105,60,45,275,206,69,6,0.0,0.0
1007,239,2020-03-16 22:47:00,0,2862.0,2043.0,0.714,13.538,384,123,103,20,261,216,45,8,0.0,0.0
1007,240,2020-03-16 22:50:00,0,2923.0,2163.0,0.74,13.914,421,187,151,36,234,191,43,13,0.0,0.0
1007,241,2020-03-16 22:53:00,0,3248.0,2323.0,0.715,15.368,431,157,113,44,274,212,62,16,0.0,0.0
1007,242,2020-03-16 22:56:00,0,3234.0,2374.0,0.734,15.37,566,217,159,58,349,296,53,30,0.0,0.0
1007,243,2020-03-16 22:59:00,0,3310.0,2431.0,0.734,15.735,526,216,177,39,310,267,43,37,0.0,0.0
1007,244,2020-03-16 23:02:00,0,3563.0,2591.0,0.727,16.907,613,264,231,33,349,271,78,16,0.0,0.0
1007,245,2020-03-16 23:05:00,0,3486.0,2475.0,0.71,16.477,320,138,110,28,182,132,50,27,0.0,0.0
1007,246,2020-03-16 23:08:00,0,3360.0,2424.0,0.722,15.9235,410,155,110,45,255,194,61,17,0.0,0.0
1007,247,2020-03-16 23:11:00,0,3234.0,2373.0,0.734,15.37,387,116,80,36,271,193,78,5,0.0,0.0
1007,248,2020-03-16 23:14:00,0,3020.0,2190.0,0.725,14.325,224,86,45,41,138,68,70,8,0.0,0.0
1007,249,2020-03-16 23:17:00,0,3109.0,2203.0,0.708,14.689,297,98,69,29,199,133,66,4,0.0,0.0
1007,250,2020-03-16 23:20:00,0,2859.0,2080.0,0.727,13.568,3,3,0,3,0,0,0,0,0.0,0.0
1007,251,2020-03-16 23:23:00,0,2706.0,1974.0,0.729,12.849,12,10,6,4,2,0,2,0,0.0,0.0
1007,252,2020-03-16 23:26:00,0,2645.0,1844.0,0.697,12.465,3,1,1,0,2,0,2,0,0.0,0.0
1007,253,2020-03-16 23:29:00,0,2496.0,1725.0,0.691,11.745,2,0,0,0,2,2,0,0,0.0,0.0
1007,254,2020-03-16 23:32:00,0,2337.0,1599.0,0.684,10.977,4,3,1,2,1,1,0,0,0.0,0.0
1007,255,2020-03-16 23:35:00,0,2254.0,1572.0,0.697,10.623,398,120,86,34,278,207,71,8,0.0,0.0
1007,256,2020-03-16 23:38:00,0,2712.0,1928.0,0.711,12.82,337,111,89,22,226,169,57,24,0.0,0.0
1007,257,2020-03-16 23:41:00,0,2694.0,1971.0,0.731,12.798,8,7,0,7,1,0,1,0,0.0,0.0
1007,258,2020-03-16 23:44:00,0,2475.0,1788.0,0.722,11.73,1,1,0,1,0,0,0,0,0.0,0.0
1007,259,2020-03-16 23:47:00,0,2335.0,1632.0,0.699,11.008,80,37,28,9,43,32,11,0,0.0,0.0
1007,260,2020-03-16 23:50:00,0,2079.0,1550.0,0.745,9.908,94,51,28,23,43,23,20,17,0.0,0.0
1007,261,2020-03-16 23:53:00,0,2474.0,1785.0,0.721,11.723,184,73,34,39,111,66,45,16,0.0,0.0
1007,262,2020-03-16 23:56:00,0,2688.0,1996.0,0.743,12.802,362,131,94,37,231,173,58,7,0.0,0.0
1007,263,2020-03-16 23:59:00,0,2863.0,2071.0,0.723,13.573,202,61,43,18,141,77,64,3,0.0,0.0
1007,264,2020-03-17 00:02:00,0,2781.0,2000.0,0.719,13.173,180,22,7,15,158,87,71,7,0.0,0.0
1007,265,2020-03-17 00:05:00,0,2851.0,2070.0,0.726,13.525,364,136,93,43,228,155,73,7,0.0,0.0
1007,266,2020-03-17 00:08:00,0,3097.0,2205.0,0.712,14.645,327,85,67,18,242,175,67,10,0.0,0.0
1007,267,2020-03-17 00:11:00,0,3102.0,2186.0,0.705,14.644,125,45,32,13,80,53,27,0,0.0,0.0
1007,268,2020-03-17 00:14:00,0,2852.0,2106.0,0.739,13.568,187,49,35,14,138,97,41,5,0.0,0.0
1007,269,2020-03-17 00:17:00,0,2862.0,2041.0,0.713,13.537,333,97,65,32,236,162,74,7,0.0,0.0
1007,270,2020-03-17 00:20:00,0,2864.0,2037.0,0.711,13.538,574,170,129,41,404,322,82,6,0.01,0.0
1007,271,2020-03-17 00:23:00,0,2785.0,2001.0,0.719,13.189,212,56,26,30,156,92,64,2,0.0,0.0
1007,272,2020-03-17 00:26:00,0,2734.0,1881.0,0.688,12.854,1,1,0,1,0,0,0,0,0.0,0.0
1007,273,2020-03-17 00:29:00,0,2501.0,1711.0,0.684,11.75,8,7,2,5,1,0,1,0,0.0,0.0
1007,274,2020-03-17 00:32:00,0,2328.0,1616.0,0.694,10.964,28,27,0,27,1,0,1,0,0.0,0.0
1007,275,2020-03-17 00:35:00,0,2264.0,1549.0,0.684,10.636,268,72,48,24,196,141,55,3,0.0,0.0
1007,276,2020-03-17 00:38:00,0,2488.0,1747.0,0.702,11.737,264,84,19,65,180,107,73,8,0.0,0.0
1007,277,2020-03-17 00:41:00,0,2729.0,1856.0,0.68,12.808,193,48,27,21,145,83,62,9,0.0,0.0
1007,278,2020-03-17 00:44:00,0,2485.0,1766.0,0.71,11.748,60,1,1,0,59,2,57,0,0.0,0.0
1007,279,2020-03-17 00:47:00,0,2323.0,1654.0,0.712,10.984,73,0,0,0,73,14,59,0,0.0,0.0
1007,280,2020-03-17 00:50:00,0,2177.0,1535.0,0.705,10.277,64,0,0,0,64,5,59,0,0.0,0.0
1007,281,2020-03-17 00:53:00,0,2113.0,1401.0,0.663,9.879,139,25,15,10,114,52,62,0,0.0,0.0
1007,282,2020-03-17 00:56:00,0,2110.0,1422.0,0.674,9.89,68,3,0,3,65,4,61,0,0.0,0.0
1007,283,2020-03-17 00:59:00,0,2033.0,1385.0,0.681,9.544,94,1,0,1,93,25,68,0,0.0,0.0
1007,284,2020-03-17 01:02:00,0,2111.0,1410.0,0.668,9.88,70,1,0,1,69,6,63,0,0.0,0.0
1007,285,2020-03-17 01:05:00,0,2110.0,1413.0,0.67,9.877,71,2,1,1,69,4,65,0,0.0,0.0
1007,286,2020-03-17 01:08:00,0,2087.0,1495.0,0.717,9.879,67,1,1,0,66,3,63,0,0.0,0.0
1007,287,2020-03-17 01:11:00,0,2096.0,1474.0,0.703,9.89,73,0,0,0,73,4,69,0,0.0,0.0
1007,288,2020-03-17 01:14:00,0,2093.0,1511.0,0.722,9.919,68,1,0,1,67,9,58,0,0.0,0.0
1007,289,2020-03-17 01:17:00,0,2168.0,1525.0,0.704,10.231,73,1,0,1,72,12,60,0,0.0,0.0
1007,290,2020-03-17 01:20:00,0,2099.0,1450.0,0.69,9.877,58,0,0,0,58,8,50,0,0.0,0.0
1007,291,2020-03-17 01:23:00,0,2126.0,1379.0,0.648,9.902,68,0,0,0,68,10,58,0,0.0,0.0
1007,292,2020-03-17 01:26:00,0,2035.0,1366.0,0.672,9.53,71,1,1,0,70,6,64,0,0.0,0.0
1007,293,2020-03-17 01:29:00,0,2036.0,1368.0,0.672,9.536,64,3,1,2,61,4,57,0,0.0,0.0
1007,294,2020-03-17 01:32:00,0,2029.0,1372.0,0.676,9.513,70,11,0,11,59,0,59,0,0.0,0.0
1007,295,2020-03-17 01:35:00,0,1946.0,1353.0,0.696,9.164,60,0,0,0,60,2,58,0,0.0,0.0
1007,296,2020-03-17 01:38:00,0,1942.0,1362.0,0.701,9.159,108,31,15,16,77,23,54,4,0.0,0.0
1007,297,2020-03-17 01:41:00,0,2331.0,1621.0,0.696,10.979,303,127,70,57,176,112,64,0,0.0,0.0
1007,298,2020-03-17 01:44:00,0,2711.0,1950.0,0.719,12.84,151,27,13,14,124,57,67,7,0.0,0.0
1007,299,2020-03-17 01:47:00,0,2865.0,2082.0,0.726,13.595,155,25,5,20,130,55,75,2,0.0,0.0
1007,300,2020-03-17 01:50:00,0,3094.0,2233.0,0.721,14.664,341,119,76,43,222,148,74,11,0.0,0.0
1007,301,2020-03-17 01:53:00,0,3233.0,2376.0,0.735,15.369,392,151,119,32,241,170,71,14,0.0,0.0
1007,302,2020-03-17 01:56:00,0,3402.0,2458.0,0.723,16.126,443,163,122,41,280,209,71,10,0.0,0.0
1007,303,2020-03-17 01:59:00,0,3233.0,2376.0,0.735,15.368,189,60,40,20,129,71,58,5,0.0,0.0
1007,304,2020-03-17 02:02:00,0,3102.0,2212.0,0.713,14.672,336,94,69,25,242,178,64,17,0.0,0.0
1007,305,2020-03-17 02:05:00,0,3088.0,2252.0,0.729,14.662,463,138,100,38,325,256,69,10,0.0,0.0
1007,306,2020-03-17 02:08:00,0,2895.5,2093.0,0.7225,13.727,186,42,34,8,144,79,65,0,0.0,0.0
1007,307,2020-03-17 02:11:00,0,2703.0,1934.0,0.716,12.792,66,0,0,0,66,4,62,0,0.0,0.0
1007,308,2020-03-17 02:14:00,0,2726.0,1875.0,0.688,12.815,166,20,13,7,146,69,77,12,0.0,0.0
1007,309,2020-03-17 02:17:00,0,2873.0,2043.0,0.711,13.582,404,100,72,28,304,218,86,20,0.0,0.0
1007,310,2020-03-17 02:20:00,0,2930.0,2148.0,0.733,13.922,314,117,88,29,197,134,63,17,0.0,0.0
1007,311,2020-03-17 02:23:00,0,3093.0,2226.0,0.72,14.65,441,137,110,27,304,234,70,27,0.0,0.0
1007,312,2020-03-17 02:26:00,0,3182.0,2266.0,0.712,15.047,229,60,40,20,169,93,76,5,0.0,0.0
1007,313,2020-03-17 02:29:00,0,3108.0,2183.0,0.702,14.664,190,47,35,12,143,66,77,5,0.0,0.0
1007,314,2020-03-17 02:32:00,0,2708.0,1935.0,0.714,12.811,59,1,0,1,58,1,57,0,0.0,0.0
1007,315,2020-03-17 02:35:00,0,2477.0,1773.0,0.716,11.724,167,37,21,16,130,54,76,2,0.0,0.0
1007,316,2020-03-17 02:38:00,0,2724.0,1867.0,0.685,12.801,494,121,84,37,373,284,89,30,0.0,0.0
1007,317,2020-03-17 02:41:00,0,2880.0,2035.0,0.707,13.6,312,93,65,28,219,141,78,17,0.0,0.0
1007,318,2020-03-17 02:44:00,0,2844.0,2118.0,0.745,13.549,360,80,54,26,280,197,83,14,0.0,0.0
1007,319,2020-03-17 02:47:00,0,2854.0,2095.0,0.734,13.566,434,113,86,27,321,233,88,13,0.0,0.0
1007,320,2020-03-17 02:50:00,0,2928.0,2138.0,0.73,13.905,426,107,69,38,319,231,88,9,0.0,0.0
1007,321,2020-03-17 02:53:00,0,2945.0,2125.0,0.722,13.958,258,57,33,24,201,124,77,0,0.0,0.0
1007,322,2020-03-17 02:56:00,0,2943.0,2130.0,0.724,13.956,178,38,12,26,140,70,70,0,0.0,0.0
1007,323,2020-03-17 02:59:00,0,2857.0,2087.0,0.73,13.568,251,38,11,27,213,133,80,4,0.0,0.0
1007,324,2020-03-17 03:02:00,0,2867.0,2033.0,0.709,13.547,79,5,2,3,74,10,64,0,0.0,0.0
1007,325,2020-03-17 03:05:00,0,2735.0,1859.0,0.68,12.836,64,0,0,0,64,10,54,0,0.0,0.0
1007,326,2020-03-17 03:08:00,0,2489.0,1712.0,0.688,11.704,58,0,0,0,58,2,56,0,0.0,0.0
1007,327,2020-03-17 03:11:00,0,2338.0,1601.0,0.685,10.983,77,2,1,1,75,13,62,0,0.0,0.0
1007,328,2020-03-17 03:14:00,0,2103.0,1471.0,0.7,9.916,68,4,1,3,64,0,64,0,0.0,0.0
1007,329,2020-03-17 03:17:00,0,2124.0,1366.0,0.643,9.881,168,31,22,9,137,71,66,6,0.0,0.0
1007,330,2020-03-17 03:20:00,0,2101.0,1441.0,0.686,9.873,153,26,12,14,127,57,70,8,0.0,0.0
1007,331,2020-03-17 03:23:00,0,2409.0,1660.0,0.689,11.331,169,56,29,27,113,49,64,8,0.0,0.0
1007,332,2020-03-17 03:26:00,0,2472.0,1815.0,0.734,11.749,215,73,32,41,142,73,69,6,0.0,0.0
1007,333,2020-03-17 03:29:00,0,2716.0,1921.0,0.707,12.83,284,99,66,33,185,122,63,10,0.0,0.0
1007,334,2020-03-17 03:32:00,0,2861.0,2050.0,0.716,13.544,397,79,62,17,318,238,80,11,0.0,0.0
1007,335,2020-03-17 03:35:00,0,2870.0,2005.0,0.698,13.529,220,61,38,23,159,98,61,32,0.0,0.0
1007,336,2020-03-17 03:38:00,0,2851.0,2110.0,0.74,13.568,313,99,79,20,214,141,73,63,0.0,0.0
1007,337,2020-03-17 03:41:00,0,3185.0,2245.0,0.705,15.035,352,154,110,44,198,125,73,55,0.0,0.0
1007,338,2020-03-17 03:44:00,0,3081.0,2256.0,0.732,14.639,454,160,119,41,294,203,91,52,0.0,0.0
1007,339,2020-03-17 03:47:00,0,2839.0,2128.0,0.75,13.542,178,33,27,6,145,76,69,27,0.0,0.0
1007,340,2020-03-17 03:50:00,0,3007.0,2196.0,0.73,14.28,151,27,17,10,124,54,70,8,0.0,0.0
1007,341,2020-03-17 03:53:00,0,2791.0,1997.0,0.715,13.208,78,2,2,0,76,2,74,0,0.0,0.0
1007,342,2020-03-17 03:56:00,0,2702.0,1958.0,0.725,12.813,111,29,26,3,82,25,57,0,0.01,0.0
1007,343,2020-03-17 03:59:00,0,2697.0,1963.0,0.728,12.799,136,32,24,8,104,45,59,8,0.0,0.0
1007,344,2020-03-17 04:02:00,0,2859.0,2097.0,0.734,13.585,369,96,72,24,273,194,79,37,0.0,0.0
1007,345,2020-03-17 04:05:00,0,3105.0,2226.0,0.717,14.7,348,100,76,24,248,160,88,57,0.0,0.0
1007,346,2020-03-17 04:08:00,0,3262.0,2306.0,0.707,15.404,434,130,92,38,304,228,76,53,0.0,0.0
1007,347,2020-03-17 04:11:00,0,3091.0,2256.0,0.73,14.678,320,79,57,22,241,148,93,62,0.0,0.0
1007,348,2020-03-17 04:14:00,0,3085.0,2251.0,0.73,14.646,358,102,72,30,256,168,88,37,0.0,0.0
1007,349,2020-03-17 04:17:00,0,2707.0,1955.0,0.722,12.829,198,38,23,15,160,83,77,7,0.0,0.0
1007,350,2020-03-17 04:20:00,0,2841.0,2157.0,0.759,13.58,121,19,14,5,102,31,71,3,0.0,0.0
1007,351,2020-03-17 04:23:00,0,2838.0,2149.0,0.757,13.56,62,0,0,0,62,0,62,0,0.0,0.0
1007,352,2020-03-17 04:26:00,0,2683.0,2016.0,0.752,12.803,68,4,3,1,64,4,60,0,0.0,0.0
1007,353,2020-03-17 04:29:00,0,2457.0,1906.0,0.776,11.789,64,9,1,8,55,0,55,0,0.0,0.0
1007,354,2020-03-17 04:32:00,0,2469.0,1814.0,0.735,11.736,105,8,1,7,97,37,60,0,0.0,0.0
1007,355,2020-03-17 04:35:00,0,2298.0,1726.0,0.751,10.967,58,0,0,0,58,2,56,0,0.0,0.0
1007,356,2020-03-17 04:38:00,0,2231.0,1650.0,0.739,10.616,76,2,1,1,74,10,64,0,0.0,0.0
1007,357,2020-03-17 04:41:00,0,2058.0,1612.0,0.783,9.895,70,1,0,1,69,12,57,0,0.0,0.0
1007,358,2020-03-17 04:44:00,0,2460.0,1830.0,0.744,11.719,296,97,70,27,199,126,73,29,0.0,0.0
1007,359,2020-03-17 04:47:00,0,2689.0,2008.0,0.747,12.817,370,90,56,34,280,196,84,45,0.0,0.0
1007,360,2020-03-17 04:50:00,0,3081.0,2278.0,0.739,14.66,303,71,37,34,232,158,74,43,0.0,0.0
1007,361,2020-03-17 04:53:00,0,2834.0,2143.0,0.756,13.537,492,173,127,46,319,227,92,22,0.0,0.0
1007,362,2020-03-17 04:56:00,0,2826.0,2199.0,0.778,13.571,230,67,59,8,163,94,69,18,0.0,0.0
1007,363,2020-03-17 04:59:00,0,2829.0,2190.0,0.774,13.572,276,75,50,25,201,122,79,11,0.0,0.0
1007,364,2020-03-17 05:02:00,0,2688.0,2019.0,0.751,12.827,56,0,0,0,56,0,56,0,0.0,0.0
1007,365,2020-03-17 05:05:00,0,2537.0,1876.0,0.74,12.075,107,22,4,18,85,21,64,0,0.0,0.0
1007,366,2020-03-17 05:08:00,0,2683.0,2030.0,0.756,12.82,245,43,17,26,202,117,85,10,0.0,0.0
1007,367,2020-03-17 05:11:00,0,2829.0,2184.0,0.772,13.565,264,68,42,26,196,121,75,13,0.0,0.0
1007,368,2020-03-17 05:14:00,0,2840.0,2145.0,0.755,13.564,88,9,4,5,79,20,59,0,0.0,0.0
1007,369,2020-03-17 05:17:00,0,2705.0,1965.0,0.726,12.833,58,0,0,0,58,0,58,0,0.0,0.0
1007,370,2020-03-17 05:20:00,0,2452.0,1846.0,0.753,11.707,144,38,27,11,106,40,66,11,0.0,0.0
1007,371,2020-03-17 05:23:00,0,2691.0,2008.0,0.746,12.827,244,39,26,13,205,139,66,34,0.0,0.0
1007,372,2020-03-17 05:26:00,0,2834.0,2160.0,0.762,13.559,422,117,84,33,305,212,93,81,0.0,0.0
1007,373,2020-03-17 05:29:00,0,2829.0,2191.0,0.775,13.573,349,121,83,38,228,146,82,31,0.01,0.0
1007,374,2020-03-17 05:32:00,0,3256.0,2356.0,0.724,15.44,379,142,81,61,237,158,79,85,0.0,0.0
1007,375,2020-03-17 05:35:00,0,3230.0,2403.0,0.744,15.387,506,167,129,38,339,264,75,62,0.0,0.0
1007,376,2020-03-17 05:38:00,0,3082.0,2285.0,0.741,14.674,599,187,145,42,412,320,92,20,0.0,0.0
1007,377,2020-03-17 05:41:00,0,2826.0,2197.0,0.777,13.567,206,68,46,22,138,84,54,13,0.0,0.0
1007,378,2020-03-17 05:44:00,0,2692.0,1991.0,0.74,12.81,370,141,101,40,229,161,68,8,0.0,0.0
1007,379,2020-03-17 05:47:00,0,2983.0,2261.0,0.758,14.257,199,63,35,28,136,95,41,2,0.0,0.0
1007,380,2020-03-17 05:50:00,0,3073.0,2313.0,0.753,14.669,233,82,49,33,151,112,39,0,0.0,0.0
1007,381,2020-03-17 05:53:00,0,3233.0,2427.0,0.751,15.423,487,116,73,43,371,284,87,28,0.0,0.0
1007,382,2020-03-17 05:56:00,0,2989.0,2289.0,0.766,14.312,269,94,63,31,175,134,41,21,0.0,0.0
1007,383,2020-03-17 05:59:00,0,2845.0,2137.0,0.751,13.576,22,12,8,4,10,5,5,3,0.0,0.0
1007,384,2020-03-17 06:02:00,1,2901.0,2255.0,0.777,13.927,626,205,147,58,421,336,85,34,0.0,0.0
1007,385,2020-03-17 06:05:00,1,3213.0,2470.0,0.769,15.394,421,144,97,47,277,206,71,4,0.0,0.0
1007,386,2020-03-17 06:08:00,1,3066.0,2322.0,0.757,14.652,704,202,150,52,502,396,106,14,0.0,0.0
1007,387,2020-03-17 06:11:00,1,3073.0,2304.0,0.75,14.659,654,217,165,52,437,346,91,3,0.0,0.0
1007,388,2020-03-17 06:14:00,1,3239.0,2357.0,0.728,15.372,522,185,138,47,337,253,84,6,0.0,0.0
1007,389,2020-03-17 06:17:00,1,3085.0,2270.0,0.736,14.668,46,19,13,6,27,17,10,0,0.0,0.0
1007,390,2020-03-17 06:20:00,1,2856.0,2076.0,0.727,13.552,42,17,8,9,25,14,11,0,0.0,0.0
1007,391,2020-03-17 06:23:00,1,2727.0,1870.0,0.686,12.816,108,34,9,25,74,35,39,0,0.0,0.0
1007,392,2020-03-17 06:26:00,1,2473.0,1805.0,0.73,11.74,149,38,4,34,111,86,25,0,0.0,0.0
1007,393,2020-03-17 06:29:00,1,2717.0,1949.0,0.717,12.865,480,124,92,32,356,273,83,16,0.0,0.0
1007,394,2020-03-17 06:32:00,1,2714.0,1933.0,0.712,12.832,92,44,21,23,48,21,27,0,0.0,0.0
1007,395,2020-03-17 06:35:00,1,2865.0,2073.0,0.723,13.583,370,37,9,28,333,262,71,2,0.0,0.0
1007,396,2020-03-17 06:38:00,1,2860.0,2050.0,0.717,13.54,444,14,2,12,430,349,81,0,0.0,0.0
1007,397,2020-03-17 06:41:00,1,2696.0,1982.0,0.735,12.816,246,2,1,1,244,172,72,0,0.0,0.0
1007,398,2020-03-17 06:44:00,1,2561.0,1807.0,0.706,12.091,59,0,0,0,59,25,34,0,0.0,0.0
1007,399,2020-03-17 06:47:00,1,2508.0,1671.0,0.666,11.733,97,33,10,23,64,21,43,0,0.0,0.0
1007,400,2020-03-17 06:50:00,1,2327.0,1632.0,0.702,10.975,17,13,6,7,4,2,2,0,0.0,0.0
1007,401,2020-03-17 06:53:00,1,2260.0,1553.0,0.687,10.623,6,2,1,1,4,3,1,0,0.0,0.0
1007,402,2020-03-17 06:56:00,1,2262.0,1567.0,0.693,10.649,5,1,0,1,4,3,1,0,0.0,0.0
1007,403,2020-03-17 06:59:00,1,2100.0,1477.0,0.703,9.911,6,1,0,1,5,2,3,0,0.0,0.0
1007,404,2020-03-17 07:02:00,1,2106.0,1424.0,0.676,9.874,103,22,9,13,81,68,13,0,0.0,0.0
1007,405,2020-03-17 07:05:00,1,2110.0,1437.0,0.681,9.907,68,18,7,11,50,35,15,0,0.0,0.0
1007,406,2020-03-17 07:08:00,1,2113.0,1419.0,0.671,9.898,753,6,3,3,747,670,77,0,0.0,0.0
1007,407,2020-03-17 07:11:00,1,2105.0,1435.0,0.682,9.882,547,23,1,22,524,478,46,0,0.0,0.0
1007,408,2020-03-17 07:14:00,1,2118.0,1391.0,0.657,9.886,611,16,4,12,595,535,60,0,0.0,0.0
1007,409,2020-03-17 07:17:00,1,2117.0,1400.0,0.661,9.89,221,1,0,1,220,172,48,0,0.0,0.0
1007,410,2020-03-17 07:20:00,1,2110.0,1410.0,0.668,9.874,288,81,39,42,207,143,64,0,0.0,0.0
1007,411,2020-03-17 07:23:00,1,2485.0,1707.0,0.687,11.68,157,19,10,9,138,68,70,0,0.01,0.0
1007,412,2020-03-17 07:26:00,1,2872.0,2018.0,0.703,13.552,409,110,80,30,299,226,73,67,0.0,0.0
1007,413,2020-03-17 07:29:00,1,2720.0,1885.0,0.693,12.806,575,140,96,44,435,340,95,25,0.0,0.0
1007,414,2020-03-17 07:32:00,1,2877.0,2016.0,0.701,13.568,315,100,76,24,215,152,63,17,0.0,0.0
1007,415,2020-03-17 07:35:00,1,2867.0,2047.0,0.714,13.564,475,108,83,25,367,279,88,10,0.0,0.0
1007,416,2020-03-17 07:38:00,1,2851.0,2065.0,0.725,13.519,317,62,48,14,255,179,76,7,0.0,0.0
1007,417,2020-03-17 07:41:00,1,3091.0,2224.0,0.72,14.641,338,85,51,34,253,187,66,0,0.0,0.0
1007,418,2020-03-17 07:44:00,1,3103.0,2169.0,0.699,14.629,215,16,4,12,199,134,65,0,0.0,0.0
1007,419,2020-03-17 07:47:00,1,2848.0,2103.0,0.738,13.55,158,41,15,26,117,78,39,0,0.0,0.0
1007,420,2020-03-17 07:50:00,1,2720.0,1892.0,0.696,12.812,13,0,0,0,13,4,9,0,0.0,0.0
1007,421,2020-03-17 07:53:00,1,2174.0,1538.0,0.707,10.27,55,20,10,10,35,22,13,0,0.0,0.0
1007,422,2020-03-17 07:56:00,1,2116.0,1366.0,0.646,9.852,8,8,4,4,0,0,0,0,0.0,0.0
1007,423,2020-03-17 07:59:00,1,2115.0,1425.0,0.674,9.913,12,12,4,8,0,0,0,0,0.0,0.0
1007,424,2020-03-17 08:02:00,1,2088.0,1506.0,0.722,9.893,8,7,2,5,1,0,1,0,0.0,0.0
1007,425,2020-03-17 08:05:00,1,2092.0,1481.0,0.708,9.884,39,24,6,18,15,5,10,0,0.0,0.0
1007,426,2020-03-17 08:08:00,1,2093.0,1473.0,0.704,9.8775,12,7,0,7,5,2,3,0,0.0,0.0
1007,427,2020-03-17 08:11:00,1,2094.0,1465.0,0.7,9.871,54,24,8,16,30,18,12,0,0.0,0.0
1007,428,2020-03-17 08:14:00,1,2113.0,1401.0,0.663,9.875,17,10,4,6,7,0,7,0,0.0,0.0
1007,429,2020-03-17 08:17:00,1,2035.0,1346.0,0.661,9.508,12,12,4,8,0,0,0,0,0.0,0.0
1007,430,2020-03-17 08:20:00,1,2119.0,1380.0,0.651,9.878,257,98,62,36,159,110,49,4,0.0,0.0
1007,431,2020-03-17 08:23:00,1,2092.0,1496.0,0.715,9.898,25,25,0,25,0,0,0,0,0.0,0.0
1007,432,2020-03-17 08:26:00,1,2345.0,1602.0,0.683,11.013,222,32,19,13,190,110,80,12,0.0,0.0
1007,433,2020-03-17 08:29:00,1,2735.0,1864.0,0.682,12.842,276,53,34,19,223,152,71,16,0.0,0.0
1007,434,2020-03-17 08:32:00,1,2712.0,1962.0,0.724,12.857,347,87,59,28,260,188,72,49,0.0,0.0
1007,435,2020-03-17 08:35:00,1,2475.0,1766.0,0.714,11.707,199,60,33,27,139,93,46,0,0.0,0.0
1007,436,2020-03-17 08:38:00,1,2886.0,1995.0,0.691,13.579,344,74,41,33,270,204,66,0,0.0,0.0
1007,437,2020-03-17 08:41:00,1,2793.0,1980.0,0.709,13.197,432,76,48,28,356,270,86,2,0.0,0.0
1007,438,2020-03-17 08:44:00,1,2705.0,1948.0,0.72,12.813,633,162,121,41,471,364,107,0,0.0,0.0
1007,439,2020-03-17 08:47:00,1,2725.0,1905.0,0.699,12.844,572,163,133,30,409,310,99,3,0.0,0.0
1007,440,2020-03-17 08:50:00,1,2719.0,1902.0,0.7,12.817,303,96,69,27,207,150,57,3,0.0,0.0
1007,441,2020-03-17 08:53:00,1,2736.0,1841.0,0.673,12.819,103,40,3,37,63,22,41,0,0.0,0.0
1007,442,2020-03-17 08:56:00,1,2737.0,1874.0,0.685,12.858,145,20,7,13,125,86,39,0,0.0,0.0
1007,443,2020-03-17 08:59:00,1,2488.0,1739.0,0.699,11.73,98,1,1,0,97,44,53,0,0.0,0.0
1007,444,2020-03-17 09:02:00,1,2332.0,1618.0,0.694,10.98,12,11,5,6,1,1,0,0,0.0,0.0
1007,445,2020-03-17 09:05:00,1,2034.0,1372.0,0.674,9.532,12,6,2,4,6,1,5,0,0.0,0.0
1007,446,2020-03-17 09:08:00,1,1963.0,1280.0,0.652,9.152,22,11,9,2,11,8,3,0,0.0,0.0
1007,447,2020-03-17 09:11:00,1,2111.0,1425.0,0.675,9.894,14,1,1,0,13,0,13,0,0.0,0.0
1007,448,2020-03-17 09:14:00,1,2088.0,1480.0,0.709,9.867,10,0,0,0,10,1,9,0,0.0,0.0
1007,449,2020-03-17 09:17:00,1,2100.0,1445.0,0.688,9.876,4,0,0,0,4,0,4,0,0.0,0.0
1007,450,2020-03-17 09:20:00,1,2112.0,1418.0,0.671,9.893,39,8,4,4,31,5,26,0,0.0,0.0
1007,451,2020-03-17 09:23:00,1,2102.0,1492.0,0.71,9.935,93,5,2,3,88,54,34,0,0.0,0.0
1007,452,2020-03-17 09:26:00,1,2105.0,1417.0,0.673,9.864,14,4,0,4,10,0,10,0,0.0,0.0
1007,453,2020-03-17 09:29:00,1,2110.0,1406.0,0.666,9.872,6,2,0,2,4,1,3,0,0.0,0.0
1007,454,2020-03-17 09:32:00,1,1949.0,1341.0,0.688,9.166,89,31,11,20,58,41,17,0,0.01,0.0
1007,455,2020-03-17 09:35:00,1,2334.0,1642.0,0.703,11.015,261,78,47,31,183,135,48,12,0.01,0.0
1007,456,2020-03-17 09:38:00,1,2708.0,1955.0,0.722,12.833,159,41,27,14,118,86,32,5,0.0,0.0
1007,457,2020-03-17 09:41:00,1,2707.0,1940.0,0.717,12.814,265,26,16,10,239,178,61,0,0.0,0.0
1007,458,2020-03-17 09:44:00,1,2647.0,1833.0,0.693,12.459,208,17,6,11,191,160,31,0,0.0,0.0
1007,459,2020-03-17 09:47:00,1,2496.0,1718.0,0.688,11.738,110,6,0,6,104,78,26,0,0.0,0.0
1007,460,2020-03-17 09:50:00,1,2336.0,1601.0,0.685,10.978,2,0,0,0,2,0,2,0,0.0,0.0
1007,461,2020-03-17 09:53:00,1,2092.0,1472.0,0.703,9.871,14,0,0,0,14,7,7,0,0.0,0.0
1007,462,2020-03-17 09:56:00,1,2105.0,1426.0,0.678,9.874,8,0,0,0,8,0,8,0,0.0,0.0
1007,463,2020-03-17 09:59:00,1,2104.0,1447.0,0.687,9.894,17,8,0,8,9,2,7,0,0.0,0.0
1007,464,2020-03-17 10:02:00,1,2119.0,1396.0,0.659,9.896,11,3,0,3,8,0,8,0,0.0,0.0
1007,465,2020-03-17 10:05:00,1,2120.0,1377.0,0.65,9.878,7,6,0,6,1,0,1,0,0.0,0.0
1007,466,2020-03-17 10:08:00,1,2111.0,1411.0,0.668,9.878,12,2,0,2,10,0,10,0,0.0,0.0
1007,467,2020-03-17 10:11:00,1,2111.0,1432.0,0.678,9.905,9,3,0,3,6,0,6,0,0.0,0.0
1007,468,2020-03-17 10:14:00,1,2104.0,1442.0,0.685,9.887,8,3,0,3,5,0,5,0,0.0,0.0
1007,469,2020-03-17 10:17:00,1,2112.0,1425.0,0.674,9.901,5,2,0,2,3,0,3,0,0.0,0.0
1007,470,2020-03-17 10:20:00,1,2101.0,1467.0,0.698,9.904,16,10,0,10,6,0,6,0,0.0,0.0
1007,471,2020-03-17 10:23:00,1,2254.0,1546.0,0.686,10.593,21,9,0,9,12,5,7,0,0.0,0.0
1007,472,2020-03-17 10:26:00,1,2175.0,1520.0,0.699,10.254,14,7,0,7,7,0,7,0,0.0,0.0
1007,473,2020-03-17 10:29:00,1,2340.0,1574.0,0.672,10.964,10,0,0,0,10,6,4,0,0.0,0.0
1007,474,2020-03-17 10:32:00,1,2262.0,1534.0,0.678,10.612,8,3,0,3,5,2,3,0,0.0,0.0
1007,475,2020-03-17 10:35:00,1,2185.0,1528.0,0.699,10.302,80,14,7,7,66,52,14,1,0.0,0.0
1007,476,2020-03-17 10:38:00,1,2173.0,1538.0,0.708,10.264,7,7,2,5,0,0,0,0,0.0,0.0
1007,477,2020-03-17 10:41:00,1,2079.0,1525.0,0.734,9.878,1,1,0,1,0,0,0,0,0.0,0.0
1007,478,2020-03-17 10:44:00,1,2170.0,1538.0,0.709,10.251,8,7,2,5,1,0,1,0,0.0,0.0
1007,479,2020-03-17 10:47:00,1,2338.0,1601.0,0.685,10.985,3,1,1,0,2,1,1,0,0.0,0.0
1007,480,2020-03-17 10:50:00,1,2101.0,1412.0,0.672,9.84,21,10,3,7,11,8,3,0,0.0,0.0
1007,481,2020-03-17 10:53:00,1,2126.0,1373.0,0.646,9.896,119,28,12,16,91,63,28,0,0.0,0.0
1007,482,2020-03-17 10:56:00,1,2331.0,1621.0,0.695,10.981,321,60,34,26,261,192,69,2,0.0,0.0
1007,483,2020-03-17 10:59:00,1,2478.0,1762.0,0.711,11.714,398,131,92,39,267,214,53,11,0.0,0.0
1007,484,2020-03-17 11:02:00,1,2717.0,1896.0,0.698,12.803,240,81,49,32,159,113,46,36,0.0,0.0
1007,485,2020-03-17 11:05:00,1,2479.0,1759.0,0.709,11.714,123,54,26,28,69,53,16,2,0.0,0.0
1007,486,2020-03-17 11:08:00,1,2360.0,1694.5,0.718,11.1745,12,12,4,8,0,0,0,0,0.0,0.0
1007,487,2020-03-17 11:11:00,1,2241.0,1630.0,0.727,10.635,45,10,4,6,35,26,9,0,0.0,0.0
1007,488,2020-03-17 11:14:00,1,2152.0,1571.0,0.73,10.217,129,44,39,5,85,68,17,0,0.0,0.0
1007,489,2020-03-17 11:17:00,1,1915.0,1448.0,0.756,9.149,6,6,4,2,0,0,0,0,0.0,0.0
1007,490,2020-03-17 11:20:00,1,1932.0,1401.0,0.725,9.161,4,2,0,2,2,1,1,0,0.0,0.0
1007,491,2020-03-17 11:23:00,1,1923.0,1431.0,0.744,9.16,85,9,3,6,76,69,7,0,0.0,0.0
1007,492,2020-03-17 11:26:00,1,1918.0,1428.0,0.745,9.139,140,31,21,10,109,88,21,0,0.0,0.0
1007,493,2020-03-17 11:29:00,1,1918.0,1444.0,0.753,9.157,2,2,0,2,0,0,0,0,0.0,0.0
1007,494,2020-03-17 11:32:00,1,1767.0,1319.0,0.746,8.424,8,8,0,8,0,0,0,0,0.0,0.0
1007,495,2020-03-17 11:35:00,1,1764.0,1329.0,0.754,8.422,10,3,1,2,7,4,3,0,0.0,0.0
1007,496,2020-03-17 11:38:00,1,1917.0,1445.0,0.754,9.152,155,0,0,0,155,140,15,0,0.0,0.0
1007,497,2020-03-17 11:41:00,1,1916.0,1454.0,0.759,9.158,61,13,2,11,48,39,9,0,0.0,0.0
1007,498,2020-03-17 11:44:00,1,1923.0,1414.0,0.736,9.142,46,3,0,3,43,13,30,0,0.0,0.0
1007,499,2020-03-17 11:47:00,1,1942.0,1364.0,0.702,9.162,120,28,5,23,92,49,43,0,0.0,0.0
1007,500,2020-03-17 11:50:00,1,1909.0,1513.0,0.793,9.197,289,33,8,25,256,204,52,0,0.0,0.0
1007,501,2020-03-17 11:53:00,1,2151.0,1627.0,0.756,10.276,419,106,69,37,313,269,44,15,0.0,0.0
1007,502,2020-03-17 11:56:00,1,2222.0,1674.0,0.753,10.607,36,2,1,1,34,20,14,0,0.0,0.0
1007,503,2020-03-17 11:59:00,1,2159.0,1583.0,0.733,10.26,488,33,22,11,455,405,50,0,0.0,0.0
1007,504,2020-03-17 12:02:00,1,1905.0,1500.0,0.788,9.165,573,0,0,0,573,518,55,0,0.0,0.0
1007,505,2020-03-17 12:05:00,1,1924.0,1432.0,0.745,9.166,321,11,5,6,310,266,44,0,0.0,0.0
1007,506,2020-03-17 12:08:00,1,1924.0,1425.0,0.741,9.16,43,18,0,18,25,8,17,0,0.0,0.0
1007,507,2020-03-17 12:11:00,1,1930.0,1400.0,0.725,9.154,25,0,0,0,25,16,9,0,0.0,0.0
1007,508,2020-03-17 12:14:00,1,1928.0,1389.0,0.72,9.135,8,0,0,0,8,4,4,0,0.0,0.0
1007,509,2020-03-17 12:17:00,1,1921.0,1428.0,0.743,9.15,0,0,0,0,0,0,0,0,0.0,0.0
1007,510,2020-03-17 12:20:00,1,1923.0,1438.0,0.748,9.167,0,0,0,0,0,0,0,0,0.0,0.0
1007,511,2020-03-17 12:23:00,1,1915.0,1451.0,0.758,9.15,0,0,0,0,0,0,0,0,0.0,0.0
1007,512,2020-03-17 12:26:00,1,1927.0,1453.0,0.754,9.201,0,0,0,0,0,0,0,0,0.0,0.0
1007,513,2020-03-17 12:29:00,1,1926.0,1420.0,0.737,9.159,4,4,3,1,0,0,0,0,0.0,0.0
1007,514,2020-03-17 12:32:00,1,1942.0,1358.0,0.699,9.154,5,2,1,1,3,0,3,0,0.0,0.0
1007,515,2020-03-17 12:35:00,1,1932.0,1384.0,0.716,9.146,5,1,1,0,4,1,3,0,0.0,0.0
1007,516,2020-03-17 12:38:00,1,1918.0,1453.0,0.758,9.166,30,0,0,0,30,20,10,0,0.0,0.0
1007,517,2020-03-17 12:41:00,1,1926.0,1436.0,0.746,9.178,46,1,0,1,45,16,29,0,0.0,0.0
1007,518,2020-03-17 12:44:00,1,1997.0,1489.0,0.746,9.516,207,38,23,15,169,131,38,10,0.0,0.0
1007,519,2020-03-17 12:47:00,1,1924.0,1423.0,0.74,9.157,183,55,28,27,128,103,25,10,0.0,0.0
1007,520,2020-03-17 12:50:00,1,1852.0,1347.0,0.727,8.788,164,25,4,21,139,119,20,0,0.0,0.0
1007,521,2020-03-17 12:53:00,1,2375.0,1810.0,0.762,11.361,362,45,14,31,317,262,55,0,0.0,0.0
1007,522,2020-03-17 12:56:00,1,2548.0,1875.0,0.736,12.115,378,112,76,36,266,215,51,1,0.0,0.0
1007,523,2020-03-17 12:59:00,1,2375.0,1814.0,0.764,11.365,555,160,123,37,395,326,69,5,0.0,0.0
1007,524,2020-03-17 13:02:00,1,2535.0,1893.0,0.747,12.085,209,75,59,16,134,106,28,4,0.0,0.0
1007,525,2020-03-17 13:05:00,1,2465.0,1816.0,0.737,11.723,137,15,3,12,122,79,43,0,0.0,0.0
1007,526,2020-03-17 13:08:00,1,2536.0,1887.0,0.744,12.081,260,33,9,24,227,175,52,0,0.0,0.0
1007,527,2020-03-17 13:11:00,1,2304.0,1737.0,0.754,11.003,463,81,40,41,382,308,74,0,0.0,0.0
1007,528,2020-03-17 13:14:00,1,2305.0,1719.0,0.746,10.985,177,50,7,43,127,89,38,0,0.0,0.0
1007,529,2020-03-17 13:17:00,1,2307.0,1733.0,0.751,11.007,107,16,4,12,91,59,32,0,0.0,0.0
1007,530,2020-03-17 13:20:00,1,2147.0,1640.0,0.764,10.277,77,7,0,7,70,43,27,0,0.0,0.0
1007,531,2020-03-17 13:23:00,1,2166.0,1574.0,0.727,10.279,36,7,0,7,29,6,23,0,0.0,0.0
1007,532,2020-03-17 13:26:00,1,2087.0,1531.0,0.734,9.918,25,2,0,2,23,4,19,0,0.0,0.0
1007,533,2020-03-17 13:29:00,1,2003.0,1486.0,0.742,9.538,195,45,32,13,150,115,35,0,0.0,0.0
1007,534,2020-03-17 13:32:00,1,2079.0,1515.0,0.729,9.868,2,2,1,1,0,0,0,0,0.0,0.0
1007,535,2020-03-17 13:35:00,1,2084.0,1533.0,0.736,9.907,3,0,0,0,3,2,1,0,0.0,0.0
1007,536,2020-03-17 13:38:00,1,1911.0,1490.0,0.78,9.181,8,0,0,0,8,5,3,0,0.0,0.0
1007,537,2020-03-17 13:41:00,1,1917.0,1442.0,0.753,9.15,30,13,2,11,17,12,5,0,0.0,0.0
1007,538,2020-03-17 13:44:00,1,1937.0,1399.0,0.722,9.182,1,1,0,1,0,0,0,0,0.0,0.0
1007,539,2020-03-17 13:47:00,1,1937.0,1383.0,0.714,9.162,3,3,0,3,0,0,0,0,0.0,0.0
1007,540,2020-03-17 13:50:00,1,1930.0,1393.0,0.722,9.146,11,1,0,1,10,0,10,0,0.0,0.0
1007,541,2020-03-17 13:53:00,1,1921.0,1435.0,0.747,9.158,39,10,5,5,29,15,14,0,0.0,0.0
1007,542,2020-03-17 13:56:00,1,1928.0,1419.0,0.736,9.167,6,0,0,0,6,2,4,0,0.0,0.0
1007,543,2020-03-17 13:59:00,1,1771.0,1319.0,0.745,8.437,224,46,34,12,178,143,35,5,0.0,0.0
1007,544,2020-03-17 14:02:00,1,2394.0,1778.0,0.743,11.401,285,65,44,21,220,174,46,20,0.0,0.0
1007,545,2020-03-17 14:05:00,1,2309.0,1704.0,0.738,10.985,370,106,61,45,264,213,51,6,0.0,0.0
1007,546,2020-03-17 14:08:00,1,2046.0,1483.5,0.7235,9.7045,166,53,34,19,113,95,18,12,0.0,0.0
1007,547,2020-03-17 14:11:00,1,1783.0,1263.0,0.709,8.424,10,2,0,2,8,1,7,0,0.0,0.0
1007,548,2020-03-17 14:14:00,1,2310.0,1735.0,0.751,11.021,7,5,0,5,2,1,1,0,0.0,0.0
1007,549,2020-03-17 14:17:00,1,2156.0,1602.0,0.743,10.269,3,2,0,2,1,0,1,0,0.0,0.0
1007,550,2020-03-17 14:20:00,1,1917.0,1455.0,0.759,9.162,23,15,3,12,8,3,5,0,0.0,0.0
1007,551,2020-03-17 14:23:00,1,1917.0,1454.0,0.758,9.165,14,4,1,3,10,6,4,0,0.0,0.0
1007,552,2020-03-17 14:26:00,1,1919.0,1447.0,0.754,9.162,18,14,1,13,4,0,4,0,0.0,0.0
1007,553,2020-03-17 14:29:00,1,1931.0,1389.0,0.719,9.147,40,22,10,12,18,8,10,1,0.0,0.0
1007,554,2020-03-17 14:32:00,1,1929.0,1416.0,0.734,9.167,227,2,0,2,225,211,14,0,0.0,0.0
1007,555,2020-03-17 14:35:00,1,1923.0,1420.0,0.739,9.148,188,13,2,11,175,147,28,0,0.0,0.0
1007,556,2020-03-17 14:38:00,1,1915.0,1442.0,0.753,9.141,59,4,1,3,55,28,27,0,0.0,0.0
1007,557,2020-03-17 14:41:00,1,1918.0,1437.0,0.749,9.146,77,7,1,6,70,47,23,0,0.0,0.0
1007,558,2020-03-17 14:44:00,1,1925.0,1410.0,0.732,9.146,300,17,7,10,283,245,38,0,0.0,0.0
1007,559,2020-03-17 14:47:00,1,1928.0,1404.0,0.729,9.15,533,8,1,7,525,475,50,0,0.0,0.0
1007,560,2020-03-17 14:50:00,1,1930.0,1407.0,0.729,9.162,158,30,0,30,128,119,9,0,0.0,0.0
1007,561,2020-03-17 14:53:00,1,1927.0,1421.0,0.737,9.168,42,3,0,3,39,19,20,0,0.0,0.0
1007,562,2020-03-17 14:56:00,1,1932.0,1415.0,0.733,9.178,16,0,0,0,16,0,16,0,0.0,0.0
1007,563,2020-03-17 14:59:00,1,1950.0,1341.0,0.687,9.168,104,6,0,6,98,67,31,0,0.0,0.0
1007,564,2020-03-17 15:02:00,1,1934.0,1382.0,0.715,9.152,389,11,1,10,378,321,57,0,0.0,0.0
1007,565,2020-03-17 15:05:00,1,1918.0,1451.0,0.757,9.162,23,3,0,3,20,0,20,0,0.0,0.0
1007,566,2020-03-17 15:08:00,1,1921.0,1451.0,0.756,9.174,106,12,2,10,94,62,32,0,0.0,0.0
1007,567,2020-03-17 15:11:00,1,1933.0,1396.0,0.722,9.161,130,12,0,12,118,84,34,0,0.0,0.0
1007,568,2020-03-17 15:14:00,1,1703.0,1216.0,0.714,8.058,602,13,0,13,589,507,82,0,0.0,0.0
1007,569,2020-03-17 15:17:00,1,1783.0,1251.0,0.701,8.411,53,1,0,1,52,44,8,0,0.0,0.0
1007,570,2020-03-17 15:20:00,1,1921.0,1418.0,0.738,9.137,60,4,0,4,56,45,11,0,0.0,0.0
1007,571,2020-03-17 15:23:00,1,1899.0,1509.0,0.794,9.154,625,4,0,4,621,570,51,0,0.0,0.0
1007,572,2020-03-17 15:26:00,1,1915.0,1465.0,0.765,9.169,459,6,0,6,453,409,44,0,0.0,0.0
1007,573,2020-03-17 15:29:00,1,1915.0,1461.0,0.763,9.161,94,3,0,3,91,65,26,0,0.0,0.0
1007,574,2020-03-17 15:32:00,1,1925.0,1421.0,0.738,9.159,149,8,0,8,141,113,28,0,0.0,0.0
1007,575,2020-03-17 15:35:00,1,1909.0,1495.0,0.783,9.175,618,8,0,8,610,534,76,0,0.0,0.0
1007,576,2020-03-17 15:38:00,1,1916.0,1465.0,0.765,9.171,351,3,0,3,348,302,46,0,0.0,0.0
1007,577,2020-03-17 15:41:00,1,1911.0,1469.0,0.769,9.156,95,2,0,2,93,67,26,0,0.0,0.0
1007,578,2020-03-17 15:44:00,1,1922.0,1417.0,0.737,9.143,41,1,0,1,40,25,15,0,0.0,0.0
1007,579,2020-03-17 15:47:00,1,1913.0,1479.0,0.773,9.176,246,64,29,35,182,139,43,0,0.0,0.0
1007,580,2020-03-17 15:50:00,1,2230.0,1656.0,0.743,10.62,199,22,10,12,177,138,39,0,0.0,0.0
1007,581,2020-03-17 15:53:00,1,2305.0,1729.0,0.75,10.995,321,61,31,30,260,190,70,4,0.0,0.0
1007,582,2020-03-17 15:56:00,1,2306.0,1730.0,0.75,11.002,402,79,48,31,323,238,85,0,0.0,0.0
1007,583,2020-03-17 15:59:00,1,2293.0,1768.0,0.771,10.991,433,116,80,36,317,245,72,12,0.0,0.0
1007,584,2020-03-17 16:02:00,1,2527.0,1936.0,0.766,12.101,370,118,88,30,252,197,55,11,0.0,0.0
1007,585,2020-03-17 16:05:00,1,2235.0,1615.0,0.723,10.596,316,116,75,41,200,154,46,5,0.0,0.0
1007,586,2020-03-17 16:08:00,1,2527.0,1913.0,0.757,12.074,472,96,63,33,376,307,69,0,0.0,0.0
1007,587,2020-03-17 16:11:00,1,2300.0,1748.0,0.76,11.0,104,50,16,34,54,36,18,0,0.0,0.0
1007,588,2020-03-17 16:14:00,1,2145.0,1615.0,0.753,10.241,302,16,4,12,286,240,46,0,0.0,0.0
1007,589,2020-03-17 16:17:00,1,1914.0,1464.0,0.765,9.164,204,0,0,0,204,167,37,0,0.0,0.0
1007,590,2020-03-17 16:20:00,1,1905.0,1520.0,0.798,9.186,26,0,0,0,26,10,16,0,0.0,0.0
1007,591,2020-03-17 16:23:00,1,2073.0,1537.0,0.741,9.868,60,17,1,16,43,27,16,0,0.0,0.0
1007,592,2020-03-17 16:26:00,1,1902.0,1500.0,0.788,9.155,9,1,1,0,8,3,5,0,0.0,0.0
1007,593,2020-03-17 16:29:00,1,1927.0,1417.0,0.735,9.16,6,0,0,0,6,1,5,0,0.0,0.0
1007,594,2020-03-17 16:32:00,1,1940.0,1357.0,0.699,9.145,17,1,0,1,16,5,11,0,0.0,0.0
1007,595,2020-03-17 16:35:00,1,1913.0,1468.0,0.767,9.164,14,0,0,0,14,8,6,0,0.0,0.0
1007,596,2020-03-17 16:38:00,1,1918.0,1446.0,0.754,9.158,12,0,0,0,12,8,4,0,0.0,0.0
1007,597,2020-03-17 16:41:00,1,1919.0,1423.0,0.742,9.137,474,5,0,5,469,404,65,0,0.0,0.0
1007,598,2020-03-17 16:44:00,1,1917.0,1447.0,0.755,9.156,674,6,0,6,668,577,91,0,0.0,0.0
1007,599,2020-03-17 16:47:00,1,1911.0,1486.0,0.777,9.175,196,2,0,2,194,156,38,0,0.0,0.0
1007,600,2020-03-17 16:50:00,1,1704.0,1194.0,0.701,8.037,100,27,0,27,73,38,35,0,0.0,0.0
1007,601,2020-03-17 16:53:00,1,1393.0,995.0,0.715,6.589,284,10,2,8,274,230,44,0,0.0,0.0
1007,602,2020-03-17 16:56:00,1,1136.0,927.0,0.816,5.501,225,0,0,0,225,183,42,0,0.0,0.0
1007,603,2020-03-17 16:59:00,1,1314.0,949.0,0.722,6.227,262,8,0,8,254,210,44,0,0.0,0.0
1007,604,2020-03-17 17:02:00,1,1562.0,1055.0,0.676,7.323,152,6,0,6,146,111,35,0,0.0,0.0
1007,605,2020-03-17 17:05:00,1,2169.0,1547.0,0.713,10.259,216,21,0,21,195,150,45,0,0.0,0.0
1007,606,2020-03-17 17:08:00,1,2207.5,1595.0,0.7225,10.4635,355,3,0,3,352,281,71,0,0.0,0.0
1007,607,2020-03-17 17:11:00,1,2246.0,1643.0,0.732,10.668,288,25,11,14,263,223,40,0,0.0,0.0
1007,608,2020-03-17 17:14:00,1,2298.0,1770.0,0.77,11.013,91,0,0,0,91,69,22,0,0.0,0.0
1007,609,2020-03-17 17:17:00,1,1988.0,1555.0,0.782,9.555,2,0,0,0,2,0,2,0,0.0,0.0
1007,610,2020-03-17 17:20:00,1,1903.0,1511.0,0.794,9.173,288,46,19,27,242,184,58,0,0.0,0.0
1007,611,2020-03-17 17:23:00,1,2303.0,1732.0,0.752,10.992,181,17,5,12,164,128,36,0,0.0,0.0
1007,612,2020-03-17 17:26:00,1,2373.0,1819.0,0.767,11.366,334,21,2,19,313,259,54,0,0.0,0.0
1007,613,2020-03-17 17:29:00,1,2537.0,1893.0,0.746,12.093,407,78,45,33,329,256,73,8,0.0,0.0
1007,614,2020-03-17 17:32:00,1,2457.0,1855.0,0.755,11.736,47,0,0,0,47,26,21,0,0.0,0.0
1007,615,2020-03-17 17:35:00,1,2226.0,1677.0,0.753,10.628,29,1,0,1,28,12,16,0,0.0,0.0
1007,616,2020-03-17 17:38:00,1,1898.0,1528.0,0.805,9.17,167,0,0,0,167,131,36,0,0.0,0.0
1007,617,2020-03-17 17:41:00,1,1915.0,1457.0,0.761,9.157,160,0,0,0,160,127,33,0,0.0,0.0
1007,618,2020-03-17 17:44:00,1,1914.0,1477.0,0.772,9.175,508,0,0,0,508,433,75,0,0.0,0.0
1007,619,2020-03-17 17:47:00,1,1912.0,1494.0,0.782,9.185,60,7,2,5,53,31,22,0,0.0,0.0
1007,620,2020-03-17 17:50:00,1,2236.0,1631.0,0.729,10.617,53,10,0,10,43,30,13,1,0.0,0.0
1007,621,2020-03-17 17:53:00,1,2322.0,1675.0,0.721,11.004,98,19,4,15,79,46,33,0,0.0,0.0
1007,622,2020-03-17 17:56:00,1,2378.0,1808.0,0.76,11.37,332,29,2,27,303,238,65,1,0.0,0.0
1007,623,2020-03-17 17:59:00,1,2541.0,1897.0,0.747,12.111,274,25,7,18,249,193,56,0,0.0,0.0
1007,624,2020-03-17 18:02:00,0,2530.0,1918.0,0.758,12.093,696,231,192,39,465,401,64,39,0.0,0.0
1007,625,2020-03-17 18:05:00,0,2991.0,2269.0,0.759,14.296,520,199,157,42,321,261,60,44,0.0,0.05
1007,626,2020-03-17 18:08:00,0,2675.0,2055.0,0.768,12.816,689,217,169,48,472,389,83,22,0.0,0.0
1007,627,2020-03-17 18:11:00,0,3142.0,2407.0,0.766,15.047,668,173,127,46,495,416,79,21,0.0,0.0
1007,628,2020-03-17 18:14:00,0,3083.0,2260.0,0.733,14.648,295,68,38,30,227,181,46,8,0.0,0.0
1007,629,2020-03-17 18:17:00,0,2838.0,2185.0,0.77,13.6,598,182,136,46,416,340,76,51,0.0,0.0
1007,630,2020-03-17 18:20:00,0,2663.0,2076.0,0.779,12.792,420,122,84,38,298,241,57,29,0.01,0.0
1007,631,2020-03-17 18:23:00,0,2099.0,1483.0,0.707,9.91,306,48,16,32,258,189,69,6,0.0,0.0
1007,632,2020-03-17 18:26:00,0,2676.0,2109.0,0.788,12.88,421,56,26,30,365,283,82,0,0.0,0.0
1007,633,2020-03-17 18:29:00,0,2752.0,2124.0,0.772,13.195,42,15,0,15,27,0,27,0,0.0,0.0
1007,634,2020-03-17 18:32:00,0,2610.0,1977.0,0.758,12.474,95,18,3,15,77,37,40,0,0.0,0.0
1007,635,2020-03-17 18:35:00,0,2544.0,1835.0,0.721,12.054,43,1,1,0,42,8,34,0,0.0,0.0
1007,636,2020-03-17 18:38:00,0,2312.0,1697.0,0.734,10.986,130,4,0,4,126,80,46,0,0.0,0.0
1007,637,2020-03-17 18:41:00,0,2153.0,1638.0,0.761,10.296,161,10,4,6,151,114,37,0,0.0,0.0
1007,638,2020-03-17 18:44:00,0,2160.0,1596.0,0.739,10.276,28,9,3,6,19,10,9,0,0.0,0.0
1007,639,2020-03-17 18:47:00,0,2156.0,1601.0,0.743,10.268,60,14,2,12,46,40,6,0,0.0,0.0
1007,640,2020-03-17 18:50:00,0,2148.0,1620.0,0.754,10.259,329,84,54,30,245,198,47,9,0.0,0.0
1007,641,2020-03-17 18:53:00,0,2520.0,1955.0,0.776,12.092,645,227,179,48,418,344,74,30,0.0,0.0
1007,642,2020-03-17 18:56:00,0,2537.0,1939.0,0.765,12.142,427,120,84,36,307,239,68,70,0.0,0.0
1007,643,2020-03-17 18:59:00,0,2677.0,2060.0,0.77,12.829,603,184,137,47,419,341,78,66,0.0,0.0
1007,644,2020-03-17 19:02:00,0,2677.0,2064.0,0.771,12.835,505,177,117,60,328,251,77,72,0.0,0.0
1007,645,2020-03-17 19:05:00,0,2464.0,1805.0,0.733,11.708,461,103,73,30,358,284,74,62,0.0,0.0
1007,646,2020-03-17 19:08:00,0,1928.0,1411.0,0.732,9.159,358,63,38,25,295,237,58,9,0.0,0.0
1007,647,2020-03-17 19:11:00,0,1950.0,1346.0,0.69,9.172,414,85,41,44,329,273,56,48,0.0,0.0
1007,648,2020-03-17 19:14:00,0,3052.0,2370.0,0.777,14.651,397,110,71,39,287,231,56,65,0.0,0.0
1007,649,2020-03-17 19:17:00,0,1978.0,1557.0,0.787,9.516,520,111,72,39,409,342,67,10,0.0,0.0
1007,650,2020-03-17 19:20:00,0,1861.0,1330.0,0.715,8.805,420,129,95,34,291,234,57,14,0.0,0.0
1007,651,2020-03-17 19:23:00,0,1989.0,1543.0,0.775,9.546,130,38,16,22,92,47,45,1,0.0,0.0
1007,652,2020-03-17 19:26:00,0,1941.0,1379.0,0.711,9.175,433,43,16,27,390,304,86,0,0.0,0.0
1007,653,2020-03-17 19:29:00,0,1772.0,1304.0,0.736,8.428,147,27,17,10,120,90,30,4,0.0,0.0
1007,654,2020-03-17 19:32:00,0,1769.0,1316.0,0.744,8.426,26,1,0,1,25,8,17,0,0.0,0.0
1007,655,2020-03-17 19:35:00,0,1780.0,1269.0,0.713,8.418,115,0,0,0,115,91,24,0,0.0,0.0
1007,656,2020-03-17 19:38:00,0,1772.0,1284.0,0.725,8.405,195,0,0,0,195,162,33,0,0.0,0.0
1007,657,2020-03-17 19:41:00,0,1931.0,1389.0,0.719,9.146,355,20,9,11,335,293,42,3,0.0,0.0
1007,658,2020-03-17 19:44:00,0,3048.0,2396.0,0.786,14.664,403,128,91,37,275,226,49,30,0.0,0.0
1007,659,2020-03-17 19:47:00,0,3329.0,2718.0,0.816,16.127,611,181,149,32,430,359,71,64,0.0,0.0
1007,660,2020-03-17 19:50:00,0,3413.0,2755.0,0.807,16.497,360,109,78,31,251,206,45,34,0.0,0.0
1007,661,2020-03-17 19:53:00,0,1927.0,1403.0,0.728,9.144,4,0,0,0,4,1,3,0,0.0,0.0
1007,662,2020-03-17 19:56:00,0,1767.0,1316.0,0.744,8.42,15,8,0,8,7,4,3,0,0.0,0.0
1007,663,2020-03-17 19:59:00,0,1789.0,1223.0,0.684,8.403,27,17,1,16,10,3,7,0,0.0,0.0
1007,664,2020-03-17 20:02:00,0,1792.0,1233.0,0.688,8.426,60,7,1,6,53,31,22,0,0.0,0.0
1007,665,2020-03-17 20:05:00,0,1773.0,1282.0,0.723,8.406,29,2,1,1,27,9,18,0,0.0,0.0
1007,666,2020-03-17 20:08:00,0,1895.5,1346.5,0.711,8.959,151,31,17,14,120,80,40,3,0.0,0.0
1007,667,2020-03-17 20:11:00,0,2018.0,1411.0,0.699,9.512,549,41,11,30,508,402,106,5,0.0,0.0
1007,668,2020-03-17 20:14:00,0,2750.0,2110.0,0.767,13.17,561,147,102,45,414,341,73,30,0.0,0.0
1007,669,2020-03-17 20:17:00,0,3388.0,2476.0,0.731,16.092,491,148,117,31,343,279,64,24,0.0,0.0
1007,670,2020-03-17 20:20:00,0,2317.0,1680.0,0.725,10.991,574,178,129,49,396,308,88,20,0.0,0.0
1007,671,2020-03-17 20:23:00,0,3440.0,2615.0,0.76,16.448,499,155,127,28,344,280,64,16,0.0,0.01
1007,672,2020-03-17 20:26:00,0,3153.0,2330.0,0.739,15.002,679,192,161,31,487,405,82,43,0.0,0.0
1007,673,2020-03-17 20:29:00,0,2843.0,2145.0,0.754,13.576,385,98,66,32,287,221,66,9,0.0,0.0
1007,674,2020-03-17 20:32:00,0,3162.0,2334.0,0.738,15.042,418,88,72,16,330,264,66,17,0.0,0.0
1007,675,2020-03-17 20:35:00,0,2838.0,2134.0,0.752,13.546,124,10,1,9,114,82,32,0,0.0,0.0
1007,676,2020-03-17 20:38:00,0,3403.0,2442.0,0.717,16.113,271,15,5,10,256,193,63,0,0.0,0.0
1007,677,2020-03-17 20:41:00,0,3321.0,2448.0,0.737,15.795,367,40,14,26,327,270,57,0,0.0,0.0
1007,678,2020-03-17 20:44:00,0,2997.0,2235.0,0.746,14.283,27,0,0,0,27,0,27,0,0.0,0.0
1007,679,2020-03-17 20:47:00,0,2604.0,2004.0,0.769,12.478,27,4,1,3,23,2,21,0,0.0,0.0
1007,680,2020-03-17 20:50:00,0,2549.0,1829.0,0.718,12.07,68,9,5,4,59,31,28,0,0.0,0.0
1007,681,2020-03-17 20:53:00,0,2397.0,1733.0,0.723,11.364,20,0,0,0,20,4,16,0,0.0,0.0
1007,682,2020-03-17 20:56:00,0,2237.0,1615.0,0.722,10.601,29,9,0,9,20,0,20,0,0.0,0.0
1007,683,2020-03-17 20:59:00,0,2089.0,1524.0,0.73,9.919,51,2,0,2,49,27,22,0,0.0,0.0
1007,684,2020-03-17 21:02:00,0,2400.0,1745.0,0.727,11.388,494,146,101,45,348,284,64,20,0.0,0.0
1007,685,2020-03-17 21:05:00,0,2632.0,1877.0,0.713,12.449,550,180,141,39,370,302,68,41,0.0,0.0
1007,686,2020-03-17 21:08:00,0,2767.0,2064.0,0.746,13.189,381,126,74,52,255,201,54,77,0.0,0.0
1007,687,2020-03-17 21:11:00,0,2761.0,2105.0,0.762,13.209,395,108,76,32,287,226,61,59,0.0,0.0
1007,688,2020-03-17 21:14:00,0,3017.0,2170.0,0.719,14.29,141,72,39,33,69,55,14,35,0.0,0.0
1007,689,2020-03-17 21:17:00,0,1946.0,1335.0,0.686,9.146,305,100,67,33,205,156,49,41,0.0,0.0
1007,690,2020-03-17 21:20:00,0,2756.0,2114.0,0.767,13.2,501,163,117,46,338,266,72,41,0.0,0.0
1007,691,2020-03-17 21:23:00,0,2694.0,1966.0,0.73,12.791,398,122,76,46,276,224,52,56,0.0,0.0
1007,692,2020-03-17 21:26:00,0,1996.0,1514.0,0.759,9.543,189,70,42,28,119,96,23,13,0.0,0.0
1007,693,2020-03-17 21:29:00,0,1466.0,1073.0,0.732,6.963,2,0,0,0,2,0,2,0,0.0,0.0
1007,694,2020-03-17 21:32:00,0,1557.0,1072.0,0.688,7.323,27,17,10,7,10,4,6,0,0.0,0.0
1007,695,2020-03-17 21:35:00,0,1632.0,1130.0,0.692,7.681,38,22,15,7,16,3,13,0,0.0,0.0
1007,696,2020-03-17 21:38:00,0,1486.0,991.0,0.667,6.952,24,17,12,5,7,1,6,0,0.0,0.0
1007,697,2020-03-17 21:41:00,0,1633.0,1151.0,0.705,7.709,6,4,0,4,2,0,2,0,0.0,0.0
1007,698,2020-03-17 21:44:00,0,1466.0,1062.0,0.724,6.952,424,98,68,30,326,262,64,2,0.0,0.0
1007,699,2020-03-17 21:47:00,0,3399.0,2487.0,0.732,16.144,467,125,88,37,342,280,62,54,0.0,0.0
1007,700,2020-03-17 21:50:00,0,3524.0,2663.0,0.755,16.835,382,106,65,41,276,231,45,58,0.0,0.0
1007,701,2020-03-17 21:53:00,0,2384.0,1763.0,0.74,11.346,445,93,68,25,352,280,72,23,0.0,0.04
1007,702,2020-03-17 21:56:00,0,2020.0,1412.0,0.699,9.524,533,146,121,25,387,320,67,23,0.0,0.0
1007,703,2020-03-17 21:59:00,0,2919.0,2245.0,0.769,13.985,357,110,72,38,247,208,39,24,0.0,0.0
1007,704,2020-03-17 22:02:00,0,3522.0,2706.0,0.768,16.873,452,155,115,40,297,246,51,18,0.0,0.0
1007,705,2020-03-17 22:05:00,0,3385.0,2550.0,0.753,16.16,540,176,132,44,364,284,80,45,0.0,0.0
1007,706,2020-03-17 22:08:00,0,3466.0,2568.0,0.741,16.501,650,191,156,35,459,366,93,35,0.0,0.0
1007,707,2020-03-17 22:11:00,0,3319.0,2392.0,0.721,15.725,211,41,26,15,170,100,70,19,0.0,0.0
1007,708,2020-03-17 22:14:00,0,2683.0,2009.0,0.749,12.795,409,115,73,42,294,218,76,10,0.0,0.0
1007,709,2020-03-17 22:17:00,0,3102.0,2220.0,0.716,14.679,429,130,93,37,299,218,81,11,0.0,0.0
1007,710,2020-03-17 22:20:00,0,2991.0,2258.0,0.755,14.286,447,126,90,36,321,238,83,24,0.0,0.0
1007,711,2020-03-17 22:23:00,0,2650.0,1793.0,0.677,12.427,280,62,40,22,218,153,65,5,0.0,0.0
1007,712,2020-03-17 22:26:00,0,3239.0,2410.0,0.744,15.43,481,119,85,34,362,268,94,56,0.0,0.0
1007,713,2020-03-17 22:29:00,0,3160.0,2308.0,0.73,15.005,366,128,98,30,238,180,58,52,0.0,0.0
1007,714,2020-03-17 22:32:00,0,3172.0,2269.0,0.715,15.008,324,108,60,48,216,150,66,61,0.0,0.0
1007,715,2020-03-17 22:35:00,0,3147.0,2363.0,0.751,15.018,243,96,61,35,147,89,58,77,0.0,0.0
1007,716,2020-03-17 22:38:00,0,2982.0,2257.0,0.757,14.249,203,80,45,35,123,61,62,55,0.0,0.07
1007,717,2020-03-17 22:41:00,0,3140.0,2448.0,0.779,15.084,294,106,59,47,188,115,73,87,0.0,0.07
1007,718,2020-03-17 22:44:00,0,2380.0,1784.0,0.749,11.354,217,50,36,14,167,103,64,10,0.0,0.01
1007,719,2020-03-17 22:47:00,0,2014.0,1452.0,0.721,9.542,35,0,0,0,35,0,35,0,0.0,0.0
1007,720,2020-03-17 22:50:00,0,1778.0,1265.0,0.712,8.407,176,4,1,3,172,105,67,4,0.0,0.0
1007,721,2020-03-17 22:53:00,0,1986.0,1553.0,0.782,9.546,503,98,55,43,405,318,87,27,0.0,0.0
1007,722,2020-03-17 22:56:00,0,3101.0,2515.0,0.811,15.004,653,168,130,38,485,385,100,31,0.0,0.0
1007,723,2020-03-17 22:59:00,0,2728.0,2213.0,0.811,13.196,481,124,92,32,357,267,90,59,0.0,0.0
1007,724,2020-03-17 23:02:00,0,3484.0,2872.0,0.824,16.906,309,121,73,48,188,117,71,57,0.0,0.01
1007,725,2020-03-17 23:05:00,0,3504.0,2803.0,0.8,16.908,436,131,85,46,305,226,79,65,0.0,0.07
1007,726,2020-03-17 23:08:00,0,2696.5,2175.0,0.8095,13.032,114,33,20,13,81,52,29,12,0.0,0.01
1007,727,2020-03-17 23:11:00,0,1889.0,1547.0,0.819,9.156,81,0,0,0,81,51,30,0,0.0,0.0
1007,728,2020-03-17 23:14:00,0,1749.0,1398.0,0.799,8.438,370,15,3,12,355,302,53,7,0.0,0.0
1007,729,2020-03-17 23:17:00,0,2413.0,2025.0,0.839,11.748,524,116,76,40,408,313,95,33,0.0,0.0
1007,730,2020-03-17 23:20:00,0,2691.0,2347.0,0.872,13.201,475,143,105,38,332,265,67,36,0.0,0.06
1007,731,2020-03-17 23:23:00,0,1887.0,1581.0,0.838,9.184,286,53,31,22,233,180,53,8,0.0,0.0
1007,732,2020-03-17 23:26:00,0,2851.0,2452.0,0.86,13.95,340,91,64,27,249,181,68,10,0.0,0.0
1007,733,2020-03-17 23:29:00,0,2285.0,1829.0,0.8,11.029,213,33,12,21,180,121,59,0,0.0,0.0
1007,734,2020-03-17 23:32:00,0,3234.0,2761.0,0.854,15.8,283,70,37,33,213,146,67,2,0.0,0.0
1007,735,2020-03-17 23:35:00,0,3160.0,2694.0,0.853,15.433,73,10,4,6,63,42,21,0,0.0,0.0
1007,736,2020-03-17 23:38:00,0,3073.0,2652.0,0.863,15.043,382,0,0,0,382,298,84,0,0.0,0.0
1007,737,2020-03-17 23:41:00,0,2845.0,2466.0,0.867,13.941,197,0,0,0,197,149,48,0,0.0,0.0
1007,738,2020-03-17 23:44:00,0,2618.0,2276.0,0.869,12.836,455,0,0,0,455,384,71,0,0.0,0.0
1007,739,2020-03-17 23:47:00,0,2483.0,2099.0,0.845,12.108,248,1,1,0,247,195,52,0,0.0,0.0
1007,740,2020-03-17 23:50:00,0,2340.0,1952.0,0.834,11.38,84,4,2,2,80,37,43,0,0.0,0.0
1007,741,2020-03-17 23:53:00,0,2276.0,1849.0,0.812,11.014,321,51,38,13,270,201,69,3,0.0,0.0
1007,742,2020-03-17 23:56:00,0,2247.0,1925.0,0.857,10.985,217,24,2,22,193,137,56,0,0.0,0.0
1007,743,2020-03-17 23:59:00,0,2255.0,1916.0,0.85,11.007,488,7,2,5,481,402,79,0,0.0,0.0
1007,744,2020-03-18 00:02:00,0,2112.0,1761.0,0.834,10.272,427,0,0,0,427,320,107,0,0.0,0.0
1007,745,2020-03-18 00:05:00,0,2047.0,1671.0,0.816,9.916,105,1,0,1,104,49,55,0,0.0,0.0
1007,746,2020-03-18 00:08:00,0,1873.0,1604.0,0.857,9.156,224,58,40,18,166,99,67,13,0.0,0.0
1007,747,2020-03-18 00:11:00,0,2207.0,1765.0,0.8,10.649,4,0,0,0,4,0,4,0,0.0,0.0
1007,748,2020-03-18 00:14:00,0,2128.0,1683.0,0.791,10.246,67,16,15,1,51,41,10,0,0.0,0.0
1007,749,2020-03-18 00:17:00,0,2273.0,1821.0,0.801,10.971,462,90,58,32,372,292,80,62,0.0,0.0
1007,750,2020-03-18 00:20:00,0,2501.0,2051.0,0.82,12.125,342,119,66,53,223,163,60,70,0.0,0.0
1007,751,2020-03-18 00:23:00,0,2478.0,2119.0,0.855,12.109,535,128,87,41,407,319,88,24,0.0,0.0
1007,752,2020-03-18 00:26:00,0,2641.0,2209.0,0.837,12.85,336,96,65,31,240,181,59,34,0.0,0.1
1007,753,2020-03-18 00:29:00,0,2426.0,1954.0,0.806,11.72,289,78,48,30,211,148,63,27,0.0,0.0
1007,754,2020-03-18 00:32:00,0,2566.0,2093.0,0.816,12.428,250,66,27,39,184,112,72,27,0.0,0.0
1007,755,2020-03-18 00:35:00,0,3091.0,2580.0,0.835,15.036,473,136,104,32,337,263,74,28,0.0,0.0
1007,756,2020-03-18 00:38:00,0,2630.0,2245.0,0.854,12.849,436,120,87,33,316,241,75,62,0.0,0.0
1007,757,2020-03-18 00:41:00,0,3039.0,2416.0,0.795,14.649,326,98,62,36,228,172,56,79,0.0,0.01
1007,758,2020-03-18 00:44:00,0,3035.0,2462.0,0.811,14.685,382,108,54,54,274,193,81,68,0.0,0.09
1007,759,2020-03-18 00:47:00,0,2485.0,2109.0,0.849,12.125,373,104,73,31,269,216,53,27,0.0,0.0
1007,760,2020-03-18 00:50:00,0,1768.0,1330.0,0.752,8.441,6,5,2,3,1,1,0,0,0.0,0.0
1007,761,2020-03-18 00:53:00,0,1515.0,1219.0,0.805,7.318,30,15,7,8,15,10,5,0,0.0,0.0
1007,762,2020-03-18 00:56:00,0,1767.0,1314.0,0.744,8.419,13,3,2,1,10,6,4,0,0.0,0.0
1007,763,2020-03-18 00:59:00,0,1894.0,1525.0,0.805,9.149,52,31,6,25,21,4,17,0,0.0,0.0
1007,764,2020-03-18 01:02:00,0,2216.0,1750.0,0.79,10.671,47,9,2,7,38,18,20,0,0.0,0.0
1007,765,2020-03-18 01:05:00,0,2477.0,2136.0,0.862,12.125,319,7,2,5,312,281,31,0,0.0,0.0
1007,766,2020-03-18 01:08:00,0,2479.0,2115.0,0.853,12.109,2,2,0,2,0,0,0,0,0.0,0.0
1007,767,2020-03-18 01:11:00,0,2508.0,2026.0,0.808,12.123,179,36,16,20,143,103,40,0,0.0,0.0
1007,768,2020-03-18 01:14:00,0,2627.0,2269.0,0.864,12.861,392,123,92,31,269,213,56,74,0.0,0.0
1007,769,2020-03-18 01:17:00,0,2846.0,2449.0,0.86,13.923,349,123,86,37,226,175,51,78,0.0,0.02
1007,770,2020-03-18 01:20:00,0,3058.0,2683.0,0.877,15.02,380,141,88,53,239,182,57,69,0.0,0.04
1007,771,2020-03-18 01:23:00,0,1938.0,1725.0,0.89,9.545,194,58,36,22,136,98,38,17,0.0,0.0
1007,772,2020-03-18 01:26:00,0,1878.0,1597.0,0.851,9.166,250,44,14,30,206,146,60,2,0.0,0.0
1007,773,2020-03-18 01:29:00,0,2490.0,2068.0,0.83,12.102,149,38,22,16,111,71,40,3,0.0,0.0
1007,774,2020-03-18 01:32:00,0,2108.0,1802.0,0.855,10.299,47,0,0,0,47,0,47,0,0.0,0.0
1007,775,2020-03-18 01:35:00,0,2239.0,1978.0,0.884,11.01,92,17,5,12,75,23,52,0,0.0,0.0
1007,776,2020-03-18 01:38:00,0,2480.0,2110.0,0.851,12.108,50,0,0,0,50,4,46,0,0.0,0.0
1007,777,2020-03-18 01:41:00,0,2487.0,2114.0,0.85,12.14,40,0,0,0,40,0,40,0,0.0,0.0
1007,778,2020-03-18 01:44:00,0,2460.0,2185.0,0.888,12.112,44,4,1,3,40,2,38,0,0.0,0.0
1007,779,2020-03-18 01:47:00,0,2451.0,2205.0,0.9,12.098,44,0,0,0,44,11,33,0,0.0,0.0
1007,780,2020-03-18 01:50:00,0,2535.0,2254.0,0.889,12.484,37,0,0,0,37,9,28,0,0.0,0.0
1007,781,2020-03-18 01:53:00,0,2477.0,2130.0,0.86,12.116,40,0,0,0,40,5,35,0,0.0,0.0
1007,782,2020-03-18 01:56:00,0,2395.0,2062.0,0.861,11.718,228,51,43,8,177,115,62,7,0.0,0.0
1007,783,2020-03-18 01:59:00,0,2473.0,2159.0,0.873,12.134,44,2,0,2,42,2,40,0,0.0,0.0
1007,784,2020-03-18 02:02:00,0,2312.0,2025.0,0.876,11.351,52,1,0,1,51,3,48,0,0.0,0.01
1007,785,2020-03-18 02:05:00,0,2245.0,1932.0,0.861,10.985,43,2,0,2,41,0,41,0,0.0,0.0
1007,786,2020-03-18 02:08:00,0,2238.5,1947.0,0.87,10.9755,261,62,48,14,199,144,55,12,0.0,0.0
1007,787,2020-03-18 02:11:00,0,2232.0,1962.0,0.879,10.966,125,3,2,1,122,74,48,0,0.0,0.0
1007,788,2020-03-18 02:14:00,0,2267.0,1869.0,0.824,11.003,205,3,0,3,202,138,64,0,0.0,0.0
1007,789,2020-03-18 02:17:00,0,2106.0,1797.0,0.854,10.287,47,2,0,2,45,0,45,0,0.0,0.0
1007,790,2020-03-18 02:20:00,0,2110.0,1744.0,0.826,10.243,148,37,19,18,111,57,54,17,0.0,0.0
1007,791,2020-03-18 02:23:00,0,2275.0,1860.0,0.818,11.024,364,109,67,42,255,187,68,43,0.0,0.01
1007,792,2020-03-18 02:26:00,0,2630.0,2248.0,0.855,12.85,341,81,45,36,260,195,65,47,0.0,0.04
1007,793,2020-03-18 02:29:00,0,2452.0,2203.0,0.899,12.099,520,166,124,42,354,288,66,34,0.0,0.01
1007,794,2020-03-18 02:32:00,0,2613.0,2280.0,0.872,12.821,365,93,58,35,272,199,73,26,0.0,0.0
1007,795,2020-03-18 02:35:00,0,2485.0,2124.0,0.855,12.142,354,136,89,47,218,172,46,69,0.0,0.0
1007,796,2020-03-18 02:38:00,0,2990.0,2612.0,0.874,14.671,371,79,41,38,292,233,59,59,0.0,0.08
1007,797,2020-03-18 02:41:00,0,2198.0,1804.0,0.821,10.659,409,137,100,37,272,216,56,15,0.0,0.0
1007,798,2020-03-18 02:44:00,0,2327.0,1986.0,0.854,11.367,615,140,96,44,475,392,83,16,0.0,0.0
1007,799,2020-03-18 02:47:00,0,2459.0,2171.0,0.883,12.091,326,88,59,29,238,172,66,20,0.0,0.0
1007,800,2020-03-18 02:50:00,0,2133.0,1703.0,0.799,10.289,44,0,0,0,44,0,44,0,0.0,0.0
1007,801,2020-03-18 02:53:00,0,2109.0,1811.0,0.859,10.315,59,6,2,4,53,0,53,0,0.0,0.0
1007,802,2020-03-18 02:56:00,0,2255.0,1888.0,0.837,10.976,71,19,0,19,52,0,52,0,0.0,0.0
1007,803,2020-03-18 02:59:00,0,2326.0,1998.0,0.859,11.375,368,98,75,23,270,201,69,20,0.0,0.0
1007,804,2020-03-18 03:02:00,0,2489.0,2080.0,0.836,12.11,379,82,49,33,297,222,75,29,0.0,0.0
1007,805,2020-03-18 03:05:00,0,2613.0,2289.0,0.876,12.828,640,186,139,47,454,355,99,55,0.0,0.05
1007,806,2020-03-18 03:08:00,0,2613.0,2294.0,0.878,12.837,443,130,92,38,313,247,66,30,0.0,0.0
1007,807,2020-03-18 03:11:00,0,2624.0,2230.0,0.85,12.81,66,0,0,0,66,17,49,0,0.0,0.0
1007,808,2020-03-18 03:14:00,0,2622.0,2282.0,0.87,12.859,139,8,0,8,131,74,57,0,0.0,0.0
1007,809,2020-03-18 03:17:00,0,2478.0,2111.0,0.852,12.102,83,2,1,1,81,25,56,0,0.0,0.0
1007,810,2020-03-18 03:20:00,0,2250.0,1961.0,0.872,11.034,70,16,8,8,54,9,45,0,0.0,0.0
1007,811,2020-03-18 03:23:00,0,2261.0,1906.0,0.843,11.021,153,40,20,20,113,53,60,5,0.0,0.0
1007,812,2020-03-18 03:26:00,0,2415.0,2027.0,0.839,11.76,317,89,58,31,228,155,73,7,0.0,0.0
1007,813,2020-03-18 03:29:00,0,2247.0,1926.0,0.857,10.986,95,0,0,0,95,42,53,0,0.0,0.0
1007,814,2020-03-18 03:32:00,0,2114.0,1801.0,0.852,10.322,66,0,0,0,66,7,59,0,0.0,0.0
1007,815,2020-03-18 03:35:00,0,2129.0,1708.0,0.802,10.279,119,21,8,13,98,46,52,0,0.0,0.0
1007,816,2020-03-18 03:38:00,0,2038.0,1666.0,0.818,9.873,98,5,0,5,93,40,53,0,0.0,0.0
1007,817,2020-03-18 03:41:00,0,1872.0,1630.0,0.871,9.182,57,4,0,4,53,2,51,0,0.0,0.0
1007,818,2020-03-18 03:44:00,0,1893.0,1563.0,0.826,9.187,61,10,0,10,51,0,51,0,0.0,0.0
1007,819,2020-03-18 03:47:00,0,1883.0,1593.0,0.846,9.182,54,2,0,2,52,0,52,0,0.0,0.0
1007,820,2020-03-18 03:50:00,0,2127.0,1678.0,0.789,10.238,277,65,49,16,212,141,71,1,0.0,0.0
1007,821,2020-03-18 03:53:00,0,2044.0,1669.0,0.816,9.901,68,12,0,12,56,6,50,0,0.0,0.0
1007,822,2020-03-18 03:56:00,0,1951.0,1625.0,0.833,9.486,53,5,1,4,48,0,48,0,0.0,0.0
1007,823,2020-03-18 03:59:00,0,1971.0,1616.0,0.82,9.556,53,7,0,7,46,2,44,0,0.0,0.0
1007,824,2020-03-18 04:02:00,0,1965.0,1623.0,0.826,9.539,77,6,2,4,71,16,55,0,0.0,0.0
1007,825,2020-03-18 04:05:00,0,1886.0,1565.0,0.83,9.163,55,0,0,0,55,0,55,0,0.0,0.0
1007,826,2020-03-18 04:08:00,0,1904.0,1540.0,0.809,9.206,183,20,13,7,163,97,66,4,0.0,0.0
1007,827,2020-03-18 04:11:00,0,2357.0,1897.0,0.805,11.388,478,141,113,28,337,268,69,46,0.0,0.0
1007,828,2020-03-18 04:14:00,0,2519.0,1932.0,0.767,12.065,319,138,82,56,181,122,59,54,0.0,0.0
1007,829,2020-03-18 04:17:00,0,2635.0,2197.0,0.834,12.814,315,85,44,41,230,169,61,51,0.0,0.0
1007,830,2020-03-18 04:20:00,0,2652.0,2186.0,0.824,12.87,372,90,53,37,282,211,71,32,0.0,0.0
1007,831,2020-03-18 04:23:00,0,1879.0,1580.0,0.841,9.151,299,58,21,37,241,176,65,30,0.0,0.0
1007,832,2020-03-18 04:26:00,0,2141.0,1665.0,0.778,10.279,482,106,81,25,376,287,89,26,0.0,0.0
1007,833,2020-03-18 04:29:00,0,2270.0,1834.0,0.808,10.976,547,90,55,35,457,363,94,2,0.0,0.0
1007,834,2020-03-18 04:32:00,0,2534.0,1936.0,0.764,12.126,305,89,52,37,216,157,59,11,0.0,0.0
1007,835,2020-03-18 04:35:00,0,2866.0,2366.0,0.826,13.91,550,144,107,37,406,328,78,73,0.0,0.03
1007,836,2020-03-18 04:38:00,0,3017.0,2535.0,0.84,14.693,346,95,51,44,251,190,61,63,0.0,0.0
1007,837,2020-03-18 04:41:00,0,2641.0,2188.0,0.829,12.826,325,79,45,34,246,194,52,26,0.0,0.0
1007,838,2020-03-18 04:44:00,0,1893.0,1544.0,0.816,9.169,140,33,11,22,107,69,38,7,0.0,0.0
1007,839,2020-03-18 04:47:00,0,2305.0,1766.0,0.766,11.037,219,87,48,39,132,101,31,10,0.0,0.0
1007,840,2020-03-18 04:50:00,0,1915.0,1476.0,0.771,9.181,14,12,2,10,2,1,1,0,0.0,0.0
1007,841,2020-03-18 04:53:00,0,1919.0,1447.0,0.754,9.163,6,0,0,0,6,2,4,0,0.0,0.0
1007,842,2020-03-18 04:56:00,0,1976.0,1591.0,0.805,9.546,3,2,1,1,1,0,1,0,0.0,0.0
1007,843,2020-03-18 04:59:00,0,2291.0,1789.0,0.781,11.007,390,2,2,0,388,346,42,0,0.0,0.0
1007,844,2020-03-18 05:02:00,0,2650.0,2195.0,0.828,12.87,660,0,0,0,660,568,92,0,0.0,0.0
1007,845,2020-03-18 05:05:00,0,2482.0,2087.0,0.841,12.09,255,0,0,0,255,199,56,0,0.0,0.0
1007,846,2020-03-18 05:08:00,0,2376.0,1980.5,0.833,11.555,98,21,16,5,77,49,28,2,0.0,0.0
1007,847,2020-03-18 05:11:00,0,2270.0,1874.0,0.825,11.02,463,135,101,34,328,264,64,21,0.0,0.04
1007,848,2020-03-18 05:14:00,0,2476.0,2142.0,0.865,12.128,374,118,88,30,256,207,49,12,0.0,0.0
1007,849,2020-03-18 05:17:00,0,2510.0,2018.0,0.804,12.122,407,116,91,25,291,218,73,36,0.0,0.0
1007,850,2020-03-18 05:20:00,0,2265.0,1877.0,0.829,11.004,171,48,36,12,123,95,28,6,0.0,0.0
1007,851,2020-03-18 05:23:00,0,2512.0,1986.0,0.791,12.098,6,6,1,5,0,0,0,0,0.0,0.0
1007,852,2020-03-18 05:26:00,0,2278.0,1852.0,0.813,11.025,7,3,0,3,4,2,2,0,0.0,0.0
1007,853,2020-03-18 05:29:00,0,2130.0,1699.0,0.798,10.272,26,6,0,6,20,3,17,0,0.01,0.0
1007,854,2020-03-18 05:32:00,0,1972.0,1583.0,0.803,9.521,48,11,0,11,37,21,16,0,0.0,0.0
1007,855,2020-03-18 05:35:00,0,1904.0,1502.0,0.789,9.165,21,15,1,14,6,2,4,0,0.0,0.0
1007,856,2020-03-18 05:38:00,0,1918.0,1439.0,0.75,9.149,29,13,6,7,16,5,11,0,0.0,0.0
1007,857,2020-03-18 05:41:00,0,1911.0,1472.0,0.77,9.16,43,18,3,15,25,13,12,0,0.0,0.0
1007,858,2020-03-18 05:44:00,0,1928.0,1424.0,0.739,9.172,41,14,2,12,27,15,12,0,0.0,0.0
1007,859,2020-03-18 05:47:00,0,1895.0,1533.0,0.809,9.163,520,96,65,31,424,341,83,8,0.0,0.0
1007,860,2020-03-18 05:50:00,0,2304.0,1728.0,0.75,10.993,444,138,97,41,306,241,65,38,0.0,0.0
1007,861,2020-03-18 05:53:00,0,2296.0,1737.0,0.757,10.968,437,143,104,39,294,233,61,53,0.0,0.0
1007,862,2020-03-18 05:56:00,0,2375.0,1801.0,0.758,11.353,451,129,87,42,322,253,69,62,0.0,0.0
1007,863,2020-03-18 05:59:00,0,2683.0,2022.0,0.754,12.811,385,67,37,30,318,247,71,56,0.0,0.0
1007,864,2020-03-18 06:02:00,1,2293.0,1796.0,0.783,11.023,572,233,190,43,339,266,73,27,0.0,0.0
1007,865,2020-03-18 06:05:00,1,2280.0,1826.0,0.801,11.006,407,146,102,44,261,186,75,13,0.0,0.01
1007,866,2020-03-18 06:08:00,1,2528.0,1924.0,0.761,12.089,509,149,108,41,360,276,84,9,0.0,0.04
1007,867,2020-03-18 06:11:00,1,2680.0,2058.0,0.768,12.839,672,220,148,72,452,347,105,7,0.0,0.0
1007,868,2020-03-18 06:14:00,1,2737.0,2212.0,0.808,13.231,296,107,65,42,189,122,67,4,0.0,0.0
1007,869,2020-03-18 06:17:00,1,2885.0,2301.0,0.798,13.916,282,107,67,40,175,102,73,12,0.0,0.0
1007,870,2020-03-18 06:20:00,1,2654.0,2123.0,0.8,12.807,158,47,15,32,111,45,66,0,0.0,0.0
1007,871,2020-03-18 06:23:00,1,2664.0,2158.0,0.81,12.885,198,96,52,44,102,48,54,2,0.0,0.0
1007,872,2020-03-18 06:26:00,1,2669.0,2102.0,0.788,12.842,252,66,27,39,186,109,77,0,0.0,0.0
1007,873,2020-03-18 06:29:00,1,2581.0,2038.0,0.79,12.424,185,44,24,20,141,68,73,0,0.0,0.0
1007,874,2020-03-18 06:32:00,1,2532.0,1914.0,0.756,12.095,94,4,2,2,90,25,65,0,0.0,0.0
1007,875,2020-03-18 06:35:00,1,2304.0,1731.0,0.751,10.994,132,0,0,0,132,66,66,0,0.0,0.0
1007,876,2020-03-18 06:38:00,1,2157.0,1590.0,0.737,10.259,66,0,0,0,66,4,62,0,0.0,0.0
1007,877,2020-03-18 06:41:00,1,1901.0,1506.0,0.792,9.156,82,7,0,7,75,15,60,0,0.0,0.0
1007,878,2020-03-18 06:44:00,1,1900.0,1530.0,0.805,9.18,78,1,0,1,77,22,55,0,0.0,0.0
1007,879,2020-03-18 06:47:00,1,1906.0,1497.0,0.785,9.166,65,2,0,2,63,0,63,0,0.0,0.0
1007,880,2020-03-18 06:50:00,1,1915.0,1475.0,0.77,9.177,78,2,0,2,76,6,70,0,0.0,0.0
1007,881,2020-03-18 06:53:00,1,1912.0,1479.0,0.773,9.17,72,2,1,1,70,4,66,0,0.0,0.0
1007,882,2020-03-18 06:56:00,1,1911.0,1501.0,0.786,9.191,71,0,0,0,71,2,69,0,0.0,0.0
1007,883,2020-03-18 06:59:00,1,1910.0,1492.0,0.781,9.176,133,19,11,8,114,44,70,0,0.0,0.0
1007,884,2020-03-18 07:02:00,1,1902.0,1503.0,0.79,9.158,75,0,0,0,75,0,75,0,0.0,0.0
1007,885,2020-03-18 07:05:00,1,1916.0,1487.0,0.776,9.194,61,0,0,0,61,0,61,0,0.0,0.0
1007,886,2020-03-18 07:08:00,1,1916.0,1462.0,0.763,9.17,63,0,0,0,63,0,63,0,0.0,0.0
1007,887,2020-03-18 07:11:00,1,1921.0,1445.0,0.752,9.168,132,17,12,5,115,36,79,0,0.0,0.0
1007,888,2020-03-18 07:14:00,1,1919.0,1428.0,0.744,9.143,85,8,1,7,77,10,67,0,0.0,0.0
1007,889,2020-03-18 07:17:00,1,1934.0,1377.0,0.712,9.147,54,0,0,0,54,4,50,0,0.0,0.0
1007,890,2020-03-18 07:20:00,1,1770.0,1313.0,0.742,8.426,87,17,8,9,70,7,63,0,0.0,0.0
1007,891,2020-03-18 07:23:00,1,1762.0,1327.0,0.753,8.413,72,5,0,5,67,4,63,0,0.0,0.0
1007,892,2020-03-18 07:26:00,1,1773.0,1317.0,0.743,8.446,67,10,0,10,57,0,57,0,0.0,0.0
1007,893,2020-03-18 07:29:00,1,1854.0,1330.0,0.717,8.777,58,0,0,0,58,0,58,0,0.0,0.0
1007,894,2020-03-18 07:32:00,1,1771.0,1315.0,0.742,8.435,53,0,0,0,53,2,51,0,0.0,0.0
1007,895,2020-03-18 07:35:00,1,1779.0,1295.0,0.728,8.444,64,0,0,0,64,2,62,0,0.0,0.0
1007,896,2020-03-18 07:38:00,1,1778.0,1274.0,0.717,8.417,70,3,1,2,67,2,65,0,0.0,0.0
1007,897,2020-03-18 07:41:00,1,1773.0,1328.0,0.749,8.456,61,0,0,0,61,0,61,0,0.0,0.0
1007,898,2020-03-18 07:44:00,1,1765.0,1307.0,0.74,8.401,56,0,0,0,56,0,56,0,0.0,0.0
1007,899,2020-03-18 07:47:00,1,1776.0,1301.0,0.733,8.438,78,10,2,8,68,0,68,0,0.0,0.0
1007,900,2020-03-18 07:50:00,1,1779.0,1294.0,0.727,8.442,114,12,4,8,102,40,62,0,0.0,0.0
1007,901,2020-03-18 07:53:00,1,1931.0,1388.0,0.719,9.147,180,29,11,18,151,86,65,2,0.0,0.0
1007,902,2020-03-18 07:56:00,1,2160.0,1591.0,0.736,10.272,253,66,42,24,187,127,60,15,0.0,0.0
1007,903,2020-03-18 07:59:00,1,2144.0,1652.0,0.771,10.278,256,80,58,22,176,120,56,4,0.0,0.0
1007,904,2020-03-18 08:02:00,1,2232.0,1649.0,0.739,10.618,383,127,91,36,256,170,86,10,0.0,0.0
1007,905,2020-03-18 08:05:00,1,2299.0,1736.0,0.755,10.979,473,132,90,42,341,242,99,3,0.0,0.0
1007,906,2020-03-18 08:08:00,1,2304.0,1724.5,0.7485,10.9855,116,16,6,10,100,39,61,0,0.0,0.0
1007,907,2020-03-18 08:11:00,1,2309.0,1713.0,0.742,10.992,182,36,13,23,146,75,71,0,0.0,0.0
1007,908,2020-03-18 08:14:00,1,2309.0,1710.0,0.741,10.991,155,38,6,32,117,51,66,0,0.0,0.0
1007,909,2020-03-18 08:17:00,1,2312.0,1700.0,0.735,10.993,98,59,21,38,39,0,39,0,0.0,0.0
1007,910,2020-03-18 08:20:00,1,2161.0,1579.0,0.731,10.263,235,80,47,33,155,96,59,0,0.42,0.0
1007,911,2020-03-18 08:23:00,1,2590.0,2016.0,0.778,12.439,588,224,169,55,364,278,86,10,0.09,0.04
1007,912,2020-03-18 08:26:00,1,2907.0,2239.0,0.77,13.931,368,159,120,39,209,133,76,9,0.0,0.0
1007,913,2020-03-18 08:29:00,1,2910.0,2180.0,0.749,13.879,503,215,172,43,288,211,77,30,0.0,0.0
1007,914,2020-03-18 08:32:00,1,2653.0,2144.0,0.808,12.826,213,94,62,32,119,56,63,15,0.0,0.0
1007,915,2020-03-18 08:35:00,1,2493.0,2042.0,0.819,12.085,222,93,59,34,129,82,47,34,0.0,0.08
1007,916,2020-03-18 08:38:00,1,2826.0,2199.0,0.778,13.57,243,74,50,24,169,110,59,49,0.0,0.11
1007,917,2020-03-18 08:41:00,1,2515.0,1977.0,0.786,12.097,422,162,115,47,260,170,90,2,0.01,0.02
1007,918,2020-03-18 08:44:00,1,3036.0,2469.0,0.813,14.696,467,195,142,53,272,188,84,13,0.0,0.0
1007,919,2020-03-18 08:47:00,1,2862.0,2368.0,0.827,13.9,298,164,109,55,134,62,72,6,0.0,0.0
1007,920,2020-03-18 08:50:00,1,2882.0,2348.0,0.815,13.954,132,53,29,24,79,12,67,3,0.0,0.0
1007,921,2020-03-18 08:53:00,1,2705.0,2311.0,0.854,13.217,156,65,48,17,91,30,61,3,0.0,0.0
1007,922,2020-03-18 08:56:00,1,2657.0,2192.0,0.825,12.896,58,0,0,0,58,0,58,0,0.0,0.0
1007,923,2020-03-18 08:59:00,1,2428.0,1955.0,0.805,11.732,63,0,0,0,63,0,63,0,0.0,0.0
1007,924,2020-03-18 09:02:00,1,2273.0,1839.0,0.809,10.994,59,0,0,0,59,0,59,0,0.0,0.0
1007,925,2020-03-18 09:05:00,1,2279.0,1821.0,0.799,10.994,77,5,0,5,72,0,72,0,0.0,0.0
1007,926,2020-03-18 09:08:00,1,2114.0,1766.0,0.835,10.284,147,63,46,17,84,15,69,0,0.0,0.0
1007,927,2020-03-18 09:11:00,1,2109.0,1760.0,0.835,10.259,70,4,1,3,66,0,66,0,0.0,0.0
1007,928,2020-03-18 09:14:00,1,2035.0,1704.0,0.837,9.905,63,2,0,2,61,2,59,0,0.0,0.0
1007,929,2020-03-18 09:17:00,1,1860.0,1668.0,0.897,9.176,63,0,0,0,63,0,63,0,0.0,0.0
1007,930,2020-03-18 09:20:00,1,1866.0,1631.0,0.874,9.158,110,40,14,26,70,10,60,2,0.0,0.0
1007,931,2020-03-18 09:23:00,1,2274.0,1817.0,0.799,10.973,312,138,91,47,174,96,78,53,0.0,0.14
1007,932,2020-03-18 09:26:00,1,2499.0,2035.0,0.814,12.098,368,137,111,26,231,162,69,20,0.06,0.03
1007,933,2020-03-18 09:29:00,1,2477.0,2160.0,0.872,12.151,345,139,124,15,206,135,71,9,0.06,0.0
1007,934,2020-03-18 09:32:00,1,2478.0,2126.0,0.858,12.118,210,75,60,15,135,65,70,3,0.0,0.0
1007,935,2020-03-18 09:35:00,1,2492.0,2079.0,0.834,12.119,85,30,0,30,55,2,53,0,0.0,0.0
1007,936,2020-03-18 09:38:00,1,2333.0,1970.0,0.844,11.374,67,2,1,1,65,9,56,0,0.0,0.0
1007,937,2020-03-18 09:41:00,1,2278.0,1825.0,0.801,10.996,69,2,1,1,67,7,60,0,0.0,0.0
1007,938,2020-03-18 09:44:00,1,2107.0,1793.0,0.851,10.286,289,107,59,48,182,101,81,1,0.0,0.0
1007,939,2020-03-18 09:47:00,1,2250.0,1945.0,0.865,11.017,152,52,41,11,100,34,66,0,0.0,0.0
1007,940,2020-03-18 09:50:00,1,2266.0,1883.0,0.831,11.013,61,1,0,1,60,0,60,0,0.0,0.0
1007,941,2020-03-18 09:53:00,1,2102.0,1773.0,0.843,10.245,60,2,0,2,58,0,58,0,0.0,0.0
1007,942,2020-03-18 09:56:00,1,2034.0,1713.0,0.842,9.911,110,34,14,20,76,6,70,0,0.0,0.0
1007,943,2020-03-18 09:59:00,1,1947.0,1686.0,0.866,9.537,70,12,2,10,58,0,58,0,0.0,0.0
1007,944,2020-03-18 10:02:00,1,1871.0,1639.0,0.876,9.188,118,29,14,15,89,15,74,5,0.0,0.0
1007,945,2020-03-18 10:05:00,1,2500.0,2044.0,0.818,12.112,336,93,49,44,243,157,86,63,0.0,0.0
1007,946,2020-03-18 10:08:00,1,2466.0,2140.0,0.868,12.087,450,173,139,34,277,196,81,17,0.11,0.0
1007,947,2020-03-18 10:11:00,1,2105.0,1800.0,0.855,10.288,63,1,1,0,62,1,61,0,0.0,0.0
1007,948,2020-03-18 10:14:00,1,2259.0,1906.0,0.844,11.01,62,4,2,2,58,2,56,0,0.0,0.01
1007,949,2020-03-18 10:17:00,1,2490.0,2082.0,0.836,12.115,226,27,10,17,199,120,79,3,0.0,0.0
1007,950,2020-03-18 10:20:00,1,2480.0,2119.0,0.855,12.116,367,166,131,35,201,121,80,11,0.11,0.0
1007,951,2020-03-18 10:23:00,1,2478.0,2127.0,0.858,12.117,260,74,46,28,186,106,80,2,0.0,0.0
1007,952,2020-03-18 10:26:00,1,2476.0,2124.0,0.858,12.107,328,145,117,28,183,109,74,4,0.0,0.0
1007,953,2020-03-18 10:29:00,1,2468.0,2155.0,0.873,12.109,67,0,0,0,67,0,67,0,0.0,0.0
1007,954,2020-03-18 10:32:00,1,2329.0,1987.0,0.853,11.376,58,0,0,0,58,0,58,0,0.0,0.0
1007,955,2020-03-18 10:35:00,1,2288.0,1813.0,0.792,11.021,65,0,0,0,65,0,65,0,0.0,0.0
1007,956,2020-03-18 10:38:00,1,2043.0,1691.0,0.828,9.922,81,2,1,1,79,10,69,0,0.0,0.01
1007,957,2020-03-18 10:41:00,1,2267.0,1854.0,0.818,10.986,320,145,105,40,175,102,73,35,0.0,0.01
1007,958,2020-03-18 10:44:00,1,2628.0,2255.0,0.858,12.851,255,98,70,28,157,88,69,19,0.22,0.05
1007,959,2020-03-18 10:47:00,1,2485.0,2100.0,0.845,12.115,262,96,44,52,166,91,75,1,0.04,0.0
1007,960,2020-03-18 10:50:00,1,2649.0,2200.0,0.83,12.874,136,34,13,21,102,31,71,0,0.0,0.01
1007,961,2020-03-18 10:53:00,1,2624.0,2276.0,0.867,12.859,186,52,43,9,134,68,66,0,0.0,0.0
1007,962,2020-03-18 10:56:00,1,2625.0,2240.0,0.853,12.825,75,0,0,0,75,8,67,0,0.0,0.0
1007,963,2020-03-18 10:59:00,1,2492.0,2080.0,0.835,12.121,77,6,4,2,71,2,69,0,0.0,0.0
1007,964,2020-03-18 11:02:00,1,2328.0,1996.0,0.857,11.383,67,0,0,0,67,0,67,0,0.0,0.0
1007,965,2020-03-18 11:05:00,1,2244.0,1944.0,0.866,10.993,65,2,0,2,63,0,63,0,0.0,0.0
1007,966,2020-03-18 11:08:00,1,2254.5,1918.0,0.8505,11.007,82,10,1,9,72,0,72,0,0.0,0.0
1007,967,2020-03-18 11:11:00,1,2265.0,1892.0,0.835,11.021,69,2,1,1,67,0,67,0,0.0,0.0
1007,968,2020-03-18 11:14:00,1,2272.0,1829.0,0.805,10.978,82,13,2,11,69,2,67,0,0.0,0.0
1007,969,2020-03-18 11:17:00,1,2108.0,1755.0,0.832,10.25,73,4,0,4,69,0,69,0,0.0,0.0
1007,970,2020-03-18 11:20:00,1,2118.0,1713.0,0.809,10.242,66,2,0,2,64,0,64,0,0.0,0.0
1007,971,2020-03-18 11:23:00,1,2130.0,1706.0,0.801,10.281,319,129,107,22,190,111,79,28,0.03,0.02
1007,972,2020-03-18 11:26:00,1,2256.0,1897.0,0.841,10.989,307,106,56,50,201,105,96,47,0.0,0.03
1007,973,2020-03-18 11:29:00,1,2927.0,2502.0,0.855,14.303,414,176,132,44,238,152,86,48,0.0,0.17
1007,974,2020-03-18 11:32:00,1,2455.0,2215.0,0.902,12.126,314,117,79,38,197,130,67,24,0.0,0.0
1007,975,2020-03-18 11:35:00,1,3012.0,2566.0,0.852,14.707,290,75,49,26,215,140,75,4,0.4,0.01
1007,976,2020-03-18 11:38:00,1,2482.0,2103.0,0.847,12.107,493,220,172,48,273,194,79,6,0.0,0.0
1007,977,2020-03-18 11:41:00,1,2692.0,2346.0,0.871,13.204,565,242,193,49,323,226,97,14,0.0,0.0
1007,978,2020-03-18 11:44:00,1,2693.0,2357.0,0.875,13.221,125,45,17,28,80,9,71,0,0.0,0.0
1007,979,2020-03-18 11:47:00,1,2634.0,2216.0,0.841,12.833,172,47,22,25,125,52,73,0,0.0,0.0
1007,980,2020-03-18 11:50:00,1,2612.0,2308.0,0.884,12.846,92,26,1,25,66,4,62,0,0.0,0.0
1007,981,2020-03-18 11:53:00,1,2617.0,2284.0,0.873,12.841,94,40,0,40,54,0,54,0,0.0,0.0
1007,982,2020-03-18 11:56:00,1,2643.0,2236.0,0.846,12.89,83,3,1,2,80,0,80,0,0.0,0.0
1007,983,2020-03-18 11:59:00,1,2495.0,2083.0,0.835,12.138,68,1,1,0,67,0,67,0,0.0,0.0
1007,984,2020-03-18 12:02:00,1,2253.0,1916.0,0.85,11.0,84,14,1,13,70,2,68,0,0.0,0.0
1007,985,2020-03-18 12:05:00,1,2282.0,1813.0,0.794,11.0,84,12,4,8,72,0,72,0,0.0,0.0
1007,986,2020-03-18 12:08:00,1,2106.0,1784.0,0.847,10.272,89,23,4,19,66,2,64,0,0.0,0.0
1007,987,2020-03-18 12:11:00,1,2104.0,1795.0,0.853,10.276,68,11,2,9,57,0,57,0,0.0,0.0
1007,988,2020-03-18 12:14:00,1,2270.0,1830.0,0.806,10.971,70,10,1,9,60,0,60,0,0.0,0.0
1007,989,2020-03-18 12:17:00,1,2108.0,1765.0,0.837,10.26,66,0,0,0,66,0,66,0,0.0,0.0
1007,990,2020-03-18 12:20:00,1,2109.0,1763.0,0.836,10.26,81,13,5,8,68,0,68,0,0.0,0.0
1007,991,2020-03-18 12:23:00,1,2128.0,1706.0,0.802,10.275,97,31,4,27,66,0,66,0,0.0,0.0
1007,992,2020-03-18 12:26:00,1,1871.0,1614.0,0.862,9.159,81,17,4,13,64,0,64,0,0.0,0.0
1007,993,2020-03-18 12:29:00,1,1882.0,1590.0,0.845,9.177,62,1,0,1,61,0,61,0,0.0,0.0
1007,994,2020-03-18 12:32:00,1,1949.0,1672.0,0.858,9.529,82,8,2,6,74,2,72,0,0.0,0.0
1007,995,2020-03-18 12:35:00,1,2122.0,1713.0,0.807,10.256,68,9,5,4,59,0,59,0,0.0,0.0
1007,996,2020-03-18 12:38:00,1,2192.0,1819.0,0.83,10.652,258,127,77,50,131,62,69,27,0.0,0.0
1007,997,2020-03-18 12:41:00,1,2489.0,2098.0,0.843,12.129,239,68,41,27,171,93,78,27,0.0,0.07
1007,998,2020-03-18 12:44:00,1,2256.0,1906.0,0.845,11.0,175,51,30,21,124,39,85,0,0.0,0.0
1007,999,2020-03-18 12:47:00,1,2416.0,2003.0,0.829,11.738,232,126,70,56,106,36,70,4,0.0,0.0
1007,1000,2020-03-18 12:50:00,1,2499.0,2068.0,0.828,12.134,488,222,186,36,266,188,78,8,0.0,0.03
1007,1001,2020-03-18 12:53:00,1,1893.0,1544.0,0.816,9.169,321,123,73,50,198,113,85,0,0.0,0.0
1007,1002,2020-03-18 12:56:00,1,2502.0,1994.0,0.797,12.067,162,52,20,32,110,39,71,1,0.0,0.0
1007,1003,2020-03-18 12:59:00,1,2844.0,2490.0,0.876,13.962,124,29,17,12,95,23,72,0,0.0,0.0
1007,1004,2020-03-18 13:02:00,1,2601.0,2349.0,0.903,12.85,59,0,0,0,59,0,59,0,0.0,0.0
1007,1005,2020-03-18 13:05:00,1,2476.0,2133.0,0.861,12.115,65,0,0,0,65,0,65,0,0.0,0.0
1007,1006,2020-03-18 13:08:00,1,2245.0,1966.0,0.875,11.022,61,0,0,0,61,0,61,0,0.0,0.0
1007,1007,2020-03-18 13:11:00,1,2250.0,1924.0,0.855,10.996,66,0,0,0,66,0,66,0,0.0,0.0
1007,1008,2020-03-18 13:14:00,1,2257.0,1893.0,0.838,10.989,67,5,4,1,62,0,62,0,0.0,0.0
1007,1009,2020-03-18 13:17:00,1,2254.0,1959.0,0.869,11.048,188,66,41,25,122,49,73,20,0.0,0.0
1007,1010,2020-03-18 13:20:00,1,2470.0,2144.0,0.868,12.107,388,175,135,40,213,134,79,13,0.33,0.02
1007,1011,2020-03-18 13:23:00,1,2461.0,2191.0,0.89,12.122,173,36,24,12,137,59,78,1,0.0,0.0
1007,1012,2020-03-18 13:26:00,1,1814.0,1498.0,0.826,8.808,118,9,1,8,109,38,71,0,0.0,0.0
1007,1013,2020-03-18 13:29:00,1,2853.0,2466.0,0.865,13.969,161,88,48,40,73,4,69,5,0.0,0.0
1007,1014,2020-03-18 13:32:00,1,2764.0,2425.0,0.877,13.577,388,113,63,50,275,186,89,47,0.0,0.0
1007,1015,2020-03-18 13:35:00,1,2759.0,2444.0,0.886,13.576,273,90,54,36,183,103,80,7,0.0,0.04
1007,1016,2020-03-18 13:38:00,1,2250.0,1937.0,0.861,11.01,318,118,73,45,200,109,91,0,0.0,0.0
1007,1017,2020-03-18 13:41:00,1,2854.0,2434.0,0.853,13.94,102,0,0,0,102,32,70,0,0.0,0.0
1007,1018,2020-03-18 13:44:00,1,2465.0,2192.0,0.889,12.137,59,0,0,0,59,2,57,0,0.0,0.0
1007,1019,2020-03-18 13:47:00,1,2243.0,1951.0,0.87,10.996,67,4,1,3,63,0,63,0,0.0,0.0
1007,1020,2020-03-18 13:50:00,1,2250.0,1937.0,0.861,11.009,64,0,0,0,64,2,62,0,0.0,0.01
1007,1021,2020-03-18 13:53:00,1,2486.0,2094.0,0.842,12.115,90,15,8,7,75,10,65,0,0.0,0.0
1007,1022,2020-03-18 13:56:00,1,2467.0,2187.0,0.886,12.143,67,0,0,0,67,0,67,0,0.0,0.0
1007,1023,2020-03-18 13:59:00,1,2473.0,2158.0,0.873,12.132,102,28,12,16,74,9,65,0,0.0,0.0
1007,1024,2020-03-18 14:02:00,1,2468.0,2140.0,0.867,12.093,76,3,3,0,73,0,73,0,0.0,0.0
1007,1025,2020-03-18 14:05:00,1,2397.0,2048.0,0.855,11.711,67,1,0,1,66,0,66,0,0.0,0.0
1007,1026,2020-03-18 14:08:00,1,2437.5,2081.0,0.854,11.908,71,1,0,1,70,0,70,0,0.0,0.0
1007,1027,2020-03-18 14:11:00,1,2478.0,2114.0,0.853,12.105,69,5,0,5,64,0,64,0,0.0,0.0
1007,1028,2020-03-18 14:14:00,1,2255.0,1919.0,0.851,11.012,162,44,36,8,118,40,78,5,0.0,0.0
1007,1029,2020-03-18 14:17:00,1,2397.0,2070.0,0.864,11.735,65,0,0,0,65,0,65,0,0.0,0.0
1007,1030,2020-03-18 14:20:00,1,2482.0,2089.0,0.842,12.094,82,7,2,5,75,1,74,0,0.0,0.0
1007,1031,2020-03-18 14:23:00,1,2495.0,2098.0,0.841,12.153,73,14,0,14,59,0,59,0,0.0,0.0
1007,1032,2020-03-18 14:26:00,1,2411.0,2024.0,0.839,11.741,71,4,3,1,67,0,67,0,0.0,0.0
1007,1033,2020-03-18 14:29:00,1,2246.0,1966.0,0.875,11.025,82,11,6,5,71,8,63,0,0.0,0.0
1007,1034,2020-03-18 14:32:00,1,2251.0,1976.0,0.878,11.058,74,7,2,5,67,0,67,0,0.0,0.01
1007,1035,2020-03-18 14:35:00,1,2487.0,2056.0,0.827,12.075,156,63,27,36,93,24,69,4,0.0,0.0
1007,1036,2020-03-18 14:38:00,1,2461.0,2177.0,0.884,12.106,349,145,101,44,204,119,85,33,0.0,0.0
1007,1037,2020-03-18 14:41:00,1,2694.0,2371.0,0.88,13.237,263,94,56,38,169,97,72,45,0.0,0.07
1007,1038,2020-03-18 14:44:00,1,2114.0,1765.0,0.835,10.285,75,2,0,2,73,4,69,0,0.0,0.0
1007,1039,2020-03-18 14:47:00,1,1896.0,1517.0,0.8,9.149,69,0,0,0,69,0,69,0,0.0,0.0
1007,1040,2020-03-18 14:50:00,1,1887.0,1574.0,0.834,9.177,84,10,0,10,74,4,70,0,0.0,0.01
1007,1041,2020-03-18 14:53:00,1,2185.0,1810.0,0.828,10.613,72,9,0,9,63,0,63,0,0.0,0.0
1007,1042,2020-03-18 14:56:00,1,2325.0,2001.0,0.861,11.377,267,89,57,32,178,95,83,34,0.0,0.01
1007,1043,2020-03-18 14:59:00,1,2394.0,2085.0,0.871,11.741,298,86,55,31,212,125,87,2,0.0,0.01
1007,1044,2020-03-18 15:02:00,1,2483.0,2099.0,0.845,12.108,436,176,130,46,260,172,88,21,0.18,0.0
1007,1045,2020-03-18 15:05:00,1,2596.0,2360.0,0.909,12.842,715,303,240,63,412,303,109,16,0.0,0.04
1007,1046,2020-03-18 15:08:00,1,2237.0,1996.0,0.892,11.024,121,59,47,12,62,0,62,0,0.0,0.0
1007,1047,2020-03-18 15:11:00,1,2272.0,1841.0,0.81,10.989,60,0,0,0,60,0,60,0,0.0,0.0
1007,1048,2020-03-18 15:14:00,1,2325.0,2001.0,0.861,11.377,78,13,5,8,65,6,59,0,0.0,0.0
1007,1049,2020-03-18 15:17:00,1,2326.0,2015.0,0.867,11.395,65,0,0,0,65,0,65,0,0.0,0.0
1007,1050,2020-03-18 15:20:00,1,2471.0,2153.0,0.872,12.118,96,14,4,10,82,18,64,0,0.0,0.0
1007,1051,2020-03-18 15:23:00,1,2467.0,2151.0,0.872,12.102,80,0,0,0,80,12,68,0,0.0,0.0
1007,1052,2020-03-18 15:26:00,1,2243.0,1975.0,0.881,11.025,74,11,1,10,63,0,63,0,0.0,0.0
1007,1053,2020-03-18 15:29:00,1,2247.0,1921.0,0.855,10.979,113,2,0,2,111,37,74,0,0.0,0.0
1007,1054,2020-03-18 15:32:00,1,2085.0,1845.0,0.885,10.258,83,11,3,8,72,0,72,0,0.0,0.0
1007,1055,2020-03-18 15:35:00,1,2097.0,1836.0,0.875,10.295,90,4,1,3,86,14,72,0,0.0,0.0
1007,1056,2020-03-18 15:38:00,1,2112.0,1748.0,0.828,10.258,76,0,0,0,76,0,76,0,0.0,0.0
1007,1057,2020-03-18 15:41:00,1,1860.0,1684.0,0.905,9.192,82,13,1,12,69,0,69,0,0.0,0.0
1007,1058,2020-03-18 15:44:00,1,2111.0,1738.0,0.823,10.241,181,111,48,63,70,0,70,9,0.0,0.0
1007,1059,2020-03-18 15:47:00,1,2238.0,1984.0,0.887,11.013,185,42,5,37,143,60,83,4,0.0,0.0
1007,1060,2020-03-18 15:50:00,1,2490.0,2098.0,0.843,12.132,99,24,9,15,75,14,61,3,0.0,0.0
1007,1061,2020-03-18 15:53:00,1,2545.0,2239.0,0.88,12.508,415,159,101,58,256,170,86,38,0.0,0.0
1007,1062,2020-03-18 15:56:00,1,2637.0,2253.0,0.854,12.886,187,41,25,16,146,73,73,16,0.0,0.02
1007,1063,2020-03-18 15:59:00,1,2124.0,1710.0,0.805,10.26,97,15,1,14,82,8,74,0,0.0,0.01
1007,1064,2020-03-18 16:02:00,1,2121.0,1716.0,0.809,10.256,85,5,1,4,80,10,70,0,0.0,0.0
1007,1065,2020-03-18 16:05:00,1,2491.0,2045.0,0.821,12.079,150,27,6,21,123,42,81,0,0.0,0.0
1007,1066,2020-03-18 16:08:00,1,2502.0,2083.0,0.833,12.162,95,27,0,27,68,6,62,0,0.0,0.0
1007,1067,2020-03-18 16:11:00,1,2479.0,2143.0,0.864,12.138,81,12,0,12,69,4,65,0,0.0,0.0
1007,1068,2020-03-18 16:14:00,1,2476.0,2106.0,0.851,12.086,70,0,0,0,70,0,70,0,0.0,0.01
1007,1069,2020-03-18 16:17:00,1,2252.0,1935.0,0.859,11.017,66,1,0,1,65,0,65,0,0.0,0.0
1007,1070,2020-03-18 16:20:00,1,2177.0,1848.0,0.849,10.625,68,1,0,1,67,0,67,0,0.0,0.0
1007,1071,2020-03-18 16:23:00,1,2261.0,1877.0,0.83,10.988,74,0,0,0,74,4,70,0,0.0,0.0
1007,1072,2020-03-18 16:26:00,1,2262.0,1896.0,0.838,11.011,81,0,0,0,81,0,81,0,0.0,0.0
1007,1073,2020-03-18 16:29:00,1,2266.0,1866.0,0.824,10.993,67,0,0,0,67,0,67,0,0.0,0.0
1007,1074,2020-03-18 16:32:00,1,2287.0,1830.0,0.8,11.037,70,0,0,0,70,2,68,0,0.0,0.0
1007,1075,2020-03-18 16:35:00,1,2198.0,1780.0,0.81,10.632,162,53,38,15,109,39,70,7,0.0,0.0
1007,1076,2020-03-18 16:38:00,1,2424.0,1956.0,0.807,11.715,418,155,102,53,263,168,95,60,0.0,0.0
1007,1077,2020-03-18 16:41:00,1,2637.0,2229.0,0.845,12.859,258,74,39,35,184,109,75,34,0.0,0.08
1007,1078,2020-03-18 16:44:00,1,1869.0,1619.0,0.866,9.155,184,34,9,25,150,72,78,2,0.0,0.01
1007,1079,2020-03-18 16:47:00,1,1828.0,1454.0,0.795,8.811,219,42,20,22,177,107,70,0,0.0,0.0
1007,1080,2020-03-18 16:50:00,1,2043.0,1657.0,0.811,9.882,274,102,56,46,172,103,69,7,0.0,0.02
1007,1081,2020-03-18 16:53:00,1,1687.0,1279.0,0.758,8.065,81,23,5,18,58,0,58,0,0.0,0.0
1007,1082,2020-03-18 16:56:00,1,1775.0,1299.0,0.732,8.432,176,20,0,20,156,70,86,0,0.0,0.0
1007,1083,2020-03-18 16:59:00,1,1916.0,1469.0,0.767,9.176,85,15,0,15,70,0,70,0,0.0,0.0
1007,1084,2020-03-18 17:02:00,1,2613.0,2303.0,0.881,12.846,132,51,0,51,81,10,71,0,0.0,0.0
1007,1085,2020-03-18 17:05:00,1,2857.0,2438.0,0.853,13.955,89,22,6,16,67,1,66,0,0.0,0.0
1007,1086,2020-03-18 17:08:00,1,2740.5,2346.0,0.856,13.394,126,40,7,33,86,14,72,0,0.0,0.0
1007,1087,2020-03-18 17:11:00,1,2624.0,2254.0,0.859,12.833,69,0,0,0,69,0,69,0,0.0,0.0
1007,1088,2020-03-18 17:14:00,1,2480.0,2132.0,0.859,12.133,64,1,1,0,63,0,63,0,0.0,0.0
1007,1089,2020-03-18 17:17:00,1,2492.0,2064.0,0.828,12.105,78,1,0,1,77,8,69,0,0.0,0.0
1007,1090,2020-03-18 17:20:00,1,2504.0,2026.0,0.809,12.108,72,0,0,0,72,0,72,0,0.0,0.0
1007,1091,2020-03-18 17:23:00,1,2258.0,1947.0,0.862,11.051,70,0,0,0,70,0,70,0,0.0,0.0
1007,1092,2020-03-18 17:26:00,1,2267.0,1868.0,0.824,11.002,92,14,0,14,78,8,70,0,0.0,0.0
1007,1093,2020-03-18 17:29:00,1,2499.0,2054.0,0.822,12.12,239,87,53,34,152,81,71,17,0.0,0.0
1007,1094,2020-03-18 17:32:00,1,2774.0,2365.0,0.853,13.548,376,76,44,32,300,214,86,57,0.0,0.05
1007,1095,2020-03-18 17:35:00,1,2108.0,1782.0,0.845,10.28,86,7,5,2,79,26,53,0,0.0,0.01
1007,1096,2020-03-18 17:38:00,1,1599.0,1274.0,0.797,7.712,68,0,0,0,68,14,54,0,0.0,0.01
1007,1097,2020-03-18 17:41:00,1,1748.0,1394.0,0.797,8.429,81,2,1,1,79,20,59,0,0.0,0.01
1007,1098,2020-03-18 17:44:00,1,1886.0,1572.0,0.834,9.171,71,13,0,13,58,4,54,0,0.0,0.0
1007,1099,2020-03-18 17:47:00,1,1826.0,1457.0,0.798,8.808,69,0,0,0,69,9,60,0,0.0,0.0
1007,1100,2020-03-18 17:50:00,1,1736.0,1428.0,0.822,8.42,195,77,51,26,118,51,67,4,0.0,0.0
1007,1101,2020-03-18 17:53:00,1,3199.0,2873.0,0.898,15.783,249,106,62,44,143,76,67,1,0.0,0.0
1007,1102,2020-03-18 17:56:00,1,3042.0,2739.0,0.9,15.019,345,106,84,22,239,161,78,7,0.27,0.0
1007,1103,2020-03-18 17:59:00,1,2531.0,2242.0,0.886,12.454,61,2,0,2,59,0,59,0,0.0,0.0
1007,1104,2020-03-18 18:02:00,0,2613.0,2286.0,0.875,12.827,79,3,1,2,76,18,58,0,0.0,0.0
1007,1105,2020-03-18 18:05:00,0,2835.0,2502.0,0.882,13.938,67,13,0,13,54,2,52,0,0.0,0.0
1007,1106,2020-03-18 18:08:00,0,2588.0,2416.0,0.933,12.87,61,3,0,3,58,0,58,0,0.0,0.0
1007,1107,2020-03-18 18:11:00,0,2600.0,2331.0,0.896,12.825,372,125,93,32,247,160,87,17,0.0,0.04
1007,1108,2020-03-18 18:14:00,0,2993.0,2571.0,0.859,14.64,471,202,139,63,269,179,90,49,0.0,0.0
1007,1109,2020-03-18 18:17:00,0,2991.0,2610.0,0.872,14.676,392,146,81,65,246,162,84,65,0.0,0.0
1007,1110,2020-03-18 18:20:00,0,2981.0,2653.0,0.89,14.682,408,139,96,43,269,189,80,63,0.0,0.15
1007,1111,2020-03-18 18:23:00,0,2999.0,2567.0,0.856,14.657,565,222,180,42,343,251,92,52,0.21,0.11
1007,1112,2020-03-18 18:26:00,0,2599.0,2365.0,0.91,12.857,702,314,259,55,388,290,98,34,0.0,0.09
1007,1113,2020-03-18 18:29:00,0,1947.0,1718.0,0.882,9.572,239,125,80,45,114,40,74,12,0.0,0.0
1007,1114,2020-03-18 18:32:00,0,1752.0,1391.0,0.794,8.443,205,101,57,44,104,36,68,11,0.0,0.0
1007,1115,2020-03-18 18:35:00,0,1889.0,1553.0,0.822,9.161,101,25,13,12,76,10,66,0,0.0,0.0
1007,1116,2020-03-18 18:38:00,0,2115.0,1743.0,0.824,10.265,395,146,111,35,249,164,85,15,0.0,0.0
1007,1117,2020-03-18 18:41:00,0,2097.0,1831.0,0.873,10.289,86,11,4,7,75,10,65,0,0.0,0.0
1007,1118,2020-03-18 18:44:00,0,2118.0,1749.0,0.826,10.283,91,26,5,21,65,2,63,0,0.0,0.0
1007,1119,2020-03-18 18:47:00,0,2095.0,1810.0,0.864,10.259,95,28,1,27,67,4,63,0,0.0,0.0
1007,1120,2020-03-18 18:50:00,0,2174.0,1881.0,0.865,10.65,106,30,16,14,76,4,72,0,0.0,0.0
1007,1121,2020-03-18 18:53:00,0,2079.0,1890.0,0.909,10.282,70,0,0,0,70,0,70,0,0.0,0.0
1007,1122,2020-03-18 18:56:00,0,2244.0,1942.0,0.865,10.993,64,6,1,5,58,0,58,0,0.0,0.0
1007,1123,2020-03-18 18:59:00,0,2074.0,1916.0,0.924,10.294,330,156,115,41,174,106,68,53,0.0,0.0
1007,1124,2020-03-18 19:02:00,0,4129.0,3837.0,0.929,20.518,690,119,75,44,571,458,113,42,0.0,0.0
1007,1125,2020-03-18 19:05:00,0,2654.0,2502.0,0.942,13.227,266,77,33,44,189,117,72,3,0.22,0.0
1007,1126,2020-03-18 19:08:00,0,2226.0,2040.0,0.916,11.029,218,72,34,38,146,73,73,4,0.0,0.0
1007,1127,2020-03-18 19:11:00,0,2485.0,2092.0,0.842,12.107,194,37,8,29,157,89,68,0,0.0,0.0
1007,1128,2020-03-18 19:14:00,0,3904.0,3689.0,0.945,19.468,323,122,89,33,201,127,74,65,0.0,0.08
1007,1129,2020-03-18 19:17:00,0,4136.0,3904.0,0.944,20.617,347,95,67,28,252,175,77,18,0.0,0.05
1007,1130,2020-03-18 19:20:00,0,2214.0,2069.0,0.935,11.013,90,16,3,13,74,8,66,0,0.0,0.0
1007,1131,2020-03-18 19:23:00,0,2227.0,2045.0,0.918,11.037,85,16,9,7,69,9,60,0,0.0,0.0
1007,1132,2020-03-18 19:26:00,0,2102.0,1782.0,0.848,10.253,62,3,2,1,59,0,59,0,0.0,0.0
1007,1133,2020-03-18 19:29:00,0,2104.0,1786.0,0.849,10.266,65,11,6,5,54,2,52,0,0.0,0.0
1007,1134,2020-03-18 19:32:00,0,2016.0,1772.0,0.879,9.904,59,1,0,1,58,0,58,0,0.0,0.0
1007,1135,2020-03-18 19:35:00,0,2011.0,1775.0,0.882,9.89,56,0,0,0,56,0,56,0,0.0,0.0
1007,1136,2020-03-18 19:38:00,0,3533.0,3341.0,0.946,17.618,393,146,96,50,247,155,92,55,0.0,0.0
1007,1137,2020-03-18 19:41:00,0,3670.0,3514.0,0.957,18.351,384,145,106,39,239,163,76,21,0.0,0.0
1007,1138,2020-03-18 19:44:00,0,3879.0,3819.0,0.985,19.51,524,223,161,62,301,208,93,60,0.0,0.05
1007,1139,2020-03-18 19:47:00,0,2509.0,2329.0,0.928,12.462,182,54,35,19,128,56,72,19,0.0,0.02
1007,1140,2020-03-18 19:50:00,0,2083.0,1858.0,0.892,10.265,79,2,1,1,77,2,75,0,0.0,0.0
1007,1141,2020-03-18 19:53:00,0,2085.0,1869.0,0.896,10.286,89,4,1,3,85,14,71,0,0.0,0.0
1007,1142,2020-03-18 19:56:00,0,1938.0,1728.0,0.892,9.55,193,67,26,41,126,50,76,6,0.0,0.0
1007,1143,2020-03-18 19:59:00,0,3545.0,3305.0,0.932,17.626,392,186,140,46,206,129,77,76,0.0,0.0
1007,1144,2020-03-18 20:02:00,0,3331.0,3079.0,0.924,16.534,455,214,159,55,241,147,94,48,0.0,0.03
1007,1145,2020-03-18 20:05:00,0,3532.0,3401.0,0.963,17.68,376,90,52,38,286,188,98,68,0.0,0.04
1007,1146,2020-03-18 20:08:00,0,2976.5,2851.5,0.957,14.8835,646,270,222,48,376,278,98,19,0.0,0.04
1007,1147,2020-03-18 20:11:00,0,2421.0,2302.0,0.951,12.087,151,63,35,28,88,18,70,1,0.0,0.03
1007,1148,2020-03-18 20:14:00,0,2167.0,1900.0,0.877,10.64,103,28,16,12,75,16,59,0,0.0,0.0
1007,1149,2020-03-18 20:17:00,0,2249.0,1933.0,0.859,11.0,244,87,50,37,157,78,79,1,0.0,0.0
1007,1150,2020-03-18 20:20:00,0,2230.0,2012.0,0.902,11.014,159,45,11,34,114,42,72,0,0.0,0.0
1007,1151,2020-03-18 20:23:00,0,4103.0,3954.0,0.964,20.544,385,95,78,17,290,206,84,0,0.12,0.0
1007,1152,2020-03-18 20:26:00,0,2433.0,2307.0,0.948,12.139,61,0,0,0,61,2,59,0,0.0,0.0
1007,1153,2020-03-18 20:29:00,0,2442.0,2237.0,0.916,12.098,71,2,1,1,69,6,63,0,0.0,0.0
1007,1154,2020-03-18 20:32:00,0,2216.0,2106.0,0.95,11.06,63,8,0,8,55,0,55,0,0.0,0.0
1007,1155,2020-03-18 20:35:00,0,2222.0,2057.0,0.926,11.032,59,3,1,2,56,0,56,0,0.0,0.0
1007,1156,2020-03-18 20:38:00,0,2213.0,2052.0,0.927,10.992,87,28,3,25,59,0,59,0,0.0,0.0
1007,1157,2020-03-18 20:41:00,0,2234.0,2017.0,0.903,11.035,68,16,0,16,52,0,52,0,0.0,0.0
1007,1158,2020-03-18 20:44:00,0,2224.0,2025.0,0.91,11.006,163,79,61,18,84,20,64,4,0.0,0.0
1007,1159,2020-03-18 20:47:00,0,2261.0,1909.0,0.844,11.024,245,119,67,52,126,59,67,12,0.0,0.0
1007,1160,2020-03-18 20:50:00,0,4099.0,3954.0,0.965,20.528,474,189,139,50,285,191,94,80,0.0,0.0
1007,1161,2020-03-18 20:53:00,0,3890.0,3718.0,0.956,19.442,393,132,99,33,261,186,75,42,0.0,0.0
1007,1162,2020-03-18 20:56:00,0,2651.0,2475.0,0.934,13.186,351,133,92,41,218,138,80,40,0.11,0.01
1007,1163,2020-03-18 20:59:00,0,3935.0,3575.0,0.908,19.462,469,190,132,58,279,194,85,83,0.0,0.01
1007,1164,2020-03-18 21:02:00,0,3556.0,3285.0,0.924,17.647,367,103,54,49,264,179,85,86,0.0,0.06
1007,1165,2020-03-18 21:05:00,0,3115.0,2821.0,0.905,15.397,381,127,76,51,254,167,87,59,0.0,0.09
1007,1166,2020-03-18 21:08:00,0,2807.0,2601.0,0.927,13.938,486,211,172,39,275,194,81,21,0.0,0.05
1007,1167,2020-03-18 21:11:00,0,2425.0,2291.0,0.945,12.089,230,51,5,46,179,103,76,0,0.0,0.0
1007,1168,2020-03-18 21:14:00,0,2261.0,1930.0,0.854,11.044,134,18,1,17,116,45,71,0,0.0,0.0
1007,1169,2020-03-18 21:17:00,0,2398.0,2065.0,0.861,11.735,74,0,0,0,74,4,70,0,0.0,0.0
1007,1170,2020-03-18 21:20:00,0,2317.0,2049.0,0.884,11.399,129,12,7,5,117,44,73,0,0.0,0.0
1007,1171,2020-03-18 21:23:00,0,2241.0,1972.0,0.88,11.013,86,23,14,9,63,2,61,0,0.0,0.0
1007,1172,2020-03-18 21:26:00,0,2174.0,1881.0,0.865,10.649,63,0,0,0,63,0,63,0,0.0,0.0
1007,1173,2020-03-18 21:29:00,0,2240.0,1975.0,0.881,11.014,70,0,0,0,70,0,70,0,0.0,0.0
1007,1174,2020-03-18 21:32:00,0,2235.0,2001.0,0.895,11.02,68,0,0,0,68,0,68,0,0.0,0.0
1007,1175,2020-03-18 21:35:00,0,2252.0,1946.0,0.864,11.028,78,11,0,11,67,0,67,0,0.0,0.0
1007,1176,2020-03-18 21:38:00,0,2255.0,1931.0,0.856,11.022,70,5,0,5,65,2,63,0,0.0,0.0
1007,1177,2020-03-18 21:41:00,0,2077.0,1881.0,0.906,10.266,70,3,0,3,67,0,67,0,0.0,0.0
1007,1178,2020-03-18 21:44:00,0,2081.0,1884.0,0.906,10.284,138,33,4,29,105,35,70,8,0.0,0.0
1007,1179,2020-03-18 21:47:00,0,2317.0,2024.0,0.873,11.369,197,29,11,18,168,86,82,5,0.0,0.0
1007,1180,2020-03-18 21:50:00,0,3895.0,3687.0,0.946,19.429,432,170,143,27,262,175,87,18,0.0,0.0
1007,1181,2020-03-18 21:53:00,0,2890.0,2642.0,0.914,14.312,381,73,51,22,308,215,93,59,0.0,0.0
1007,1182,2020-03-18 21:56:00,0,4126.0,3892.0,0.943,20.565,353,111,72,39,242,153,89,68,0.0,0.13
1007,1183,2020-03-18 21:59:00,0,4204.0,3996.0,0.95,20.988,401,169,120,49,232,155,77,79,0.0,0.19
1007,1184,2020-03-18 22:02:00,0,3909.0,3672.0,0.939,19.465,467,191,160,31,276,205,71,15,0.07,0.03
1007,1185,2020-03-18 22:05:00,0,2081.0,1875.0,0.901,10.274,271,94,63,31,177,110,67,12,0.0,0.0
1007,1186,2020-03-18 22:08:00,0,2566.0,2499.0,0.974,12.876,383,136,105,31,247,172,75,17,0.05,0.02
1007,1187,2020-03-18 22:11:00,0,2428.0,2307.0,0.95,12.121,647,389,333,56,258,188,70,33,0.0,0.0
1007,1188,2020-03-18 22:14:00,0,2234.0,1997.0,0.894,11.012,354,158,107,51,196,129,67,3,0.0,0.0
1007,1189,2020-03-18 22:17:00,0,3200.0,2869.0,0.896,15.784,464,219,167,52,245,165,80,52,0.0,0.0
1007,1190,2020-03-18 22:20:00,0,2451.0,2227.0,0.909,12.124,495,249,195,54,246,168,78,23,0.0,0.11
1007,1191,2020-03-18 22:23:00,0,2881.0,2697.0,0.936,14.337,285,99,58,41,186,123,63,2,0.27,0.0
1007,1192,2020-03-18 22:26:00,0,2108.0,1771.0,0.84,10.265,176,56,17,39,120,48,72,0,0.0,0.0
1007,1193,2020-03-18 22:29:00,0,2091.0,1813.0,0.867,10.247,69,20,6,14,49,2,47,0,0.0,0.0
1007,1194,2020-03-18 22:32:00,0,2239.0,1999.0,0.893,11.035,52,2,2,0,50,0,50,0,0.0,0.0
1007,1195,2020-03-18 22:35:00,0,2251.0,1959.0,0.871,11.037,86,3,0,3,83,16,67,0,0.0,0.0
1007,1196,2020-03-18 22:38:00,0,2270.0,1888.0,0.832,11.035,83,10,1,9,73,11,62,0,0.0,0.0
1007,1197,2020-03-18 22:41:00,0,2237.0,2006.0,0.897,11.033,64,6,0,6,58,0,58,0,0.0,0.0
1007,1198,2020-03-18 22:44:00,0,2064.0,1952.0,0.946,10.291,74,5,1,4,69,0,69,0,0.0,0.0
1007,1199,2020-03-18 22:47:00,0,2071.0,1917.0,0.926,10.28,70,2,0,2,68,0,68,0,0.0,0.0
1007,1200,2020-03-18 22:50:00,0,2005.0,1840.0,0.918,9.937,73,5,0,5,68,0,68,0,0.0,0.0
1007,1201,2020-03-18 22:53:00,0,2150.0,1972.0,0.917,10.655,84,17,1,16,67,0,67,0,0.0,0.0
1007,1202,2020-03-18 22:56:00,0,2226.0,2001.0,0.899,10.987,102,33,2,31,69,0,69,0,0.0,0.0
1007,1203,2020-03-18 22:59:00,0,2080.0,1893.0,0.91,10.293,74,7,5,2,67,2,65,0,0.0,0.0
1007,1204,2020-03-18 23:02:00,0,3247.0,3020.0,0.93,16.135,238,137,82,55,101,39,62,22,0.0,0.0
1007,1205,2020-03-18 23:05:00,0,3255.0,3000.0,0.922,16.146,226,103,44,59,123,45,78,11,0.0,0.0
1007,1206,2020-03-18 23:08:00,0,3874.0,3628.0,0.9345,19.2805,409,166,114,52,243,149,94,91,0.0,0.0
1007,1207,2020-03-18 23:11:00,0,4493.0,4256.0,0.947,22.415,417,94,52,42,323,226,97,45,0.0,0.26
1007,1208,2020-03-18 23:14:00,0,2231.0,2001.0,0.897,11.005,391,7,1,6,384,280,104,0,0.0,0.02
1007,1209,2020-03-18 23:17:00,0,1847.0,1727.0,0.935,9.188,201,73,40,33,128,56,72,8,0.0,0.0
1007,1210,2020-03-18 23:20:00,0,4096.0,3974.0,0.97,20.539,404,101,72,29,303,213,90,12,0.39,0.0
1007,1211,2020-03-18 23:23:00,0,2499.0,2399.0,0.96,12.502,228,61,44,17,167,95,72,17,0.0,0.0
1007,1212,2020-03-18 23:26:00,0,2200.0,2131.0,0.968,11.028,63,3,2,1,60,4,56,0,0.0,0.0
1007,1213,2020-03-18 23:29:00,0,2214.0,2088.0,0.943,11.034,61,3,0,3,58,0,58,0,0.0,0.0
1007,1214,2020-03-18 23:32:00,0,2230.0,2000.0,0.897,11.0,99,13,11,2,86,25,61,5,0.0,0.0
1007,1215,2020-03-18 23:35:00,0,3961.0,3822.0,0.965,19.836,164,61,36,25,103,47,56,39,0.0,0.19
1007,1216,2020-03-18 23:38:00,0,3308.0,3200.0,0.967,16.576,378,187,155,32,191,118,73,16,0.0,0.0
1007,1217,2020-03-18 23:41:00,0,1841.0,1727.0,0.938,9.164,169,49,10,39,120,51,69,1,0.0,0.0
1007,1218,2020-03-18 23:44:00,0,3174.0,2967.0,0.935,15.789,519,221,180,41,298,226,72,2,0.0,0.0
1007,1219,2020-03-18 23:47:00,0,3442.0,3348.0,0.973,17.267,601,297,236,61,304,225,79,16,0.0,0.0
1007,1220,2020-03-18 23:50:00,0,3744.0,3601.0,0.962,18.738,348,133,94,39,215,165,50,24,0.0,0.01
1007,1221,2020-03-18 23:53:00,0,3881.0,3736.0,0.963,19.427,433,223,178,45,210,193,17,23,0.0,0.05
1007,1222,2020-03-18 23:56:00,0,3908.0,3671.0,0.939,19.461,95,67,16,51,28,28,0,3,0.0,0.0
1007,1223,2020-03-18 23:59:00,0,3912.0,3682.0,0.941,19.489,225,80,36,44,145,136,9,8,0.0,0.0
1007,1224,2020-03-19 00:02:00,0,3505.0,3445.0,0.983,17.622,65,50,30,20,15,12,3,13,0.0,0.0
1007,1225,2020-03-19 00:05:00,0,3284.0,3236.0,0.986,16.521,51,33,11,22,18,15,3,0,0.0,0.0
1007,1226,2020-03-19 00:08:00,0,3172.0,2999.0,0.946,15.816,9,9,0,9,0,0,0,0,0.0,0.0
1007,1227,2020-03-19 00:11:00,0,2938.0,2788.0,0.949,14.662,8,8,0,8,0,0,0,0,0.0,0.0
1007,1228,2020-03-19 00:14:00,0,2803.0,2647.0,0.945,13.973,10,10,0,10,0,0,0,0,0.0,0.0
1007,1229,2020-03-19 00:17:00,0,2558.0,2560.0,1.001,12.911,8,8,2,6,0,0,0,0,0.0,0.0
1007,1230,2020-03-19 00:20:00,0,2553.0,2561.0,1.003,12.894,2,1,0,1,1,0,1,0,0.0,0.0
1007,1231,2020-03-19 00:23:00,0,2577.0,2459.0,0.954,12.875,19,6,1,5,13,12,1,0,0.0,0.0
1007,1232,2020-03-19 00:26:00,0,2590.0,2407.0,0.93,12.869,66,29,2,27,37,34,3,0,0.0,0.0
1007,1233,2020-03-19 00:29:00,0,2564.0,2487.0,0.97,12.856,13,13,7,6,0,0,0,0,0.0,0.0
1007,1234,2020-03-19 00:32:00,0,2573.0,2479.0,0.963,12.882,15,15,4,11,0,0,0,0,0.0,0.0
1007,1235,2020-03-19 00:35:00,0,2589.0,2412.0,0.931,12.872,155,102,61,41,53,50,3,17,0.0,0.0
1007,1236,2020-03-19 00:38:00,0,2812.0,2620.0,0.932,13.978,426,185,127,58,241,219,22,84,0.0,0.0
1007,1237,2020-03-19 00:41:00,0,2945.0,2795.0,0.949,14.699,285,136,84,52,149,138,11,49,0.0,0.0
1007,1238,2020-03-19 00:44:00,0,2802.0,2654.0,0.947,13.977,209,60,27,33,149,137,12,23,0.0,0.0
1007,1239,2020-03-19 00:47:00,0,2439.0,2238.0,0.918,12.086,118,68,47,21,50,45,5,11,0.0,0.0
1007,1240,2020-03-19 00:50:00,0,2561.0,2477.0,0.967,12.832,166,44,22,22,122,102,20,9,0.0,0.0
1007,1241,2020-03-19 00:53:00,0,2946.0,2774.0,0.941,14.679,542,144,107,37,398,343,55,19,0.0,0.0
1007,1242,2020-03-19 00:56:00,0,2225.0,2044.0,0.919,11.028,502,40,25,15,462,393,69,3,0.0,0.0
1007,1243,2020-03-19 00:59:00,0,3312.0,3111.0,0.939,16.493,359,216,161,55,143,115,28,40,0.0,0.0
1007,1244,2020-03-19 01:02:00,0,3322.0,3103.0,0.934,16.522,304,92,63,29,212,132,80,4,0.24,0.0
1007,1245,2020-03-19 01:05:00,0,3170.0,3032.0,0.956,15.848,209,103,75,28,106,48,58,10,0.0,0.0
1007,1246,2020-03-19 01:08:00,0,3315.0,3142.0,0.948,16.538,152,57,18,39,95,38,57,0,0.0,0.0
1007,1247,2020-03-19 01:11:00,0,3328.0,3082.0,0.926,16.523,138,19,4,15,119,43,76,1,0.0,0.0
1007,1248,2020-03-19 01:14:00,0,3028.0,2842.0,0.939,15.076,69,6,1,5,63,0,63,0,0.0,0.0
1007,1249,2020-03-19 01:17:00,0,2809.0,2612.0,0.93,13.961,86,23,0,23,63,0,63,0,0.0,0.0
1007,1250,2020-03-19 01:20:00,0,2581.0,2416.0,0.936,12.843,193,76,61,15,117,51,66,16,0.0,0.0
1007,1251,2020-03-19 01:23:00,0,2592.0,2372.0,0.915,12.837,417,179,139,40,238,155,83,75,0.0,0.0
1007,1252,2020-03-19 01:26:00,0,2742.0,2535.0,0.924,13.611,606,268,221,47,338,248,90,38,0.05,0.0
1007,1253,2020-03-19 01:29:00,0,2205.0,2108.0,0.956,11.022,430,197,159,38,233,167,66,22,0.01,0.0
1007,1254,2020-03-19 01:32:00,0,2569.0,2469.0,0.961,12.857,435,217,176,41,218,151,67,25,0.0,0.0
1007,1255,2020-03-19 01:35:00,0,2834.0,2529.0,0.892,13.967,492,264,202,62,228,157,71,17,0.0,0.0
1007,1256,2020-03-19 01:38:00,0,2819.0,2595.0,0.921,13.978,669,311,239,72,358,260,98,33,0.0,0.0
1007,1257,2020-03-19 01:41:00,0,3117.0,2813.0,0.902,15.397,889,325,252,73,564,423,141,15,0.0,0.0
1007,1258,2020-03-19 01:44:00,0,2949.0,2749.0,0.932,14.661,767,338,273,65,429,337,92,17,0.0,0.06
1007,1259,2020-03-19 01:47:00,0,3200.0,2894.0,0.904,15.813,886,306,234,72,580,465,115,9,0.0,0.0
1007,1260,2020-03-19 01:50:00,0,2969.0,2686.0,0.904,14.673,362,136,114,22,226,161,65,22,0.0,0.0
1007,1261,2020-03-19 01:53:00,0,3044.0,2771.0,0.91,15.061,460,69,43,26,391,305,86,12,0.0,0.0
1007,1262,2020-03-19 01:56:00,0,2971.0,2707.0,0.911,14.704,677,230,177,53,447,350,97,38,0.0,0.0
1007,1263,2020-03-19 01:59:00,0,2983.0,2641.0,0.885,14.677,193,54,26,28,139,83,56,1,0.0,0.0
1007,1264,2020-03-19 02:02:00,0,2977.0,2695.0,0.905,14.712,308,18,4,14,290,193,97,0,0.0,0.0
1007,1265,2020-03-19 02:05:00,0,2975.0,2648.0,0.89,14.655,319,70,32,38,249,169,80,0,0.0,0.0
1007,1266,2020-03-19 02:08:00,0,2903.5,2587.5,0.891,14.306,393,168,130,38,225,150,75,13,0.0,0.0
1007,1267,2020-03-19 02:11:00,0,2832.0,2527.0,0.892,13.957,113,41,31,10,72,52,20,3,0.0,0.0
1007,1268,2020-03-19 02:14:00,0,2663.0,2428.0,0.912,13.18,5,2,0,2,3,0,3,0,0.0,0.0
1007,1269,2020-03-19 02:17:00,0,2456.0,2225.0,0.906,12.14,10,2,1,1,8,4,4,0,0.0,0.0
1007,1270,2020-03-19 02:20:00,0,2492.0,2058.0,0.826,12.097,66,1,1,0,65,38,27,0,0.0,0.0
1007,1271,2020-03-19 02:23:00,0,2247.0,1926.0,0.857,10.984,184,19,2,17,165,106,59,0,0.0,0.0
1007,1272,2020-03-19 02:26:00,0,2242.0,1952.0,0.871,10.996,14,0,0,0,14,4,10,0,0.0,0.0
1007,1273,2020-03-19 02:29:00,0,2262.0,1868.0,0.826,10.982,36,2,1,1,34,4,30,0,0.0,0.0
1007,1274,2020-03-19 02:32:00,0,2263.0,1879.0,0.83,10.997,25,8,0,8,17,2,15,0,0.0,0.0
1007,1275,2020-03-19 02:35:00,0,2256.0,1953.0,0.865,11.052,14,7,2,5,7,1,6,0,0.0,0.0
1007,1276,2020-03-19 02:38:00,0,2272.0,1857.0,0.817,11.009,18,7,0,7,11,4,7,0,0.0,0.0
1007,1277,2020-03-19 02:41:00,0,2108.0,1794.0,0.851,10.292,10,4,2,2,6,1,5,0,0.0,0.0
1007,1278,2020-03-19 02:44:00,0,2181.0,1840.0,0.843,10.632,7,0,0,0,7,1,6,0,0.0,0.0
1007,1279,2020-03-19 02:47:00,0,2091.0,1834.0,0.877,10.269,124,9,3,6,115,56,59,0,0.0,0.0
1007,1280,2020-03-19 02:50:00,0,1936.0,1744.0,0.901,9.557,172,16,1,15,156,93,63,0,0.0,0.0
1007,1281,2020-03-19 02:53:00,0,2098.0,1827.0,0.871,10.289,128,33,18,15,95,36,59,0,0.0,0.0
1007,1282,2020-03-19 02:56:00,0,2238.0,2002.0,0.895,11.033,64,6,2,4,58,4,54,0,0.0,0.0
1007,1283,2020-03-19 02:59:00,0,2229.0,2011.0,0.902,11.007,130,22,5,17,108,46,62,0,0.0,0.0
1007,1284,2020-03-19 03:02:00,0,2319.0,2013.0,0.868,11.367,87,17,8,9,70,20,50,0,0.0,0.0
1007,1285,2020-03-19 03:05:00,0,2492.0,2048.0,0.822,12.085,155,2,2,0,153,100,53,0,0.0,0.0
1007,1286,2020-03-19 03:08:00,0,2478.0,2107.0,0.85,12.097,81,62,39,23,19,9,10,0,0.0,0.0
1007,1287,2020-03-19 03:11:00,0,2467.0,2180.0,0.884,12.135,446,154,113,41,292,214,78,26,0.0,0.0
1007,1288,2020-03-19 03:14:00,0,2634.0,2249.0,0.854,12.868,585,221,166,55,364,273,91,59,0.0,0.0
1007,1289,2020-03-19 03:17:00,0,2845.0,2455.0,0.863,13.929,477,136,90,46,341,253,88,90,0.0,0.0
1007,1290,2020-03-19 03:20:00,0,2847.0,2490.0,0.875,13.973,534,149,113,36,385,298,87,77,0.0,0.0
1007,1291,2020-03-19 03:23:00,0,3157.0,2683.0,0.85,15.408,533,163,117,46,370,271,99,51,0.0,0.06
1007,1292,2020-03-19 03:26:00,0,2486.0,2101.0,0.845,12.121,453,161,109,52,292,215,77,13,0.0,0.01
1007,1293,2020-03-19 03:29:00,0,2592.0,2410.0,0.93,12.879,588,216,175,41,372,293,79,30,0.0,0.0
1007,1294,2020-03-19 03:32:00,0,2532.0,2274.0,0.898,12.493,664,246,197,49,418,322,96,16,0.0,0.0
1007,1295,2020-03-19 03:35:00,0,2590.0,2363.0,0.912,12.819,432,136,98,38,296,200,96,10,0.0,0.02
1007,1296,2020-03-19 03:38:00,0,2576.0,2445.0,0.949,12.856,554,203,169,34,351,254,97,17,0.0,0.04
1007,1297,2020-03-19 03:41:00,0,2838.0,2507.0,0.883,13.955,87,14,7,7,73,4,69,2,0.0,0.0
1007,1298,2020-03-19 03:44:00,0,2839.0,2487.0,0.876,13.938,114,37,6,31,77,10,67,2,0.0,0.0
1007,1299,2020-03-19 03:47:00,0,2667.0,2446.0,0.917,13.215,359,168,136,32,191,121,70,29,0.0,0.0
1007,1300,2020-03-19 03:50:00,0,2585.0,2392.0,0.926,12.833,281,148,108,40,133,56,77,0,0.0,0.0
1007,1301,2020-03-19 03:53:00,0,2615.0,2282.0,0.873,12.831,429,201,147,54,228,150,78,18,0.0,0.0
1007,1302,2020-03-19 03:56:00,0,2541.0,2256.0,0.888,12.511,63,10,4,6,53,0,53,0,0.0,0.0
1007,1303,2020-03-19 03:59:00,0,2484.0,2076.0,0.836,12.087,58,1,1,0,57,0,57,0,0.0,0.0
1007,1304,2020-03-19 04:02:00,0,2244.0,1937.0,0.863,10.985,83,31,0,31,52,0,52,0,0.0,0.0
1007,1305,2020-03-19 04:05:00,0,2173.0,1879.0,0.865,10.641,80,29,0,29,51,0,51,0,0.0,0.0
1007,1306,2020-03-19 04:08:00,0,2108.0,1772.0,0.841,10.269,71,16,7,9,55,0,55,0,0.0,0.0
1007,1307,2020-03-19 04:11:00,0,2097.0,1829.0,0.872,10.289,60,4,3,1,56,0,56,0,0.0,0.0
1007,1308,2020-03-19 04:14:00,0,2103.0,1796.0,0.854,10.276,77,3,0,3,74,8,66,0,0.0,0.0
1007,1309,2020-03-19 04:17:00,0,2253.0,1922.0,0.853,11.003,56,1,0,1,55,2,53,0,0.0,0.0
1007,1310,2020-03-19 04:20:00,0,2254.0,1921.0,0.852,11.006,73,5,2,3,68,0,68,0,0.0,0.0
1007,1311,2020-03-19 04:23:00,0,2324.0,1991.0,0.857,11.362,371,155,114,41,216,145,71,41,0.0,0.0
1007,1312,2020-03-19 04:26:00,0,2638.0,2231.0,0.845,12.865,453,178,122,56,275,200,75,83,0.0,0.0
1007,1313,2020-03-19 04:29:00,0,2602.0,2346.0,0.902,12.848,460,155,110,45,305,221,84,57,0.0,0.08
1007,1314,2020-03-19 04:32:00,0,2448.0,2223.0,0.908,12.106,332,164,125,39,168,116,52,10,0.0,0.0
1007,1315,2020-03-19 04:35:00,0,2625.0,2290.0,0.872,12.877,393,105,56,49,288,226,62,8,0.0,0.0
1007,1316,2020-03-19 04:38:00,0,2840.0,2511.0,0.884,13.968,457,198,152,46,259,205,54,23,0.0,0.0
1007,1317,2020-03-19 04:41:00,0,2580.0,2446.0,0.948,12.874,264,107,78,29,157,116,41,12,0.0,0.0
1007,1318,2020-03-19 04:44:00,0,2600.0,2367.0,0.91,12.865,29,15,6,9,14,5,9,0,0.0,0.0
1007,1319,2020-03-19 04:47:00,0,2616.0,2285.0,0.874,12.835,7,1,0,1,6,2,4,0,0.0,0.0
1007,1320,2020-03-19 04:50:00,0,2473.0,2142.0,0.866,12.116,15,10,0,10,5,1,4,0,0.0,0.0
1007,1321,2020-03-19 04:53:00,0,2310.0,2083.0,0.902,11.408,2,0,0,0,2,1,1,0,0.0,0.0
1007,1322,2020-03-19 04:56:00,0,2466.0,2149.0,0.872,12.093,493,194,150,44,299,230,69,22,0.0,0.0
1007,1323,2020-03-19 04:59:00,0,2602.0,2321.0,0.892,12.821,553,194,146,48,359,266,93,87,0.0,0.0
1007,1324,2020-03-19 05:02:00,0,2849.0,2454.0,0.861,13.942,442,124,81,43,318,228,90,40,0.0,0.0
1007,1325,2020-03-19 05:05:00,0,2493.0,2088.0,0.837,12.134,398,150,104,46,248,171,77,48,0.0,0.03
1007,1326,2020-03-19 05:08:00,0,2533.5,2261.0,0.8915,12.4845,452,207,173,34,245,181,64,30,0.0,0.0
1007,1327,2020-03-19 05:11:00,0,2574.0,2434.0,0.946,12.835,149,55,15,40,94,28,66,1,0.0,0.0
1007,1328,2020-03-19 05:14:00,0,2972.0,2684.0,0.903,14.682,274,59,19,40,215,126,89,2,0.0,0.0
1007,1329,2020-03-19 05:17:00,0,2969.0,2688.0,0.906,14.673,222,45,3,42,177,109,68,0,0.0,0.0
1007,1330,2020-03-19 05:20:00,0,2987.0,2641.0,0.884,14.692,440,162,119,43,278,192,86,10,0.0,0.0
1007,1331,2020-03-19 05:23:00,0,2663.0,2458.0,0.923,13.212,230,0,0,0,230,159,71,0,0.0,0.0
1007,1332,2020-03-19 05:26:00,0,2453.0,2242.0,0.914,12.149,118,8,2,6,110,46,64,0,0.0,0.0
1007,1333,2020-03-19 05:29:00,0,2304.0,2058.0,0.893,11.355,137,8,0,8,129,63,66,0,0.0,0.0
1007,1334,2020-03-19 05:32:00,0,2242.0,1978.0,0.882,11.024,89,5,1,4,84,13,71,0,0.0,0.0
1007,1335,2020-03-19 05:35:00,0,2251.0,1930.0,0.858,11.005,122,3,1,2,119,57,62,0,0.0,0.0
1007,1336,2020-03-19 05:38:00,0,2249.0,1953.0,0.868,11.023,104,20,12,8,84,36,48,0,0.0,0.0
1007,1337,2020-03-19 05:41:00,0,2257.0,1937.0,0.858,11.037,17,9,2,7,8,1,7,0,0.0,0.0
1007,1338,2020-03-19 05:44:00,0,2277.0,1847.0,0.811,11.014,17,0,0,0,17,1,16,0,0.0,0.0
1007,1339,2020-03-19 05:47:00,0,2275.0,1818.0,0.799,10.976,58,16,7,9,42,13,29,0,0.0,0.0
1007,1340,2020-03-19 05:50:00,0,2193.0,1803.0,0.822,10.636,66,1,1,0,65,8,57,0,0.0,0.0
1007,1341,2020-03-19 05:53:00,0,2127.0,1742.0,0.819,10.309,49,6,1,5,43,15,28,0,0.0,0.0
1007,1342,2020-03-19 05:56:00,0,2040.0,1692.0,0.829,9.909,65,0,0,0,65,2,63,0,0.0,0.0
1007,1343,2020-03-19 05:59:00,0,2113.0,1734.0,0.821,10.248,80,1,1,0,79,27,52,0,0.0,0.0
1007,1344,2020-03-19 06:02:00,1,2113.0,1744.0,0.825,10.256,418,129,93,36,289,214,75,21,0.0,0.0
1007,1345,2020-03-19 06:05:00,1,2338.0,1956.0,0.837,11.379,321,146,101,45,175,126,49,12,0.0,0.0
1007,1346,2020-03-19 06:08:00,1,2484.0,2100.0,0.845,12.114,177,67,22,45,110,47,63,0,0.0,0.0
1007,1347,2020-03-19 06:11:00,1,2490.0,2102.0,0.844,12.137,184,70,43,27,114,52,62,8,0.0,0.0
1007,1348,2020-03-19 06:14:00,1,2497.0,2052.0,0.822,12.109,320,123,87,36,197,146,51,0,0.0,0.0
1007,1349,2020-03-19 06:17:00,1,2511.0,2011.0,0.801,12.119,517,225,170,55,292,198,94,14,0.0,0.0
1007,1350,2020-03-19 06:20:00,1,2491.0,2073.0,0.832,12.11,508,249,184,65,259,185,74,29,0.0,0.0
1007,1351,2020-03-19 06:23:00,1,2657.0,2111.0,0.794,12.807,496,178,136,42,318,223,95,7,0.0,0.0
1007,1352,2020-03-19 06:26:00,1,2662.0,2116.0,0.795,12.832,165,44,8,36,121,57,64,0,0.0,0.0
1007,1353,2020-03-19 06:29:00,1,2670.0,2112.0,0.791,12.86,238,115,60,55,123,72,51,0,0.0,0.0
1007,1354,2020-03-19 06:32:00,1,2661.0,2140.0,0.804,12.852,313,78,43,35,235,150,85,0,0.0,0.0
1007,1355,2020-03-19 06:35:00,1,2664.0,2129.0,0.799,12.853,220,57,30,27,163,79,84,0,0.0,0.0
1007,1356,2020-03-19 06:38:00,1,2515.0,1976.0,0.786,12.099,104,26,3,23,78,4,74,0,0.0,0.0
1007,1357,2020-03-19 06:41:00,1,2293.0,1780.0,0.776,11.007,110,41,5,36,69,4,65,0,0.0,0.0
1007,1358,2020-03-19 06:44:00,1,2301.0,1736.0,0.754,10.988,182,53,21,32,129,57,72,0,0.0,0.0
1007,1359,2020-03-19 06:47:00,1,2298.0,1760.0,0.766,11.003,111,7,3,4,104,40,64,0,0.0,0.0
1007,1360,2020-03-19 06:50:00,1,2280.0,1807.0,0.792,10.985,80,8,1,7,72,44,28,0,0.0,0.0
1007,1361,2020-03-19 06:53:00,1,2228.0,1676.0,0.752,10.633,142,9,0,9,133,64,69,0,0.0,0.0
1007,1362,2020-03-19 06:56:00,1,2158.0,1585.0,0.734,10.259,109,36,13,23,73,29,44,0,0.0,0.0
1007,1363,2020-03-19 06:59:00,1,2073.0,1566.0,0.756,9.903,53,29,8,21,24,11,13,0,0.0,0.0
1007,1364,2020-03-19 07:02:00,1,1981.0,1559.0,0.787,9.532,95,3,1,2,92,25,67,0,0.0,0.0
1007,1365,2020-03-19 07:05:00,1,2156.0,1585.0,0.735,10.251,85,17,10,7,68,10,58,0,0.0,0.0
1007,1366,2020-03-19 07:08:00,1,1983.0,1563.0,0.788,9.544,5,2,1,1,3,1,2,0,0.0,0.0
1007,1367,2020-03-19 07:11:00,1,1902.0,1525.0,0.802,9.181,13,12,2,10,1,1,0,0,0.0,0.0
1007,1368,2020-03-19 07:14:00,1,1910.0,1485.0,0.777,9.17,52,13,6,7,39,30,9,0,0.0,0.0
1007,1369,2020-03-19 07:17:00,1,1908.0,1467.0,0.769,9.141,42,15,0,15,27,18,9,0,0.0,0.0
1007,1370,2020-03-19 07:20:00,1,1906.0,1513.0,0.794,9.185,11,8,0,8,3,1,2,0,0.0,0.0
1007,1371,2020-03-19 07:23:00,1,1898.0,1530.0,0.806,9.173,6,5,0,5,1,0,1,0,0.0,0.0
1007,1372,2020-03-19 07:26:00,1,1896.0,1509.0,0.796,9.143,149,87,63,24,62,20,42,0,0.0,0.0
1007,1373,2020-03-19 07:29:00,1,2223.0,1691.0,0.761,10.63,273,90,53,37,183,107,76,10,0.0,0.0
1007,1374,2020-03-19 07:32:00,1,2536.0,1917.0,0.756,12.117,305,105,64,41,200,126,74,35,0.0,0.02
1007,1375,2020-03-19 07:35:00,1,2441.0,1910.0,0.782,11.732,424,140,112,28,284,213,71,29,0.0,0.0
1007,1376,2020-03-19 07:38:00,1,2524.0,1954.0,0.774,12.107,76,14,0,14,62,0,62,0,0.0,0.0
1007,1377,2020-03-19 07:41:00,1,2287.0,1781.0,0.779,10.983,57,0,0,0,57,0,57,0,0.0,0.0
1007,1378,2020-03-19 07:44:00,1,2142.0,1666.0,0.778,10.285,241,8,4,4,233,158,75,0,0.0,0.0
1007,1379,2020-03-19 07:47:00,1,2161.0,1604.0,0.743,10.289,337,0,0,0,337,266,71,0,0.0,0.0
1007,1380,2020-03-19 07:50:00,1,2149.0,1626.0,0.757,10.268,86,1,0,1,85,31,54,0,0.0,0.0
1007,1381,2020-03-19 07:53:00,1,2147.0,1654.0,0.771,10.291,81,5,2,3,76,13,63,0,0.0,0.0
1007,1382,2020-03-19 07:56:00,1,2140.0,1641.0,0.767,10.248,116,42,13,29,74,13,61,0,0.0,0.0
1007,1383,2020-03-19 07:59:00,1,2147.0,1652.0,0.769,10.29,102,22,11,11,80,18,62,0,0.0,0.0
1007,1384,2020-03-19 08:02:00,1,2302.0,1758.0,0.764,11.017,304,104,66,38,200,122,78,13,0.0,0.0
1007,1385,2020-03-19 08:05:00,1,2530.0,1925.0,0.761,12.102,227,109,67,42,118,61,57,16,0.0,0.0
1007,1386,2020-03-19 08:08:00,1,2528.5,1926.0,0.762,12.096,94,28,11,17,66,7,59,3,0.0,0.0
1007,1387,2020-03-19 08:11:00,1,2527.0,1927.0,0.763,12.09,260,63,45,18,197,117,80,0,0.0,0.0
1007,1388,2020-03-19 08:14:00,1,2436.0,1906.0,0.782,11.71,107,47,37,10,60,12,48,1,0.0,0.0
1007,1389,2020-03-19 08:17:00,1,2286.0,1794.0,0.785,10.993,64,0,0,0,64,0,64,0,0.0,0.0
1007,1390,2020-03-19 08:20:00,1,2051.0,1624.0,0.792,9.881,40,0,0,0,40,0,40,0,0.0,0.0
1007,1391,2020-03-19 08:23:00,1,1909.0,1486.0,0.779,9.165,58,2,0,2,56,2,54,0,0.0,0.0
1007,1392,2020-03-19 08:26:00,1,1907.0,1486.0,0.779,9.159,61,5,0,5,56,0,56,0,0.0,0.0
1007,1393,2020-03-19 08:29:00,1,1922.0,1412.0,0.735,9.137,53,9,5,4,44,4,40,0,0.0,0.0
1007,1394,2020-03-19 08:32:00,1,1907.0,1475.0,0.773,9.148,46,0,0,0,46,4,42,0,0.0,0.0
1007,1395,2020-03-19 08:35:00,1,1921.0,1464.0,0.762,9.188,59,1,1,0,58,4,54,0,0.0,0.0
1007,1396,2020-03-19 08:38:00,1,1902.0,1500.0,0.788,9.155,40,0,0,0,40,2,38,0,0.0,0.0
1007,1397,2020-03-19 08:41:00,1,1905.0,1530.0,0.803,9.198,45,1,0,1,44,0,44,0,0.0,0.0
1007,1398,2020-03-19 08:44:00,1,1897.0,1545.0,0.814,9.183,62,6,3,3,56,0,56,0,0.0,0.0
1007,1399,2020-03-19 08:47:00,1,2156.0,1609.0,0.746,10.276,81,21,14,7,60,11,49,0,0.0,0.0
1007,1400,2020-03-19 08:50:00,1,1896.0,1525.0,0.804,9.16,67,1,1,0,66,17,49,0,0.0,0.0
1007,1401,2020-03-19 08:53:00,1,1908.0,1500.0,0.786,9.177,41,3,1,2,38,0,38,0,0.0,0.0
1007,1402,2020-03-19 08:56:00,1,1903.0,1500.0,0.788,9.158,33,3,0,3,30,0,30,0,0.0,0.0
1007,1403,2020-03-19 08:59:00,1,1979.0,1567.0,0.792,9.534,42,7,2,5,35,0,35,0,0.0,0.0
1007,1404,2020-03-19 09:02:00,1,1980.0,1558.0,0.787,9.527,42,6,0,6,36,0,36,0,0.0,0.0
1007,1405,2020-03-19 09:05:00,1,1894.0,1524.0,0.805,9.149,45,10,1,9,35,0,35,0,0.0,0.0
1007,1406,2020-03-19 09:08:00,1,2079.0,1561.0,0.751,9.918,59,16,0,16,43,6,37,0,0.0,0.0
1007,1407,2020-03-19 09:11:00,1,2148.0,1616.0,0.752,10.254,53,7,1,6,46,13,33,0,0.0,0.0
1007,1408,2020-03-19 09:14:00,1,2137.0,1673.0,0.783,10.271,47,7,2,5,40,4,36,0,0.0,0.0
1007,1409,2020-03-19 09:17:00,1,2309.0,1734.0,0.751,11.018,117,78,49,29,39,9,30,4,0.0,0.0
1007,1410,2020-03-19 09:20:00,1,2505.0,2005.0,0.8,12.089,370,109,68,41,261,200,61,80,0.0,0.0
1007,1411,2020-03-19 09:23:00,1,2450.0,1886.0,0.77,11.74,336,124,91,33,212,162,50,17,0.0,0.0
1007,1412,2020-03-19 09:26:00,1,2511.0,1999.0,0.796,12.108,285,140,88,52,145,97,48,5,0.0,0.0
1007,1413,2020-03-19 09:29:00,1,2515.0,1988.0,0.791,12.109,159,69,30,39,90,44,46,3,0.0,0.0
1007,1414,2020-03-19 09:32:00,1,2517.0,1961.0,0.779,12.089,237,121,63,58,116,56,60,0,0.0,0.0
1007,1415,2020-03-19 09:35:00,1,2529.0,1977.0,0.782,12.153,183,20,3,17,163,96,67,0,0.0,0.0
1007,1416,2020-03-19 09:38:00,1,2447.0,1886.0,0.771,11.729,55,4,0,4,51,2,49,0,0.0,0.0
1007,1417,2020-03-19 09:41:00,1,2307.0,1720.0,0.746,10.994,53,5,0,5,48,0,48,0,0.0,0.0
1007,1418,2020-03-19 09:44:00,1,2063.0,1606.0,0.778,9.909,48,6,1,5,42,0,42,0,0.0,0.0
1007,1419,2020-03-19 09:47:00,1,2138.0,1679.0,0.785,10.284,86,7,1,6,79,35,44,0,0.0,0.0
1007,1420,2020-03-19 09:50:00,1,2157.0,1592.0,0.738,10.26,38,0,0,0,38,2,36,0,0.0,0.0
1007,1421,2020-03-19 09:53:00,1,1915.0,1467.0,0.766,9.169,71,1,0,1,70,31,39,0,0.0,0.0
1007,1422,2020-03-19 09:56:00,1,1914.0,1464.0,0.765,9.161,29,0,0,0,29,0,29,0,0.0,0.0
1007,1423,2020-03-19 09:59:00,1,1897.0,1525.0,0.804,9.164,39,2,0,2,37,6,31,0,0.0,0.0
1007,1424,2020-03-19 10:02:00,1,1901.0,1503.0,0.791,9.154,87,14,6,8,73,36,37,0,0.0,0.0
1007,1425,2020-03-19 10:05:00,1,1901.0,1536.0,0.808,9.192,32,0,0,0,32,0,32,0,0.0,0.0
1007,1426,2020-03-19 10:08:00,1,1900.0,1510.0,0.794,9.16,38,5,0,5,33,0,33,0,0.0,0.0
1007,1427,2020-03-19 10:11:00,1,1906.0,1494.0,0.784,9.165,45,5,0,5,40,0,40,0,0.0,0.0
1007,1428,2020-03-19 10:14:00,1,1915.0,1453.0,0.758,9.156,38,1,0,1,37,0,37,0,0.0,0.0
1007,1429,2020-03-19 10:17:00,1,1897.0,1518.0,0.8,9.155,43,0,0,0,43,0,43,0,0.0,0.0
1007,1430,2020-03-19 10:20:00,1,1898.0,1522.0,0.802,9.162,54,8,1,7,46,0,46,0,0.0,0.0
1007,1431,2020-03-19 10:23:00,1,1895.0,1535.0,0.81,9.164,92,22,1,21,70,30,40,0,0.0,0.0
1007,1432,2020-03-19 10:26:00,1,1887.0,1540.0,0.816,9.141,163,62,40,22,101,66,35,4,0.0,0.0
1007,1433,2020-03-19 10:29:00,1,2130.0,1687.0,0.792,10.259,41,12,0,12,29,0,29,0,0.0,0.0
1007,1434,2020-03-19 10:32:00,1,2153.0,1626.0,0.755,10.283,23,2,1,1,21,0,21,0,0.0,0.0
1007,1435,2020-03-19 10:35:00,1,1980.0,1585.0,0.801,9.558,50,31,6,25,19,0,19,0,0.0,0.0
1007,1436,2020-03-19 10:38:00,1,1897.0,1539.0,0.811,9.179,16,0,0,0,16,0,16,0,0.0,0.0
1007,1437,2020-03-19 10:41:00,1,1910.0,1499.0,0.785,9.187,78,53,34,19,25,0,25,0,0.0,0.0
1007,1438,2020-03-19 10:44:00,1,1915.0,1473.0,0.769,9.176,56,23,9,14,33,0,33,0,0.0,0.0
1007,1439,2020-03-19 10:47:00,1,1928.0,1428.0,0.74,9.179,38,9,4,5,29,0,29,0,0.0,0.0
1007,1440,2020-03-19 10:50:00,1,1926.0,1428.0,0.742,9.17,26,0,0,0,26,0,26,0,0.0,0.0
1007,1441,2020-03-19 10:53:00,1,1917.0,1438.0,0.75,9.145,20,6,4,2,14,0,14,0,0.0,0.0
1007,1442,2020-03-19 10:56:00,1,1910.0,1491.0,0.781,9.178,55,35,20,15,20,0,20,0,0.0,0.0
1007,1443,2020-03-19 10:59:00,1,1917.0,1462.0,0.763,9.173,28,19,1,18,9,0,9,0,0.0,0.0
1007,1444,2020-03-19 11:02:00,1,1930.0,1413.0,0.732,9.167,30,0,0,0,30,0,30,0,0.0,0.0
1007,1445,2020-03-19 11:05:00,1,1933.0,1422.0,0.736,9.19,57,31,12,19,26,0,26,0,0.0,0.0
1007,1446,2020-03-19 11:08:00,1,2077.5,1561.0,0.7505,9.914,171,24,16,8,147,100,47,0,0.0,0.0
1007,1447,2020-03-19 11:11:00,1,2222.0,1700.0,0.765,10.638,159,28,4,24,131,80,51,3,0.0,0.0
1007,1448,2020-03-19 11:14:00,1,2262.0,1862.0,0.823,10.976,213,106,67,39,107,79,28,20,0.0,0.0
1007,1449,2020-03-19 11:17:00,1,2264.0,1876.0,0.829,10.996,266,144,98,46,122,90,32,20,0.0,0.0
1007,1450,2020-03-19 11:20:00,1,2259.0,1883.0,0.833,10.987,91,51,30,21,40,13,27,3,0.0,0.0
1007,1451,2020-03-19 11:23:00,1,2279.0,1827.0,0.802,11.003,40,19,1,18,21,0,21,0,0.0,0.0
1007,1452,2020-03-19 11:26:00,1,2137.0,1660.0,0.777,10.259,35,13,1,12,22,0,22,0,0.0,0.0
1007,1453,2020-03-19 11:29:00,1,1905.0,1508.0,0.791,9.175,50,14,1,13,36,0,36,0,0.0,0.0
1007,1454,2020-03-19 11:32:00,1,1910.0,1489.0,0.78,9.173,59,7,2,5,52,2,50,0,0.0,0.0
1007,1455,2020-03-19 11:35:00,1,1900.0,1498.0,0.788,9.145,53,0,0,0,53,0,53,0,0.0,0.0
1007,1456,2020-03-19 11:38:00,1,1894.0,1509.0,0.797,9.132,42,0,0,0,42,2,40,0,0.0,0.0
1007,1457,2020-03-19 11:41:00,1,1977.0,1562.0,0.79,9.52,33,0,0,0,33,0,33,0,0.0,0.0
1007,1458,2020-03-19 11:44:00,1,2069.0,1576.0,0.762,9.897,52,14,3,11,38,0,38,0,0.0,0.0
1007,1459,2020-03-19 11:47:00,1,1974.0,1569.0,0.795,9.515,59,8,0,8,51,16,35,0,0.0,0.0
1007,1460,2020-03-19 11:50:00,1,2153.0,1605.0,0.746,10.261,56,23,0,23,33,0,33,0,0.0,0.0
1007,1461,2020-03-19 11:53:00,1,2141.0,1638.0,0.765,10.249,38,4,0,4,34,4,30,0,0.0,0.0
1007,1462,2020-03-19 11:56:00,1,2154.0,1606.0,0.746,10.267,50,13,2,11,37,5,32,0,0.0,0.0
1007,1463,2020-03-19 11:59:00,1,2149.0,1627.0,0.757,10.269,34,9,0,9,25,0,25,0,0.0,0.0
1007,1464,2020-03-19 12:02:00,1,2064.0,1598.0,0.774,9.9,35,6,1,5,29,0,29,0,0.0,0.0
1007,1465,2020-03-19 12:05:00,1,1970.0,1582.0,0.803,9.514,33,4,0,4,29,0,29,0,0.0,0.0
1007,1466,2020-03-19 12:08:00,1,1974.0,1598.0,0.809,9.546,34,0,0,0,34,0,34,0,0.0,0.0
1007,1467,2020-03-19 12:11:00,1,1897.0,1544.0,0.814,9.186,85,41,26,15,44,4,40,0,0.0,0.0
1007,1468,2020-03-19 12:14:00,1,2128.0,1694.0,0.796,10.26,143,32,12,20,111,59,52,0,0.0,0.0
1007,1469,2020-03-19 12:17:00,1,2291.0,1803.0,0.787,11.023,101,39,26,13,62,19,43,0,0.0,0.0
1007,1470,2020-03-19 12:20:00,1,2259.0,1885.0,0.834,10.99,607,290,233,57,317,250,67,9,0.0,0.0
1007,1471,2020-03-19 12:23:00,1,2438.0,1918.0,0.787,11.731,262,63,39,24,199,119,80,0,0.08,0.0
1007,1472,2020-03-19 12:26:00,1,2525.0,1941.0,0.769,12.097,437,189,117,72,248,171,77,1,0.0,0.0
1007,1473,2020-03-19 12:29:00,1,2530.0,1929.0,0.763,12.103,725,348,271,77,377,285,92,3,0.0,0.0
1007,1474,2020-03-19 12:32:00,1,2497.0,2035.0,0.815,12.091,502,178,140,38,324,228,96,4,0.0,0.0
1007,1475,2020-03-19 12:35:00,1,2496.0,2035.0,0.815,12.088,429,198,139,59,231,143,88,2,0.0,0.0
1007,1476,2020-03-19 12:38:00,1,2508.0,1997.0,0.796,12.093,685,289,218,71,396,292,104,6,0.0,0.0
1007,1477,2020-03-19 12:41:00,1,2518.0,1971.0,0.783,12.101,320,170,104,66,150,75,75,2,0.0,0.0
1007,1478,2020-03-19 12:44:00,1,2514.0,1974.0,0.785,12.091,172,36,11,25,136,67,69,3,0.0,0.0
1007,1479,2020-03-19 12:47:00,1,2531.0,1904.0,0.752,12.079,186,69,25,44,117,49,68,0,0.0,0.0
1007,1480,2020-03-19 12:50:00,1,2448.0,1889.0,0.772,11.739,126,44,9,35,82,14,68,1,0.0,0.0
1007,1481,2020-03-19 12:53:00,1,2533.0,1931.0,0.762,12.119,174,85,40,45,89,19,70,2,0.0,0.0
1007,1482,2020-03-19 12:56:00,1,2351.0,1890.0,0.804,11.354,167,89,32,57,78,0,78,1,0.0,0.0
1007,1483,2020-03-19 12:59:00,1,2215.0,1721.0,0.777,10.633,69,5,1,4,64,0,64,0,0.0,0.0
1007,1484,2020-03-19 13:02:00,1,1890.0,1534.0,0.812,9.146,92,34,1,33,58,0,58,0,0.0,0.0
1007,1485,2020-03-19 13:05:00,1,1893.0,1530.0,0.808,9.154,66,3,1,2,63,0,63,0,0.0,0.0
1007,1486,2020-03-19 13:08:00,1,1919.0,1453.0,0.757,9.169,74,10,7,3,64,0,64,0,0.0,0.0
1007,1487,2020-03-19 13:11:00,1,1919.0,1439.0,0.75,9.154,58,0,0,0,58,0,58,0,0.0,0.0
1007,1488,2020-03-19 13:14:00,1,1913.0,1471.0,0.769,9.167,64,0,0,0,64,0,64,0,0.0,0.0
1007,1489,2020-03-19 13:17:00,1,1912.0,1481.0,0.774,9.174,58,1,1,0,57,0,57,0,0.0,0.0
1007,1490,2020-03-19 13:20:00,1,1916.0,1440.0,0.752,9.145,68,0,0,0,68,0,68,0,0.0,0.0
1007,1491,2020-03-19 13:23:00,1,1915.0,1451.0,0.758,9.151,61,1,0,1,60,0,60,0,0.0,0.0
1007,1492,2020-03-19 13:26:00,1,1920.0,1469.0,0.765,9.191,63,4,1,3,59,0,59,0,0.0,0.0
1007,1493,2020-03-19 13:29:00,1,1917.0,1440.0,0.751,9.149,59,0,0,0,59,0,59,0,0.0,0.0
1007,1494,2020-03-19 13:32:00,1,1932.0,1420.0,0.735,9.183,58,0,0,0,58,0,58,0,0.0,0.0
1007,1495,2020-03-19 13:35:00,1,1931.0,1404.0,0.727,9.164,86,24,7,17,62,0,62,0,0.0,0.0
1007,1496,2020-03-19 13:38:00,1,1925.0,1427.0,0.741,9.166,70,7,2,5,63,0,63,0,0.0,0.0
1007,1497,2020-03-19 13:41:00,1,1923.0,1430.0,0.744,9.162,79,6,0,6,73,6,67,0,0.0,0.0
1007,1498,2020-03-19 13:44:00,1,1923.0,1425.0,0.741,9.155,68,4,0,4,64,0,64,0,0.0,0.0
1007,1499,2020-03-19 13:47:00,1,1916.0,1452.0,0.758,9.157,77,15,5,10,62,6,56,0,0.0,0.0
1007,1500,2020-03-19 13:50:00,1,1908.0,1520.0,0.797,9.199,91,19,10,9,72,16,56,0,0.0,0.0
1007,1501,2020-03-19 13:53:00,1,1892.0,1533.0,0.81,9.15,92,32,0,32,60,0,60,0,0.0,0.0
1007,1502,2020-03-19 13:56:00,1,1903.0,1519.0,0.798,9.179,65,1,0,1,64,0,64,0,0.0,0.0
1007,1503,2020-03-19 13:59:00,1,1914.0,1460.0,0.763,9.157,59,0,0,0,59,0,59,0,0.0,0.0
1007,1504,2020-03-19 14:02:00,1,1917.0,1442.0,0.752,9.151,75,5,2,3,70,4,66,0,0.0,0.0
1007,1505,2020-03-19 14:05:00,1,1926.0,1423.0,0.739,9.164,66,1,0,1,65,0,65,0,0.0,0.0
1007,1506,2020-03-19 14:08:00,1,1847.5,1389.0,0.7525,8.8165,55,0,0,0,55,0,55,0,0.0,0.0
1007,1507,2020-03-19 14:11:00,1,1769.0,1355.0,0.766,8.469,158,50,30,20,108,47,61,1,0.0,0.0
1007,1508,2020-03-19 14:14:00,1,2147.0,1632.0,0.76,10.266,193,51,22,29,142,67,75,1,0.0,0.0
1007,1509,2020-03-19 14:17:00,1,2208.0,1732.0,0.784,10.617,462,197,152,45,265,179,86,7,0.08,0.0
1007,1510,2020-03-19 14:20:00,1,2519.0,1941.0,0.771,12.073,375,154,110,44,221,161,60,47,0.0,0.0
1007,1511,2020-03-19 14:23:00,1,3053.0,2437.0,0.798,14.726,346,204,144,60,142,83,59,14,0.0,0.0
1007,1512,2020-03-19 14:26:00,1,2518.0,1972.0,0.783,12.106,384,231,179,52,153,97,56,49,0.0,0.0
1007,1513,2020-03-19 14:29:00,1,2666.0,2085.0,0.782,12.814,560,261,208,53,299,229,70,51,0.0,0.0
1007,1514,2020-03-19 14:32:00,1,3421.0,2739.0,0.801,16.511,366,161,106,55,205,141,64,56,0.02,0.01
1007,1515,2020-03-19 14:35:00,1,2519.0,1971.0,0.782,12.106,293,135,81,54,158,88,70,45,0.0,0.0
1007,1516,2020-03-19 14:38:00,1,2634.0,2240.0,0.851,12.859,275,123,61,62,152,83,69,34,0.03,0.06
1007,1517,2020-03-19 14:41:00,1,2645.0,2190.0,0.828,12.845,332,172,116,56,160,92,68,6,0.02,0.0
1007,1518,2020-03-19 14:44:00,1,2619.0,2271.0,0.867,12.834,205,112,75,37,93,33,60,2,0.01,0.0
1007,1519,2020-03-19 14:47:00,1,2285.0,1817.0,0.795,11.016,206,108,55,53,98,34,64,9,0.0,0.0
1007,1520,2020-03-19 14:50:00,1,2104.0,1774.0,0.843,10.254,217,58,10,48,159,78,81,0,0.0,0.0
1007,1521,2020-03-19 14:53:00,1,2495.0,2062.0,0.826,12.113,139,49,20,29,90,28,62,4,0.0,0.0
1007,1522,2020-03-19 14:56:00,1,2484.0,2126.0,0.856,12.139,65,4,0,4,61,0,61,0,0.07,0.0
1007,1523,2020-03-19 14:59:00,1,2317.0,2024.0,0.874,11.369,58,0,0,0,58,0,58,0,0.0,0.0
1007,1524,2020-03-19 15:02:00,1,2247.0,1904.0,0.847,10.959,82,22,8,14,60,2,58,0,0.01,0.0
1007,1525,2020-03-19 15:05:00,1,2187.0,1820.0,0.833,10.631,69,3,1,2,66,0,66,0,0.0,0.0
1007,1526,2020-03-19 15:08:00,1,2046.0,1697.0,0.83,9.939,71,2,1,1,69,8,61,0,0.0,0.0
1007,1527,2020-03-19 15:11:00,1,2042.0,1685.0,0.825,9.91,55,0,0,0,55,2,53,0,0.0,0.0
1007,1528,2020-03-19 15:14:00,1,1872.0,1608.0,0.859,9.157,84,2,1,1,82,18,64,0,0.08,0.0
1007,1529,2020-03-19 15:17:00,1,2139.0,1653.0,0.773,10.256,143,79,8,71,64,3,61,0,0.0,0.0
1007,1530,2020-03-19 15:20:00,1,1888.0,1536.0,0.813,9.14,83,22,0,22,61,0,61,0,0.0,0.0
1007,1531,2020-03-19 15:23:00,1,1921.0,1457.0,0.758,9.182,106,55,0,55,51,0,51,0,0.03,0.0
1007,1532,2020-03-19 15:26:00,1,1910.0,1459.0,0.764,9.14,81,15,0,15,66,0,66,0,0.0,0.0
1007,1533,2020-03-19 15:29:00,1,1916.0,1468.0,0.766,9.175,51,2,1,1,49,0,49,0,0.05,0.0
1007,1534,2020-03-19 15:32:00,1,1908.0,1495.0,0.784,9.172,61,0,0,0,61,0,61,0,0.0,0.0
1007,1535,2020-03-19 15:35:00,1,1920.0,1460.0,0.761,9.18,133,57,3,54,76,2,74,0,0.0,0.0
1007,1536,2020-03-19 15:38:00,1,1903.0,1497.0,0.787,9.153,100,37,2,35,63,2,61,0,0.02,0.0
1007,1537,2020-03-19 15:41:00,1,1982.0,1592.0,0.804,9.571,81,22,4,18,59,0,59,0,0.0,0.0
1007,1538,2020-03-19 15:44:00,1,1928.0,1442.0,0.748,9.195,106,41,5,36,65,0,65,0,0.0,0.0
1007,1539,2020-03-19 15:47:00,1,1928.0,1390.0,0.721,9.137,103,44,0,44,59,0,59,0,0.0,0.0
1007,1540,2020-03-19 15:50:00,1,1758.0,1353.0,0.769,8.426,94,25,3,22,69,0,69,0,0.0,0.0
1007,1541,2020-03-19 15:53:00,1,1906.0,1525.0,0.8,9.199,191,69,35,34,122,52,70,0,0.06,0.0
1007,1542,2020-03-19 15:56:00,1,2295.0,1787.0,0.779,11.021,123,37,13,24,86,32,54,15,0.0,0.0
1007,1543,2020-03-19 15:59:00,1,2520.0,1961.0,0.778,12.102,265,80,65,15,185,122,63,11,0.0,0.0
1007,1544,2020-03-19 16:02:00,1,2293.0,1779.0,0.776,11.005,75,17,0,17,58,0,58,0,0.0,0.0
1007,1545,2020-03-19 16:05:00,1,2056.0,1634.0,0.795,9.912,68,12,6,6,56,0,56,0,0.0,0.0
1007,1546,2020-03-19 16:08:00,1,1902.0,1502.0,0.79,9.155,58,2,1,1,56,0,56,0,0.01,0.0
1007,1547,2020-03-19 16:11:00,1,1919.0,1441.0,0.751,9.155,66,0,0,0,66,0,66,0,0.0,0.0
1007,1548,2020-03-19 16:14:00,1,1918.0,1454.0,0.758,9.169,62,0,0,0,62,0,62,0,0.0,0.0
1007,1549,2020-03-19 16:17:00,1,1920.0,1454.0,0.758,9.173,86,20,5,15,66,2,64,0,0.08,0.0
1007,1550,2020-03-19 16:20:00,1,1918.0,1441.0,0.751,9.154,92,35,0,35,57,0,57,0,0.0,0.0
1007,1551,2020-03-19 16:23:00,1,1920.0,1438.0,0.749,9.157,69,9,1,8,60,4,56,0,0.0,0.0
1007,1552,2020-03-19 16:26:00,1,1917.0,1443.0,0.753,9.152,83,13,3,10,70,14,56,0,0.01,0.0
1007,1553,2020-03-19 16:29:00,1,1910.0,1483.0,0.776,9.168,59,7,4,3,52,0,52,0,0.0,0.0
1007,1554,2020-03-19 16:32:00,1,1901.0,1514.0,0.796,9.167,62,5,0,5,57,0,57,0,0.0,0.0
1007,1555,2020-03-19 16:35:00,1,1982.0,1548.0,0.781,9.524,133,56,39,17,77,26,51,7,0.0,0.0
1007,1556,2020-03-19 16:38:00,1,2073.0,1564.0,0.754,9.901,85,15,3,12,70,10,60,0,0.0,0.0
1007,1557,2020-03-19 16:41:00,1,1901.0,1514.0,0.796,9.166,117,13,3,10,104,38,66,0,0.0,0.0
1007,1558,2020-03-19 16:44:00,1,1895.0,1510.0,0.797,9.139,69,11,5,6,58,0,58,0,0.0,0.0
1007,1559,2020-03-19 16:47:00,1,2142.0,1603.0,0.748,10.214,178,68,33,35,110,45,65,1,0.06,0.0
1007,1560,2020-03-19 16:50:00,1,2297.0,1742.0,0.758,10.979,145,83,20,63,62,10,52,6,0.0,0.0
1007,1561,2020-03-19 16:53:00,1,2356.0,1862.0,0.79,11.345,127,62,20,42,65,0,65,1,0.0,0.0
1007,1562,2020-03-19 16:56:00,1,2529.0,1919.0,0.759,12.09,184,73,41,32,111,49,62,0,0.01,0.0
1007,1563,2020-03-19 16:59:00,1,2448.0,1895.0,0.774,11.743,209,75,46,29,134,79,55,14,0.0,0.0
1007,1564,2020-03-19 17:02:00,1,2515.0,1955.0,0.777,12.073,355,164,109,55,191,114,77,44,0.01,0.0
1007,1565,2020-03-19 17:05:00,1,2295.0,1761.0,0.767,10.994,266,137,102,35,129,61,68,19,0.01,0.0
1007,1566,2020-03-19 17:08:00,1,2300.5,1752.0,0.7615,11.0045,62,0,0,0,62,0,62,0,0.0,0.0
1007,1567,2020-03-19 17:11:00,1,2306.0,1743.0,0.756,11.015,54,0,0,0,54,0,54,0,0.0,0.0
1007,1568,2020-03-19 17:14:00,1,2144.0,1636.0,0.763,10.259,63,0,0,0,63,0,63,0,0.0,0.0
1007,1569,2020-03-19 17:17:00,1,1899.0,1523.0,0.802,9.169,59,0,0,0,59,0,59,0,0.0,0.0
1007,1570,2020-03-19 17:20:00,1,1910.0,1487.0,0.779,9.173,52,0,0,0,52,0,52,0,0.0,0.0
1007,1571,2020-03-19 17:23:00,1,1930.0,1421.0,0.736,9.177,58,0,0,0,58,0,58,0,0.0,0.0
1007,1572,2020-03-19 17:26:00,1,1929.0,1396.0,0.724,9.144,51,0,0,0,51,0,51,0,0.0,0.0
1007,1573,2020-03-19 17:29:00,1,1934.0,1406.0,0.727,9.176,52,0,0,0,52,0,52,0,0.0,0.0
1007,1574,2020-03-19 17:32:00,1,1922.0,1440.0,0.75,9.166,59,0,0,0,59,0,59,0,0.0,0.0
1007,1575,2020-03-19 17:35:00,1,1924.0,1423.0,0.74,9.155,122,40,18,22,82,22,60,1,0.0,0.0
1007,1576,2020-03-19 17:38:00,1,2081.0,1555.0,0.747,9.919,207,138,81,57,69,9,60,6,0.0,0.0
1007,1577,2020-03-19 17:41:00,1,2144.0,1639.0,0.764,10.264,163,61,29,32,102,37,65,1,0.0,0.0
1007,1578,2020-03-19 17:44:00,1,2306.0,1730.0,0.75,11.003,85,24,3,21,61,2,59,0,0.0,0.0
1007,1579,2020-03-19 17:47:00,1,2152.0,1621.0,0.753,10.276,75,14,2,12,61,0,61,0,0.0,0.0
1007,1580,2020-03-19 17:50:00,1,1903.0,1500.0,0.788,9.16,107,46,15,31,61,3,58,1,0.0,0.0
1007,1581,2020-03-19 17:53:00,1,2152.0,1607.0,0.747,10.258,197,135,94,41,62,0,62,28,0.0,0.0
1007,1582,2020-03-19 17:56:00,1,2300.0,1757.0,0.764,11.006,268,173,118,55,95,32,63,30,0.0,0.0
1007,1583,2020-03-19 17:59:00,1,2537.0,1896.0,0.747,12.094,138,42,19,23,96,30,66,3,0.01,0.0
1007,1584,2020-03-19 18:02:00,0,2499.0,2017.0,0.807,12.079,716,413,347,66,303,211,92,34,0.07,0.05
1007,1585,2020-03-19 18:05:00,0,2814.0,2217.0,0.788,13.544,609,298,259,39,311,228,83,45,0.0,0.0
1007,1586,2020-03-19 18:08:00,0,2905.0,2230.0,0.768,13.916,252,112,85,27,140,65,75,26,0.0,0.0
1007,1587,2020-03-19 18:11:00,0,2911.0,2200.0,0.756,13.905,348,190,145,45,158,90,68,39,0.0,0.0
1007,1588,2020-03-19 18:14:00,0,2659.0,2144.0,0.806,12.851,233,102,84,18,131,56,75,10,0.0,0.0
1007,1589,2020-03-19 18:17:00,0,2602.0,1989.0,0.764,12.456,62,1,0,1,61,4,57,0,0.0,0.0
1007,1590,2020-03-19 18:20:00,0,2472.0,1821.0,0.737,11.756,116,3,0,3,113,38,75,0,0.01,0.0
1007,1591,2020-03-19 18:23:00,0,2309.0,1731.0,0.75,11.015,94,2,0,2,92,29,63,0,0.01,0.0
1007,1592,2020-03-19 18:26:00,0,2143.0,1625.0,0.758,10.243,101,10,0,10,91,20,71,0,0.0,0.0
1007,1593,2020-03-19 18:29:00,0,1991.0,1534.0,0.77,9.544,233,53,34,19,180,104,76,4,0.0,0.0
1007,1594,2020-03-19 18:32:00,0,2296.0,1726.0,0.751,10.958,488,261,212,49,227,141,86,24,0.03,0.01
1007,1595,2020-03-19 18:35:00,0,2528.0,1924.0,0.761,12.092,280,116,89,27,164,102,62,28,0.0,0.0
1007,1596,2020-03-19 18:38:00,0,2515.0,1961.0,0.779,12.081,416,214,170,44,202,126,76,26,0.04,0.0
1007,1597,2020-03-19 18:41:00,0,2696.0,1999.0,0.741,12.834,324,105,61,44,219,161,58,5,0.0,0.0
1007,1598,2020-03-19 18:44:00,0,2677.0,2061.0,0.77,12.832,474,190,164,26,284,190,94,36,0.0,0.0
1007,1599,2020-03-19 18:47:00,0,2677.0,2035.0,0.76,12.8,164,49,19,30,115,57,58,22,0.0,0.0
1007,1600,2020-03-19 18:50:00,0,2680.0,2032.0,0.758,12.809,256,91,65,26,165,87,78,6,0.03,0.0
1007,1601,2020-03-19 18:53:00,0,2543.0,1858.0,0.731,12.077,57,3,2,1,54,0,54,0,0.0,0.0
1007,1602,2020-03-19 18:56:00,0,2322.0,1678.0,0.723,11.007,51,0,0,0,51,0,51,0,0.0,0.0
1007,1603,2020-03-19 18:59:00,0,2156.0,1606.0,0.745,10.274,101,41,0,41,60,0,60,0,0.0,0.0
1007,1604,2020-03-19 19:02:00,0,1993.0,1513.0,0.759,9.529,278,130,94,36,148,85,63,9,0.01,0.0
1007,1605,2020-03-19 19:05:00,0,2540.0,1899.0,0.748,12.11,379,138,92,46,241,172,69,22,0.37,0.04
1007,1606,2020-03-19 19:08:00,0,2525.0,1962.0,0.777,12.122,657,231,186,45,426,339,87,38,0.0,0.0
1007,1607,2020-03-19 19:11:00,0,2681.0,2028.0,0.756,12.81,600,199,149,50,401,297,104,45,0.0,0.0
1007,1608,2020-03-19 19:14:00,0,2679.0,2086.0,0.779,12.863,286,122,79,43,164,101,63,44,0.0,0.0
1007,1609,2020-03-19 19:17:00,0,2695.0,2028.0,0.753,12.865,123,42,21,21,81,27,54,15,0.0,0.0
1007,1610,2020-03-19 19:20:00,0,2672.0,2096.0,0.785,12.848,110,56,22,34,54,10,44,6,0.0,0.0
1007,1611,2020-03-19 19:23:00,0,2528.0,1933.0,0.765,12.102,63,9,0,9,54,0,54,0,0.0,0.0
1007,1612,2020-03-19 19:26:00,0,2388.0,1776.0,0.744,11.376,64,2,0,2,62,0,62,0,0.0,0.0
1007,1613,2020-03-19 19:29:00,0,2330.0,1647.0,0.707,11.004,60,2,1,1,58,0,58,0,0.0,0.0
1007,1614,2020-03-19 19:32:00,0,2085.0,1529.0,0.733,9.906,281,133,117,16,148,83,65,18,0.0,0.0
1007,1615,2020-03-19 19:35:00,0,2077.0,1547.0,0.745,9.898,52,3,0,3,49,0,49,0,0.0,0.0
1007,1616,2020-03-19 19:38:00,0,1913.0,1462.0,0.764,9.156,80,10,5,5,70,6,64,0,0.0,0.0
1007,1617,2020-03-19 19:41:00,0,1932.0,1403.0,0.726,9.164,61,3,0,3,58,0,58,0,0.0,0.0
1007,1618,2020-03-19 19:44:00,0,1924.0,1423.0,0.74,9.156,139,58,14,44,81,20,61,14,0.0,0.0
1007,1619,2020-03-19 19:47:00,0,2230.0,1653.0,0.741,10.617,575,133,91,42,442,343,99,22,0.0,0.0
1007,1620,2020-03-19 19:50:00,0,2551.0,1850.0,0.725,12.099,427,119,87,32,308,219,89,22,0.0,0.0
1007,1621,2020-03-19 19:53:00,0,2683.0,2008.0,0.749,12.794,654,275,221,54,379,294,85,53,0.0,0.0
1007,1622,2020-03-19 19:56:00,0,2671.0,2091.0,0.783,12.839,693,305,256,49,388,294,94,44,0.0,0.0
1007,1623,2020-03-19 19:59:00,0,3382.0,2520.0,0.745,16.115,620,307,267,40,313,238,75,44,0.0,0.0
1007,1624,2020-03-19 20:02:00,0,2925.0,2161.0,0.739,13.919,711,310,258,52,401,306,95,66,0.0,0.0
1007,1625,2020-03-19 20:05:00,0,3073.0,2340.0,0.762,14.699,652,325,282,43,327,243,84,76,0.0,0.0
1007,1626,2020-03-19 20:08:00,0,3230.0,2398.5,0.7435,15.383,865,330,278,52,535,425,110,71,0.0,0.0
1007,1627,2020-03-19 20:11:00,0,3387.0,2457.0,0.725,16.067,742,319,270,49,423,328,95,58,0.0,0.0
1007,1628,2020-03-19 20:14:00,0,3239.0,2385.0,0.736,15.401,537,236,194,42,301,228,73,57,0.0,0.0
1007,1629,2020-03-19 20:17:00,0,3320.0,2385.0,0.718,15.723,811,349,286,63,462,362,100,59,0.0,0.01
1007,1630,2020-03-19 20:20:00,0,3405.0,2470.0,0.725,16.15,758,296,222,74,462,360,102,32,0.0,0.01
1007,1631,2020-03-19 20:23:00,0,2764.0,2086.0,0.755,13.201,302,119,79,40,183,129,54,25,0.0,0.0
1007,1632,2020-03-19 20:26:00,0,3002.0,2198.0,0.732,14.262,737,281,244,37,456,372,84,34,0.0,0.0
1007,1633,2020-03-19 20:29:00,0,3253.0,2331.0,0.717,15.397,735,241,189,52,494,397,97,22,0.0,0.0
1007,1634,2020-03-19 20:32:00,0,2995.0,2229.0,0.744,14.267,728,340,279,61,388,299,89,76,0.0,0.0
1007,1635,2020-03-19 20:35:00,0,2764.0,2046.0,0.74,13.158,368,140,106,34,228,162,66,24,0.0,0.0
1007,1636,2020-03-19 20:38:00,0,3172.0,2287.0,0.721,15.03,613,283,230,53,330,251,79,63,0.0,0.0
1007,1637,2020-03-19 20:41:00,0,3423.0,2376.0,0.694,16.116,393,62,27,35,331,240,91,0,0.0,0.0
1007,1638,2020-03-19 20:44:00,0,3177.0,2315.0,0.729,15.081,202,83,36,47,119,58,61,24,0.0,0.0
1007,1639,2020-03-19 20:47:00,0,3175.0,2253.0,0.71,15.004,183,71,29,42,112,45,67,6,0.0,0.0
1007,1640,2020-03-19 20:50:00,0,3018.0,2182.0,0.723,14.307,505,179,132,47,326,243,83,22,0.0,0.0
1007,1641,2020-03-19 20:53:00,0,2768.0,2082.0,0.752,13.213,66,1,0,1,65,0,65,0,0.0,0.0
1007,1642,2020-03-19 20:56:00,0,2631.0,1903.0,0.723,12.473,76,0,0,0,76,0,76,0,0.0,0.0
1007,1643,2020-03-19 20:59:00,0,2476.0,1769.0,0.714,11.716,124,60,30,30,64,4,60,11,0.0,0.0
1007,1644,2020-03-19 21:02:00,0,2646.0,1824.0,0.689,12.444,483,179,126,53,304,232,72,15,0.0,0.0
1007,1645,2020-03-19 21:05:00,0,2474.0,1786.0,0.722,11.727,412,169,130,39,243,176,67,23,0.0,0.0
1007,1646,2020-03-19 21:08:00,0,2469.0,1782.0,0.722,11.701,65,6,2,4,59,2,57,0,0.0,0.0
1007,1647,2020-03-19 21:11:00,0,2413.0,1667.0,0.691,11.352,66,7,1,6,59,0,59,1,0.0,0.0
1007,1648,2020-03-19 21:14:00,0,2404.0,1694.0,0.704,11.348,126,43,23,20,83,11,72,7,0.0,0.0
1007,1649,2020-03-19 21:17:00,0,2397.0,1726.0,0.72,11.355,70,9,4,5,61,0,61,0,0.0,0.0
1007,1650,2020-03-19 21:20:00,0,2238.0,1643.0,0.734,10.638,46,1,1,0,45,0,45,0,0.0,0.0
1007,1651,2020-03-19 21:23:00,0,2082.0,1523.0,0.731,9.891,194,76,69,7,118,58,60,6,0.0,0.0
1007,1652,2020-03-19 21:26:00,0,1994.0,1541.0,0.773,9.561,116,31,27,4,85,16,69,0,0.0,0.0
1007,1653,2020-03-19 21:29:00,0,2015.0,1458.0,0.724,9.552,63,0,0,0,63,0,63,0,0.0,0.0
1007,1654,2020-03-19 21:32:00,0,2027.0,1373.0,0.678,9.507,286,134,101,33,152,80,72,8,0.0,0.0
1007,1655,2020-03-19 21:35:00,0,2082.0,1540.0,0.74,9.908,409,131,96,35,278,191,87,14,0.0,0.0
1007,1656,2020-03-19 21:38:00,0,2470.0,1790.0,0.725,11.715,560,238,190,48,322,237,85,36,0.0,0.0
1007,1657,2020-03-19 21:41:00,0,2753.0,2109.0,0.766,13.18,512,205,161,44,307,228,79,42,0.0,0.0
1007,1658,2020-03-19 21:44:00,0,3181.0,2260.0,0.711,15.036,728,277,242,35,451,361,90,83,0.0,0.0
1007,1659,2020-03-19 21:47:00,0,3020.0,2164.0,0.716,14.295,706,302,249,53,404,318,86,64,0.0,0.0
1007,1660,2020-03-19 21:50:00,0,3163.0,2314.0,0.732,15.026,746,282,238,44,464,360,104,69,0.0,0.0
1007,1661,2020-03-19 21:53:00,0,3158.0,2337.0,0.74,15.031,625,245,176,69,380,289,91,36,0.0,0.0
1007,1662,2020-03-19 21:56:00,0,3011.0,2216.0,0.736,14.319,236,88,49,39,148,105,43,10,0.0,0.0
1007,1663,2020-03-19 21:59:00,0,3028.0,2192.0,0.724,14.356,508,171,124,47,337,265,72,42,0.12,0.0
1007,1664,2020-03-19 22:02:00,0,3159.0,2332.0,0.738,15.028,711,306,257,49,405,313,92,56,0.0,0.0
1007,1665,2020-03-19 22:05:00,0,3010.0,2185.0,0.726,14.279,304,105,68,37,199,142,57,10,0.0,0.0
1007,1666,2020-03-19 22:08:00,0,2852.0,2121.0,0.744,13.587,490,165,118,47,325,246,79,10,0.0,0.0
1007,1667,2020-03-19 22:11:00,0,2775.0,2070.0,0.746,13.226,154,48,28,20,106,50,56,5,0.0,0.0
1007,1668,2020-03-19 22:14:00,0,3012.0,2185.0,0.725,14.287,450,170,143,27,280,208,72,29,0.0,0.0
1007,1669,2020-03-19 22:17:00,0,2776.0,2063.0,0.743,13.221,660,261,200,61,399,299,100,35,0.0,0.0
1007,1670,2020-03-19 22:20:00,0,2768.0,2033.0,0.735,13.158,636,223,160,63,413,315,98,29,0.0,0.0
1007,1671,2020-03-19 22:23:00,0,2786.0,1993.0,0.715,13.185,438,145,88,57,293,199,94,33,0.0,0.0
1007,1672,2020-03-19 22:26:00,0,2763.0,2093.0,0.757,13.202,376,134,92,42,242,175,67,65,0.0,0.0
1007,1673,2020-03-19 22:29:00,0,2777.0,1999.0,0.72,13.155,687,217,165,52,470,383,87,31,0.0,0.0
1007,1674,2020-03-19 22:32:00,0,2761.0,2117.0,0.767,13.223,493,134,97,37,359,280,79,18,0.0,0.0
1007,1675,2020-03-19 22:35:00,0,2792.0,1988.0,0.712,13.202,375,83,47,36,292,214,78,6,0.0,0.0
1007,1676,2020-03-19 22:38:00,0,2709.0,1970.0,0.727,12.855,175,59,32,27,116,49,67,0,0.0,0.0
1007,1677,2020-03-19 22:41:00,0,2614.0,1930.0,0.739,12.435,441,129,86,43,312,225,87,5,0.0,0.0
1007,1678,2020-03-19 22:44:00,0,2635.0,1864.0,0.707,12.448,92,25,9,16,67,0,67,0,0.0,0.0
1007,1679,2020-03-19 22:47:00,0,2639.0,1884.0,0.714,12.485,117,42,17,25,75,8,67,0,0.0,0.0
1007,1680,2020-03-19 22:50:00,0,2644.0,1855.0,0.702,12.472,183,61,19,42,122,56,66,0,0.0,0.0
1007,1681,2020-03-19 22:53:00,0,2388.0,1756.0,0.735,11.353,87,22,0,22,65,0,65,0,0.0,0.0
1007,1682,2020-03-19 22:56:00,0,2329.0,1625.0,0.698,10.975,89,11,0,11,78,14,64,0,0.0,0.0
1007,1683,2020-03-19 22:59:00,0,2081.0,1512.0,0.726,9.875,69,2,0,2,67,4,63,0,0.0,0.0
1007,1684,2020-03-19 23:02:00,0,2024.0,1400.0,0.692,9.524,72,4,0,4,68,3,65,0,0.0,0.0
1007,1685,2020-03-19 23:05:00,0,1867.0,1281.0,0.686,8.774,159,31,6,25,128,41,87,0,0.0,0.0
1007,1686,2020-03-19 23:08:00,0,1987.0,1361.0,0.685,9.3365,354,146,111,35,208,121,87,13,0.0,0.0
1007,1687,2020-03-19 23:11:00,0,2107.0,1441.0,0.684,9.899,97,30,23,7,67,9,58,0,0.0,0.0
1007,1688,2020-03-19 23:14:00,0,2031.0,1362.0,0.67,9.509,135,45,35,10,90,20,70,0,0.0,0.0
1007,1689,2020-03-19 23:17:00,0,1957.0,1285.0,0.657,9.135,111,27,17,10,84,18,66,0,0.0,0.0
1007,1690,2020-03-19 23:20:00,0,1975.0,1247.0,0.631,9.161,142,25,9,16,117,43,74,0,0.0,0.0
1007,1691,2020-03-19 23:23:00,0,1801.0,1228.0,0.682,8.456,64,6,4,2,58,4,54,0,0.0,0.0
1007,1692,2020-03-19 23:26:00,0,1725.0,1132.0,0.656,8.048,135,49,34,15,86,24,62,4,0.0,0.0
1007,1693,2020-03-19 23:29:00,0,1957.0,1320.0,0.675,9.171,449,139,94,45,310,235,75,37,0.0,0.0
1007,1694,2020-03-19 23:32:00,0,2488.0,1714.0,0.689,11.7,506,219,162,57,287,207,80,15,0.0,0.0
1007,1695,2020-03-19 23:35:00,0,2482.0,1746.0,0.703,11.714,323,93,47,46,230,167,63,3,0.0,0.0
1007,1696,2020-03-19 23:38:00,0,2710.0,1927.0,0.711,12.813,429,124,83,41,305,234,71,52,0.0,0.0
1007,1697,2020-03-19 23:41:00,0,2856.0,2087.0,0.731,13.565,598,255,220,35,343,276,67,65,0.0,0.0
1007,1698,2020-03-19 23:44:00,0,2857.0,2084.0,0.729,13.565,527,174,137,37,353,295,58,63,0.0,0.0
1007,1699,2020-03-19 23:47:00,0,3269.0,2268.0,0.694,15.391,916,366,319,47,550,466,84,84,0.0,0.0
1007,1700,2020-03-19 23:50:00,0,3261.0,2279.0,0.699,15.371,426,100,72,28,326,272,54,18,0.0,0.0
1007,1701,2020-03-19 23:53:00,0,3107.0,2177.0,0.701,14.654,268,74,36,38,194,162,32,9,0.0,0.0
1007,1702,2020-03-19 23:56:00,0,2951.0,2101.0,0.712,13.954,392,65,26,39,327,276,51,0,0.0,0.0
1007,1703,2020-03-19 23:59:00,0,2936.0,2093.0,0.713,13.887,324,103,51,52,221,190,31,0,0.0,0.0
1007,1704,2020-03-20 00:02:00,0,2852.0,2088.0,0.732,13.551,199,106,59,47,93,78,15,2,0.0,0.0
1007,1705,2020-03-20 00:05:00,0,2860.0,2074.0,0.725,13.565,252,101,55,46,151,130,21,3,0.0,0.0
1007,1706,2020-03-20 00:08:00,0,2851.0,2090.0,0.733,13.547,272,90,37,53,182,160,22,0,0.0,0.0
1007,1707,2020-03-20 00:11:00,0,2844.0,2152.0,0.757,13.587,384,147,79,68,237,211,26,6,0.0,0.0
1007,1708,2020-03-20 00:14:00,0,2805.0,2253.0,0.803,13.547,602,198,161,37,404,347,57,22,0.23,0.0
1007,1709,2020-03-20 00:17:00,0,2814.0,2242.0,0.797,13.57,327,84,38,46,243,205,38,0,0.0,0.0
1007,1710,2020-03-20 00:20:00,0,2810.0,2254.0,0.802,13.568,384,142,95,47,242,220,22,7,0.0,0.0
1007,1711,2020-03-20 00:23:00,0,2980.0,2293.0,0.77,14.279,421,126,83,43,295,263,32,22,0.0,0.0
1007,1712,2020-03-20 00:26:00,0,2812.0,2255.0,0.802,13.577,687,205,150,55,482,423,59,39,0.0,0.0
1007,1713,2020-03-20 00:29:00,0,2823.0,2255.0,0.799,13.619,280,140,84,56,140,129,11,0,0.0,0.0
1007,1714,2020-03-20 00:32:00,0,2814.0,2206.0,0.784,13.529,277,121,80,41,156,135,21,28,0.0,0.0
1007,1715,2020-03-20 00:35:00,0,2829.0,2183.0,0.772,13.563,162,93,44,49,69,65,4,4,0.0,0.0
1007,1716,2020-03-20 00:38:00,0,2837.0,2150.0,0.758,13.56,9,9,2,7,0,0,0,1,0.0,0.0
1007,1717,2020-03-20 00:41:00,0,2693.0,1959.0,0.727,12.78,13,13,2,11,0,0,0,0,0.0,0.0
1007,1718,2020-03-20 00:44:00,0,2457.0,1876.0,0.764,11.758,64,29,12,17,35,32,3,0,0.0,0.0
1007,1719,2020-03-20 00:47:00,0,2496.0,1736.0,0.695,11.758,3,3,1,2,0,0,0,0,0.0,0.0
1007,1720,2020-03-20 00:50:00,0,2162.0,1604.0,0.742,10.295,30,9,5,4,21,18,3,0,0.0,0.0
1007,1721,2020-03-20 00:53:00,0,2092.0,1513.0,0.723,9.919,0,0,0,0,0,0,0,0,0.0,0.0
1007,1722,2020-03-20 00:56:00,0,2021.0,1416.0,0.7,9.531,10,3,0,3,7,7,0,0,0.0,0.0
1007,1723,2020-03-20 00:59:00,0,1952.0,1330.0,0.681,9.162,179,88,43,45,91,90,1,4,0.0,0.0
1007,1724,2020-03-20 01:02:00,0,2096.0,1465.0,0.699,9.878,477,178,125,53,299,270,29,21,0.0,0.0
1007,1725,2020-03-20 01:05:00,0,2079.0,1553.0,0.747,9.91,320,199,141,58,121,109,12,11,0.0,0.0
1007,1726,2020-03-20 01:08:00,0,2239.0,1609.0,0.719,10.604,318,125,80,45,193,173,20,11,0.0,0.0
1007,1727,2020-03-20 01:11:00,0,2493.0,1714.0,0.687,11.72,427,146,117,29,281,234,47,14,0.0,0.0
1007,1728,2020-03-20 01:14:00,0,2331.0,1669.0,0.716,11.033,388,93,44,49,295,243,52,0,0.0,0.0
1007,1729,2020-03-20 01:17:00,0,2495.0,1706.0,0.684,11.718,319,117,75,42,202,174,28,23,0.0,0.0
1007,1730,2020-03-20 01:20:00,0,2851.0,2092.0,0.734,13.55,137,58,39,19,79,65,14,21,0.0,0.0
1007,1731,2020-03-20 01:23:00,0,2772.0,2037.0,0.735,13.178,667,209,161,48,458,402,56,51,0.0,0.05
1007,1732,2020-03-20 01:26:00,0,2473.0,1793.0,0.725,11.729,380,111,72,39,269,238,31,10,0.0,0.0
1007,1733,2020-03-20 01:29:00,0,2706.0,1959.0,0.724,12.83,332,116,82,34,216,187,29,33,0.0,0.0
1007,1734,2020-03-20 01:32:00,0,2711.0,1971.0,0.727,12.864,363,112,61,51,251,206,45,0,0.0,0.0
1007,1735,2020-03-20 01:35:00,0,2711.0,1913.0,0.706,12.798,389,137,86,51,252,223,29,5,0.0,0.0
1007,1736,2020-03-20 01:38:00,0,2706.0,1970.0,0.728,12.843,411,162,121,41,249,226,23,16,0.0,0.0
1007,1737,2020-03-20 01:41:00,0,2705.0,1958.0,0.724,12.825,791,230,181,49,561,491,70,43,0.0,0.0
1007,1738,2020-03-20 01:44:00,0,2712.0,1919.0,0.708,12.809,394,122,79,43,272,241,31,27,0.0,0.0
1007,1739,2020-03-20 01:47:00,0,2716.0,1899.0,0.699,12.803,26,20,12,8,6,4,2,0,0.0,0.0
1007,1740,2020-03-20 01:50:00,0,2554.0,1817.0,0.712,12.075,16,12,0,12,4,1,3,0,0.0,0.0
1007,1741,2020-03-20 01:53:00,0,2415.0,1666.0,0.69,11.361,9,7,4,3,2,0,2,0,0.0,0.0
1007,1742,2020-03-20 01:56:00,0,2168.0,1539.0,0.71,10.245,15,15,6,9,0,0,0,0,0.0,0.0
1007,1743,2020-03-20 01:59:00,0,2103.0,1455.0,0.692,9.899,28,8,2,6,20,16,4,0,0.0,0.0
1007,1744,2020-03-20 02:02:00,0,1941.0,1358.0,0.699,9.152,93,4,2,2,89,80,9,0,0.0,0.0
1007,1745,2020-03-20 02:05:00,0,1966.0,1254.0,0.638,9.135,52,30,18,12,22,18,4,0,0.0,0.0
1007,1746,2020-03-20 02:08:00,0,1840.0,1214.0,0.6615,8.593,12,11,5,6,1,0,1,0,0.0,0.0
1007,1747,2020-03-20 02:11:00,0,1714.0,1174.0,0.685,8.051,10,4,0,4,6,2,4,0,0.0,0.0
1007,1748,2020-03-20 02:14:00,0,1549.0,1109.0,0.716,7.332,1,1,1,0,0,0,0,0,0.0,0.0
1007,1749,2020-03-20 02:17:00,0,1555.0,1097.0,0.705,7.341,221,70,33,37,151,135,16,1,0.0,0.0
1007,1750,2020-03-20 02:20:00,0,1928.0,1388.0,0.72,9.134,284,133,105,28,151,130,21,19,0.0,0.0
1007,1751,2020-03-20 02:23:00,0,1938.0,1380.0,0.712,9.162,196,65,29,36,131,114,17,35,0.0,0.0
1007,1752,2020-03-20 02:26:00,0,2867.0,2054.0,0.716,13.571,463,178,146,32,285,240,45,45,0.0,0.0
1007,1753,2020-03-20 02:29:00,0,2853.0,2102.0,0.737,13.568,492,172,132,40,320,282,38,33,0.0,0.0
1007,1754,2020-03-20 02:32:00,0,2709.0,1968.0,0.727,12.853,502,198,162,36,304,257,47,39,0.0,0.0
1007,1755,2020-03-20 02:35:00,0,2725.0,1881.0,0.69,12.819,432,193,151,42,239,211,28,22,0.0,0.0
1007,1756,2020-03-20 02:38:00,0,2719.0,1922.0,0.707,12.841,45,31,16,15,14,6,8,6,0.0,0.0
1007,1757,2020-03-20 02:41:00,0,2736.0,1855.0,0.678,12.835,116,60,36,24,56,48,8,5,0.0,0.0
1007,1758,2020-03-20 02:44:00,0,2473.0,1791.0,0.724,11.725,133,27,20,7,106,90,16,0,0.0,0.0
1007,1759,2020-03-20 02:47:00,0,2504.0,1681.0,0.671,11.728,49,4,1,3,45,34,11,0,0.0,0.0
1007,1760,2020-03-20 02:50:00,0,2169.0,1543.0,0.711,10.256,6,1,0,1,5,0,5,0,0.0,0.0
1007,1761,2020-03-20 02:53:00,0,2103.0,1422.0,0.676,9.861,5,1,0,1,4,0,4,0,0.0,0.0
1007,1762,2020-03-20 02:56:00,0,1943.0,1340.0,0.689,9.139,20,12,2,10,8,0,8,0,0.0,0.0
1007,1763,2020-03-20 02:59:00,0,1970.0,1262.0,0.641,9.161,7,0,0,0,7,0,7,0,0.0,0.0
1007,1764,2020-03-20 03:02:00,0,1711.0,1179.0,0.689,8.048,17,10,0,10,7,0,7,0,0.0,0.0
1007,1765,2020-03-20 03:05:00,0,1547.0,1116.0,0.721,7.331,13,8,0,8,5,0,5,0,0.0,0.0
1007,1766,2020-03-20 03:08:00,0,1546.0,1122.0,0.726,7.332,92,36,19,17,56,43,13,2,0.0,0.0
1007,1767,2020-03-20 03:11:00,0,1861.0,1299.0,0.698,8.772,325,159,110,49,166,135,31,24,0.0,0.0
1007,1768,2020-03-20 03:14:00,0,2102.0,1482.0,0.705,9.924,297,138,112,26,159,138,21,21,0.0,0.0
1007,1769,2020-03-20 03:17:00,0,2098.0,1463.0,0.697,9.888,415,151,118,33,264,218,46,46,0.0,0.0
1007,1770,2020-03-20 03:20:00,0,2077.0,1538.0,0.741,9.887,499,131,83,48,368,313,55,11,0.0,0.0
1007,1771,2020-03-20 03:23:00,0,2164.0,1564.0,0.723,10.258,75,22,7,15,53,44,9,6,0.0,0.0
1007,1772,2020-03-20 03:26:00,0,2339.0,1591.0,0.68,10.979,159,66,19,47,93,79,14,9,0.0,0.0
1007,1773,2020-03-20 03:29:00,0,2167.0,1564.0,0.721,10.27,32,30,0,30,2,0,2,0,0.0,0.0
1007,1774,2020-03-20 03:32:00,0,2106.0,1447.0,0.687,9.899,15,13,0,13,2,0,2,0,0.0,0.0
1007,1775,2020-03-20 03:35:00,0,1937.0,1342.0,0.693,9.12,12,9,1,8,3,0,3,0,0.0,0.0
1007,1776,2020-03-20 03:38:00,0,1973.0,1253.0,0.635,9.162,91,32,21,11,59,50,9,0,0.0,0.0
1007,1777,2020-03-20 03:41:00,0,2088.0,1529.0,0.732,9.918,218,91,73,18,127,107,20,6,0.0,0.0
1007,1778,2020-03-20 03:44:00,0,2711.0,1902.0,0.702,12.789,204,71,45,26,133,102,31,18,0.0,0.0
1007,1779,2020-03-20 03:47:00,0,2330.0,1617.0,0.694,10.972,394,205,164,41,189,154,35,27,0.0,0.0
1007,1780,2020-03-20 03:50:00,0,2338.0,1594.0,0.682,10.979,427,117,80,37,310,254,56,45,0.0,0.0
1007,1781,2020-03-20 03:53:00,0,2326.0,1643.0,0.706,10.982,557,184,139,45,373,318,55,15,0.0,0.0
1007,1782,2020-03-20 03:56:00,0,2326.0,1644.0,0.707,10.984,367,161,107,54,206,182,24,24,0.0,0.0
1007,1783,2020-03-20 03:59:00,0,2323.0,1642.0,0.707,10.972,97,54,28,26,43,35,8,1,0.0,0.0
1007,1784,2020-03-20 04:02:00,0,2348.0,1593.0,0.678,11.016,35,16,5,11,19,10,9,0,0.0,0.0
1007,1785,2020-03-20 04:05:00,0,2091.0,1473.0,0.704,9.871,5,0,0,0,5,0,5,0,0.0,0.0
1007,1786,2020-03-20 04:08:00,0,2020.0,1370.0,0.678,9.477,7,1,0,1,6,0,6,0,0.0,0.0
1007,1787,2020-03-20 04:11:00,0,1956.0,1300.0,0.664,9.146,2,0,0,0,2,0,2,0,0.0,0.0
1007,1788,2020-03-20 04:14:00,0,1798.0,1209.0,0.673,8.424,13,9,2,7,4,0,4,0,0.0,0.0
1007,1789,2020-03-20 04:17:00,0,1714.0,1182.0,0.689,8.064,9,3,2,1,6,0,6,0,0.0,0.0
1007,1790,2020-03-20 04:20:00,0,1547.0,1118.0,0.723,7.332,9,2,0,2,7,0,7,0,0.0,0.0
1007,1791,2020-03-20 04:23:00,0,1559.0,1074.0,0.689,7.33,4,0,0,0,4,0,4,0,0.0,0.0
1007,1792,2020-03-20 04:26:00,0,1474.0,1017.0,0.689,6.935,6,0,0,0,6,0,6,0,0.0,0.0
1007,1793,2020-03-20 04:29:00,0,1316.0,951.0,0.723,6.238,11,2,0,2,9,0,9,0,0.0,0.0
1007,1794,2020-03-20 04:32:00,0,1561.0,1060.0,0.68,7.323,151,51,19,32,100,85,15,19,0.0,0.0
1007,1795,2020-03-20 04:35:00,0,1942.0,1371.0,0.706,9.17,71,60,33,27,11,8,3,10,0.0,0.0
1007,1796,2020-03-20 04:38:00,0,2080.0,1542.0,0.741,9.901,410,180,143,37,230,198,32,40,0.0,0.0
1007,1797,2020-03-20 04:41:00,0,2331.0,1615.0,0.693,10.974,420,119,78,41,301,257,44,7,0.0,0.0
1007,1798,2020-03-20 04:44:00,0,2324.0,1643.0,0.707,10.976,341,91,51,40,250,206,44,21,0.0,0.0
1007,1799,2020-03-20 04:47:00,0,2322.0,1642.0,0.707,10.966,314,172,123,49,142,120,22,49,0.0,0.0
1007,1800,2020-03-20 04:50:00,0,2324.0,1673.0,0.72,11.008,252,115,90,25,137,117,20,36,0.0,0.0
1007,1801,2020-03-20 04:53:00,0,2334.0,1629.0,0.698,10.998,428,114,82,32,314,274,40,3,0.0,0.0
1007,1802,2020-03-20 04:56:00,0,2326.0,1627.0,0.699,10.968,262,36,20,16,226,209,17,8,0.0,0.0
1007,1803,2020-03-20 04:59:00,0,2339.0,1620.0,0.693,11.009,63,27,12,15,36,34,2,1,0.0,0.0
1007,1804,2020-03-20 05:02:00,0,2166.0,1557.0,0.718,10.259,46,46,1,45,0,0,0,0,0.0,0.0
1007,1805,2020-03-20 05:05:00,0,2107.0,1443.0,0.685,9.899,3,1,0,1,2,0,2,0,0.0,0.0
1007,1806,2020-03-20 05:08:00,0,2035.5,1346.0,0.6605,9.51,1,0,0,0,1,0,1,0,0.0,0.0
1007,1807,2020-03-20 05:11:00,0,1964.0,1249.0,0.636,9.121,3,1,0,1,2,0,2,0,0.0,0.0
1007,1808,2020-03-20 05:14:00,0,1712.0,1191.0,0.696,8.064,0,0,0,0,0,0,0,0,0.0,0.0
1007,1809,2020-03-20 05:17:00,0,1626.0,1150.0,0.707,7.681,133,80,54,26,53,50,3,0,0.0,0.0
1007,1810,2020-03-20 05:20:00,0,1539.0,1134.0,0.737,7.319,20,20,2,18,0,0,0,0,0.0,0.0
1007,1811,2020-03-20 05:23:00,0,1554.0,1081.0,0.696,7.319,15,15,3,12,0,0,0,0,0.0,0.0
1007,1812,2020-03-20 05:26:00,0,1389.0,1027.0,0.739,6.611,82,50,12,38,32,27,5,0,0.0,0.0
1007,1813,2020-03-20 05:29:00,0,1477.0,1045.0,0.707,6.978,53,30,15,15,23,20,3,0,0.0,0.0
1007,1814,2020-03-20 05:32:00,0,1553.0,1087.0,0.7,7.322,19,18,10,8,1,0,1,0,0.0,0.0
1007,1815,2020-03-20 05:35:00,0,1474.0,1034.0,0.701,6.954,2,1,0,1,1,0,1,0,0.0,0.0
1007,1816,2020-03-20 05:38:00,0,1307.0,986.0,0.755,6.24,9,8,2,6,1,0,1,0,0.0,0.0
1007,1817,2020-03-20 05:41:00,0,1322.0,930.0,0.704,6.238,7,6,0,6,1,0,1,0,0.0,0.0
1007,1818,2020-03-20 05:44:00,0,1325.0,919.0,0.694,6.237,2,2,0,2,0,0,0,0,0.0,0.0
1007,1819,2020-03-20 05:47:00,0,1237.0,885.0,0.716,5.856,11,7,0,7,4,4,0,0,0.0,0.0
1007,1820,2020-03-20 05:50:00,0,1327.0,892.0,0.672,6.217,33,6,2,4,27,23,4,0,0.0,0.0
1007,1821,2020-03-20 05:53:00,0,1300.0,1015.0,0.781,6.245,27,24,8,16,3,2,1,0,0.0,0.0
1007,1822,2020-03-20 05:56:00,0,1552.0,1092.0,0.703,7.326,6,5,1,4,1,0,1,0,0.0,0.0
1007,1823,2020-03-20 05:59:00,0,1551.0,1086.0,0.7,7.316,4,1,1,0,3,0,3,0,0.0,0.0
1007,1824,2020-03-20 06:02:00,1,1554.0,1100.0,0.708,7.343,1,0,0,0,1,0,1,0,0.0,0.0
1007,1825,2020-03-20 06:05:00,1,1556.0,1089.0,0.7,7.335,1,0,0,0,1,0,1,0,0.0,0.0
1007,1826,2020-03-20 06:08:00,1,1297.0,1023.0,0.789,6.244,11,11,3,8,0,0,0,0,0.0,0.0
1007,1827,2020-03-20 06:11:00,1,1314.0,970.0,0.738,6.253,1,1,0,1,0,0,0,0,0.0,0.0
1007,1828,2020-03-20 06:14:00,1,1321.0,916.0,0.694,6.218,15,6,0,6,9,6,3,0,0.0,0.0
1007,1829,2020-03-20 06:17:00,1,1314.0,936.0,0.712,6.215,73,52,27,25,21,16,5,0,0.0,0.0
1007,1830,2020-03-20 06:20:00,1,1713.0,1175.0,0.686,8.05,268,87,42,45,181,162,19,23,0.0,0.0
1007,1831,2020-03-20 06:23:00,1,2332.0,1654.0,0.709,11.019,137,97,69,28,40,35,5,33,0.0,0.0
1007,1832,2020-03-20 06:26:00,1,2857.0,2090.0,0.732,13.569,319,128,90,38,191,172,19,76,0.0,0.0
1007,1833,2020-03-20 06:29:00,1,2862.0,2068.0,0.723,13.565,255,84,49,35,171,157,14,66,0.0,0.0
1007,1834,2020-03-20 06:32:00,1,3093.0,2248.0,0.727,14.675,346,107,64,43,239,218,21,79,0.0,0.0
1007,1835,2020-03-20 06:35:00,1,2852.0,2084.0,0.73,13.546,398,168,116,52,230,212,18,78,0.0,0.0
1007,1836,2020-03-20 06:38:00,1,3090.0,2252.0,0.729,14.666,293,119,71,48,174,160,14,68,0.0,0.13
1007,1837,2020-03-20 06:41:00,1,3075.0,2306.0,0.75,14.671,301,114,73,41,187,170,17,87,0.0,0.14
1007,1838,2020-03-20 06:44:00,1,3229.0,2490.0,0.771,15.48,371,144,86,58,227,212,15,117,0.0,0.16
1007,1839,2020-03-20 06:47:00,1,3415.0,2717.0,0.795,16.463,375,96,55,41,279,257,22,62,0.0,0.1
1007,1840,2020-03-20 06:50:00,1,2789.0,2302.0,0.825,13.535,483,215,162,53,268,231,37,35,0.0,0.0
1007,1841,2020-03-20 06:53:00,1,3174.0,2630.0,0.829,15.418,483,174,119,55,309,289,20,102,0.0,0.12
1007,1842,2020-03-20 06:56:00,1,3399.0,2806.0,0.826,16.497,376,125,76,49,251,232,19,21,0.41,0.0
1007,1843,2020-03-20 06:59:00,1,2582.0,2063.0,0.799,12.459,332,154,85,69,178,164,14,80,0.0,0.01
1007,1844,2020-03-20 07:02:00,1,3385.0,2884.0,0.852,16.528,286,137,78,59,149,133,16,81,0.0,0.11
1007,1845,2020-03-20 07:05:00,1,3090.0,2608.0,0.844,15.064,234,62,31,31,172,155,17,1,0.0,0.08
1007,1846,2020-03-20 07:08:00,1,3317.0,2797.0,0.843,16.165,366,130,91,39,236,207,29,37,0.24,0.0
1007,1847,2020-03-20 07:11:00,1,2998.0,2599.0,0.867,14.69,491,140,91,49,351,330,21,76,0.04,0.04
1007,1848,2020-03-20 07:14:00,1,2046.0,1664.0,0.813,9.902,214,205,139,66,9,7,2,45,0.0,0.0
1007,1849,2020-03-20 07:17:00,1,3003.0,2539.0,0.846,14.642,490,238,170,68,252,224,28,60,0.0,0.02
1007,1850,2020-03-20 07:20:00,1,2179.0,1856.0,0.851,10.642,401,130,91,39,271,248,23,13,0.0,0.0
1007,1851,2020-03-20 07:23:00,1,2629.0,2237.0,0.851,12.834,393,94,52,42,299,270,29,0,0.0,0.0
1007,1852,2020-03-20 07:26:00,1,3356.0,2993.0,0.892,16.535,458,158,98,60,300,268,32,82,0.0,0.02
1007,1853,2020-03-20 07:29:00,1,3507.0,3134.0,0.894,17.288,330,101,50,51,229,212,17,32,0.0,0.08
1007,1854,2020-03-20 07:32:00,1,3358.0,2949.0,0.878,16.494,402,121,92,29,281,249,32,16,0.0,0.0
1007,1855,2020-03-20 07:35:00,1,2026.0,1733.0,0.855,9.901,59,24,14,10,35,33,2,0,0.0,0.0
1007,1856,2020-03-20 07:38:00,1,2426.0,1980.0,0.816,11.753,240,52,5,47,188,172,16,0,0.0,0.0
1007,1857,2020-03-20 07:41:00,1,2767.0,2408.0,0.87,13.568,218,78,16,62,140,124,16,3,0.0,0.0
1007,1858,2020-03-20 07:44:00,1,3286.0,2873.0,0.874,16.128,104,61,13,48,43,40,3,1,0.0,0.0
1007,1859,2020-03-20 07:47:00,1,3342.0,3048.0,0.912,16.54,104,32,2,30,72,61,11,1,0.0,0.0
1007,1860,2020-03-20 07:50:00,1,3482.0,3202.0,0.92,17.263,376,48,10,38,328,295,33,2,0.0,0.0
1007,1861,2020-03-20 07:53:00,1,3352.0,3040.0,0.907,16.572,58,20,11,9,38,34,4,0,0.0,0.0
1007,1862,2020-03-20 07:56:00,1,3036.0,2746.0,0.905,15.002,3,1,0,1,2,2,0,0,0.0,0.0
1007,1863,2020-03-20 07:59:00,1,2751.0,2465.0,0.896,13.566,76,4,0,4,72,62,10,0,0.0,0.0
1007,1864,2020-03-20 08:02:00,1,2606.0,2322.0,0.891,12.838,1,0,0,0,1,0,1,0,0.0,0.0
1007,1865,2020-03-20 08:05:00,1,2367.0,2194.0,0.927,11.753,0,0,0,0,0,0,0,0,0.0,0.0
1007,1866,2020-03-20 08:08:00,1,2180.5,2025.0,0.9285,10.8325,3,0,0,0,3,2,1,0,0.0,0.0
1007,1867,2020-03-20 08:11:00,1,1994.0,1856.0,0.93,9.912,2,2,0,2,0,0,0,0,0.0,0.0
1007,1868,2020-03-20 08:14:00,1,1997.0,1855.0,0.929,9.922,40,20,9,11,20,20,0,1,0.0,0.0
1007,1869,2020-03-20 08:17:00,1,2232.0,2014.0,0.902,11.025,249,91,53,38,158,143,15,21,0.0,0.0
1007,1870,2020-03-20 08:20:00,1,2628.0,2287.0,0.87,12.886,293,135,78,57,158,145,13,80,0.0,0.05
1007,1871,2020-03-20 08:23:00,1,2744.0,2531.0,0.923,13.613,291,83,45,38,208,185,23,66,0.0,0.13
1007,1872,2020-03-20 08:26:00,1,2971.0,2677.0,0.901,14.671,302,104,64,40,198,180,18,41,0.13,0.09
1007,1873,2020-03-20 08:29:00,1,2367.0,2190.0,0.926,11.75,143,53,12,41,90,77,13,0,0.0,0.0
1007,1874,2020-03-20 08:32:00,1,2587.0,2385.0,0.922,12.834,55,10,4,6,45,40,5,0,0.0,0.0
1007,1875,2020-03-20 08:35:00,1,2453.0,2202.0,0.898,12.104,33,17,9,8,16,16,0,1,0.0,0.0
1007,1876,2020-03-20 08:38:00,1,2628.0,2257.0,0.859,12.851,3,3,0,3,0,0,0,0,0.0,0.0
1007,1877,2020-03-20 08:41:00,1,2600.0,2317.0,0.891,12.811,0,0,0,0,0,0,0,0,0.0,0.0
1007,1878,2020-03-20 08:44:00,1,2613.0,2295.0,0.878,12.836,25,10,0,10,15,14,1,0,0.0,0.0
1007,1879,2020-03-20 08:47:00,1,2617.0,2293.0,0.876,12.85,106,23,6,17,83,77,6,0,0.0,0.0
1007,1880,2020-03-20 08:50:00,1,2588.0,2357.0,0.911,12.807,302,109,68,41,193,181,12,16,0.0,0.03
1007,1881,2020-03-20 08:53:00,1,2657.0,2466.0,0.928,13.201,307,105,59,46,202,195,7,60,0.0,0.13
1007,1882,2020-03-20 08:56:00,1,2525.0,2290.0,0.907,12.485,116,33,27,6,83,74,9,0,0.0,0.0
1007,1883,2020-03-20 08:59:00,1,2375.0,2197.0,0.925,11.788,1,0,0,0,1,0,1,0,0.0,0.01
1007,1884,2020-03-20 09:02:00,1,2443.0,2272.0,0.93,12.143,69,52,23,29,17,15,2,0,0.0,0.0
1007,1885,2020-03-20 09:05:00,1,2595.0,2374.0,0.915,12.852,71,71,21,50,0,0,0,0,0.0,0.0
1007,1886,2020-03-20 09:08:00,1,2343.0,2272.0,0.97,11.746,20,20,4,16,0,0,0,0,0.0,0.0
1007,1887,2020-03-20 09:11:00,1,2347.0,2220.0,0.946,11.704,3,3,2,1,0,0,0,0,0.0,0.0
1007,1888,2020-03-20 09:14:00,1,2379.0,2125.0,0.893,11.724,129,66,43,23,63,59,4,19,0.0,0.03
1007,1889,2020-03-20 09:17:00,1,2601.0,2380.0,0.915,12.884,395,67,30,37,328,305,23,42,0.0,0.18
1007,1890,2020-03-20 09:20:00,1,2740.0,2513.0,0.917,13.578,307,110,61,49,197,186,11,72,0.0,0.0
1007,1891,2020-03-20 09:23:00,1,2721.0,2626.0,0.965,13.626,206,47,25,22,159,148,11,26,0.0,0.07
1007,1892,2020-03-20 09:26:00,1,2229.0,2020.0,0.906,11.019,444,153,115,38,291,258,33,9,0.2,0.01
1007,1893,2020-03-20 09:29:00,1,2597.0,2365.0,0.911,12.85,879,365,284,81,514,464,50,20,0.0,0.02
1007,1894,2020-03-20 09:32:00,1,2350.0,2188.0,0.931,11.68,528,177,126,51,351,309,42,11,0.0,0.0
1007,1895,2020-03-20 09:35:00,1,2622.0,2248.0,0.857,12.82,595,224,172,52,371,342,29,42,0.0,0.06
1007,1896,2020-03-20 09:38:00,1,2951.0,2794.0,0.947,14.719,755,282,215,67,473,427,46,23,0.0,0.06
1007,1897,2020-03-20 09:41:00,1,2617.0,2298.0,0.878,12.853,102,28,10,18,74,68,6,14,0.0,0.0
1007,1898,2020-03-20 09:44:00,1,2723.0,2597.0,0.954,13.602,45,44,18,26,1,0,1,1,0.0,0.0
1007,1899,2020-03-20 09:47:00,1,3116.0,2833.0,0.909,15.411,28,28,7,21,0,0,0,1,0.0,0.0
1007,1900,2020-03-20 09:50:00,1,2698.0,2636.0,0.977,13.547,1,0,0,0,1,0,1,0,0.0,0.0
1007,1901,2020-03-20 09:53:00,1,2578.0,2445.0,0.949,12.864,7,7,2,5,0,0,0,0,0.0,0.0
1007,1902,2020-03-20 09:56:00,1,2613.0,2309.0,0.884,12.851,13,11,4,7,2,2,0,0,0.0,0.0
1007,1903,2020-03-20 09:59:00,1,2378.0,2163.0,0.91,11.763,4,2,0,2,2,2,0,0,0.0,0.0
1007,1904,2020-03-20 10:02:00,1,2232.0,2017.0,0.904,11.027,5,2,0,2,3,2,1,0,0.0,0.0
1007,1905,2020-03-20 10:05:00,1,1986.0,1907.0,0.96,9.937,4,4,0,4,0,0,0,0,0.0,0.0
1007,1906,2020-03-20 10:08:00,1,2016.0,1782.0,0.884,9.915,13,13,4,9,0,0,0,7,0.0,0.0
1007,1907,2020-03-20 10:11:00,1,1987.0,1898.0,0.955,9.931,147,137,71,66,10,8,2,52,0.0,0.0
1007,1908,2020-03-20 10:14:00,1,2221.0,2023.0,0.911,10.99,74,66,26,40,8,6,2,20,0.0,0.0
1007,1909,2020-03-20 10:17:00,1,2365.0,2188.0,0.925,11.743,62,60,31,29,2,0,2,12,0.0,0.0
1007,1910,2020-03-20 10:20:00,1,2213.0,2067.0,0.934,11.009,15,14,9,5,1,0,1,1,0.0,0.0
1007,1911,2020-03-20 10:23:00,1,2052.0,1981.0,0.965,10.278,3,0,0,0,3,0,3,0,0.0,0.0
1007,1912,2020-03-20 10:26:00,1,1989.0,1852.0,0.931,9.888,25,18,2,16,7,6,1,0,0.0,0.0
1007,1913,2020-03-20 10:29:00,1,1999.0,1824.0,0.912,9.897,9,3,0,3,6,4,2,0,0.0,0.0
1007,1914,2020-03-20 10:32:00,1,2011.0,1777.0,0.884,9.891,2,1,0,1,1,0,1,0,0.0,0.0
1007,1915,2020-03-20 10:35:00,1,1853.0,1681.0,0.907,9.163,45,17,15,2,28,23,5,0,0.0,0.0
1007,1916,2020-03-20 10:38:00,1,1858.0,1707.0,0.918,9.21,2,0,0,0,2,0,2,0,0.0,0.0
1007,1917,2020-03-20 10:41:00,1,1860.0,1652.0,0.888,9.157,1,1,1,0,0,0,0,0,0.0,0.0
1007,1918,2020-03-20 10:44:00,1,1869.0,1632.0,0.873,9.171,7,5,1,4,2,0,2,0,0.0,0.0
1007,1919,2020-03-20 10:47:00,1,1868.0,1632.0,0.874,9.165,8,0,0,0,8,6,2,0,0.0,0.0
1007,1920,2020-03-20 10:50:00,1,1850.0,1698.0,0.918,9.167,1,1,1,0,0,0,0,0,0.0,0.0
1007,1921,2020-03-20 10:53:00,1,1932.0,1733.0,0.897,9.532,10,0,0,0,10,8,2,0,0.0,0.0
1007,1922,2020-03-20 10:56:00,1,1853.0,1694.0,0.914,9.178,17,9,6,3,8,6,2,0,0.0,0.0
1007,1923,2020-03-20 10:59:00,1,2016.0,1789.0,0.888,9.924,27,15,5,10,12,10,2,0,0.0,0.0
1007,1924,2020-03-20 11:02:00,1,2012.0,1822.0,0.905,9.945,102,90,48,42,12,11,1,32,0.0,0.0
1007,1925,2020-03-20 11:05:00,1,2221.0,2032.0,0.915,11.002,190,80,42,38,110,96,14,54,0.0,0.04
1007,1926,2020-03-20 11:08:00,1,2367.0,2190.5,0.925,11.753,284,148,97,51,136,123,13,68,0.0,0.08
1007,1927,2020-03-20 11:11:00,1,2513.0,2349.0,0.935,12.504,439,148,102,46,291,259,32,21,0.08,0.0
1007,1928,2020-03-20 11:14:00,1,2519.0,2311.0,0.917,12.484,75,20,5,15,55,45,10,0,0.0,0.01
1007,1929,2020-03-20 11:17:00,1,2360.0,2229.0,0.944,11.768,36,6,2,4,30,25,5,0,0.0,0.0
1007,1930,2020-03-20 11:20:00,1,2201.0,2118.0,0.962,11.019,13,5,2,3,8,6,2,0,0.0,0.0
1007,1931,2020-03-20 11:23:00,1,2216.0,2111.0,0.952,11.069,20,7,4,3,13,12,1,0,0.0,0.0
1007,1932,2020-03-20 11:26:00,1,2229.0,2019.0,0.906,11.015,21,0,0,0,21,19,2,0,0.0,0.0
1007,1933,2020-03-20 11:29:00,1,1972.0,1934.0,0.981,9.912,10,2,1,1,8,6,2,0,0.0,0.0
1007,1934,2020-03-20 11:32:00,1,1985.0,1864.0,0.939,9.885,1,1,1,0,0,0,0,0,0.0,0.0
1007,1935,2020-03-20 11:35:00,1,2010.0,1810.0,0.9,9.924,27,13,6,7,14,9,5,0,0.0,0.0
1007,1936,2020-03-20 11:38:00,1,1837.0,1751.0,0.953,9.177,2,0,0,0,2,0,2,0,0.0,0.0
1007,1937,2020-03-20 11:41:00,1,1856.0,1681.0,0.906,9.173,2,0,0,0,2,0,2,0,0.0,0.0
1007,1938,2020-03-20 11:44:00,1,2011.0,1767.0,0.879,9.879,111,38,9,29,73,62,11,12,0.0,0.0
1007,1939,2020-03-20 11:47:00,1,2223.0,2040.0,0.918,11.017,357,162,93,69,195,169,26,71,0.0,0.0
1007,1940,2020-03-20 11:50:00,1,2348.0,2282.0,0.972,11.779,382,103,55,48,279,243,36,42,0.0,0.16
1007,1941,2020-03-20 11:53:00,1,2342.0,2279.0,0.973,11.749,224,64,44,20,160,141,19,2,0.0,0.0
1007,1942,2020-03-20 11:56:00,1,2590.0,2412.0,0.931,12.875,319,153,95,58,166,144,22,50,0.0,0.0
1007,1943,2020-03-20 11:59:00,1,2646.0,2528.0,0.955,13.225,316,122,69,53,194,161,33,43,0.0,0.0
1007,1944,2020-03-20 12:02:00,1,2511.0,2340.0,0.932,12.484,40,37,12,25,3,0,3,5,0.0,0.0
1007,1945,2020-03-20 12:05:00,1,2215.0,2083.0,0.94,11.032,22,19,8,11,3,0,3,0,0.0,0.0
1007,1946,2020-03-20 12:08:00,1,2291.0,2122.0,0.926,11.377,21,19,10,9,2,0,2,2,0.0,0.0
1008,1,2020-03-16 10:53:00,1,4242.0,2519.0,0.594,19.503,300,177,124,53,123,90,33,6,0.0,0.0
1008,2,2020-03-16 10:56:00,1,3475.0,2116.0,0.609,16.035,49,16,5,11,33,14,19,0,0.0,0.01
1008,3,2020-03-16 10:59:00,1,3167.0,1877.0,0.593,14.559,187,82,53,29,105,70,35,0,0.0,0.0
1008,4,2020-03-16 11:02:00,1,3153.0,1865.0,0.592,14.49,44,18,4,14,26,13,13,0,0.0,0.0
1008,5,2020-03-16 11:05:00,1,2818.0,1725.0,0.612,13.015,39,12,1,11,27,8,19,0,0.0,0.0
1008,6,2020-03-16 11:08:00,1,2592.0,1657.0,0.639,12.046,54,50,8,42,4,1,3,0,0.0,0.0
1008,7,2020-03-16 11:11:00,1,2588.5,1655.5,0.6395,12.031,33,24,8,16,9,1,8,0,0.0,0.01
1008,8,2020-03-16 11:14:00,1,2585.0,1654.0,0.64,12.016,195,84,55,29,111,78,33,10,0.0,0.0
1008,9,2020-03-16 11:17:00,1,2571.0,1685.0,0.655,11.995,66,33,18,15,33,12,21,0,0.03,0.02
1008,10,2020-03-16 11:20:00,1,2865.0,2056.0,0.718,13.566,8,3,2,1,5,2,3,0,0.0,0.0
1008,11,2020-03-16 11:23:00,1,2218.0,1645.0,0.742,10.559,17,8,0,8,9,0,9,0,0.0,0.0
1008,12,2020-03-16 11:26:00,1,2224.0,1595.0,0.718,10.527,137,42,26,16,95,57,38,4,0.0,0.0
1008,13,2020-03-16 11:29:00,1,1909.0,1351.0,0.708,9.016,47,6,2,4,41,0,41,0,0.0,0.0
1008,14,2020-03-16 11:32:00,1,1907.0,1359.0,0.713,9.02,46,31,3,28,15,3,12,0,0.0,0.0
1008,15,2020-03-16 11:35:00,1,1905.0,1387.0,0.728,9.041,117,36,11,25,81,48,33,3,0.0,0.0
1008,16,2020-03-16 11:38:00,1,1859.0,1546.0,0.832,9.036,224,97,68,29,127,91,36,1,0.0,0.0
1008,17,2020-03-16 11:41:00,1,1869.0,1522.0,0.814,9.047,4,1,0,1,3,3,0,0,0.0,0.0
1008,18,2020-03-16 11:44:00,1,1633.0,1441.0,0.883,8.03,1,1,0,1,0,0,0,0,0.0,0.0
1008,19,2020-03-16 11:47:00,1,1645.0,1411.0,0.857,8.045,10,3,1,2,7,1,6,0,0.03,0.02
1008,20,2020-03-16 11:50:00,1,2149.0,1859.0,0.865,10.527,4,1,0,1,3,1,2,0,0.0,0.0
1008,21,2020-03-16 11:53:00,1,1292.0,1310.0,1.014,6.542,9,5,2,3,4,2,2,1,0.01,0.0
1008,22,2020-03-16 11:56:00,1,1098.0,1081.0,0.985,5.522,46,23,11,12,23,4,19,0,0.0,0.0
1008,23,2020-03-16 11:59:00,1,1092.0,1106.0,1.012,5.529,49,38,13,25,11,7,4,0,0.0,0.0
1008,24,2020-03-16 12:02:00,1,1075.0,1189.0,1.106,5.55,65,38,16,22,27,11,16,1,0.0,0.0
1008,25,2020-03-16 12:05:00,1,1280.0,1363.0,1.065,6.551,164,62,24,38,102,65,37,0,0.0,0.0
1008,26,2020-03-16 12:08:00,1,1493.0,1497.0,1.003,7.539,421,227,166,61,194,140,54,4,0.0,0.0
1008,27,2020-03-16 12:11:00,1,2614.0,2484.0,0.951,13.048,464,245,185,60,219,158,61,2,0.0,0.0
1008,28,2020-03-16 12:14:00,1,2101.0,2052.0,0.977,10.55,42,42,23,19,0,0,0,0,0.0,0.0
1008,29,2020-03-16 12:17:00,1,1038.0,1323.0,1.275,5.553,45,42,3,39,3,1,2,0,0.0,0.0
1008,30,2020-03-16 12:20:00,1,836.0,1135.0,1.357,4.549,57,24,16,8,33,26,7,2,0.0,0.0
1008,31,2020-03-16 12:23:00,1,947.0,1178.0,1.243,5.036,63,32,24,8,31,25,6,4,0.0,0.0
1008,32,2020-03-16 12:26:00,1,721.0,1068.0,1.481,4.024,24,24,6,18,0,0,0,0,0.0,0.0
1008,33,2020-03-16 12:29:00,1,734.0,1024.0,1.396,4.023,4,4,2,2,0,0,0,0,0.0,0.0
1008,34,2020-03-16 12:32:00,1,608.0,1037.0,1.705,3.542,5,4,1,3,1,1,0,0,0.01,0.0
1008,35,2020-03-16 12:35:00,1,381.0,936.0,2.456,2.538,0,0,0,0,0,0,0,0,0.0,0.0
1008,36,2020-03-16 12:38:00,1,684.0,1223.0,1.789,4.047,0,0,0,0,0,0,0,0,0.0,0.0
1008,37,2020-03-16 12:41:00,1,378.0,955.0,2.526,2.547,0,0,0,0,0,0,0,0,0.0,0.02
1008,38,2020-03-16 12:44:00,1,138.0,907.0,6.557,1.547,0,0,0,0,0,0,0,0,0.0,0.0
1008,39,2020-03-16 12:47:00,1,42.0,790.0,6.021111,1.041,4,4,0,4,0,0,0,0,0.0,0.0
1008,40,2020-03-16 12:50:00,1,35.0,819.0,5.485222,1.043,4,3,1,2,1,0,1,0,0.01,0.0
1008,41,2020-03-16 12:53:00,1,36.0,814.0,4.949333,1.043,3,3,1,2,0,0,0,0,0.0,0.0
1008,42,2020-03-16 12:56:00,1,-211.0,795.0,4.413444,0.048,18,18,0,18,0,0,0,0,0.0,0.0
1008,43,2020-03-16 12:59:00,1,-96.0,836.0,3.877556,0.547,29,18,9,9,11,6,5,0,0.0,0.0
1008,44,2020-03-16 13:02:00,1,23.0,861.0,3.341667,1.045,30,10,2,8,20,2,18,0,0.0,0.0
1008,45,2020-03-16 13:05:00,1,-104.0,868.0,2.805778,0.549,65,6,1,5,59,15,44,0,0.0,0.0
1008,46,2020-03-16 13:08:00,1,-208.0,785.0,2.269889,0.048,87,1,0,1,86,28,58,0,0.0,0.0
1008,47,2020-03-16 13:11:00,1,863.0,1496.0,1.734,5.056,229,125,93,32,104,70,34,3,0.0,0.0
1008,48,2020-03-16 13:14:00,1,1499.0,1985.0,1.324,8.101,168,97,59,38,71,43,28,0,0.0,0.0
1008,49,2020-03-16 13:17:00,1,1167.0,1790.0,1.534,6.579,291,175,140,35,116,83,33,8,0.0,0.0
1008,50,2020-03-16 13:20:00,1,844.0,1576.0,1.867,5.071,162,91,61,30,71,56,15,0,0.0,0.0
1008,51,2020-03-16 13:23:00,1,1477.0,2050.0,1.387,8.089,204,113,82,31,91,46,45,0,0.0,0.0
1008,52,2020-03-16 13:26:00,1,1039.0,1789.0,1.721,6.074,170,78,52,26,92,57,35,3,0.0,0.0
1008,53,2020-03-16 13:29:00,1,1149.0,1853.0,1.612,6.579,145,25,10,15,120,67,53,0,0.0,0.0
1008,54,2020-03-16 13:32:00,1,1128.0,1933.0,1.714,6.581,174,35,15,20,139,83,56,0,0.0,0.0
1008,55,2020-03-16 13:35:00,1,1130.0,1917.0,1.696,6.574,94,33,11,22,61,28,33,0,0.0,0.0
1008,56,2020-03-16 13:38:00,1,101.0,1044.0,10.369,1.551,23,8,4,4,15,9,6,0,0.0,0.0
1008,57,2020-03-16 13:41:00,1,-241.0,909.0,7.681667,0.055,30,0,0,0,30,0,30,0,0.0,0.0
1008,58,2020-03-16 13:44:00,1,-234.0,881.0,4.994333,0.054,13,0,0,0,13,0,13,0,0.01,0.0
1008,59,2020-03-16 13:47:00,1,626.0,1444.0,2.307,4.063,30,14,2,12,16,2,14,0,0.0,0.0
1008,60,2020-03-16 13:50:00,1,49.0,1244.0,25.616,1.567,27,7,6,1,20,4,16,0,0.0,0.0
1008,61,2020-03-16 13:53:00,1,70.0,1164.0,16.723,1.562,56,49,36,13,7,0,7,0,0.0,0.0
1008,62,2020-03-16 13:56:00,1,54.0,1222.0,22.506,1.565,10,7,4,3,3,0,3,0,0.0,0.0
1008,63,2020-03-16 13:59:00,1,41.0,1269.0,30.762,1.566,12,3,0,3,9,0,9,0,0.0,0.0
1008,64,2020-03-16 14:02:00,1,-266.0,1002.0,24.7134,0.061,19,5,0,5,14,3,11,0,0.0,0.0
1008,65,2020-03-16 14:05:00,1,-276.0,1040.0,18.6648,0.063,44,12,1,11,32,7,25,0,0.0,0.0
1008,66,2020-03-16 14:08:00,1,-453.0,758.0,12.6162,-0.948,36,13,3,10,23,6,17,0,0.0,0.0
1008,67,2020-03-16 14:11:00,1,494.5,753.5,6.5676,2.7815,6,3,2,1,3,0,3,0,0.0,0.0
1008,68,2020-03-16 14:14:00,1,1442.0,749.0,0.519,6.511,14,7,2,5,7,2,5,0,0.0,0.0
1008,69,2020-03-16 14:17:00,1,1316.0,752.0,0.571,6.02,4,4,2,2,0,0,0,0,0.0,0.0
1008,70,2020-03-16 14:20:00,1,1430.0,796.0,0.557,6.515,0,0,0,0,0,0,0,0,0.01,0.0
1008,71,2020-03-16 14:23:00,1,1429.0,803.0,0.562,6.519,13,4,0,4,9,2,7,0,0.0,0.0
1008,72,2020-03-16 14:26:00,1,1430.0,805.0,0.563,6.528,5,2,2,0,3,1,2,0,0.0,0.0
1008,73,2020-03-16 14:29:00,1,1303.0,801.0,0.615,6.019,2,0,0,0,2,2,0,0,0.0,0.0
1008,74,2020-03-16 14:32:00,1,1417.0,845.0,0.596,6.518,6,0,0,0,6,3,3,0,0.0,0.0
1008,75,2020-03-16 14:35:00,1,1417.0,860.0,0.607,6.533,251,116,89,27,135,89,46,4,0.0,0.0
1008,76,2020-03-16 14:38:00,1,1379.0,981.0,0.712,6.518,89,7,4,3,82,55,27,0,0.0,0.0
1008,77,2020-03-16 14:41:00,1,1503.0,997.0,0.663,7.026,112,45,6,39,67,27,40,0,0.0,0.0
1008,78,2020-03-16 14:44:00,1,1619.0,1030.0,0.636,7.52,43,0,0,0,43,2,41,0,0.0,0.0
1008,79,2020-03-16 14:47:00,1,1386.0,973.0,0.703,6.537,88,28,16,12,60,39,21,0,0.0,0.0
1008,80,2020-03-16 14:50:00,1,1393.0,943.0,0.677,6.533,15,9,0,9,6,0,6,0,0.0,0.0
1008,81,2020-03-16 14:53:00,1,1398.0,909.0,0.65,6.514,1,0,0,0,1,0,1,0,0.0,0.0
1008,82,2020-03-16 14:56:00,1,1405.0,885.0,0.63,6.514,0,0,0,0,0,0,0,0,0.0,0.0
1008,83,2020-03-16 14:59:00,1,1411.0,883.0,0.625,6.539,20,6,5,1,14,9,5,0,0.01,0.0
1008,84,2020-03-16 15:02:00,1,1284.0,864.0,0.673,6.015,10,8,1,7,2,1,1,0,0.0,0.0
1008,85,2020-03-16 15:05:00,1,1283.0,872.0,0.68,6.021,4,0,0,0,4,0,4,0,0.0,0.0
1008,86,2020-03-16 15:08:00,1,1406.0,886.0,0.63,6.521,18,0,0,0,18,0,18,0,0.0,0.0
1008,87,2020-03-16 15:11:00,1,1286.0,876.0,0.681,6.038,5,0,0,0,5,0,5,0,0.0,0.0
1008,88,2020-03-16 15:14:00,1,1288.0,859.0,0.667,6.025,0,0,0,0,0,0,0,0,0.0,0.0
1008,89,2020-03-16 15:17:00,1,1159.0,863.0,0.745,5.523,5,0,0,0,5,0,5,0,0.0,0.0
1008,90,2020-03-16 15:20:00,1,1282.0,883.0,0.688,6.028,8,0,0,0,8,3,5,0,0.0,0.0
1008,91,2020-03-16 15:23:00,1,1039.0,849.0,0.818,5.033,0,0,0,0,0,0,0,0,0.0,0.0
1008,92,2020-03-16 15:26:00,1,1037.0,850.0,0.82,5.028,36,8,2,6,28,10,18,0,0.0,0.0
1008,93,2020-03-16 15:29:00,1,1272.0,908.0,0.714,6.017,22,2,0,2,20,12,8,0,0.0,0.0
1008,94,2020-03-16 15:32:00,1,1279.0,884.0,0.691,6.02,35,0,0,0,35,13,22,0,0.0,0.0
1008,95,2020-03-16 15:35:00,1,1156.0,875.0,0.757,5.522,62,3,0,3,59,4,55,0,0.0,0.0
1008,96,2020-03-16 15:38:00,1,1161.0,872.0,0.751,5.538,70,5,0,5,65,33,32,0,0.0,0.0
1008,97,2020-03-16 15:41:00,1,1154.0,874.0,0.757,5.516,24,2,0,2,22,2,20,0,0.0,0.0
1008,98,2020-03-16 15:44:00,1,1150.0,890.0,0.774,5.516,49,2,0,2,47,3,44,0,0.0,0.0
1008,99,2020-03-16 15:47:00,1,1035.0,855.0,0.826,5.025,21,0,0,0,21,0,21,0,0.0,0.0
1008,100,2020-03-16 15:50:00,1,1034.0,865.0,0.837,5.031,20,1,0,1,19,0,19,0,0.0,0.0
1008,101,2020-03-16 15:53:00,1,1151.0,901.0,0.782,5.532,9,0,0,0,9,0,9,0,0.01,0.0
1008,102,2020-03-16 15:56:00,1,1026.0,885.0,0.863,5.022,7,1,0,1,6,4,2,0,0.0,0.0
1008,103,2020-03-16 15:59:00,1,1031.0,879.0,0.852,5.035,39,0,0,0,39,1,38,0,0.0,0.0
1008,104,2020-03-16 16:02:00,1,1038.0,844.0,0.813,5.025,21,0,0,0,21,0,21,0,0.0,0.0
1008,105,2020-03-16 16:05:00,1,1052.0,796.0,0.756,5.025,19,3,0,3,16,0,16,0,0.0,0.0
1008,106,2020-03-16 16:08:00,1,1045.0,809.0,0.774,5.013,263,117,75,42,146,95,51,4,0.0,0.0
1008,107,2020-03-16 16:11:00,1,1358.0,1073.0,0.79,6.539,180,81,67,14,99,66,33,7,0.0,0.0
1008,108,2020-03-16 16:14:00,1,1356.0,1069.0,0.788,6.525,122,61,24,37,61,30,31,0,0.0,0.0
1008,109,2020-03-16 16:17:00,1,1582.0,1164.0,0.735,7.522,281,109,80,29,172,121,51,3,0.0,0.0
1008,110,2020-03-16 16:20:00,1,2426.0,1809.0,0.746,11.561,272,131,100,31,141,99,42,0,0.0,0.0
1008,111,2020-03-16 16:23:00,1,2728.0,2070.0,0.759,13.04,39,34,0,34,5,1,4,0,0.0,0.0
1008,112,2020-03-16 16:26:00,1,1335.0,1155.0,0.866,6.539,25,8,0,8,17,0,17,0,0.0,0.0
1008,113,2020-03-16 16:29:00,1,1138.0,929.0,0.816,5.512,69,36,8,28,33,14,19,0,0.0,0.0
1008,114,2020-03-16 16:32:00,1,1381.0,968.0,0.701,6.514,93,29,7,22,64,33,31,0,0.0,0.0
1008,115,2020-03-16 16:35:00,1,2708.0,2179.0,0.805,13.082,158,58,17,41,100,45,55,0,0.0,0.0
1008,116,2020-03-16 16:38:00,1,2719.0,2103.0,0.773,13.042,141,36,10,26,105,59,46,0,0.0,0.0
1008,117,2020-03-16 16:41:00,1,2503.0,1994.0,0.797,12.069,43,11,2,9,32,12,20,0,0.0,0.0
1008,118,2020-03-16 16:44:00,1,2085.0,1663.0,0.798,10.056,17,2,0,2,15,1,14,0,0.0,0.0
1008,119,2020-03-16 16:47:00,1,1883.0,1470.0,0.781,9.048,20,6,3,3,14,6,8,0,0.0,0.0
1008,120,2020-03-16 16:50:00,1,1653.0,1370.0,0.829,8.03,10,6,0,6,4,1,3,0,0.0,0.0
1008,121,2020-03-16 16:53:00,1,1772.0,1409.0,0.795,8.541,57,0,0,0,57,0,57,0,0.0,0.0
1008,122,2020-03-16 16:56:00,1,1536.0,1342.0,0.874,7.537,60,7,0,7,53,2,51,0,0.0,0.0
1008,123,2020-03-16 16:59:00,1,1545.0,1321.0,0.855,7.552,51,3,0,3,48,4,44,0,0.0,0.0
1008,124,2020-03-16 17:02:00,1,1551.0,1265.0,0.815,7.513,168,3,0,3,165,129,36,0,0.0,0.0
1008,125,2020-03-16 17:05:00,1,1570.0,1213.0,0.773,7.529,76,28,16,12,48,26,22,0,0.0,0.0
1008,126,2020-03-16 17:08:00,1,1549.0,1267.0,0.818,7.507,43,23,4,19,20,7,13,0,0.0,0.0
1008,127,2020-03-16 17:11:00,1,1747.5,1256.0,0.729,8.276,46,37,1,36,9,3,6,0,0.0,0.0
1008,128,2020-03-16 17:14:00,1,1946.0,1245.0,0.64,9.045,39,23,0,23,16,4,12,0,0.0,0.0
1008,129,2020-03-16 17:17:00,1,1828.0,1195.0,0.654,8.526,74,6,2,4,68,16,52,0,0.0,0.0
1008,130,2020-03-16 17:20:00,1,1705.0,1182.0,0.693,8.027,93,1,0,1,92,14,78,0,0.0,0.0
1008,131,2020-03-16 17:23:00,1,1702.0,1204.0,0.707,8.039,39,10,2,8,29,7,22,0,0.0,0.0
1008,132,2020-03-16 17:26:00,1,1705.0,1192.0,0.699,8.038,97,29,7,22,68,44,24,2,0.0,0.0
1008,133,2020-03-16 17:29:00,1,1698.0,1210.0,0.713,8.029,29,6,0,6,23,7,16,0,0.0,0.0
1008,134,2020-03-16 17:32:00,1,1708.0,1168.0,0.684,8.021,5,2,0,2,3,2,1,0,0.0,0.0
1008,135,2020-03-16 17:35:00,1,1698.0,1212.0,0.714,8.033,18,3,0,3,15,5,10,0,0.0,0.0
1008,136,2020-03-16 17:38:00,1,1700.0,1201.0,0.707,8.028,22,7,4,3,15,4,11,0,0.0,0.0
1008,137,2020-03-16 17:41:00,1,1721.0,1142.0,0.663,8.046,26,3,1,2,23,7,16,0,0.0,0.0
1008,138,2020-03-16 17:44:00,1,1702.0,1192.0,0.7,8.027,55,10,8,2,45,26,19,0,0.01,0.0
1008,139,2020-03-16 17:47:00,1,1933.0,1254.0,0.649,9.004,6,0,0,0,6,1,5,0,0.0,0.0
1008,140,2020-03-16 17:50:00,1,1825.0,1239.0,0.679,8.561,37,8,1,7,29,5,24,0,0.0,0.0
1008,141,2020-03-16 17:53:00,1,1701.0,1206.0,0.709,8.038,106,18,3,15,88,45,43,0,0.0,0.0
1008,142,2020-03-16 17:56:00,1,1894.0,1399.0,0.739,9.013,68,13,3,10,55,17,38,0,0.0,0.0
1008,143,2020-03-16 17:59:00,1,2225.0,1585.0,0.712,10.523,333,182,136,46,151,99,52,5,0.0,0.0
1008,144,2020-03-16 18:02:00,0,2428.0,1814.0,0.747,11.575,636,378,314,64,258,191,67,22,0.0,0.0
1008,145,2020-03-16 18:05:00,0,2768.0,1934.0,0.699,13.046,531,332,282,50,199,136,63,9,0.0,0.0
1008,146,2020-03-16 18:08:00,0,2789.0,1879.0,0.674,13.068,437,248,198,50,189,143,46,10,0.0,0.0
1008,147,2020-03-16 18:11:00,0,2798.0,1831.0,0.654,13.051,166,82,60,22,84,61,23,2,0.0,0.0
1008,148,2020-03-16 18:14:00,0,2239.0,1561.0,0.697,10.549,39,8,1,7,31,3,28,0,0.0,0.0
1008,149,2020-03-16 18:17:00,0,1899.0,1394.0,0.734,9.027,92,34,21,13,58,22,36,0,0.0,0.0
1008,150,2020-03-16 18:20:00,0,1912.0,1363.0,0.713,9.044,69,31,16,15,38,8,30,0,0.0,0.0
1008,151,2020-03-16 18:23:00,0,1913.0,1344.0,0.703,9.023,10,8,2,6,2,0,2,0,0.0,0.0
1008,152,2020-03-16 18:26:00,0,1929.0,1260.0,0.653,8.997,3,3,0,3,0,0,0,0,0.0,0.0
1008,153,2020-03-16 18:29:00,0,1707.0,1199.0,0.702,8.055,2,2,0,2,0,0,0,0,0.0,0.0
1008,154,2020-03-16 18:32:00,0,1928.0,1327.0,0.688,9.064,213,71,39,32,142,91,51,8,0.0,0.0
1008,155,2020-03-16 18:35:00,0,2221.0,1601.0,0.721,10.524,193,95,63,32,98,62,36,3,0.0,0.0
1008,156,2020-03-16 18:38:00,0,2124.0,1504.0,0.708,10.036,10,5,0,5,5,2,3,0,0.0,0.0
1008,157,2020-03-16 18:41:00,0,1896.0,1412.0,0.745,9.032,4,0,0,0,4,0,4,0,0.0,0.0
1008,158,2020-03-16 18:44:00,0,1901.0,1383.0,0.728,9.021,19,9,4,5,10,1,9,0,0.0,0.0
1008,159,2020-03-16 18:47:00,0,1672.0,1295.0,0.774,8.02,27,10,1,9,17,5,12,0,0.0,0.0
1008,160,2020-03-16 18:50:00,0,1914.0,1336.0,0.698,9.019,292,130,87,43,162,115,47,4,0.0,0.0
1008,161,2020-03-16 18:53:00,0,2216.0,1606.0,0.725,10.51,190,123,93,30,67,54,13,4,0.0,0.0
1008,162,2020-03-16 18:56:00,0,2232.0,1589.0,0.712,10.552,185,104,69,35,81,57,24,11,0.0,0.0
1008,163,2020-03-16 18:59:00,0,2201.0,1709.0,0.776,10.566,265,129,90,39,136,96,40,3,0.0,0.0
1008,164,2020-03-16 19:02:00,0,2428.0,1763.0,0.726,11.521,201,56,18,38,145,113,32,3,0.0,0.0
1008,165,2020-03-16 19:05:00,0,2409.0,1834.0,0.761,11.522,565,299,246,53,266,209,57,14,0.0,0.0
1008,166,2020-03-16 19:08:00,0,2641.0,1910.0,0.723,12.52,175,99,66,33,76,63,13,0,0.0,0.0
1008,167,2020-03-16 19:11:00,0,2210.0,1663.0,0.753,10.548,7,2,1,1,5,1,4,0,0.0,0.0
1008,168,2020-03-16 19:14:00,0,2121.0,1534.0,0.723,10.057,18,3,0,3,15,7,8,0,0.0,0.0
1008,169,2020-03-16 19:17:00,0,1888.0,1444.0,0.765,9.037,23,7,2,5,16,5,11,0,0.0,0.0
1008,170,2020-03-16 19:20:00,0,1906.0,1374.0,0.721,9.032,2,1,1,0,1,0,1,0,0.0,0.0
1008,171,2020-03-16 19:23:00,0,1922.0,1311.0,0.682,9.023,208,125,89,36,83,62,21,6,0.0,0.0
1008,172,2020-03-16 19:26:00,0,2120.0,1507.0,0.71,10.023,420,260,210,50,160,119,41,19,0.0,0.0
1008,173,2020-03-16 19:29:00,0,2212.0,1667.0,0.754,10.56,205,107,75,32,98,75,23,9,0.0,0.0
1008,174,2020-03-16 19:32:00,0,2232.0,1571.0,0.704,10.535,14,14,5,9,0,0,0,0,0.0,0.0
1008,175,2020-03-16 19:35:00,0,1784.0,1342.0,0.752,8.516,49,7,0,7,42,18,24,0,0.0,0.0
1008,176,2020-03-16 19:38:00,0,1356.0,1071.0,0.79,6.53,43,23,8,15,20,7,13,0,0.0,0.0
1008,177,2020-03-16 19:41:00,0,1892.0,1420.0,0.75,9.027,235,104,46,58,131,79,52,3,0.0,0.0
1008,178,2020-03-16 19:44:00,0,2219.0,1642.0,0.74,10.561,334,160,107,53,174,130,44,11,0.0,0.0
1008,179,2020-03-16 19:47:00,0,2310.0,1737.0,0.752,11.024,347,164,120,44,183,133,50,7,0.0,0.0
1008,180,2020-03-16 19:50:00,0,2417.0,1831.0,0.757,11.552,389,193,153,40,196,143,53,3,0.0,0.0
1008,181,2020-03-16 19:53:00,0,2208.0,1675.0,0.759,10.554,39,2,0,2,37,6,31,0,0.0,0.0
1008,182,2020-03-16 19:56:00,0,2006.0,1507.0,0.751,9.573,6,0,0,0,6,0,6,0,0.0,0.0
1008,183,2020-03-16 19:59:00,0,1895.0,1398.0,0.738,9.015,21,10,1,9,11,4,7,0,0.0,0.0
1008,184,2020-03-16 20:02:00,0,1916.0,1331.0,0.695,9.024,16,0,0,0,16,6,10,0,0.0,0.0
1008,185,2020-03-16 20:05:00,0,1793.0,1315.0,0.733,8.521,307,165,127,38,142,105,37,2,0.0,0.0
1008,186,2020-03-16 20:08:00,0,2001.0,1504.0,0.752,9.55,212,87,59,28,125,75,50,7,0.0,0.0
1008,187,2020-03-16 20:11:00,0,2408.5,1629.5,0.6875,11.294,336,101,54,47,235,173,62,1,0.0,0.0
1008,188,2020-03-16 20:14:00,0,2816.0,1755.0,0.623,13.038,479,284,240,44,195,149,46,13,0.0,0.0
1008,189,2020-03-16 20:17:00,0,2808.0,1779.0,0.634,13.033,66,41,31,10,25,18,7,0,0.0,0.0
1008,190,2020-03-16 20:20:00,0,2599.0,1608.0,0.619,12.019,28,10,6,4,18,10,8,0,0.0,0.0
1008,191,2020-03-16 20:23:00,0,2264.0,1456.0,0.643,10.533,31,6,2,4,25,0,25,0,0.0,0.0
1008,192,2020-03-16 20:26:00,0,2295.0,1340.0,0.584,10.528,209,122,97,25,87,69,18,2,0.0,0.0
1008,193,2020-03-16 20:29:00,0,2283.0,1413.0,0.619,10.56,3,2,1,1,1,0,1,0,0.0,0.0
1008,194,2020-03-16 20:32:00,0,2302.0,1334.0,0.579,10.548,31,11,7,4,20,12,8,0,0.0,0.0
1008,195,2020-03-16 20:35:00,0,2076.0,1241.0,0.598,9.556,27,8,3,5,19,9,10,0,0.0,0.0
1008,196,2020-03-16 20:38:00,0,2083.0,1218.0,0.585,9.556,9,3,1,2,6,3,3,0,0.0,0.0
1008,197,2020-03-16 20:41:00,0,2071.0,1248.0,0.603,9.54,121,61,43,18,60,39,21,0,0.0,0.0
1008,198,2020-03-16 20:44:00,0,2070.0,1243.0,0.6,9.531,3,2,0,2,1,1,0,0,0.0,0.0
1008,199,2020-03-16 20:47:00,0,2082.0,1184.0,0.569,9.516,128,36,21,15,92,67,25,7,0.0,0.0
1008,200,2020-03-16 20:50:00,0,2293.0,1358.0,0.592,10.537,218,134,102,32,84,65,19,6,0.0,0.0
1008,201,2020-03-16 20:53:00,0,2256.0,1472.0,0.652,10.519,175,64,41,23,111,83,28,6,0.0,0.0
1008,202,2020-03-16 20:56:00,0,2608.0,1595.0,0.611,12.043,219,94,60,34,125,99,26,8,0.0,0.0
1008,203,2020-03-16 20:59:00,0,2580.0,1708.0,0.662,12.057,360,183,148,35,177,141,36,8,0.0,0.0
1008,204,2020-03-16 21:02:00,0,2817.0,1768.0,0.628,13.058,254,134,98,36,120,88,32,6,0.0,0.0
1008,205,2020-03-16 21:05:00,0,2811.0,1783.0,0.634,13.051,394,192,154,38,202,138,64,18,0.0,0.0
1008,206,2020-03-16 21:08:00,0,2812.0,1803.0,0.641,13.075,402,183,148,35,219,170,49,7,0.0,0.0
1008,207,2020-03-16 21:11:00,0,2812.0,1790.0,0.636,13.063,375,214,173,41,161,122,39,22,0.0,0.0
1008,208,2020-03-16 21:14:00,0,2810.0,1755.0,0.625,13.014,238,133,99,34,105,80,25,11,0.0,0.0
1008,209,2020-03-16 21:17:00,0,2608.0,1596.0,0.612,12.043,58,22,13,9,36,24,12,0,0.0,0.0
1008,210,2020-03-16 21:20:00,0,2272.0,1438.0,0.633,10.545,15,8,2,6,7,3,4,0,0.0,0.0
1008,211,2020-03-16 21:23:00,0,2061.0,1305.0,0.633,9.566,46,3,1,2,43,8,35,0,0.0,0.0
1008,212,2020-03-16 21:26:00,0,2076.0,1236.0,0.595,9.55,18,4,1,3,14,3,11,0,0.0,0.0
1008,213,2020-03-16 21:29:00,0,2077.0,1231.0,0.593,9.545,36,6,0,6,30,17,13,0,0.0,0.0
1008,214,2020-03-16 21:32:00,0,2080.0,1192.0,0.573,9.518,42,18,6,12,24,7,17,2,0.0,0.0
1008,215,2020-03-16 21:35:00,0,2284.0,1390.0,0.609,10.539,233,84,53,31,149,105,44,7,0.0,0.0
1008,216,2020-03-16 21:38:00,0,2615.0,1564.0,0.598,12.037,416,203,157,46,213,163,50,19,0.0,0.0
1008,217,2020-03-16 21:41:00,0,2608.0,1596.0,0.612,12.044,323,224,188,36,99,79,20,5,0.0,0.0
1008,218,2020-03-16 21:44:00,0,2609.0,1594.0,0.611,12.044,170,31,8,23,139,94,45,0,0.0,0.0
1008,219,2020-03-16 21:47:00,0,2617.0,1584.0,0.605,12.064,248,61,24,37,187,107,80,0,0.0,0.0
1008,220,2020-03-16 21:50:00,0,2601.0,1612.0,0.62,12.035,341,160,129,31,181,125,56,16,0.0,0.0
1008,221,2020-03-16 21:53:00,0,2599.0,1628.0,0.626,12.044,537,303,260,43,234,180,54,21,0.0,0.0
1008,222,2020-03-16 21:56:00,0,2600.0,1605.0,0.617,12.023,305,196,152,44,109,82,27,13,0.0,0.0
1008,223,2020-03-16 21:59:00,0,2603.0,1627.0,0.625,12.059,720,299,236,63,421,330,91,25,0.0,0.0
1008,224,2020-03-16 22:02:00,0,2599.0,1616.0,0.622,12.028,466,260,216,44,206,160,46,22,0.0,0.0
1008,225,2020-03-16 22:05:00,0,2618.0,1587.0,0.606,12.071,512,248,181,67,264,196,68,17,0.0,0.0
1008,226,2020-03-16 22:08:00,0,2618.0,1550.0,0.592,12.031,80,58,29,29,22,16,6,0,0.0,0.0
1008,227,2020-03-16 22:11:00,0,2623.0,1571.0,0.599,12.074,89,55,23,32,34,15,19,0,0.0,0.0
1008,228,2020-03-16 22:14:00,0,2603.0,1582.0,0.608,12.008,129,72,33,39,57,26,31,0,0.0,0.0
1008,229,2020-03-16 22:17:00,0,2609.0,1552.0,0.595,12.001,82,41,19,22,41,23,18,3,0.0,0.0
1008,230,2020-03-16 22:20:00,0,2384.0,1515.0,0.636,11.07,19,5,4,1,14,9,5,0,0.0,0.0
1008,231,2020-03-16 22:23:00,0,2294.0,1357.0,0.591,10.541,7,0,0,0,7,3,4,0,0.0,0.0
1008,232,2020-03-16 22:26:00,0,2079.0,1224.0,0.589,9.545,6,4,1,3,2,1,1,0,0.0,0.0
1008,233,2020-03-16 22:29:00,0,1972.0,1124.0,0.57,9.017,9,7,1,6,2,1,1,0,0.0,0.0
1008,234,2020-03-16 22:32:00,0,1747.0,1041.0,0.596,8.037,11,4,1,3,7,3,4,0,0.0,0.0
1008,235,2020-03-16 22:35:00,0,1754.0,1005.0,0.573,8.022,71,34,21,13,37,19,18,0,0.0,0.0
1008,236,2020-03-16 22:38:00,0,1851.0,1119.0,0.605,8.534,28,13,4,9,15,2,13,0,0.0,0.0
1008,237,2020-03-16 22:41:00,0,1860.0,1099.0,0.591,8.546,19,5,0,5,14,0,14,0,0.0,0.0
1008,238,2020-03-16 22:44:00,0,1734.0,1064.0,0.614,8.011,15,1,0,1,14,0,14,0,0.0,0.0
1008,239,2020-03-16 22:47:00,0,1734.0,1070.0,0.617,8.017,23,7,3,4,16,5,11,0,0.0,0.0
1008,240,2020-03-16 22:50:00,0,1748.0,1023.0,0.585,8.021,31,18,0,18,13,7,6,0,0.0,0.0
1008,241,2020-03-16 22:53:00,0,1740.0,1048.0,0.602,8.018,13,1,1,0,12,4,8,0,0.0,0.0
1008,242,2020-03-16 22:56:00,0,2070.0,1225.0,0.591,9.514,282,227,186,41,55,38,17,3,0.0,0.0
1008,243,2020-03-16 22:59:00,0,2617.0,1563.0,0.597,12.043,585,355,311,44,230,177,53,17,0.0,0.0
1008,244,2020-03-16 23:02:00,0,2588.0,1660.0,0.641,12.037,208,127,97,30,81,53,28,11,0.0,0.0
1008,245,2020-03-16 23:05:00,0,2833.0,1696.0,0.599,13.039,111,90,40,50,21,3,18,5,0.0,0.0
1008,246,2020-03-16 23:08:00,0,2810.0,1777.0,0.632,13.041,203,119,81,38,84,55,29,7,0.0,0.0
1008,247,2020-03-16 23:11:00,0,2807.5,1781.5,0.6345,13.036,322,119,87,32,203,165,38,18,0.0,0.0
1008,248,2020-03-16 23:14:00,0,2805.0,1786.0,0.637,13.031,481,303,260,43,178,130,48,13,0.0,0.0
1008,249,2020-03-16 23:17:00,0,2824.0,1729.0,0.612,13.041,123,75,39,36,48,35,13,1,0.0,0.0
1008,250,2020-03-16 23:20:00,0,2825.0,1722.0,0.609,13.038,58,45,24,21,13,6,7,6,0.0,0.0
1008,251,2020-03-16 23:23:00,0,2827.0,1722.0,0.609,13.046,257,165,120,45,92,61,31,5,0.0,0.0
1008,252,2020-03-16 23:26:00,0,2805.0,1797.0,0.641,13.042,452,248,194,54,204,164,40,10,0.0,0.0
1008,253,2020-03-16 23:29:00,0,2833.0,1702.0,0.601,13.046,6,6,4,2,0,0,0,0,0.0,0.0
1008,254,2020-03-16 23:32:00,0,2625.0,1501.0,0.572,12.007,99,58,37,21,41,35,6,9,0.0,0.0
1008,255,2020-03-16 23:35:00,0,2620.0,1552.0,0.592,12.042,296,168,127,41,128,103,25,3,0.0,0.0
1008,256,2020-03-16 23:38:00,0,2622.0,1594.0,0.608,12.097,148,77,49,28,71,49,22,10,0.0,0.0
1008,257,2020-03-16 23:41:00,0,2605.0,1613.0,0.619,12.052,222,74,57,17,148,123,25,7,0.0,0.0
1008,258,2020-03-16 23:44:00,0,2594.0,1640.0,0.632,12.034,191,70,43,27,121,90,31,9,0.0,0.0
1008,259,2020-03-16 23:47:00,0,2615.0,1577.0,0.603,12.049,105,25,13,12,80,71,9,0,0.0,0.0
1008,260,2020-03-16 23:50:00,0,2270.0,1440.0,0.635,10.54,27,5,4,1,22,16,6,5,0.0,0.0
1008,261,2020-03-16 23:53:00,0,2300.0,1313.0,0.571,10.518,31,8,5,3,23,2,21,0,0.0,0.0
1008,262,2020-03-16 23:56:00,0,2070.0,1218.0,0.588,9.506,12,1,0,1,11,3,8,0,0.0,0.0
1008,263,2020-03-16 23:59:00,0,2086.0,1185.0,0.568,9.53,84,24,17,7,60,41,19,0,0.0,0.0
1008,264,2020-03-17 00:02:00,0,1974.0,1102.0,0.558,9.0,7,2,0,2,5,3,2,0,0.0,0.0
1008,265,2020-03-17 00:05:00,0,1747.0,1036.0,0.593,8.032,86,61,43,18,25,16,9,0,0.0,0.0
1008,266,2020-03-17 00:08:00,0,2081.0,1180.0,0.567,9.508,300,196,149,47,104,79,25,4,0.0,0.0
1008,267,2020-03-17 00:11:00,0,2388.0,1473.0,0.617,11.04,369,199,158,41,170,136,34,11,0.0,0.0
1008,268,2020-03-17 00:14:00,0,2611.0,1552.0,0.594,12.008,277,168,119,49,109,82,27,8,0.0,0.0
1008,269,2020-03-17 00:17:00,0,2601.0,1657.0,0.637,12.084,549,315,263,52,234,181,53,11,0.0,0.0
1008,270,2020-03-17 00:20:00,0,2585.0,1645.0,0.636,12.007,264,115,67,48,149,103,46,9,0.0,0.0
1008,271,2020-03-17 00:23:00,0,2587.0,1659.0,0.641,12.032,493,299,244,55,194,152,42,10,0.0,0.0
1008,272,2020-03-17 00:26:00,0,2838.0,1691.0,0.596,13.054,717,436,395,41,281,219,62,45,0.0,0.0
1008,273,2020-03-17 00:29:00,0,2832.0,1681.0,0.594,13.018,193,110,85,25,83,65,18,7,0.0,0.0
1008,274,2020-03-17 00:32:00,0,2617.0,1566.0,0.598,12.044,27,25,6,19,2,1,1,0,0.0,0.0
1008,275,2020-03-17 00:35:00,0,2282.0,1393.0,0.611,10.532,4,4,3,1,0,0,0,0,0.0,0.0
1008,276,2020-03-17 00:38:00,0,2312.0,1303.0,0.563,10.554,22,20,3,17,2,0,2,0,0.0,0.0
1008,277,2020-03-17 00:41:00,0,2094.0,1171.0,0.559,9.549,12,11,2,9,1,0,1,2,0.0,0.0
1008,278,2020-03-17 00:44:00,0,2090.0,1157.0,0.554,9.515,6,6,2,4,0,0,0,0,0.0,0.0
1008,279,2020-03-17 00:47:00,0,2079.0,1235.0,0.594,9.558,227,132,88,44,95,65,30,12,0.0,0.0
1008,280,2020-03-17 00:50:00,0,2277.0,1400.0,0.615,10.521,482,301,249,52,181,136,45,13,0.0,0.0
1008,281,2020-03-17 00:53:00,0,2514.0,1468.0,0.584,11.531,314,133,96,37,181,123,58,11,0.0,0.0
1008,282,2020-03-17 00:56:00,0,2604.0,1603.0,0.616,12.035,91,68,27,41,23,7,16,12,0.0,0.0
1008,283,2020-03-17 00:59:00,0,2839.0,1675.0,0.59,13.04,421,313,260,53,108,70,38,9,0.0,0.0
1008,284,2020-03-17 01:02:00,0,2707.0,1661.0,0.613,12.504,681,386,333,53,295,226,69,15,0.0,0.0
1008,285,2020-03-17 01:05:00,0,2826.0,1687.0,0.597,13.001,341,168,113,55,173,135,38,1,0.0,0.0
1008,286,2020-03-17 01:08:00,0,2725.0,1632.0,0.599,12.545,302,96,62,34,206,145,61,10,0.0,0.0
1008,287,2020-03-17 01:11:00,0,2605.0,1606.0,0.617,12.043,192,61,28,33,131,81,50,0,0.0,0.0
1008,288,2020-03-17 01:14:00,0,2612.0,1592.0,0.61,12.054,308,147,115,32,161,110,51,11,0.0,0.0
1008,289,2020-03-17 01:17:00,0,2513.0,1467.0,0.584,11.524,74,31,19,12,43,33,10,4,0.0,0.0
1008,290,2020-03-17 01:20:00,0,2285.0,1384.0,0.606,10.535,229,134,94,40,95,81,14,5,0.0,0.0
1008,291,2020-03-17 01:23:00,0,2300.0,1334.0,0.58,10.541,219,80,35,45,139,108,31,0,0.0,0.0
1008,292,2020-03-17 01:26:00,0,2283.0,1391.0,0.609,10.536,257,117,66,51,140,96,44,15,0.0,0.0
1008,293,2020-03-17 01:29:00,0,2290.0,1374.0,0.6,10.543,194,96,50,46,98,68,30,2,0.0,0.0
1008,294,2020-03-17 01:32:00,0,2284.0,1394.0,0.61,10.542,144,90,64,26,54,40,14,1,0.0,0.0
1008,295,2020-03-17 01:35:00,0,2288.0,1356.0,0.593,10.518,4,2,1,1,2,0,2,0,0.0,0.0
1008,296,2020-03-17 01:38:00,0,2194.0,1233.0,0.562,10.01,5,0,0,0,5,2,3,0,0.0,0.0
1008,297,2020-03-17 01:41:00,0,2094.0,1126.0,0.538,9.496,12,1,0,1,11,3,8,0,0.0,0.0
1008,298,2020-03-17 01:44:00,0,1994.0,1060.0,0.531,9.032,7,0,0,0,7,0,7,0,0.0,0.0
1008,299,2020-03-17 01:47:00,0,1760.0,994.0,0.565,8.036,13,5,0,5,8,2,6,0,0.0,0.0
1008,300,2020-03-17 01:50:00,0,1768.0,960.0,0.543,8.029,50,11,9,2,39,26,13,0,0.0,0.0
1008,301,2020-03-17 01:53:00,0,1775.0,916.0,0.516,8.007,17,4,2,2,13,1,12,0,0.0,0.0
1008,302,2020-03-17 01:56:00,0,1782.0,913.0,0.512,8.032,25,11,1,10,14,5,9,0,0.0,0.0
1008,303,2020-03-17 01:59:00,0,1790.0,893.0,0.499,8.041,8,0,0,0,8,3,5,0,0.0,0.0
1008,304,2020-03-17 02:02:00,0,1789.0,886.0,0.495,8.032,72,50,39,11,22,9,13,0,0.0,0.0
1008,305,2020-03-17 02:05:00,0,1751.0,1013.0,0.578,8.02,302,175,126,49,127,95,32,7,0.0,0.0
1008,306,2020-03-17 02:08:00,0,2308.0,1306.0,0.566,10.541,305,145,101,44,160,141,19,13,0.0,0.0
1008,307,2020-03-17 02:11:00,0,2388.5,1469.5,0.6135,11.0385,198,128,81,47,70,40,30,14,0.0,0.0
1008,308,2020-03-17 02:14:00,0,2469.0,1633.0,0.661,11.536,102,65,30,35,37,8,29,8,0.0,0.0
1008,309,2020-03-17 02:17:00,0,2567.0,1725.0,0.672,12.024,466,268,215,53,198,153,45,25,0.0,0.0
1008,310,2020-03-17 02:20:00,0,2812.0,1783.0,0.634,13.054,256,149,110,39,107,77,30,9,0.0,0.0
1008,311,2020-03-17 02:23:00,0,2692.0,1750.0,0.65,12.546,503,259,205,54,244,197,47,17,0.0,0.0
1008,312,2020-03-17 02:26:00,0,2468.0,1659.0,0.672,11.56,349,211,160,51,138,114,24,8,0.0,0.0
1008,313,2020-03-17 02:29:00,0,2474.0,1621.0,0.655,11.542,606,357,311,46,249,185,64,21,0.0,0.0
1008,314,2020-03-17 02:32:00,0,2220.0,1589.0,0.716,10.506,538,292,243,49,246,193,53,16,0.0,0.0
1008,315,2020-03-17 02:35:00,0,2236.0,1549.0,0.693,10.525,255,143,98,45,112,77,35,3,0.0,0.0
1008,316,2020-03-17 02:38:00,0,2276.0,1431.0,0.629,10.551,17,16,0,16,1,0,1,0,0.0,0.0
1008,317,2020-03-17 02:41:00,0,1935.0,1279.0,0.661,9.042,0,0,0,0,0,0,0,0,0.0,0.0
1008,318,2020-03-17 02:44:00,0,1711.0,1155.0,0.675,8.02,0,0,0,0,0,0,0,0,0.0,0.0
1008,319,2020-03-17 02:47:00,0,1731.0,1076.0,0.622,8.012,211,101,74,27,110,75,35,4,0.0,0.0
1008,320,2020-03-17 02:50:00,0,1729.0,1107.0,0.64,8.041,174,97,74,23,77,61,16,3,0.0,0.0
1008,321,2020-03-17 02:53:00,0,1738.0,1061.0,0.611,8.023,0,0,0,0,0,0,0,0,0.0,0.0
1008,322,2020-03-17 02:56:00,0,1507.0,973.0,0.645,7.015,2,2,0,2,0,0,0,0,0.0,0.0
1008,323,2020-03-17 02:59:00,0,1389.0,934.0,0.672,6.505,7,3,0,3,4,1,3,0,0.0,0.0
1008,324,2020-03-17 03:02:00,0,1411.0,869.0,0.616,6.521,0,0,0,0,0,0,0,0,0.0,0.0
1008,325,2020-03-17 03:05:00,0,1394.0,923.0,0.662,6.516,316,193,153,40,123,89,34,7,0.0,0.0
1008,326,2020-03-17 03:08:00,0,1824.0,1200.0,0.658,8.514,190,120,80,40,70,56,14,0,0.0,0.0
1008,327,2020-03-17 03:11:00,0,1933.0,1276.0,0.66,9.028,129,38,6,32,91,52,39,5,0.0,0.0
1008,328,2020-03-17 03:14:00,0,2268.0,1425.0,0.628,10.515,434,95,58,37,339,293,46,14,0.0,0.0
1008,329,2020-03-17 03:17:00,0,2229.0,1576.0,0.707,10.528,363,202,161,41,161,119,42,6,0.0,0.0
1008,330,2020-03-17 03:20:00,0,2352.0,1579.0,0.672,11.016,364,234,197,37,130,95,35,8,0.0,0.0
1008,331,2020-03-17 03:23:00,0,2486.0,1606.0,0.646,11.572,403,226,193,33,177,136,41,26,0.0,0.0
1008,332,2020-03-17 03:26:00,0,2466.0,1648.0,0.669,11.54,402,194,147,47,208,164,44,9,0.0,0.0
1008,333,2020-03-17 03:29:00,0,2469.0,1645.0,0.666,11.551,561,202,170,32,359,312,47,15,0.0,0.0
1008,334,2020-03-17 03:32:00,0,2473.0,1636.0,0.662,11.556,423,192,145,47,231,175,56,24,0.0,0.0
1008,335,2020-03-17 03:35:00,0,2246.0,1555.0,0.692,10.573,758,447,393,54,311,242,69,41,0.0,0.0
1008,336,2020-03-17 03:38:00,0,2234.0,1557.0,0.697,10.525,393,191,153,38,202,157,45,23,0.0,0.0
1008,337,2020-03-17 03:41:00,0,2254.0,1512.0,0.671,10.555,290,106,83,23,184,140,44,0,0.0,0.0
1008,338,2020-03-17 03:44:00,0,2263.0,1439.0,0.636,10.509,61,29,18,11,32,23,9,2,0.0,0.0
1008,339,2020-03-17 03:47:00,0,2274.0,1422.0,0.625,10.536,178,80,64,16,98,66,32,6,0.0,0.0
1008,340,2020-03-17 03:50:00,0,2272.0,1413.0,0.622,10.515,185,47,31,16,138,95,43,0,0.0,0.0
1008,341,2020-03-17 03:53:00,0,1934.0,1278.0,0.661,9.034,22,7,5,2,15,9,6,0,0.0,0.0
1008,342,2020-03-17 03:56:00,0,1955.0,1177.0,0.602,9.007,43,2,1,1,41,1,40,0,0.0,0.0
1008,343,2020-03-17 03:59:00,0,1734.0,1078.0,0.622,8.028,18,0,0,0,18,1,17,0,0.0,0.0
1008,344,2020-03-17 04:02:00,0,1632.0,997.0,0.611,7.536,37,1,0,1,36,17,19,0,0.0,0.0
1008,345,2020-03-17 04:05:00,0,1398.0,919.0,0.657,6.527,148,40,22,18,108,72,36,3,0.0,0.0
1008,346,2020-03-17 04:08:00,0,1506.0,975.0,0.647,7.012,339,224,183,41,115,79,36,6,0.0,0.0
1008,347,2020-03-17 04:11:00,0,1710.0,1160.0,0.678,8.022,96,36,23,13,60,43,17,2,0.0,0.0
1008,348,2020-03-17 04:14:00,0,1934.0,1268.0,0.656,9.025,315,157,111,46,158,122,36,35,0.0,0.0
1008,349,2020-03-17 04:17:00,0,2037.0,1341.0,0.659,9.511,149,68,51,17,81,61,20,0,0.0,0.0
1008,350,2020-03-17 04:20:00,0,1933.0,1304.0,0.675,9.06,163,39,22,17,124,82,42,0,0.0,0.0
1008,351,2020-03-17 04:23:00,0,2288.0,1370.0,0.599,10.532,344,179,141,38,165,116,49,8,0.01,0.0
1008,352,2020-03-17 04:26:00,0,2278.0,1397.0,0.613,10.523,314,159,120,39,155,125,30,5,0.0,0.0
1008,353,2020-03-17 04:29:00,0,1925.0,1314.0,0.683,9.038,140,95,75,20,45,36,9,0,0.0,0.0
1008,354,2020-03-17 04:32:00,0,1952.0,1192.0,0.611,9.012,95,55,41,14,40,35,5,0,0.0,0.0
1008,355,2020-03-17 04:35:00,0,1939.0,1234.0,0.636,9.005,143,58,38,20,85,68,17,5,0.0,0.0
1008,356,2020-03-17 04:38:00,0,1936.0,1270.0,0.656,9.034,352,235,198,37,117,89,28,11,0.0,0.0
1008,357,2020-03-17 04:41:00,0,1949.0,1231.0,0.631,9.044,108,74,55,19,34,28,6,0,0.0,0.0
1008,358,2020-03-17 04:44:00,0,1850.0,1118.0,0.605,8.526,0,0,0,0,0,0,0,0,0.0,0.0
1008,359,2020-03-17 04:47:00,0,1737.0,1059.0,0.61,8.016,141,89,65,24,52,41,11,8,0.0,0.0
1008,360,2020-03-17 04:50:00,0,1729.0,1093.0,0.632,8.024,160,106,81,25,54,42,12,5,0.0,0.0
1008,361,2020-03-17 04:53:00,0,1735.0,1082.0,0.623,8.033,110,76,59,17,34,20,14,5,0.0,0.0
1008,362,2020-03-17 04:56:00,0,1960.0,1169.0,0.597,9.017,83,51,13,38,32,6,26,2,0.0,0.0
1008,363,2020-03-17 04:59:00,0,1943.0,1240.0,0.638,9.028,124,87,44,43,37,11,26,0,0.0,0.0
1008,364,2020-03-17 05:02:00,0,1947.0,1242.0,0.638,9.045,181,110,89,21,71,60,11,1,0.0,0.0
1008,365,2020-03-17 05:05:00,0,1726.0,1102.0,0.638,8.023,5,0,0,0,5,0,5,0,0.0,0.0
1008,366,2020-03-17 05:08:00,0,1744.0,1042.0,0.598,8.026,4,4,0,4,0,0,0,0,0.0,0.0
1008,367,2020-03-17 05:11:00,0,1633.5,980.0,0.6005,7.5215,0,0,0,0,0,0,0,0,0.0,0.0
1008,368,2020-03-17 05:14:00,0,1523.0,918.0,0.603,7.017,2,0,0,0,2,0,2,0,0.0,0.0
1008,369,2020-03-17 05:17:00,0,1751.0,1021.0,0.583,8.029,160,98,69,29,62,49,13,11,0.0,0.0
1008,370,2020-03-17 05:20:00,0,1960.0,1165.0,0.594,9.015,170,152,122,30,18,14,4,0,0.0,0.0
1008,371,2020-03-17 05:23:00,0,1968.0,1162.0,0.59,9.039,108,71,52,19,37,30,7,1,0.0,0.0
1008,372,2020-03-17 05:26:00,0,1739.0,1049.0,0.603,8.015,0,0,0,0,0,0,0,0,0.0,0.0
1008,373,2020-03-17 05:29:00,0,1767.0,966.0,0.546,8.033,20,20,13,7,0,0,0,0,0.0,0.0
1008,374,2020-03-17 05:32:00,0,1642.0,952.0,0.58,7.523,28,22,13,9,6,3,3,0,0.0,0.0
1008,375,2020-03-17 05:35:00,0,1401.0,891.0,0.636,6.507,38,22,16,6,16,10,6,1,0.0,0.0
1008,376,2020-03-17 05:38:00,0,1405.0,886.0,0.631,6.519,18,16,12,4,2,1,1,0,0.0,0.0
1008,377,2020-03-17 05:41:00,0,1528.0,903.0,0.591,7.021,2,2,0,2,0,0,0,0,0.0,0.0
1008,378,2020-03-17 05:44:00,0,1408.0,872.0,0.619,6.514,7,7,2,5,0,0,0,0,0.0,0.0
1008,379,2020-03-17 05:47:00,0,1415.0,849.0,0.6,6.513,27,21,19,2,6,3,3,0,0.01,0.0
1008,380,2020-03-17 05:50:00,0,1417.0,836.0,0.59,6.508,40,34,28,6,6,5,1,0,0.0,0.0
1008,381,2020-03-17 05:53:00,0,1417.0,839.0,0.592,6.511,5,5,1,4,0,0,0,0,0.0,0.0
1008,382,2020-03-17 05:56:00,0,1422.0,822.0,0.578,6.514,95,81,57,24,14,3,11,6,0.0,0.0
1008,383,2020-03-17 05:59:00,0,1746.0,1016.0,0.582,8.003,215,110,84,26,105,72,33,25,0.0,0.0
1008,384,2020-03-17 06:02:00,1,1931.0,1283.0,0.665,9.028,474,270,223,47,204,144,60,15,0.0,0.0
1008,385,2020-03-17 06:05:00,1,2490.0,1540.0,0.618,11.517,316,182,130,52,134,91,43,19,0.0,0.0
1008,386,2020-03-17 06:08:00,1,2601.0,1614.0,0.62,12.035,364,199,149,50,165,119,46,14,0.0,0.0
1008,387,2020-03-17 06:11:00,1,2606.0,1590.0,0.61,12.029,244,133,91,42,111,70,41,6,0.0,0.0
1008,388,2020-03-17 06:14:00,1,2491.0,1553.0,0.624,11.534,121,89,52,37,32,18,14,0,0.0,0.0
1008,389,2020-03-17 06:17:00,1,2510.0,1481.0,0.59,11.529,164,81,61,20,83,53,30,8,0.0,0.0
1008,390,2020-03-17 06:20:00,1,2396.0,1442.0,0.602,11.037,281,141,107,34,140,94,46,0,0.0,0.0
1008,391,2020-03-17 06:23:00,1,2398.0,1413.0,0.589,11.014,106,49,26,23,57,24,33,0,0.0,0.0
1008,392,2020-03-17 06:26:00,1,2191.0,1249.0,0.57,10.016,15,14,5,9,1,0,1,0,0.0,0.0
1008,393,2020-03-17 06:29:00,1,1967.0,1150.0,0.585,9.022,0,0,0,0,0,0,0,0,0.0,0.0
1008,394,2020-03-17 06:32:00,1,1989.0,1079.0,0.543,9.032,0,0,0,0,0,0,0,0,0.0,0.0
1008,395,2020-03-17 06:35:00,1,1759.0,1003.0,0.57,8.04,48,26,19,7,22,12,10,4,0.0,0.0
1008,396,2020-03-17 06:38:00,1,1758.0,1002.0,0.57,8.038,139,66,36,30,73,40,33,1,0.0,0.0
1008,397,2020-03-17 06:41:00,1,1987.0,1086.0,0.546,9.031,249,128,95,33,121,81,40,7,0.0,0.0
1008,398,2020-03-17 06:44:00,1,1963.0,1170.0,0.596,9.03,167,97,72,25,70,49,21,3,0.0,0.0
1008,399,2020-03-17 06:47:00,1,1967.0,1138.0,0.579,9.011,3,1,0,1,2,2,0,0,0.0,0.0
1008,400,2020-03-17 06:50:00,1,1999.0,1034.0,0.517,9.023,8,1,0,1,7,4,3,0,0.0,0.0
1008,401,2020-03-17 06:53:00,1,1758.0,978.0,0.556,8.012,24,2,0,2,22,10,12,0,0.0,0.0
1008,402,2020-03-17 06:56:00,1,1777.0,924.0,0.52,8.024,9,6,1,5,3,0,3,0,0.0,0.0
1008,403,2020-03-17 06:59:00,1,1674.0,837.0,0.5,7.522,6,0,0,0,6,1,5,0,0.0,0.0
1008,404,2020-03-17 07:02:00,1,1552.0,796.0,0.513,6.997,72,24,17,7,48,25,23,0,0.0,0.0
1008,405,2020-03-17 07:05:00,1,1670.0,837.0,0.501,7.508,65,6,2,4,59,17,42,0,0.0,0.0
1008,406,2020-03-17 07:08:00,1,1677.0,824.0,0.491,7.521,6,4,2,2,2,0,2,0,0.0,0.0
1008,407,2020-03-17 07:11:00,1,1557.0,788.0,0.506,7.006,21,13,2,11,8,2,6,0,0.0,0.0
1008,408,2020-03-17 07:14:00,1,1444.0,757.0,0.524,6.529,5,2,0,2,3,1,2,0,0.0,0.0
1008,409,2020-03-17 07:17:00,1,1451.0,730.0,0.504,6.525,12,2,0,2,10,4,6,0,0.0,0.0
1008,410,2020-03-17 07:20:00,1,1445.0,754.0,0.522,6.531,1,0,0,0,1,0,1,0,0.0,0.0
1008,411,2020-03-17 07:23:00,1,1684.0,789.0,0.468,7.51,6,0,0,0,6,0,6,0,0.0,0.0
1008,412,2020-03-17 07:26:00,1,1800.0,822.0,0.457,8.004,36,0,0,0,36,0,36,0,0.0,0.0
1008,413,2020-03-17 07:29:00,1,1560.0,786.0,0.504,7.016,125,50,23,27,75,35,40,4,0.0,0.0
1008,414,2020-03-17 07:32:00,1,1982.0,1111.0,0.56,9.039,289,121,91,30,168,118,50,0,0.0,0.0
1008,415,2020-03-17 07:35:00,1,2317.0,1263.0,0.545,10.527,225,118,87,31,107,66,41,4,0.0,0.0
1008,416,2020-03-17 07:38:00,1,2311.0,1300.0,0.563,10.545,131,73,41,32,58,32,26,0,0.0,0.0
1008,417,2020-03-17 07:41:00,1,2305.0,1330.0,0.577,10.554,210,110,80,30,100,63,37,11,0.0,0.0
1008,418,2020-03-17 07:44:00,1,2312.0,1278.0,0.553,10.524,108,21,7,14,87,53,34,2,0.0,0.0
1008,419,2020-03-17 07:47:00,1,2304.0,1273.0,0.553,10.488,194,63,18,45,131,78,53,0,0.0,0.0
1008,420,2020-03-17 07:50:00,1,2319.0,1245.0,0.537,10.515,106,33,25,8,73,36,37,0,0.0,0.0
1008,421,2020-03-17 07:53:00,1,1973.0,1123.0,0.569,9.016,11,1,0,1,10,3,7,0,0.0,0.0
1008,422,2020-03-17 07:56:00,1,1984.0,1069.0,0.539,9.002,9,0,0,0,9,0,9,0,0.0,0.0
1008,423,2020-03-17 07:59:00,1,2006.0,1009.0,0.503,9.022,5,0,0,0,5,0,5,0,0.0,0.0
1008,424,2020-03-17 08:02:00,1,1772.0,934.0,0.527,8.016,61,16,10,6,45,24,21,0,0.0,0.0
1008,425,2020-03-17 08:05:00,1,1789.0,888.0,0.496,8.034,3,0,0,0,3,2,1,0,0.0,0.0
1008,426,2020-03-17 08:08:00,1,1798.0,819.0,0.456,7.99,9,9,1,8,0,0,0,0,0.0,0.0
1008,427,2020-03-17 08:11:00,1,1555.0,793.0,0.5205,7.004,33,6,3,3,27,6,21,0,0.0,0.0
1008,428,2020-03-17 08:14:00,1,1312.0,767.0,0.585,6.018,11,11,1,10,0,0,0,0,0.0,0.0
1008,429,2020-03-17 08:17:00,1,1311.0,765.0,0.583,6.011,4,4,0,4,0,0,0,0,0.0,0.0
1008,430,2020-03-17 08:20:00,1,1429.0,807.0,0.564,6.525,188,81,59,22,107,68,39,3,0.0,0.0
1008,431,2020-03-17 08:23:00,1,1402.0,921.0,0.657,6.543,122,61,48,13,61,44,17,3,0.0,0.0
1008,432,2020-03-17 08:26:00,1,1392.0,927.0,0.666,6.51,42,24,17,7,18,12,6,1,0.0,0.0
1008,433,2020-03-17 08:29:00,1,1402.0,894.0,0.638,6.513,2,2,1,1,0,0,0,0,0.0,0.0
1008,434,2020-03-17 08:32:00,1,1420.0,838.0,0.59,6.525,38,22,16,6,16,12,4,0,0.0,0.0
1008,435,2020-03-17 08:35:00,1,1437.0,777.0,0.541,6.522,4,4,1,3,0,0,0,0,0.0,0.0
1008,436,2020-03-17 08:38:00,1,1437.0,766.0,0.533,6.511,38,29,13,16,9,6,3,0,0.0,0.0
1008,437,2020-03-17 08:41:00,1,1426.0,821.0,0.576,6.527,0,0,0,0,0,0,0,0,0.0,0.0
1008,438,2020-03-17 08:44:00,1,1427.0,804.0,0.564,6.515,0,0,0,0,0,0,0,0,0.0,0.0
1008,439,2020-03-17 08:47:00,1,1416.0,836.0,0.59,6.507,0,0,0,0,0,0,0,0,0.0,0.0
1008,440,2020-03-17 08:50:00,1,1409.0,863.0,0.613,6.508,0,0,0,0,0,0,0,0,0.0,0.0
1008,441,2020-03-17 08:53:00,1,1526.0,906.0,0.594,7.016,20,6,4,2,14,1,13,0,0.0,0.0
1008,442,2020-03-17 08:56:00,1,1401.0,903.0,0.645,6.519,19,15,2,13,4,0,4,0,0.0,0.0
1008,443,2020-03-17 08:59:00,1,1410.0,862.0,0.611,6.509,14,6,3,3,8,0,8,0,0.0,0.0
1008,444,2020-03-17 09:02:00,1,1650.0,918.0,0.556,7.517,25,9,8,1,16,2,14,0,0.0,0.0
1008,445,2020-03-17 09:05:00,1,1403.0,908.0,0.647,6.532,140,69,29,40,71,26,45,7,0.0,0.0
1008,446,2020-03-17 09:08:00,1,1604.0,1097.0,0.684,7.536,68,38,18,20,30,12,18,0,0.0,0.0
1008,447,2020-03-17 09:11:00,1,1955.0,1197.0,0.612,9.029,102,69,38,31,33,20,13,2,0.0,0.0
1008,448,2020-03-17 09:14:00,1,1843.0,1127.0,0.611,8.51,44,31,0,31,13,0,13,0,0.0,0.0
1008,449,2020-03-17 09:17:00,1,1631.0,991.0,0.608,7.524,18,11,4,7,7,0,7,0,0.0,0.0
1008,450,2020-03-17 09:20:00,1,1653.0,929.0,0.562,7.541,6,4,2,2,2,0,2,0,0.0,0.0
1008,451,2020-03-17 09:23:00,1,1521.0,942.0,0.62,7.035,317,139,99,40,178,123,55,2,0.0,0.0
1008,452,2020-03-17 09:26:00,1,1623.0,1025.0,0.632,7.53,57,0,0,0,57,0,57,0,0.0,0.0
1008,453,2020-03-17 09:29:00,1,1386.0,962.0,0.694,6.527,54,16,9,7,38,25,13,0,0.0,0.0
1008,454,2020-03-17 09:32:00,1,1399.0,908.0,0.649,6.518,140,92,84,8,48,36,12,30,0.05,0.0
1008,455,2020-03-17 09:35:00,1,1373.0,1004.0,0.732,6.521,113,56,40,16,57,32,25,0,0.01,0.0
1008,456,2020-03-17 09:38:00,1,1921.0,1340.0,0.698,9.051,209,96,53,43,113,64,49,8,0.0,0.0
1008,457,2020-03-17 09:41:00,1,2137.0,1461.0,0.684,10.037,169,78,43,35,91,48,43,7,0.0,0.0
1008,458,2020-03-17 09:44:00,1,2144.0,1440.0,0.672,10.042,199,139,106,33,60,43,17,1,0.01,0.0
1008,459,2020-03-17 09:47:00,1,2142.0,1436.0,0.67,10.03,14,7,1,6,7,1,6,1,0.0,0.0
1008,460,2020-03-17 09:50:00,1,2395.0,1451.0,0.606,11.041,62,25,12,13,37,16,21,0,0.0,0.0
1008,461,2020-03-17 09:53:00,1,2155.0,1363.0,0.632,10.002,113,55,29,26,58,19,39,0,0.0,0.0
1008,462,2020-03-17 09:56:00,1,2156.0,1381.0,0.641,10.024,129,47,14,33,82,34,48,1,0.0,0.0
1008,463,2020-03-17 09:59:00,1,2163.0,1353.0,0.625,10.022,89,42,18,24,47,30,17,0,0.0,0.0
1008,464,2020-03-17 10:02:00,1,1949.0,1216.0,0.624,9.024,1,1,0,1,0,0,0,0,0.0,0.0
1008,465,2020-03-17 10:05:00,1,1971.0,1138.0,0.577,9.025,27,16,8,8,11,5,6,0,0.0,0.0
1008,466,2020-03-17 10:08:00,1,1983.0,1094.0,0.552,9.023,22,15,8,7,7,5,2,0,0.0,0.0
1008,467,2020-03-17 10:11:00,1,1621.0,1025.0,0.632,7.52,8,7,0,7,1,1,0,0,0.0,0.0
1008,468,2020-03-17 10:14:00,1,1640.0,956.0,0.583,7.521,14,13,2,11,1,1,0,0,0.0,0.0
1008,469,2020-03-17 10:17:00,1,1645.0,932.0,0.566,7.515,9,9,3,6,0,0,0,0,0.0,0.0
1008,470,2020-03-17 10:20:00,1,1737.0,1056.0,0.608,8.014,74,26,14,12,48,23,25,0,0.0,0.0
1008,471,2020-03-17 10:23:00,1,1858.0,1072.0,0.577,8.508,0,0,0,0,0,0,0,0,0.0,0.0
1008,472,2020-03-17 10:26:00,1,1620.0,1015.0,0.627,7.508,33,20,9,11,13,5,8,0,0.0,0.0
1008,473,2020-03-17 10:29:00,1,1627.0,1016.0,0.625,7.535,14,9,4,5,5,4,1,0,0.0,0.0
1008,474,2020-03-17 10:32:00,1,1632.0,989.0,0.606,7.527,501,213,162,51,288,227,61,1,0.0,0.0
1008,475,2020-03-17 10:35:00,1,1965.0,1159.0,0.59,9.026,94,65,39,26,29,25,4,0,0.0,0.0
1008,476,2020-03-17 10:38:00,1,1962.0,1161.0,0.591,9.016,0,0,0,0,0,0,0,0,0.0,0.0
1008,477,2020-03-17 10:41:00,1,1984.0,1090.0,0.549,9.024,121,60,46,14,61,50,11,0,0.0,0.0
1008,478,2020-03-17 10:44:00,1,1622.0,1019.0,0.628,7.519,1,1,1,0,0,0,0,0,0.01,0.0
1008,479,2020-03-17 10:47:00,1,1633.0,968.0,0.593,7.507,3,3,0,3,0,0,0,0,0.0,0.0
1008,480,2020-03-17 10:50:00,1,1663.0,879.0,0.529,7.525,42,27,19,8,15,9,6,0,0.0,0.0
1008,481,2020-03-17 10:53:00,1,1656.0,895.0,0.541,7.517,1,1,0,1,0,0,0,0,0.0,0.0
1008,482,2020-03-17 10:56:00,1,1651.0,923.0,0.559,7.526,10,10,1,9,0,0,0,0,0.0,0.0
1008,483,2020-03-17 10:59:00,1,1636.0,956.0,0.584,7.505,3,1,1,0,2,1,1,0,0.0,0.0
1008,484,2020-03-17 11:02:00,1,1652.0,894.0,0.541,7.5,1,1,0,1,0,0,0,0,0.0,0.0
1008,485,2020-03-17 11:05:00,1,1658.0,890.0,0.537,7.518,3,1,0,1,2,0,2,0,0.0,0.0
1008,486,2020-03-17 11:08:00,1,1648.0,934.0,0.567,7.527,38,12,0,12,26,0,26,0,0.0,0.0
1008,487,2020-03-17 11:11:00,1,1639.5,961.5,0.587,7.524,8,5,0,5,3,0,3,0,0.0,0.0
1008,488,2020-03-17 11:14:00,1,1631.0,989.0,0.607,7.521,20,20,0,20,0,0,0,0,0.0,0.0
1008,489,2020-03-17 11:17:00,1,1391.0,945.0,0.679,6.527,30,20,6,14,10,0,10,4,0.0,0.0
1008,490,2020-03-17 11:20:00,1,1719.0,1125.0,0.654,8.019,141,60,35,25,81,48,33,7,0.0,0.0
1008,491,2020-03-17 11:23:00,1,1937.0,1243.0,0.642,9.01,206,118,81,37,88,52,36,6,0.0,0.0
1008,492,2020-03-17 11:26:00,1,1925.0,1279.0,0.665,9.0,206,128,91,37,78,50,28,9,0.0,0.0
1008,493,2020-03-17 11:29:00,1,1938.0,1260.0,0.65,9.032,79,61,34,27,18,8,10,0,0.0,0.0
1008,494,2020-03-17 11:32:00,1,1723.0,1129.0,0.655,8.038,0,0,0,0,0,0,0,0,0.0,0.0
1008,495,2020-03-17 11:35:00,1,1742.0,1046.0,0.601,8.022,14,4,1,3,10,5,5,0,0.0,0.0
1008,496,2020-03-17 11:38:00,1,1631.0,983.0,0.603,7.513,42,5,0,5,37,0,37,0,0.0,0.0
1008,497,2020-03-17 11:41:00,1,1396.0,919.0,0.658,6.517,17,4,1,3,13,0,13,0,0.0,0.0
1008,498,2020-03-17 11:44:00,1,1408.0,878.0,0.623,6.519,8,0,0,0,8,0,8,0,0.0,0.0
1008,499,2020-03-17 11:47:00,1,1405.0,896.0,0.637,6.53,11,1,1,0,10,0,10,0,0.0,0.0
1008,500,2020-03-17 11:50:00,1,1404.0,898.0,0.64,6.526,11,0,0,0,11,0,11,0,0.0,0.0
1008,501,2020-03-17 11:53:00,1,1398.0,911.0,0.651,6.515,29,1,0,1,28,0,28,0,0.0,0.0
1008,502,2020-03-17 11:56:00,1,1404.0,890.0,0.634,6.517,29,3,2,1,26,2,24,0,0.0,0.0
1008,503,2020-03-17 11:59:00,1,1402.0,897.0,0.64,6.517,28,0,0,0,28,0,28,0,0.0,0.0
1008,504,2020-03-17 12:02:00,1,1407.0,867.0,0.617,6.502,20,9,2,7,11,2,9,0,0.0,0.0
1008,505,2020-03-17 12:05:00,1,1405.0,894.0,0.637,6.525,143,84,45,39,59,26,33,0,0.0,0.0
1008,506,2020-03-17 12:08:00,1,1744.0,1034.0,0.593,8.017,178,67,33,34,111,62,49,5,0.0,0.0
1008,507,2020-03-17 12:11:00,1,1721.0,1127.0,0.655,8.03,183,126,94,32,57,35,22,0,0.0,0.0
1008,508,2020-03-17 12:14:00,1,1948.0,1211.0,0.622,9.015,446,178,137,41,268,195,73,13,0.0,0.0
1008,509,2020-03-17 12:17:00,1,2053.0,1303.0,0.635,9.531,452,220,186,34,232,180,52,16,0.0,0.0
1008,510,2020-03-17 12:20:00,1,1935.0,1264.0,0.653,9.024,12,12,0,12,0,0,0,0,0.0,0.0
1008,511,2020-03-17 12:23:00,1,1972.0,1149.0,0.583,9.041,0,0,0,0,0,0,0,0,0.0,0.0
1008,512,2020-03-17 12:26:00,1,1748.0,1027.0,0.588,8.024,14,2,0,2,12,4,8,0,0.0,0.0
1008,513,2020-03-17 12:29:00,1,1768.0,954.0,0.539,8.024,14,3,3,0,11,4,7,0,0.0,0.0
1008,514,2020-03-17 12:32:00,1,1524.0,913.0,0.599,7.016,9,0,0,0,9,0,9,0,0.0,0.0
1008,515,2020-03-17 12:35:00,1,1403.0,893.0,0.637,6.518,17,0,0,0,17,0,17,0,0.0,0.0
1008,516,2020-03-17 12:38:00,1,1410.0,863.0,0.612,6.513,5,0,0,0,5,2,3,0,0.0,0.0
1008,517,2020-03-17 12:41:00,1,1529.0,899.0,0.588,7.02,26,9,4,5,17,5,12,0,0.0,0.0
1008,518,2020-03-17 12:44:00,1,1647.0,943.0,0.573,7.534,18,7,3,4,11,4,7,0,0.0,0.0
1008,519,2020-03-17 12:47:00,1,1434.0,781.0,0.544,6.516,0,0,0,0,0,0,0,0,0.0,0.0
1008,520,2020-03-17 12:50:00,1,1420.0,844.0,0.594,6.529,1,0,0,0,1,0,1,0,0.0,0.0
1008,521,2020-03-17 12:53:00,1,1404.0,902.0,0.642,6.531,2,0,0,0,2,0,2,0,0.0,0.0
1008,522,2020-03-17 12:56:00,1,1649.0,922.0,0.559,7.52,0,0,0,0,0,0,0,0,0.0,0.0
1008,523,2020-03-17 12:59:00,1,1653.0,901.0,0.545,7.51,0,0,0,0,0,0,0,0,0.0,0.0
1008,524,2020-03-17 13:02:00,1,1408.0,871.0,0.619,6.512,0,0,0,0,0,0,0,0,0.0,0.0
1008,525,2020-03-17 13:05:00,1,1403.0,893.0,0.636,6.518,11,6,2,4,5,2,3,0,0.0,0.0
1008,526,2020-03-17 13:08:00,1,1644.0,952.0,0.579,7.53,8,0,0,0,8,0,8,0,0.0,0.0
1008,527,2020-03-17 13:11:00,1,1400.0,918.0,0.656,6.532,4,1,1,0,3,0,3,0,0.0,0.0
1008,528,2020-03-17 13:14:00,1,1751.0,998.0,0.57,8.006,194,82,58,24,112,67,45,5,0.0,0.0
1008,529,2020-03-17 13:17:00,1,1749.0,1006.0,0.575,8.006,13,0,0,0,13,2,11,0,0.0,0.0
1008,530,2020-03-17 13:20:00,1,1753.0,995.0,0.568,8.011,472,209,162,47,263,209,54,2,0.0,0.0
1008,531,2020-03-17 13:23:00,1,1851.0,1113.0,0.601,8.526,77,33,4,29,44,21,23,2,0.0,0.0
1008,532,2020-03-17 13:26:00,1,1952.0,1196.0,0.612,9.016,163,28,0,28,135,90,45,16,0.0,0.0
1008,533,2020-03-17 13:29:00,1,2196.0,1257.0,0.572,10.046,117,35,8,27,82,51,31,5,0.0,0.0
1008,534,2020-03-17 13:32:00,1,2186.0,1267.0,0.58,10.016,180,81,48,33,99,65,34,4,0.0,0.0
1008,535,2020-03-17 13:35:00,1,2301.0,1294.0,0.562,10.499,110,64,25,39,46,13,33,0,0.0,0.0
1008,536,2020-03-17 13:38:00,1,1956.0,1195.0,0.611,9.031,35,20,3,17,15,8,7,0,0.0,0.0
1008,537,2020-03-17 13:41:00,1,1984.0,1106.0,0.558,9.041,2,0,0,0,2,1,1,0,0.0,0.0
1008,538,2020-03-17 13:44:00,1,1756.0,983.0,0.56,8.009,4,0,0,0,4,0,4,0,0.0,0.0
1008,539,2020-03-17 13:47:00,1,1767.0,970.0,0.549,8.037,10,4,1,3,6,0,6,0,0.0,0.0
1008,540,2020-03-17 13:50:00,1,1774.0,930.0,0.524,8.02,28,7,1,6,21,4,17,0,0.0,0.0
1008,541,2020-03-17 13:53:00,1,1760.0,971.0,0.552,8.01,111,70,59,11,41,33,8,0,0.01,0.0
1008,542,2020-03-17 13:56:00,1,1752.0,1017.0,0.58,8.031,0,0,0,0,0,0,0,0,0.0,0.0
1008,543,2020-03-17 13:59:00,1,1655.0,887.0,0.536,7.502,15,15,0,15,0,0,0,0,0.0,0.0
1008,544,2020-03-17 14:02:00,1,1530.0,880.0,0.575,7.004,4,4,0,4,0,0,0,0,0.0,0.0
1008,545,2020-03-17 14:05:00,1,1774.0,939.0,0.53,8.029,1,0,0,0,1,1,0,0,0.0,0.0
1008,546,2020-03-17 14:08:00,1,1768.0,937.0,0.53,8.003,31,18,8,10,13,7,6,0,0.0,0.0
1008,547,2020-03-17 14:11:00,1,1704.0,946.5,0.5565,7.7615,2,2,1,1,0,0,0,0,0.0,0.0
1008,548,2020-03-17 14:14:00,1,1640.0,956.0,0.583,7.52,6,6,0,6,0,0,0,0,0.0,0.0
1008,549,2020-03-17 14:17:00,1,1619.0,1024.0,0.632,7.514,2,2,0,2,0,0,0,0,0.0,0.0
1008,550,2020-03-17 14:20:00,1,1627.0,992.0,0.609,7.509,3,3,0,3,0,0,0,0,0.0,0.0
1008,551,2020-03-17 14:23:00,1,1631.0,981.0,0.601,7.513,5,5,2,3,0,0,0,0,0.0,0.0
1008,552,2020-03-17 14:26:00,1,1639.0,973.0,0.594,7.535,1,1,1,0,0,0,0,0,0.0,0.0
1008,553,2020-03-17 14:29:00,1,1638.0,969.0,0.592,7.526,125,44,30,14,81,58,23,0,0.0,0.0
1008,554,2020-03-17 14:32:00,1,1639.0,955.0,0.583,7.518,0,0,0,0,0,0,0,0,0.0,0.0
1008,555,2020-03-17 14:35:00,1,1641.0,941.0,0.574,7.509,11,5,1,4,6,1,5,0,0.0,0.0
1008,556,2020-03-17 14:38:00,1,1637.0,960.0,0.586,7.513,12,0,0,0,12,4,8,0,0.0,0.0
1008,557,2020-03-17 14:41:00,1,1631.0,986.0,0.605,7.518,28,1,0,1,27,0,27,0,0.0,0.0
1008,558,2020-03-17 14:44:00,1,1643.0,953.0,0.58,7.528,28,18,6,12,10,4,6,0,0.0,0.0
1008,559,2020-03-17 14:47:00,1,1641.0,950.0,0.579,7.517,0,0,0,0,0,0,0,0,0.0,0.0
1008,560,2020-03-17 14:50:00,1,1658.0,909.0,0.548,7.538,15,10,5,5,5,0,5,0,0.0,0.0
1008,561,2020-03-17 14:53:00,1,1652.0,923.0,0.559,7.533,8,6,3,3,2,0,2,0,0.0,0.0
1008,562,2020-03-17 14:56:00,1,1654.0,903.0,0.546,7.519,41,20,8,12,21,0,21,0,0.0,0.0
1008,563,2020-03-17 14:59:00,1,1661.0,883.0,0.531,7.524,75,13,1,12,62,0,62,0,0.0,0.0
1008,564,2020-03-17 15:02:00,1,1662.0,874.0,0.526,7.517,135,93,50,43,42,19,23,0,0.0,0.0
1008,565,2020-03-17 15:05:00,1,1623.0,1023.0,0.63,7.529,143,52,11,41,91,43,48,7,0.0,0.0
1008,566,2020-03-17 15:08:00,1,1835.0,1161.0,0.633,8.516,249,127,102,25,122,78,44,2,0.0,0.0
1008,567,2020-03-17 15:11:00,1,1956.0,1171.0,0.599,9.003,106,50,26,24,56,20,36,0,0.0,0.0
1008,568,2020-03-17 15:14:00,1,1959.0,1166.0,0.595,9.009,197,57,21,36,140,85,55,0,0.0,0.0
1008,569,2020-03-17 15:17:00,1,2200.0,1236.0,0.562,10.036,165,52,16,36,113,62,51,1,0.0,0.0
1008,570,2020-03-17 15:20:00,1,2172.0,1318.0,0.607,10.018,302,161,132,29,141,88,53,5,0.0,0.0
1008,571,2020-03-17 15:23:00,1,2183.0,1288.0,0.59,10.027,14,2,0,2,12,1,11,0,0.0,0.0
1008,572,2020-03-17 15:26:00,1,2092.0,1156.0,0.552,9.523,20,19,0,19,1,0,1,0,0.0,0.0
1008,573,2020-03-17 15:29:00,1,1861.0,1059.0,0.569,8.505,10,10,3,7,0,0,0,0,0.0,0.0
1008,574,2020-03-17 15:32:00,1,1752.0,1004.0,0.573,8.015,15,15,0,15,0,0,0,0,0.0,0.0
1008,575,2020-03-17 15:35:00,1,1873.0,1041.0,0.556,8.532,2,2,0,2,0,0,0,0,0.0,0.0
1008,576,2020-03-17 15:38:00,1,1873.0,1014.0,0.541,8.505,6,6,1,5,0,0,0,0,0.0,0.0
1008,577,2020-03-17 15:41:00,1,1874.0,1017.0,0.543,8.509,7,7,0,7,0,0,0,0,0.01,0.0
1008,578,2020-03-17 15:44:00,1,1633.0,983.0,0.602,7.521,54,28,17,11,26,8,18,0,0.0,0.0
1008,579,2020-03-17 15:47:00,1,1876.0,1022.0,0.545,8.522,17,1,1,0,16,1,15,0,0.0,0.0
1008,580,2020-03-17 15:50:00,1,1754.0,1000.0,0.57,8.019,10,0,0,0,10,2,8,0,0.0,0.0
1008,581,2020-03-17 15:53:00,1,1644.0,947.0,0.576,7.524,49,3,1,2,46,10,36,0,0.0,0.0
1008,582,2020-03-17 15:56:00,1,1631.0,984.0,0.604,7.515,57,11,6,5,46,25,21,0,0.0,0.0
1008,583,2020-03-17 15:59:00,1,1627.0,997.0,0.613,7.513,10,0,0,0,10,0,10,0,0.0,0.0
1008,584,2020-03-17 16:02:00,1,1875.0,1022.0,0.545,8.52,13,3,1,2,10,0,10,0,0.0,0.0
1008,585,2020-03-17 16:05:00,1,1875.0,1006.0,0.536,8.504,72,25,18,7,47,8,39,0,0.0,0.0
1008,586,2020-03-17 16:08:00,1,1867.0,1027.0,0.55,8.493,3,2,1,1,1,0,1,0,0.0,0.0
1008,587,2020-03-17 16:11:00,1,1755.0,1012.0,0.577,8.035,196,65,47,18,131,94,37,1,0.0,0.0
1008,588,2020-03-17 16:14:00,1,1854.0,1109.0,0.598,8.534,96,18,5,13,78,44,34,0,0.0,0.0
1008,589,2020-03-17 16:17:00,1,2203.0,1219.0,0.553,10.032,212,105,57,48,107,64,43,6,0.0,0.0
1008,590,2020-03-17 16:20:00,1,2171.0,1334.0,0.615,10.03,306,197,155,42,109,85,24,12,0.0,0.0
1008,591,2020-03-17 16:23:00,1,2298.0,1325.0,0.576,10.523,227,173,132,41,54,37,17,24,0.0,0.0
1008,592,2020-03-17 16:26:00,1,2520.0,1439.0,0.571,11.523,229,144,112,32,85,67,18,14,0.0,0.0
1008,593,2020-03-17 16:29:00,1,2523.0,1439.0,0.571,11.533,164,92,60,32,72,46,26,1,0.0,0.0
1008,594,2020-03-17 16:32:00,1,2531.0,1407.0,0.556,11.53,41,22,13,9,19,8,11,0,0.0,0.0
1008,595,2020-03-17 16:35:00,1,2421.0,1341.0,0.554,11.026,34,16,11,5,18,6,12,0,0.0,0.0
1008,596,2020-03-17 16:38:00,1,2206.0,1189.0,0.539,10.01,12,4,0,4,8,4,4,0,0.0,0.0
1008,597,2020-03-17 16:41:00,1,1855.0,1093.0,0.589,8.518,3,3,1,2,0,0,0,0,0.0,0.0
1008,598,2020-03-17 16:44:00,1,1872.0,1021.0,0.546,8.507,10,10,1,9,0,0,0,0,0.0,0.0
1008,599,2020-03-17 16:47:00,1,1647.0,939.0,0.57,7.529,14,10,4,6,4,2,2,0,0.0,0.0
1008,600,2020-03-17 16:50:00,1,1676.0,792.0,0.472,7.483,38,8,2,6,30,0,30,0,0.0,0.0
1008,601,2020-03-17 16:53:00,1,1328.0,699.0,0.526,6.009,16,9,1,8,7,3,4,0,0.0,0.0
1008,602,2020-03-17 16:56:00,1,1675.0,818.0,0.488,7.507,24,24,2,22,0,0,0,0,0.0,0.0
1008,603,2020-03-17 16:59:00,1,1878.0,1002.0,0.533,8.508,41,34,17,17,7,4,3,0,0.0,0.0
1008,604,2020-03-17 17:02:00,1,1986.0,1071.0,0.539,9.009,34,16,6,10,18,10,8,0,0.0,0.0
1008,605,2020-03-17 17:05:00,1,1980.0,1094.0,0.553,9.015,42,6,0,6,36,1,35,0,0.0,0.0
1008,606,2020-03-17 17:08:00,1,1860.0,1077.0,0.579,8.521,15,3,1,2,12,7,5,0,0.0,0.0
1008,607,2020-03-17 17:11:00,1,1850.5,1103.0,0.596,8.512,21,14,5,9,7,4,3,0,0.0,0.0
1008,608,2020-03-17 17:14:00,1,1841.0,1129.0,0.613,8.503,9,8,2,6,1,1,0,0,0.0,0.0
1008,609,2020-03-17 17:17:00,1,1617.0,1049.0,0.649,7.533,4,2,1,1,2,0,2,0,0.0,0.0
1008,610,2020-03-17 17:20:00,1,1626.0,1004.0,0.618,7.517,9,9,2,7,0,0,0,0,0.0,0.0
1008,611,2020-03-17 17:23:00,1,1633.0,981.0,0.6,7.52,70,41,23,18,29,13,16,0,0.0,0.0
1008,612,2020-03-17 17:26:00,1,1963.0,1138.0,0.58,8.995,220,122,70,52,98,53,45,6,0.0,0.0
1008,613,2020-03-17 17:29:00,1,1938.0,1273.0,0.657,9.045,253,107,68,39,146,97,49,4,0.0,0.0
1008,614,2020-03-17 17:32:00,1,1927.0,1272.0,0.66,9.001,4,0,0,0,4,0,4,0,0.0,0.0
1008,615,2020-03-17 17:35:00,1,1841.0,1135.0,0.617,8.51,2,0,0,0,2,0,2,0,0.0,0.0
1008,616,2020-03-17 17:38:00,1,1603.0,1088.0,0.679,7.52,5,0,0,0,5,2,3,0,0.0,0.0
1008,617,2020-03-17 17:41:00,1,1604.0,1075.0,0.67,7.512,21,20,0,20,1,1,0,0,0.0,0.0
1008,618,2020-03-17 17:44:00,1,1730.0,1097.0,0.634,8.033,14,5,0,5,9,0,9,0,0.0,0.0
1008,619,2020-03-17 17:47:00,1,1607.0,1071.0,0.666,7.517,19,6,0,6,13,2,11,0,0.0,0.0
1008,620,2020-03-17 17:50:00,1,1725.0,1096.0,0.635,8.01,30,17,0,17,13,0,13,0,0.0,0.0
1008,621,2020-03-17 17:53:00,1,1862.0,1097.0,0.589,8.55,174,98,66,32,76,50,26,17,0.0,0.0
1008,622,2020-03-17 17:56:00,1,1954.0,1203.0,0.615,9.033,76,43,26,17,33,15,18,1,0.0,0.0
1008,623,2020-03-17 17:59:00,1,1965.0,1161.0,0.591,9.028,4,0,0,0,4,3,1,0,0.0,0.0
1008,624,2020-03-17 18:02:00,0,1620.0,1037.0,0.64,7.529,8,0,0,0,8,1,7,0,0.0,0.0
1008,625,2020-03-17 18:05:00,0,1629.0,991.0,0.608,7.515,7,0,0,0,7,2,5,0,0.0,0.0
1008,626,2020-03-17 18:08:00,0,1622.0,1008.0,0.621,7.508,73,8,2,6,65,35,30,3,0.0,0.0
1008,627,2020-03-17 18:11:00,0,1956.0,1196.0,0.611,9.032,457,216,159,57,241,172,69,31,0.0,0.0
1008,628,2020-03-17 18:14:00,0,2250.0,1478.0,0.657,10.502,562,398,328,70,164,133,31,37,0.0,0.0
1008,629,2020-03-17 18:17:00,0,2504.0,1515.0,0.605,11.542,338,230,186,44,108,74,34,30,0.0,0.0
1008,630,2020-03-17 18:20:00,0,2493.0,1553.0,0.623,11.542,280,151,111,40,129,84,45,31,0.0,0.0
1008,631,2020-03-17 18:23:00,0,2496.0,1506.0,0.603,11.504,319,176,146,30,143,96,47,26,0.0,0.0
1008,632,2020-03-17 18:26:00,0,2473.0,1633.0,0.66,11.554,435,205,141,64,230,165,65,20,0.0,0.0
1008,633,2020-03-17 18:29:00,0,2472.0,1608.0,0.651,11.52,482,261,209,52,221,168,53,18,0.0,0.0
1008,634,2020-03-17 18:32:00,0,2489.0,1552.0,0.623,11.527,265,163,117,46,102,85,17,15,0.0,0.0
1008,635,2020-03-17 18:35:00,0,2490.0,1529.0,0.614,11.505,352,242,186,56,110,91,19,23,0.0,0.0
1008,636,2020-03-17 18:38:00,0,2501.0,1509.0,0.603,11.526,332,213,160,53,119,95,24,18,0.0,0.0
1008,637,2020-03-17 18:41:00,0,2261.0,1444.0,0.639,10.508,417,283,237,46,134,110,24,33,0.0,0.0
1008,638,2020-03-17 18:44:00,0,2262.0,1456.0,0.644,10.526,416,292,242,50,124,94,30,28,0.0,0.0
1008,639,2020-03-17 18:47:00,0,2476.0,1600.0,0.646,11.528,691,471,399,72,220,171,49,30,0.0,0.0
1008,640,2020-03-17 18:50:00,0,2486.0,1575.0,0.633,11.537,339,257,210,47,82,64,18,30,0.0,0.0
1008,641,2020-03-17 18:53:00,0,2271.0,1433.0,0.631,10.534,305,209,149,60,96,61,35,31,0.0,0.0
1008,642,2020-03-17 18:56:00,0,2471.0,1636.0,0.662,11.547,612,402,350,52,210,157,53,17,0.0,0.0
1008,643,2020-03-17 18:59:00,0,2597.0,1649.0,0.635,12.059,326,185,148,37,141,95,46,25,0.0,0.0
1008,644,2020-03-17 19:02:00,0,2829.0,1724.0,0.609,13.055,228,162,110,52,66,29,37,15,0.0,0.0
1008,645,2020-03-17 19:05:00,0,2468.0,1625.0,0.659,11.522,633,395,344,51,238,185,53,37,0.0,0.0
1008,646,2020-03-17 19:08:00,0,2477.0,1617.0,0.653,11.552,663,450,384,66,213,166,47,30,0.0,0.0
1008,647,2020-03-17 19:11:00,0,2485.0,1555.0,0.626,11.514,470,308,257,51,162,124,38,35,0.0,0.0
1008,648,2020-03-17 19:14:00,0,2711.0,1680.0,0.62,12.543,541,266,215,51,275,212,63,14,0.0,0.0
1008,649,2020-03-17 19:17:00,0,2476.0,1600.0,0.646,11.529,530,296,237,59,234,180,54,27,0.0,0.0
1008,650,2020-03-17 19:20:00,0,2716.0,1658.0,0.61,12.539,390,227,182,45,163,126,37,22,0.0,0.0
1008,651,2020-03-17 19:23:00,0,2380.0,1482.0,0.623,11.02,263,176,146,30,87,73,14,23,0.0,0.0
1008,652,2020-03-17 19:26:00,0,2180.0,1280.0,0.587,10.006,8,8,1,7,0,0,0,0,0.0,0.0
1008,653,2020-03-17 19:29:00,0,1943.0,1244.0,0.64,9.033,17,17,3,14,0,0,0,0,0.0,0.0
1008,654,2020-03-17 19:32:00,0,1953.0,1209.0,0.619,9.032,44,41,33,8,3,3,0,0,0.0,0.0
1008,655,2020-03-17 19:35:00,0,1962.0,1151.0,0.587,9.005,0,0,0,0,0,0,0,0,0.0,0.0
1008,656,2020-03-17 19:38:00,0,1850.0,1109.0,0.599,8.519,168,155,111,44,13,11,2,25,0.0,0.0
1008,657,2020-03-17 19:41:00,0,2294.0,1346.0,0.587,10.529,362,306,263,43,56,41,15,87,0.0,0.0
1008,658,2020-03-17 19:44:00,0,2255.0,1477.0,0.655,10.52,168,155,113,42,13,7,6,67,0.0,0.0
1008,659,2020-03-17 19:47:00,0,2497.0,1520.0,0.609,11.52,277,215,150,65,62,46,16,98,0.0,0.0
1008,660,2020-03-17 19:50:00,0,2595.0,1621.0,0.625,12.021,397,303,226,77,94,70,24,95,0.0,0.0
1008,661,2020-03-17 19:53:00,0,2473.0,1625.0,0.657,11.545,275,222,157,65,53,39,14,108,0.0,0.0
1008,662,2020-03-17 19:56:00,0,2576.0,1709.0,0.663,12.042,507,370,303,67,137,100,37,101,0.0,0.0
1008,663,2020-03-17 19:59:00,0,2815.0,1759.0,0.625,13.039,194,174,110,64,20,13,7,90,0.0,0.0
1008,664,2020-03-17 20:02:00,0,2784.0,1880.0,0.675,13.049,142,124,70,54,18,4,14,99,0.0,0.0
1008,665,2020-03-17 20:05:00,0,3005.0,1971.0,0.656,14.024,503,364,285,79,139,102,37,119,0.0,0.0
1008,666,2020-03-17 20:08:00,0,2758.0,1947.0,0.706,13.023,609,460,389,71,149,120,29,55,0.0,0.09
1008,667,2020-03-17 20:11:00,0,2604.5,1807.5,0.693,12.2635,221,30,7,23,191,115,76,34,0.0,0.0
1008,668,2020-03-17 20:14:00,0,2451.0,1668.0,0.68,11.504,400,249,179,70,151,117,34,68,0.0,0.0
1008,669,2020-03-17 20:17:00,0,3295.0,2311.0,0.701,15.539,236,200,127,73,36,24,12,103,0.0,0.0
1008,670,2020-03-17 20:20:00,0,3303.0,2289.0,0.693,15.55,197,144,104,40,53,32,21,45,0.0,0.44
1008,671,2020-03-17 20:23:00,0,2953.0,2170.0,0.735,14.038,779,569,497,72,210,164,46,44,0.0,0.02
1008,672,2020-03-17 20:26:00,0,2772.0,1894.0,0.683,13.021,396,288,242,46,108,83,25,18,0.0,0.0
1008,673,2020-03-17 20:29:00,0,1596.0,1108.0,0.694,7.516,102,24,15,9,78,41,37,4,0.0,0.0
1008,674,2020-03-17 20:32:00,0,3053.0,2285.0,0.748,14.558,192,177,118,59,15,3,12,93,0.0,0.14
1008,675,2020-03-17 20:35:00,0,3273.0,2410.0,0.736,15.562,408,297,234,63,111,82,29,61,0.0,0.0
1008,676,2020-03-17 20:38:00,0,1930.0,1304.0,0.676,9.05,219,103,67,36,116,74,42,31,0.0,0.0
1008,677,2020-03-17 20:41:00,0,2849.0,2086.0,0.732,13.536,353,155,114,41,198,133,65,41,0.0,0.0
1008,678,2020-03-17 20:44:00,0,2941.0,2239.0,0.761,14.067,384,223,180,43,161,125,36,61,0.0,0.0
1008,679,2020-03-17 20:47:00,0,2254.0,1488.0,0.66,10.528,267,89,58,31,178,120,58,10,0.0,0.0
1008,680,2020-03-17 20:50:00,0,2947.0,2203.0,0.748,14.052,547,278,216,62,269,205,64,32,0.0,0.0
1008,681,2020-03-17 20:53:00,0,2145.0,1417.0,0.661,10.02,66,17,7,10,49,30,19,0,0.0,0.0
1008,682,2020-03-17 20:56:00,0,2038.0,1365.0,0.67,9.542,163,64,44,20,99,65,34,6,0.0,0.0
1008,683,2020-03-17 20:59:00,0,2927.0,2295.0,0.784,14.074,104,98,52,46,6,3,3,59,0.0,0.02
1008,684,2020-03-17 21:02:00,0,3266.0,2470.0,0.756,15.603,107,90,57,33,17,13,4,32,0.0,0.01
1008,685,2020-03-17 21:05:00,0,2915.0,2313.0,0.793,14.046,449,308,252,56,141,106,35,72,0.0,0.02
1008,686,2020-03-17 21:08:00,0,2953.0,2173.0,0.736,14.039,110,94,70,24,16,7,9,13,0.0,0.01
1008,687,2020-03-17 21:11:00,0,2942.0,2246.0,0.764,14.078,163,126,63,63,37,23,14,63,0.0,0.12
1008,688,2020-03-17 21:14:00,0,2736.0,2095.0,0.766,13.099,100,70,47,23,30,14,16,27,0.0,0.04
1008,689,2020-03-17 21:17:00,0,2648.0,1907.0,0.72,12.546,249,190,150,40,59,42,17,7,0.0,0.0
1008,690,2020-03-17 21:20:00,0,2412.0,1842.0,0.764,11.543,272,114,74,40,158,99,59,7,0.0,0.03
1008,691,2020-03-17 21:23:00,0,2840.0,2140.0,0.754,13.557,326,186,146,40,140,108,32,12,0.0,0.0
1008,692,2020-03-17 21:26:00,0,2714.0,2121.0,0.782,13.041,90,77,49,28,13,7,6,35,0.0,0.0
1008,693,2020-03-17 21:29:00,0,2936.0,2244.0,0.764,14.05,313,240,190,50,73,49,24,82,0.0,0.03
1008,694,2020-03-17 21:32:00,0,2725.0,2129.0,0.781,13.093,868,642,566,76,226,188,38,230,0.0,0.0
1008,695,2020-03-17 21:35:00,0,3255.0,2463.0,0.757,15.553,901,646,571,75,255,197,58,152,0.0,0.0
1008,696,2020-03-17 21:38:00,0,3141.0,2400.0,0.764,15.034,973,655,590,65,318,256,62,35,0.4,0.13
1008,697,2020-03-17 21:41:00,0,3165.0,2368.0,0.748,15.092,385,256,223,33,129,103,26,28,0.0,0.0
1008,698,2020-03-17 21:44:00,0,2967.0,2110.0,0.711,14.028,41,37,20,17,4,3,1,33,0.0,0.0
1008,699,2020-03-17 21:47:00,0,2851.0,2089.0,0.733,13.547,590,406,351,55,184,143,41,152,0.0,0.0
1008,700,2020-03-17 21:50:00,0,3275.0,2430.0,0.742,15.594,513,260,225,35,253,174,79,23,0.08,0.0
1008,701,2020-03-17 21:53:00,0,3228.0,2540.0,0.787,15.529,800,380,333,47,420,317,103,40,0.17,0.0
1008,702,2020-03-17 21:56:00,0,3248.0,2497.0,0.769,15.561,210,96,79,17,114,77,37,6,0.31,0.0
1008,703,2020-03-17 21:59:00,0,3235.0,2537.0,0.784,15.556,339,148,104,44,191,128,63,28,0.15,0.0
1008,704,2020-03-17 22:02:00,0,2963.0,2157.0,0.728,14.065,653,279,227,52,374,271,103,22,0.07,0.0
1008,705,2020-03-17 22:05:00,0,3028.0,2363.0,0.78,14.546,741,422,344,78,319,241,78,7,0.21,0.0
1008,706,2020-03-17 22:08:00,0,3259.0,2432.0,0.746,15.535,178,143,77,66,35,25,10,60,0.0,0.0
1008,707,2020-03-17 22:11:00,0,2905.0,2347.0,0.808,14.045,414,217,167,50,197,140,57,20,0.02,0.0
1008,708,2020-03-17 22:14:00,0,2922.0,2302.0,0.788,14.062,379,195,148,47,184,132,52,29,0.23,0.0
1008,709,2020-03-17 22:17:00,0,2959.0,2134.0,0.721,14.021,101,93,49,44,8,2,6,14,0.0,0.0
1008,710,2020-03-17 22:20:00,0,3278.0,2399.0,0.732,15.571,160,124,72,52,36,12,24,14,0.0,0.0
1008,711,2020-03-17 22:23:00,0,2933.0,2239.0,0.763,14.035,432,263,212,51,169,112,57,6,0.04,0.0
1008,712,2020-03-17 22:26:00,0,3153.0,2393.0,0.759,15.072,575,325,268,57,250,187,63,39,0.22,0.0
1008,713,2020-03-17 22:29:00,0,2946.0,2190.0,0.743,14.032,307,226,182,44,81,63,18,76,0.0,0.0
1008,714,2020-03-17 22:32:00,0,3039.0,2344.0,0.771,14.57,153,124,85,39,29,20,9,57,0.0,0.0
1008,715,2020-03-17 22:35:00,0,2833.0,2154.0,0.76,13.548,370,212,177,35,158,106,52,25,0.21,0.0
1008,716,2020-03-17 22:38:00,0,2428.0,1771.0,0.73,11.528,60,17,10,7,43,28,15,2,0.0,0.0
1008,717,2020-03-17 22:41:00,0,2221.0,1613.0,0.726,10.535,48,4,1,3,44,11,33,0,0.0,0.0
1008,718,2020-03-17 22:44:00,0,2538.0,1862.0,0.734,12.061,314,146,106,40,168,99,69,23,0.0,0.0
1008,719,2020-03-17 22:47:00,0,2952.0,2169.0,0.735,14.033,124,64,34,30,60,29,31,4,0.0,0.0
1008,720,2020-03-17 22:50:00,0,3262.0,2446.0,0.75,15.561,476,232,178,54,244,180,64,22,0.0,0.0
1008,721,2020-03-17 22:53:00,0,2901.0,2364.0,0.815,14.049,491,219,176,43,272,200,72,3,0.0,0.0
1008,722,2020-03-17 22:56:00,0,2952.0,2181.0,0.739,14.048,236,92,44,48,144,67,77,4,0.0,0.0
1008,723,2020-03-17 22:59:00,0,3244.0,2516.0,0.776,15.569,339,67,32,35,272,184,88,1,0.0,0.0
1008,724,2020-03-17 23:02:00,0,3250.0,2506.0,0.771,15.578,483,200,146,54,283,200,83,14,0.12,0.0
1008,725,2020-03-17 23:05:00,0,3262.0,2441.0,0.748,15.556,38,21,7,14,17,10,7,0,0.0,0.0
1008,726,2020-03-17 23:08:00,0,2960.0,2188.0,0.739,14.085,44,20,6,14,24,9,15,0,0.0,0.0
1008,727,2020-03-17 23:11:00,0,2728.0,2093.0,0.77,13.0665,88,1,0,1,87,16,71,0,0.0,0.0
1008,728,2020-03-17 23:14:00,0,2496.0,1998.0,0.801,12.048,273,110,63,47,163,112,51,30,0.0,0.0
1008,729,2020-03-17 23:17:00,0,2669.0,2297.0,0.861,13.059,305,194,146,48,111,91,20,73,0.0,0.02
1008,730,2020-03-17 23:20:00,0,2998.0,2471.0,0.824,14.549,619,343,281,62,276,205,71,51,0.24,0.0
1008,731,2020-03-17 23:23:00,0,2893.0,2394.0,0.828,14.048,372,247,195,52,125,92,33,89,0.0,0.0
1008,732,2020-03-17 23:26:00,0,3005.0,2467.0,0.821,14.571,248,138,91,47,110,80,30,51,0.0,0.01
1008,733,2020-03-17 23:29:00,0,1978.0,1570.0,0.794,9.529,72,31,10,21,41,17,24,2,0.0,0.0
1008,734,2020-03-17 23:32:00,0,2696.0,2189.0,0.812,13.047,368,132,85,47,236,164,72,15,0.08,0.01
1008,735,2020-03-17 23:35:00,0,3088.0,2585.0,0.837,15.031,363,137,83,54,226,154,72,26,0.0,0.0
1008,736,2020-03-17 23:38:00,0,2978.0,2564.0,0.861,14.574,307,204,141,63,103,75,28,93,0.0,0.05
1008,737,2020-03-17 23:41:00,0,3214.0,2640.0,0.821,15.587,272,148,101,47,124,85,39,52,0.0,0.1
1008,738,2020-03-17 23:44:00,0,2515.0,1929.0,0.767,12.047,278,138,102,36,140,97,43,13,0.0,0.01
1008,739,2020-03-17 23:47:00,0,3004.0,2488.0,0.828,14.591,388,232,180,52,156,112,44,35,0.0,0.0
1008,740,2020-03-17 23:50:00,0,2970.0,2570.0,0.865,14.548,449,210,170,40,239,166,73,12,0.08,0.0
1008,741,2020-03-17 23:53:00,0,3008.0,2454.0,0.816,14.568,139,94,72,22,45,29,16,21,0.0,0.0
1008,742,2020-03-17 23:56:00,0,2972.0,2581.0,0.868,14.567,340,168,127,41,172,125,47,40,0.0,0.0
1008,743,2020-03-17 23:59:00,0,2789.0,2313.0,0.829,13.55,332,134,99,35,198,142,56,17,0.0,0.0
1008,744,2020-03-18 00:02:00,0,3023.0,2419.0,0.8,14.587,209,140,97,43,69,40,29,11,0.0,0.0
1008,745,2020-03-18 00:05:00,0,2681.0,2253.0,0.841,13.057,418,286,234,52,132,92,40,64,0.0,0.05
1008,746,2020-03-18 00:08:00,0,3036.0,2346.0,0.773,14.559,221,164,109,55,57,35,22,59,0.0,0.03
1008,747,2020-03-18 00:11:00,0,3025.0,2382.0,0.787,14.558,305,213,152,61,92,49,43,0,0.0,0.0
1008,748,2020-03-18 00:14:00,0,2964.0,2173.0,0.733,14.084,381,204,143,61,177,121,56,31,0.0,0.0
1008,749,2020-03-18 00:17:00,0,2961.0,2183.0,0.737,14.084,784,462,390,72,322,259,63,150,0.0,0.0
1008,750,2020-03-18 00:20:00,0,3254.0,2457.0,0.755,15.541,783,453,383,70,330,265,65,208,0.0,0.0
1008,751,2020-03-18 00:23:00,0,3029.0,2357.0,0.778,14.544,525,309,246,63,216,149,67,50,0.0,0.05
1008,752,2020-03-18 00:26:00,0,3018.0,2411.0,0.799,14.559,333,156,112,44,177,121,56,21,0.0,0.0
1008,753,2020-03-18 00:29:00,0,3277.0,2409.0,0.735,15.58,164,84,38,46,80,37,43,9,0.0,0.0
1008,754,2020-03-18 00:32:00,0,3024.0,2384.0,0.788,14.555,519,228,184,44,291,206,85,16,0.02,0.0
1008,755,2020-03-18 00:35:00,0,3050.0,2308.0,0.757,14.574,179,162,106,56,17,10,7,78,0.0,0.08
1008,756,2020-03-18 00:38:00,0,2522.0,1922.0,0.762,12.065,339,187,128,59,152,89,63,9,0.0,0.01
1008,757,2020-03-18 00:41:00,0,3020.0,2427.0,0.803,14.587,377,250,188,62,127,81,46,34,0.0,0.02
1008,758,2020-03-18 00:44:00,0,2995.0,2459.0,0.821,14.522,571,307,243,64,264,206,58,42,0.0,0.0
1008,759,2020-03-18 00:47:00,0,3052.0,2279.0,0.747,14.549,241,132,100,32,109,84,25,7,0.28,0.0
1008,760,2020-03-18 00:50:00,0,3276.0,2405.0,0.734,15.57,147,107,54,53,40,19,21,29,0.0,0.0
1008,761,2020-03-18 00:53:00,0,3131.0,2408.0,0.769,15.004,329,161,118,43,168,107,61,12,0.0,0.0
1008,762,2020-03-18 00:56:00,0,3142.0,2389.0,0.76,15.024,273,206,147,59,67,38,29,56,0.0,0.04
1008,763,2020-03-18 00:59:00,0,3041.0,2337.0,0.768,14.568,320,168,108,60,152,108,44,4,0.0,0.0
1008,764,2020-03-18 01:02:00,0,3052.0,2307.0,0.756,14.579,304,179,133,46,125,90,35,82,0.0,0.0
1008,765,2020-03-18 01:05:00,0,3360.0,2544.0,0.757,16.054,811,459,406,53,352,286,66,279,0.0,0.02
1008,766,2020-03-18 01:08:00,0,3978.0,2605.0,0.655,18.558,628,362,313,49,266,219,47,315,0.0,0.0
1008,767,2020-03-18 01:11:00,0,3621.0,2488.0,0.687,17.021,398,225,161,64,173,127,46,97,0.0,0.03
1008,768,2020-03-18 01:14:00,0,3618.0,2476.0,0.684,16.999,225,159,116,43,66,29,37,39,0.0,0.0
1008,769,2020-03-18 01:17:00,0,3634.0,2442.0,0.672,17.021,543,223,163,60,320,244,76,88,0.07,0.0
1008,770,2020-03-18 01:20:00,0,3661.0,2344.0,0.64,17.021,196,132,77,55,64,49,15,32,0.0,0.0
1008,771,2020-03-18 01:23:00,0,3970.0,2614.0,0.659,18.536,245,116,64,52,129,104,25,22,0.0,0.0
1008,772,2020-03-18 01:26:00,0,3619.0,2501.0,0.691,17.027,471,256,208,48,215,172,43,188,0.0,0.0
1008,773,2020-03-18 01:29:00,0,4019.0,2439.0,0.607,18.537,487,320,255,65,167,116,51,54,0.0,0.0
1008,774,2020-03-18 01:32:00,0,4021.0,2433.0,0.605,18.538,208,152,96,56,56,29,27,46,0.0,0.12
1008,775,2020-03-18 01:35:00,0,3710.0,2156.0,0.581,17.006,473,254,197,57,219,152,67,21,0.18,0.01
1008,776,2020-03-18 01:38:00,0,4023.0,2457.0,0.611,18.572,387,204,156,48,183,120,63,65,0.05,0.0
1008,777,2020-03-18 01:41:00,0,3795.0,2346.0,0.618,17.552,206,128,83,45,78,47,31,50,0.0,0.0
1008,778,2020-03-18 01:44:00,0,4109.0,2588.0,0.63,19.055,545,247,175,72,298,221,77,56,0.0,0.0
1008,779,2020-03-18 01:47:00,0,4031.0,2445.0,0.607,18.589,489,245,171,74,244,181,63,12,0.0,0.0
1008,780,2020-03-18 01:50:00,0,4009.0,2502.0,0.624,18.567,520,253,188,65,267,196,71,30,0.0,0.1
1008,781,2020-03-18 01:53:00,0,3674.0,2285.0,0.622,17.005,301,181,131,50,120,88,32,35,0.0,0.0
1008,782,2020-03-18 01:56:00,0,4039.0,2384.0,0.59,18.556,338,202,146,56,136,96,40,62,0.16,0.0
1008,783,2020-03-18 01:59:00,0,4054.0,2349.0,0.579,18.577,687,373,308,65,314,233,81,86,0.06,0.0
1008,784,2020-03-18 02:02:00,0,4050.0,2375.0,0.587,18.587,597,386,299,87,211,157,54,138,0.0,0.0
1008,785,2020-03-18 02:05:00,0,4119.0,2497.0,0.606,18.994,836,496,398,98,340,243,97,29,0.0,0.0
1008,786,2020-03-18 02:08:00,0,4031.0,2445.0,0.607,18.589,1161,653,530,123,508,378,130,20,0.0,0.0
1008,787,2020-03-18 02:11:00,0,3531.5,2410.5,0.6955,16.5835,669,485,409,76,184,126,58,57,0.0,0.0
1008,788,2020-03-18 02:14:00,0,3032.0,2376.0,0.784,14.578,164,103,66,37,61,35,26,58,0.0,0.05
1008,789,2020-03-18 02:17:00,0,3047.0,2317.0,0.76,14.569,134,85,62,23,49,12,37,46,0.0,0.01
1008,790,2020-03-18 02:20:00,0,3019.0,2386.0,0.79,14.537,122,78,28,50,44,12,32,27,0.0,0.0
1008,791,2020-03-18 02:23:00,0,3212.0,2602.0,0.81,15.536,552,339,281,58,213,152,61,213,0.0,0.0
1008,792,2020-03-18 02:26:00,0,3015.0,2416.0,0.801,14.554,292,183,133,50,109,75,34,70,0.0,0.02
1008,793,2020-03-18 02:29:00,0,3246.0,2495.0,0.768,15.553,555,313,256,57,242,182,60,40,0.01,0.0
1008,794,2020-03-18 02:32:00,0,3013.0,2450.0,0.813,14.586,535,260,205,55,275,201,74,26,0.05,0.01
1008,795,2020-03-18 02:35:00,0,2988.0,2475.0,0.828,14.511,407,296,234,62,111,66,45,12,0.0,0.0
1008,796,2020-03-18 02:38:00,0,3021.0,2419.0,0.801,14.583,395,260,205,55,135,84,51,24,0.08,0.01
1008,797,2020-03-18 02:41:00,0,3038.0,2292.0,0.754,14.508,262,148,106,42,114,84,30,33,0.0,0.13
1008,798,2020-03-18 02:44:00,0,3040.0,2339.0,0.769,14.568,276,183,134,49,93,51,42,30,0.0,0.0
1008,799,2020-03-18 02:47:00,0,3022.0,2394.0,0.792,14.556,338,234,183,51,104,64,40,144,0.0,0.0
1008,800,2020-03-18 02:50:00,0,3041.0,2321.0,0.763,14.553,154,92,67,25,62,31,31,90,0.0,0.0
1008,801,2020-03-18 02:53:00,0,3020.0,2406.0,0.797,14.562,93,51,31,20,42,6,36,7,0.0,0.0
1008,802,2020-03-18 02:56:00,0,3241.0,2553.0,0.788,15.596,183,127,84,43,56,28,28,29,0.0,0.0
1008,803,2020-03-18 02:59:00,0,3112.0,2514.0,0.808,15.045,413,310,258,52,103,67,36,23,0.24,0.0
1008,804,2020-03-18 03:02:00,0,3007.0,2454.0,0.816,14.565,68,33,15,18,35,3,32,2,0.0,0.0
1008,805,2020-03-18 03:05:00,0,3001.0,2475.0,0.825,14.564,101,64,29,35,37,4,33,0,0.0,0.0
1008,806,2020-03-18 03:08:00,0,3017.0,2435.0,0.807,14.581,66,30,11,19,36,4,32,12,0.0,0.0
1008,807,2020-03-18 03:11:00,0,3022.0,2380.0,0.788,14.544,72,48,27,21,24,5,19,0,0.0,0.0
1008,808,2020-03-18 03:14:00,0,3056.0,2259.0,0.739,14.542,2,2,0,2,0,0,0,0,0.0,0.0
1008,809,2020-03-18 03:17:00,0,2725.0,2084.0,0.765,13.045,6,2,2,0,4,3,1,0,0.0,0.0
1008,810,2020-03-18 03:20:00,0,2517.0,1945.0,0.773,12.071,0,0,0,0,0,0,0,0,0.0,0.0
1008,811,2020-03-18 03:23:00,0,2537.0,1841.0,0.726,12.036,3,3,0,3,0,0,0,0,0.0,0.0
1008,812,2020-03-18 03:26:00,0,2425.0,1796.0,0.741,11.542,88,66,56,10,22,16,6,15,0.0,0.0
1008,813,2020-03-18 03:29:00,0,2508.0,1942.0,0.774,12.033,200,158,115,43,42,29,13,92,0.0,0.0
1008,814,2020-03-18 03:32:00,0,2708.0,2158.0,0.797,13.057,282,209,166,43,73,50,23,54,0.0,0.05
1008,815,2020-03-18 03:35:00,0,2725.0,2095.0,0.769,13.055,171,121,82,39,50,27,23,64,0.06,0.31
1008,816,2020-03-18 03:38:00,0,3050.0,2265.0,0.743,14.525,293,187,134,53,106,72,34,16,0.0,0.0
1008,817,2020-03-18 03:41:00,0,3045.0,2301.0,0.756,14.546,429,265,206,59,164,116,48,60,0.0,0.09
1008,818,2020-03-18 03:44:00,0,2937.0,2248.0,0.766,14.061,429,233,197,36,196,152,44,196,0.0,0.0
1008,819,2020-03-18 03:47:00,0,3051.0,2290.0,0.751,14.556,518,272,212,60,246,182,64,86,0.02,0.0
1008,820,2020-03-18 03:50:00,0,3232.0,2551.0,0.789,15.56,478,302,248,54,176,125,51,64,0.0,0.0
1008,821,2020-03-18 03:53:00,0,3055.0,2265.0,0.741,14.545,501,284,231,53,217,143,74,19,0.0,0.0
1008,822,2020-03-18 03:56:00,0,3051.0,2309.0,0.757,14.577,215,141,103,38,74,48,26,68,0.0,0.0
1008,823,2020-03-18 03:59:00,0,3147.0,2395.0,0.761,15.051,246,164,101,63,82,45,37,1,0.01,0.0
1008,824,2020-03-18 04:02:00,0,2710.0,2118.0,0.782,13.023,214,145,106,39,69,38,31,51,0.01,0.0
1008,825,2020-03-18 04:05:00,0,2960.0,2181.0,0.737,14.078,68,52,29,23,16,4,12,5,0.0,0.0
1008,826,2020-03-18 04:08:00,0,2939.0,2182.0,0.743,13.995,241,153,118,35,88,48,40,46,0.19,0.0
1008,827,2020-03-18 04:11:00,0,3066.0,2238.0,0.73,14.56,344,224,183,41,120,86,34,72,0.0,0.0
1008,828,2020-03-18 04:14:00,0,3050.0,2317.0,0.76,14.581,40,37,18,19,3,1,2,7,0.0,0.0
1008,829,2020-03-18 04:17:00,0,3262.0,2446.0,0.75,15.561,240,185,115,70,55,32,23,10,0.0,0.0
1008,830,2020-03-18 04:20:00,0,3147.0,2403.0,0.764,15.059,57,42,31,11,15,8,7,6,0.0,0.0
1008,831,2020-03-18 04:23:00,0,3063.0,2237.0,0.73,14.544,10,10,2,8,0,0,0,0,0.0,0.0
1008,832,2020-03-18 04:26:00,0,3071.0,2152.0,0.701,14.484,10,10,5,5,0,0,0,0,0.0,0.0
1008,833,2020-03-18 04:29:00,0,3087.0,2121.0,0.687,14.512,13,5,2,3,8,6,2,0,0.0,0.0
1008,834,2020-03-18 04:32:00,0,3109.0,2077.0,0.668,14.551,113,69,51,18,44,29,15,8,0.0,0.0
1008,835,2020-03-18 04:35:00,0,3089.0,2099.0,0.68,14.495,88,51,33,18,37,27,10,2,0.0,0.0
1008,836,2020-03-18 04:38:00,0,3078.0,2161.0,0.702,14.52,223,118,86,32,105,67,38,59,0.0,0.0
1008,837,2020-03-18 04:41:00,0,3076.0,2209.0,0.718,14.567,537,278,218,60,259,198,61,136,0.08,0.11
1008,838,2020-03-18 04:44:00,0,3176.0,2268.0,0.714,15.025,693,403,322,81,290,209,81,13,0.05,0.0
1008,839,2020-03-18 04:47:00,0,3183.0,2269.0,0.713,15.053,535,301,228,73,234,177,57,22,0.0,0.0
1008,840,2020-03-18 04:50:00,0,3277.0,2381.0,0.727,15.547,93,41,19,22,52,15,37,5,0.0,0.0
1008,841,2020-03-18 04:53:00,0,3295.0,2331.0,0.707,15.562,231,141,97,44,90,59,31,10,0.0,0.0
1008,842,2020-03-18 04:56:00,0,3286.0,2331.0,0.709,15.529,344,200,143,57,144,98,46,63,0.0,0.0
1008,843,2020-03-18 04:59:00,0,3076.0,2194.0,0.713,14.549,188,139,100,39,49,30,19,111,0.0,0.0
1008,844,2020-03-18 05:02:00,0,3073.0,2204.0,0.717,14.55,529,351,290,61,178,139,39,110,0.0,0.0
1008,845,2020-03-18 05:05:00,0,3190.0,2217.0,0.695,15.023,301,176,144,32,125,94,31,93,0.0,0.0
1008,846,2020-03-18 05:08:00,0,3083.0,2160.0,0.701,14.539,272,160,113,47,112,80,32,9,0.0,0.0
1008,847,2020-03-18 05:11:00,0,2889.5,2171.0,0.755,13.7885,187,128,87,41,59,29,30,17,0.0,0.0
1008,848,2020-03-18 05:14:00,0,2696.0,2182.0,0.809,13.038,15,8,5,3,7,3,4,0,0.0,0.0
1008,849,2020-03-18 05:17:00,0,2724.0,2037.0,0.748,12.99,7,4,2,2,3,0,3,0,0.0,0.0
1008,850,2020-03-18 05:20:00,0,2745.0,2037.0,0.742,13.072,14,11,8,3,3,1,2,0,0.0,0.0
1008,851,2020-03-18 05:23:00,0,2746.0,1998.0,0.728,13.032,242,152,109,43,90,60,30,97,0.0,0.0
1008,852,2020-03-18 05:26:00,0,2931.0,2238.0,0.764,14.025,396,184,145,39,212,173,39,142,0.0,0.0
1008,853,2020-03-18 05:29:00,0,2709.0,2163.0,0.798,13.07,479,182,127,55,297,211,86,60,0.09,0.0
1008,854,2020-03-18 05:32:00,0,2933.0,2272.0,0.775,14.071,347,143,104,39,204,143,61,101,0.0,0.0
1008,855,2020-03-18 05:35:00,0,2929.0,2257.0,0.771,14.039,512,318,245,73,194,140,54,29,0.0,0.04
1008,856,2020-03-18 05:38:00,0,2927.0,2308.0,0.788,14.086,496,285,226,59,211,144,67,88,0.0,0.0
1008,857,2020-03-18 05:41:00,0,2686.0,2197.0,0.818,13.016,694,489,374,115,205,145,60,38,0.0,0.0
1008,858,2020-03-18 05:44:00,0,2925.0,2273.0,0.777,14.041,518,430,348,82,88,49,39,7,0.12,0.45
1008,859,2020-03-18 05:47:00,0,2829.0,2172.0,0.768,13.551,132,111,74,37,21,12,9,46,0.0,0.0
1008,860,2020-03-18 05:50:00,0,2936.0,2240.0,0.763,14.047,302,258,204,54,44,28,16,33,0.0,0.0
1008,861,2020-03-18 05:53:00,0,2722.0,2079.0,0.764,13.028,599,394,317,77,205,135,70,12,0.0,0.0
1008,862,2020-03-18 05:56:00,0,2724.0,2091.0,0.768,13.048,230,147,106,41,83,51,32,17,0.0,0.0
1008,863,2020-03-18 05:59:00,0,2820.0,2189.0,0.776,13.536,154,108,67,41,46,25,21,22,0.0,0.0
1008,864,2020-03-18 06:02:00,1,2696.0,2191.0,0.813,13.048,332,184,145,39,148,93,55,58,0.0,0.0
1008,865,2020-03-18 06:05:00,1,2943.0,2238.0,0.761,14.072,243,153,113,40,90,62,28,90,0.0,0.0
1008,866,2020-03-18 06:08:00,1,2728.0,2109.0,0.773,13.082,404,285,220,65,119,80,39,25,0.0,0.0
1008,867,2020-03-18 06:11:00,1,2951.0,2157.0,0.731,14.014,403,223,165,58,180,108,72,24,0.0,0.0
1008,868,2020-03-18 06:14:00,1,2749.0,2003.0,0.728,13.049,688,358,275,83,330,249,81,51,0.0,0.0
1008,869,2020-03-18 06:17:00,1,2977.0,2060.0,0.692,14.01,940,470,376,94,470,351,119,5,0.0,0.0
1008,870,2020-03-18 06:20:00,1,2946.0,2190.0,0.743,14.03,1107,723,598,125,384,283,101,8,0.0,0.0
1008,871,2020-03-18 06:23:00,1,2954.0,2187.0,0.74,14.059,730,448,354,94,282,203,79,27,0.0,0.0
1008,872,2020-03-18 06:26:00,1,2998.0,2003.0,0.668,14.031,852,439,350,89,413,320,93,0,0.0,0.0
1008,873,2020-03-18 06:29:00,1,3006.0,1961.0,0.652,14.017,799,402,326,76,397,293,104,40,0.0,0.0
1008,874,2020-03-18 06:32:00,1,3001.0,1975.0,0.658,14.012,499,299,232,67,200,147,53,79,0.11,0.0
1008,875,2020-03-18 06:35:00,1,2767.0,1921.0,0.694,13.031,595,313,250,63,282,201,81,0,0.0,0.0
1008,876,2020-03-18 06:38:00,1,2892.0,1938.0,0.67,13.542,67,45,27,18,22,9,13,0,0.0,0.0
1008,877,2020-03-18 06:41:00,1,2994.0,2020.0,0.674,14.034,253,49,23,26,204,134,70,0,0.0,0.0
1008,878,2020-03-18 06:44:00,1,3001.0,2007.0,0.669,14.048,37,6,0,6,31,0,31,0,0.0,0.0
1008,879,2020-03-18 06:47:00,1,2797.0,1825.0,0.652,13.04,70,13,7,6,57,9,48,2,0.0,0.0
1008,880,2020-03-18 06:50:00,1,2810.0,1776.0,0.632,13.036,21,3,0,3,18,6,12,0,0.0,0.0
1008,881,2020-03-18 06:53:00,1,2829.0,1697.0,0.6,13.026,20,8,3,5,12,6,6,0,0.0,0.0
1008,882,2020-03-18 06:56:00,1,2727.0,1636.0,0.6,12.558,0,0,0,0,0,0,0,0,0.0,0.0
1008,883,2020-03-18 06:59:00,1,2499.0,1525.0,0.61,11.534,0,0,0,0,0,0,0,0,0.0,0.0
1008,884,2020-03-18 07:02:00,1,2504.0,1504.0,0.601,11.531,122,70,45,25,52,33,19,18,0.0,0.0
1008,885,2020-03-18 07:05:00,1,2821.0,1706.0,0.605,13.005,267,169,118,51,98,67,31,69,0.0,0.0
1008,886,2020-03-18 07:08:00,1,2997.0,2004.0,0.669,14.029,346,185,142,43,161,112,49,86,0.0,0.0
1008,887,2020-03-18 07:11:00,1,2998.0,2002.0,0.668,14.031,159,125,78,47,34,21,13,45,0.12,0.0
1008,888,2020-03-18 07:14:00,1,2870.0,2027.0,0.706,13.551,385,211,177,34,174,136,38,53,0.07,0.0
1008,889,2020-03-18 07:17:00,1,2980.0,2066.0,0.694,14.028,452,229,176,53,223,160,63,38,0.0,0.0
1008,890,2020-03-18 07:20:00,1,2965.0,2153.0,0.726,14.068,588,298,239,59,290,219,71,9,0.0,0.0
1008,891,2020-03-18 07:23:00,1,2960.0,2146.0,0.725,14.039,698,340,252,88,358,267,91,7,0.0,0.0
1008,892,2020-03-18 07:26:00,1,2731.0,2057.0,0.753,13.038,870,351,283,68,519,407,112,9,0.0,0.0
1008,893,2020-03-18 07:29:00,1,2960.0,2138.0,0.722,14.029,106,53,18,35,53,22,31,0,0.0,0.0
1008,894,2020-03-18 07:32:00,1,2957.0,2137.0,0.723,14.018,124,29,11,18,95,40,55,0,0.0,0.0
1008,895,2020-03-18 07:35:00,1,2727.0,2081.0,0.763,13.049,163,31,9,22,132,69,63,0,0.0,0.0
1008,896,2020-03-18 07:38:00,1,2759.0,1951.0,0.707,13.032,10,2,1,1,8,0,8,0,0.0,0.0
1008,897,2020-03-18 07:41:00,1,2416.0,1818.0,0.753,11.533,26,4,1,3,22,3,19,0,0.0,0.0
1008,898,2020-03-18 07:44:00,1,2434.0,1744.0,0.716,11.522,17,5,3,2,12,5,7,0,0.0,0.0
1008,899,2020-03-18 07:47:00,1,2451.0,1693.0,0.691,11.532,5,0,0,0,5,2,3,0,0.0,0.0
1008,900,2020-03-18 07:50:00,1,2458.0,1671.0,0.68,11.536,3,0,0,0,3,0,3,0,0.0,0.0
1008,901,2020-03-18 07:53:00,1,2463.0,1623.0,0.659,11.501,120,54,42,12,66,39,27,8,0.0,0.0
1008,902,2020-03-18 07:56:00,1,2556.0,1777.0,0.695,12.038,82,78,34,44,4,3,1,55,0.0,0.0
1008,903,2020-03-18 07:59:00,1,2447.0,1705.0,0.697,11.53,251,158,114,44,93,62,31,24,0.0,0.0
1008,904,2020-03-18 08:02:00,1,2444.0,1730.0,0.708,11.544,30,22,13,9,8,0,8,0,0.0,0.0
1008,905,2020-03-18 08:05:00,1,2461.0,1657.0,0.673,11.531,3,3,1,2,0,0,0,0,0.0,0.0
1008,906,2020-03-18 08:08:00,1,2240.0,1532.0,0.684,10.524,2,2,0,2,0,0,0,0,0.0,0.0
1008,907,2020-03-18 08:11:00,1,2069.5,1469.0,0.712,9.781,131,130,96,34,1,1,0,0,0.0,0.0
1008,908,2020-03-18 08:14:00,1,1899.0,1406.0,0.74,9.038,40,40,1,39,0,0,0,0,0.0,0.0
1008,909,2020-03-18 08:17:00,1,1992.0,1513.0,0.76,9.524,7,4,2,2,3,0,3,0,0.0,0.0
1008,910,2020-03-18 08:20:00,1,2462.0,2149.0,0.873,12.082,145,104,66,38,41,31,10,3,0.0,0.0
1008,911,2020-03-18 08:23:00,1,1935.0,1712.0,0.885,9.521,741,372,303,69,369,286,83,103,0.53,0.03
1008,912,2020-03-18 08:26:00,1,2477.0,2075.0,0.838,12.055,254,145,105,40,109,85,24,100,0.0,0.01
1008,913,2020-03-18 08:29:00,1,2259.0,1966.0,0.871,11.076,331,167,125,42,164,103,61,81,0.0,0.07
1008,914,2020-03-18 08:32:00,1,2154.0,1880.0,0.873,10.569,347,115,79,36,232,162,70,15,0.0,0.0
1008,915,2020-03-18 08:35:00,1,2483.0,2042.0,0.822,12.043,193,59,17,42,134,84,50,1,0.0,0.02
1008,916,2020-03-18 08:38:00,1,2150.0,1871.0,0.87,10.544,78,8,2,6,70,12,58,0,0.0,0.02
1008,917,2020-03-18 08:41:00,1,2473.0,2075.0,0.839,12.04,74,1,0,1,73,43,30,0,0.0,0.02
1008,918,2020-03-18 08:44:00,1,2473.0,2090.0,0.845,12.057,106,39,22,17,67,30,37,0,0.01,0.01
1008,919,2020-03-18 08:47:00,1,2464.0,2119.0,0.86,12.055,29,1,1,0,28,8,20,0,0.01,0.0
1008,920,2020-03-18 08:50:00,1,2265.0,1921.0,0.848,11.051,62,15,7,8,47,23,24,0,0.0,0.0
1008,921,2020-03-18 08:53:00,1,2185.0,1748.0,0.8,10.544,17,0,0,0,17,6,11,0,0.0,0.01
1008,922,2020-03-18 08:56:00,1,2189.0,1701.0,0.777,10.508,63,22,16,6,41,26,15,0,0.0,0.0
1008,923,2020-03-18 08:59:00,1,2407.0,1847.0,0.767,11.53,181,20,5,15,161,99,62,0,0.0,0.0
1008,924,2020-03-18 09:02:00,1,2522.0,1883.0,0.747,12.023,164,96,42,54,68,45,23,2,0.0,0.0
1008,925,2020-03-18 09:05:00,1,2766.0,1921.0,0.695,13.024,162,110,77,33,52,13,39,0,0.0,0.0
1008,926,2020-03-18 09:08:00,1,2548.0,1786.0,0.701,12.018,29,28,23,5,1,0,1,0,0.0,0.0
1008,927,2020-03-18 09:11:00,1,2591.0,1647.0,0.636,12.033,15,15,2,13,0,0,0,0,0.0,0.0
1008,928,2020-03-18 09:14:00,1,2593.0,1637.0,0.631,12.028,12,11,0,11,1,0,1,0,0.0,0.0
1008,929,2020-03-18 09:17:00,1,2603.0,1589.0,0.611,12.017,35,4,0,4,31,1,30,0,0.0,0.0
1008,930,2020-03-18 09:20:00,1,2256.0,1512.0,0.67,10.561,26,0,0,0,26,0,26,0,0.0,0.0
1008,931,2020-03-18 09:23:00,1,2254.0,1469.0,0.652,10.51,33,0,0,0,33,1,32,0,0.0,0.0
1008,932,2020-03-18 09:26:00,1,2374.0,1491.0,0.628,11.005,91,23,13,10,68,45,23,0,0.0,0.0
1008,933,2020-03-18 09:29:00,1,2572.0,1698.0,0.66,12.015,0,0,0,0,0,0,0,0,0.0,0.0
1008,934,2020-03-18 09:32:00,1,2692.0,1729.0,0.642,12.521,54,7,3,4,47,4,43,0,0.0,0.0
1008,935,2020-03-18 09:35:00,1,2586.0,1626.0,0.629,11.989,17,2,0,2,15,0,15,0,0.0,0.0
1008,936,2020-03-18 09:38:00,1,2598.0,1626.0,0.626,12.037,22,0,0,0,22,10,12,0,0.0,0.0
1008,937,2020-03-18 09:41:00,1,2599.0,1604.0,0.617,12.018,33,0,0,0,33,5,28,0,0.0,0.0
1008,938,2020-03-18 09:44:00,1,2617.0,1529.0,0.584,12.003,42,0,0,0,42,17,25,0,0.0,0.0
1008,939,2020-03-18 09:47:00,1,2626.0,1535.0,0.585,12.045,97,31,17,14,66,19,47,0,0.0,0.0
1008,940,2020-03-18 09:50:00,1,2834.0,1659.0,0.585,13.004,237,129,75,54,108,61,47,10,0.0,0.0
1008,941,2020-03-18 09:53:00,1,2793.0,1806.0,0.646,13.005,211,122,83,39,89,54,35,80,0.0,0.09
1008,942,2020-03-18 09:56:00,1,3141.0,1936.0,0.616,14.52,256,126,83,43,130,99,31,42,0.18,0.03
1008,943,2020-03-18 09:59:00,1,2788.0,1854.0,0.665,13.036,323,158,121,37,165,113,52,4,0.0,0.02
1008,944,2020-03-18 10:02:00,1,3132.0,1999.0,0.638,14.553,645,324,250,74,321,235,86,43,0.0,0.0
1008,945,2020-03-18 10:05:00,1,3097.0,2101.0,0.678,14.53,710,365,275,90,345,252,93,18,0.0,0.15
1008,946,2020-03-18 10:08:00,1,3103.0,2093.0,0.675,14.542,761,403,308,95,358,267,91,4,0.0,0.0
1008,947,2020-03-18 10:11:00,1,3098.0,2079.0,0.671,14.509,846,466,373,93,380,293,87,30,0.0,0.0
1008,948,2020-03-18 10:14:00,1,3097.0,2095.0,0.676,14.522,1037,562,464,98,475,374,101,23,0.0,0.0
1008,949,2020-03-18 10:17:00,1,2976.0,2089.0,0.702,14.04,92,57,33,24,35,23,12,5,0.0,0.0
1008,950,2020-03-18 10:20:00,1,3097.0,2094.0,0.676,14.521,40,35,6,29,5,3,2,1,0.0,0.0
1008,951,2020-03-18 10:23:00,1,2860.0,2076.0,0.726,13.566,60,43,21,22,17,6,11,0,0.0,0.0
1008,952,2020-03-18 10:26:00,1,2747.0,1999.0,0.728,13.036,7,4,1,3,3,0,3,0,0.0,0.0
1008,953,2020-03-18 10:29:00,1,2567.0,1725.0,0.672,12.023,20,9,3,6,11,0,11,0,0.0,0.0
1008,954,2020-03-18 10:32:00,1,2592.0,1634.0,0.631,12.021,19,10,0,10,9,0,9,0,0.0,0.0
1008,955,2020-03-18 10:35:00,1,2603.0,1590.0,0.611,12.015,24,12,5,7,12,0,12,0,0.0,0.0
1008,956,2020-03-18 10:38:00,1,2599.0,1612.0,0.62,12.024,197,81,57,24,116,83,33,21,0.0,0.0
1008,957,2020-03-18 10:41:00,1,3114.0,2068.0,0.664,14.559,150,87,51,36,63,32,31,52,0.0,0.0
1008,958,2020-03-18 10:44:00,1,2892.0,1944.0,0.672,13.546,89,52,20,32,37,15,22,24,0.0,0.0
1008,959,2020-03-18 10:47:00,1,2903.0,1901.0,0.655,13.544,30,30,0,30,0,0,0,0,0.0,0.0
1008,960,2020-03-18 10:50:00,1,2823.0,1730.0,0.613,13.04,13,10,1,9,3,2,1,0,0.0,0.0
1008,961,2020-03-18 10:53:00,1,2500.0,1528.0,0.611,11.541,0,0,0,0,0,0,0,0,0.0,0.0
1008,962,2020-03-18 10:56:00,1,2623.0,1543.0,0.588,12.043,14,1,1,0,13,0,13,0,0.0,0.0
1008,963,2020-03-18 10:59:00,1,2492.0,1541.0,0.618,11.525,13,0,0,0,13,0,13,0,0.0,0.0
1008,964,2020-03-18 11:02:00,1,2598.0,1613.0,0.621,12.024,16,1,0,1,15,0,15,0,0.0,0.0
1008,965,2020-03-18 11:05:00,1,2573.0,1706.0,0.663,12.027,23,0,0,0,23,2,21,0,0.0,0.0
1008,966,2020-03-18 11:08:00,1,2566.0,1713.0,0.667,12.007,6,1,1,0,5,0,5,0,0.0,0.0
1008,967,2020-03-18 11:11:00,1,2214.0,1617.0,0.742,10.5135,24,1,0,1,23,2,21,0,0.0,0.0
1008,968,2020-03-18 11:14:00,1,1862.0,1521.0,0.817,9.02,127,71,60,11,56,41,15,0,0.0,0.0
1008,969,2020-03-18 11:17:00,1,1905.0,1388.0,0.729,9.042,0,0,0,0,0,0,0,0,0.0,0.0
1008,970,2020-03-18 11:20:00,1,1908.0,1343.0,0.704,9.004,0,0,0,0,0,0,0,0,0.0,0.0
1008,971,2020-03-18 11:23:00,1,2245.0,1533.0,0.683,10.543,10,6,3,3,4,1,3,0,0.0,0.0
1008,972,2020-03-18 11:26:00,1,2234.0,1542.0,0.691,10.508,1,0,0,0,1,0,1,0,0.0,0.0
1008,973,2020-03-18 11:29:00,1,1898.0,1408.0,0.742,9.038,5,0,0,0,5,0,5,0,0.0,0.0
1008,974,2020-03-18 11:32:00,1,1687.0,1235.0,0.732,8.014,1,0,0,0,1,0,1,0,0.0,0.0
1008,975,2020-03-18 11:35:00,1,1707.0,1171.0,0.686,8.022,0,0,0,0,0,0,0,0,0.0,0.0
1008,976,2020-03-18 11:38:00,1,1685.0,1258.0,0.747,8.034,151,77,59,18,74,54,20,17,0.0,0.0
1008,977,2020-03-18 11:41:00,1,2506.0,1950.0,0.778,12.031,65,15,2,13,50,21,29,24,0.0,0.0
1008,978,2020-03-18 11:44:00,1,2370.0,1965.0,0.829,11.514,280,51,22,29,229,158,71,38,0.0,0.0
1008,979,2020-03-18 11:47:00,1,2372.0,1999.0,0.843,11.56,337,196,146,50,141,84,57,25,0.0,0.0
1008,980,2020-03-18 11:50:00,1,2392.0,1917.0,0.801,11.548,26,26,2,24,0,0,0,0,0.0,0.0
1008,981,2020-03-18 11:53:00,1,2199.0,1698.0,0.772,10.544,0,0,0,0,0,0,0,0,0.0,0.0
1008,982,2020-03-18 11:56:00,1,2244.0,1520.0,0.677,10.524,7,7,2,5,0,0,0,0,0.0,0.0
1008,983,2020-03-18 11:59:00,1,2147.0,1414.0,0.659,10.025,20,12,0,12,8,1,7,0,0.0,0.0
1008,984,2020-03-18 12:02:00,1,1910.0,1353.0,0.708,9.022,8,2,0,2,6,2,4,0,0.0,0.0
1008,985,2020-03-18 12:05:00,1,1916.0,1324.0,0.691,9.015,51,50,0,50,1,0,1,0,0.0,0.0
1008,986,2020-03-18 12:08:00,1,1934.0,1271.0,0.657,9.028,44,39,0,39,5,0,5,0,0.0,0.0
1008,987,2020-03-18 12:11:00,1,1934.0,1278.0,0.661,9.035,7,0,0,0,7,0,7,0,0.0,0.0
1008,988,2020-03-18 12:14:00,1,1915.0,1344.0,0.702,9.032,3,0,0,0,3,0,3,0,0.0,0.0
1008,989,2020-03-18 12:17:00,1,1918.0,1306.0,0.681,9.003,49,29,12,17,20,9,11,2,0.0,0.0
1008,990,2020-03-18 12:20:00,1,2026.0,1389.0,0.686,9.52,0,0,0,0,0,0,0,0,0.0,0.0
1008,991,2020-03-18 12:23:00,1,1914.0,1343.0,0.702,9.027,18,4,3,1,14,2,12,0,0.0,0.0
1008,992,2020-03-18 12:26:00,1,2031.0,1374.0,0.677,9.524,1,0,0,0,1,0,1,0,0.0,0.0
1008,993,2020-03-18 12:29:00,1,2032.0,1378.0,0.678,9.533,51,26,9,17,25,14,11,0,0.0,0.0
1008,994,2020-03-18 12:32:00,1,2024.0,1384.0,0.684,9.508,39,39,0,39,0,0,0,0,0.0,0.0
1008,995,2020-03-18 12:35:00,1,2145.0,1410.0,0.657,10.013,13,5,1,4,8,0,8,0,0.0,0.0
1008,996,2020-03-18 12:38:00,1,2238.0,1520.0,0.679,10.5,263,151,118,33,112,76,36,66,0.0,0.0
1008,997,2020-03-18 12:41:00,1,2236.0,1535.0,0.687,10.509,128,79,40,39,49,36,13,18,0.08,0.0
1008,998,2020-03-18 12:44:00,1,2433.0,1739.0,0.714,11.513,114,75,37,38,39,7,32,15,0.0,0.0
1008,999,2020-03-18 12:47:00,1,2440.0,1752.0,0.718,11.552,121,51,18,33,70,31,39,36,0.0,0.0
1008,1000,2020-03-18 12:50:00,1,2413.0,1830.0,0.759,11.533,245,131,98,33,114,79,35,69,0.0,0.0
1008,1001,2020-03-18 12:53:00,1,2763.0,1924.0,0.696,13.015,161,69,45,24,92,58,34,33,0.04,0.03
1008,1002,2020-03-18 12:56:00,1,2424.0,1812.0,0.748,11.555,30,0,0,0,30,1,29,0,0.0,0.0
1008,1003,2020-03-18 12:59:00,1,2435.0,1749.0,0.718,11.532,30,1,0,1,29,6,23,1,0.0,0.0
1008,1004,2020-03-18 13:02:00,1,2250.0,1523.0,0.677,10.55,26,2,1,1,24,2,22,0,0.0,0.0
1008,1005,2020-03-18 13:05:00,1,2274.0,1408.0,0.619,10.521,18,0,0,0,18,2,16,0,0.0,0.0
1008,1006,2020-03-18 13:08:00,1,2035.0,1372.0,0.674,9.537,0,0,0,0,0,0,0,0,0.0,0.0
1008,1007,2020-03-18 13:11:00,1,1919.0,1312.0,0.684,9.012,1,1,1,0,0,0,0,0,0.0,0.0
1008,1008,2020-03-18 13:14:00,1,1933.0,1265.0,0.654,9.016,0,0,0,0,0,0,0,0,0.0,0.0
1008,1009,2020-03-18 13:17:00,1,1916.0,1340.0,0.699,9.032,42,31,9,22,11,4,7,0,0.0,0.0
1008,1010,2020-03-18 13:20:00,1,1906.0,1359.0,0.713,9.016,2,2,0,2,0,0,0,0,0.0,0.0
1008,1011,2020-03-18 13:23:00,1,1908.0,1374.0,0.72,9.041,8,5,0,5,3,1,2,0,0.0,0.0
1008,1012,2020-03-18 13:26:00,1,1929.0,1292.0,0.67,9.032,20,15,8,7,5,1,4,0,0.0,0.0
1008,1013,2020-03-18 13:29:00,1,1932.0,1281.0,0.663,9.029,1,1,1,0,0,0,0,0,0.0,0.0
1008,1014,2020-03-18 13:32:00,1,1811.0,1250.0,0.69,8.518,17,13,6,7,4,0,4,0,0.0,0.0
1008,1015,2020-03-18 13:35:00,1,1934.0,1270.0,0.657,9.029,9,9,0,9,0,0,0,0,0.0,0.0
1008,1016,2020-03-18 13:38:00,1,1816.0,1236.0,0.681,8.522,0,0,0,0,0,0,0,0,0.0,0.0
1008,1017,2020-03-18 13:41:00,1,1691.0,1233.0,0.729,8.027,2,1,0,1,1,1,0,0,0.0,0.01
1008,1018,2020-03-18 13:44:00,1,1907.0,1350.0,0.708,9.007,10,0,0,0,10,0,10,0,0.0,0.0
1008,1019,2020-03-18 13:47:00,1,1915.0,1341.0,0.7,9.032,1,0,0,0,1,1,0,0,0.0,0.0
1008,1020,2020-03-18 13:50:00,1,1809.0,1268.0,0.701,8.53,47,24,11,13,23,10,13,0,0.0,0.0
1008,1021,2020-03-18 13:53:00,1,1885.0,1445.0,0.766,9.028,26,0,0,0,26,0,26,0,0.0,0.0
1008,1022,2020-03-18 13:56:00,1,2008.0,1461.0,0.728,9.529,43,29,11,18,14,2,12,4,0.0,0.0
1008,1023,2020-03-18 13:59:00,1,2212.0,1650.0,0.746,10.543,200,114,60,54,86,48,38,87,0.0,0.0
1008,1024,2020-03-18 14:02:00,1,2381.0,1919.0,0.806,11.505,370,194,147,47,176,129,47,82,0.09,0.0
1008,1025,2020-03-18 14:05:00,1,2385.0,1970.0,0.826,11.578,352,169,124,45,183,133,50,69,0.11,0.01
1008,1026,2020-03-18 14:08:00,1,2730.0,2036.0,0.746,13.009,671,295,230,65,376,281,95,30,0.04,0.05
1008,1027,2020-03-18 14:11:00,1,2567.5,1962.5,0.766,12.288,857,397,335,62,460,355,105,27,0.0,0.0
1008,1028,2020-03-18 14:14:00,1,2405.0,1889.0,0.786,11.567,891,468,372,96,423,318,105,35,0.0,0.0
1008,1029,2020-03-18 14:17:00,1,2732.0,2078.0,0.761,13.064,1061,436,337,99,625,489,136,62,0.0,0.0
1008,1030,2020-03-18 14:20:00,1,2616.0,2049.0,0.783,12.574,22,7,2,5,15,2,13,10,0.0,0.0
1008,1031,2020-03-18 14:23:00,1,2716.0,2120.0,0.78,13.049,137,64,18,46,73,34,39,22,0.0,0.0
1008,1032,2020-03-18 14:26:00,1,2730.0,2069.0,0.758,13.047,160,70,34,36,90,36,54,2,0.0,0.0
1008,1033,2020-03-18 14:29:00,1,2383.0,1967.0,0.825,11.568,46,35,16,19,11,2,9,2,0.0,0.0
1008,1034,2020-03-18 14:32:00,1,2181.0,1769.0,0.811,10.553,0,0,0,0,0,0,0,0,0.0,0.0
1008,1035,2020-03-18 14:35:00,1,2215.0,1610.0,0.727,10.511,33,1,1,0,32,15,17,0,0.0,0.0
1008,1036,2020-03-18 14:38:00,1,1864.0,1519.0,0.815,9.026,36,0,0,0,36,4,32,0,0.0,0.0
1008,1037,2020-03-18 14:41:00,1,1878.0,1471.0,0.783,9.03,29,0,0,0,29,3,26,0,0.0,0.0
1008,1038,2020-03-18 14:44:00,1,1893.0,1428.0,0.754,9.038,13,0,0,0,13,2,11,0,0.0,0.0
1008,1039,2020-03-18 14:47:00,1,1911.0,1348.0,0.705,9.025,15,2,0,2,13,0,13,0,0.0,0.0
1008,1040,2020-03-18 14:50:00,1,1690.0,1253.0,0.741,8.048,28,0,0,0,28,2,26,0,0.0,0.0
1008,1041,2020-03-18 14:53:00,1,1797.0,1295.0,0.72,8.515,12,1,0,1,11,2,9,0,0.0,0.0
1008,1042,2020-03-18 14:56:00,1,1682.0,1264.0,0.752,8.028,32,11,3,8,21,13,8,0,0.0,0.0
1008,1043,2020-03-18 14:59:00,1,1793.0,1316.0,0.734,8.521,0,0,0,0,0,0,0,0,0.0,0.0
1008,1044,2020-03-18 15:02:00,1,1677.0,1274.0,0.76,8.019,6,2,1,1,4,0,4,0,0.0,0.0
1008,1045,2020-03-18 15:05:00,1,1933.0,1275.0,0.66,9.027,2,0,0,0,2,0,2,0,0.0,0.0
1008,1046,2020-03-18 15:08:00,1,1911.0,1332.0,0.697,9.006,1,0,0,0,1,1,0,0,0.0,0.0
1008,1047,2020-03-18 15:11:00,1,1922.0,1307.0,0.68,9.018,159,87,59,28,72,43,29,42,0.0,0.0
1008,1048,2020-03-18 15:14:00,1,2433.0,1767.0,0.726,11.544,191,89,57,32,102,66,36,39,0.0,0.06
1008,1049,2020-03-18 15:17:00,1,2243.0,1525.0,0.68,10.527,176,54,34,20,122,71,51,18,0.0,0.02
1008,1050,2020-03-18 15:20:00,1,2406.0,1841.0,0.765,11.517,190,38,13,25,152,71,81,45,0.0,0.0
1008,1051,2020-03-18 15:23:00,1,2399.0,1878.0,0.783,11.53,72,26,7,19,46,19,27,3,0.0,0.0
1008,1052,2020-03-18 15:26:00,1,2196.0,1725.0,0.786,10.56,0,0,0,0,0,0,0,0,0.0,0.0
1008,1053,2020-03-18 15:29:00,1,2218.0,1621.0,0.731,10.534,0,0,0,0,0,0,0,0,0.0,0.0
1008,1054,2020-03-18 15:32:00,1,1873.0,1493.0,0.797,9.034,3,1,1,0,2,1,1,0,0.0,0.0
1008,1055,2020-03-18 15:35:00,1,1981.0,1563.0,0.789,9.538,28,0,0,0,28,0,28,0,0.0,0.0
1008,1056,2020-03-18 15:38:00,1,1981.0,1556.0,0.785,9.53,6,0,0,0,6,0,6,0,0.0,0.0
1008,1057,2020-03-18 15:41:00,1,1984.0,1555.0,0.783,9.539,0,0,0,0,0,0,0,0,0.0,0.0
1008,1058,2020-03-18 15:44:00,1,1868.0,1527.0,0.818,9.05,11,6,1,5,5,0,5,0,0.0,0.0
1008,1059,2020-03-18 15:47:00,1,2117.0,1533.0,0.724,10.038,32,27,9,18,5,2,3,0,0.0,0.0
1008,1060,2020-03-18 15:50:00,1,2231.0,1581.0,0.708,10.541,4,3,2,1,1,1,0,0,0.0,0.0
1008,1061,2020-03-18 15:53:00,1,2239.0,1538.0,0.687,10.525,0,0,0,0,0,0,0,0,0.0,0.0
1008,1062,2020-03-18 15:56:00,1,2243.0,1489.0,0.664,10.488,102,60,37,23,42,17,25,4,0.0,0.0
1008,1063,2020-03-18 15:59:00,1,2237.0,1565.0,0.7,10.546,137,49,23,26,88,41,47,15,0.0,0.0
1008,1064,2020-03-18 16:02:00,1,2249.0,1524.0,0.678,10.549,1,1,0,1,0,0,0,0,0.0,0.0
1008,1065,2020-03-18 16:05:00,1,2021.0,1428.0,0.707,9.542,6,4,1,3,2,0,2,0,0.0,0.0
1008,1066,2020-03-18 16:08:00,1,2030.0,1362.0,0.671,9.507,11,9,1,8,2,0,2,0,0.0,0.0
1008,1067,2020-03-18 16:11:00,1,1932.0,1271.0,0.658,9.019,26,18,2,16,8,0,8,0,0.0,0.0
1008,1068,2020-03-18 16:14:00,1,1926.0,1287.0,0.668,9.015,17,13,2,11,4,0,4,0,0.0,0.0
1008,1069,2020-03-18 16:17:00,1,1933.0,1254.0,0.648,9.005,1,1,0,1,0,0,0,0,0.0,0.0
1008,1070,2020-03-18 16:20:00,1,1926.0,1285.0,0.667,9.012,11,9,2,7,2,0,2,2,0.0,0.0
1008,1071,2020-03-18 16:23:00,1,1908.0,1380.0,0.723,9.047,1,0,0,0,1,0,1,0,0.0,0.0
1008,1072,2020-03-18 16:26:00,1,1927.0,1279.0,0.664,9.008,0,0,0,0,0,0,0,0,0.0,0.0
1008,1073,2020-03-18 16:29:00,1,1683.0,1263.0,0.751,8.029,135,69,44,25,66,39,27,15,0.0,0.0
1008,1074,2020-03-18 16:32:00,1,2223.0,1613.0,0.726,10.543,307,164,124,40,143,94,49,47,0.03,0.0
1008,1075,2020-03-18 16:35:00,1,2419.0,1821.0,0.753,11.549,127,78,39,39,49,22,27,60,0.0,0.06
1008,1076,2020-03-18 16:38:00,1,2419.0,1828.0,0.756,11.555,356,136,98,38,220,160,60,77,0.24,0.02
1008,1077,2020-03-18 16:41:00,1,2284.0,1838.0,0.805,11.035,131,43,30,13,88,45,43,10,0.0,0.0
1008,1078,2020-03-18 16:44:00,1,2397.0,1898.0,0.792,11.547,162,53,27,26,109,53,56,11,0.0,0.0
1008,1079,2020-03-18 16:47:00,1,2386.0,1934.0,0.811,11.541,69,8,2,6,61,22,39,0,0.0,0.0
1008,1080,2020-03-18 16:50:00,1,2355.0,2093.0,0.889,11.597,119,64,24,40,55,23,32,5,0.0,0.0
1008,1081,2020-03-18 16:53:00,1,2322.0,2161.0,0.931,11.541,115,60,12,48,55,24,31,1,0.0,0.0
1008,1082,2020-03-18 16:56:00,1,2346.0,2094.0,0.893,11.563,136,85,43,42,51,23,28,0,0.0,0.0
1008,1083,2020-03-18 16:59:00,1,2360.0,2042.0,0.865,11.561,65,14,2,12,51,22,29,0,0.0,0.0
1008,1084,2020-03-18 17:02:00,1,2158.0,1842.0,0.853,10.542,3,2,1,1,1,0,1,0,0.0,0.0
1008,1085,2020-03-18 17:05:00,1,1821.0,1688.0,0.927,9.046,4,4,2,2,0,0,0,0,0.0,0.0
1008,1086,2020-03-18 17:08:00,1,1831.0,1667.0,0.91,9.06,0,0,0,0,0,0,0,0,0.0,0.0
1008,1087,2020-03-18 17:11:00,1,2035.5,1619.5,0.806,9.813,0,0,0,0,0,0,0,0,0.0,0.0
1008,1088,2020-03-18 17:14:00,1,2240.0,1572.0,0.702,10.566,0,0,0,0,0,0,0,0,0.0,0.0
1008,1089,2020-03-18 17:17:00,1,2240.0,1533.0,0.684,10.524,8,8,1,7,0,0,0,0,0.0,0.0
1008,1090,2020-03-18 17:20:00,1,2122.0,1503.0,0.708,10.024,1,1,0,1,0,0,0,0,0.0,0.0
1008,1091,2020-03-18 17:23:00,1,2001.0,1491.0,0.745,9.534,0,0,0,0,0,0,0,0,0.0,0.0
1008,1092,2020-03-18 17:26:00,1,2128.0,1484.0,0.697,10.03,0,0,0,0,0,0,0,0,0.0,0.0
1008,1093,2020-03-18 17:29:00,1,2248.0,1496.0,0.666,10.512,0,0,0,0,0,0,0,0,0.0,0.0
1008,1094,2020-03-18 17:32:00,1,2258.0,1479.0,0.655,10.534,70,29,13,16,41,17,24,0,0.0,0.0
1008,1095,2020-03-18 17:35:00,1,2219.0,1604.0,0.723,10.52,73,38,18,20,35,6,29,0,0.0,0.0
1008,1096,2020-03-18 17:38:00,1,2620.0,1522.0,0.581,12.008,0,0,0,0,0,0,0,0,0.0,0.0
1008,1097,2020-03-18 17:41:00,1,2635.0,1476.0,0.56,12.017,34,13,2,11,21,9,12,0,0.0,0.0
1008,1098,2020-03-18 17:44:00,1,2511.0,1476.0,0.588,11.528,177,91,58,33,86,43,43,53,0.0,0.01
1008,1099,2020-03-18 17:47:00,1,2900.0,1870.0,0.645,13.498,295,149,103,46,146,102,44,63,0.0,0.09
1008,1100,2020-03-18 17:50:00,1,2631.0,1508.0,0.573,12.036,108,48,28,20,60,47,13,2,0.0,0.0
1008,1101,2020-03-18 17:53:00,1,2803.0,1799.0,0.642,13.038,37,34,11,23,3,0,3,5,0.0,0.0
1008,1102,2020-03-18 17:56:00,1,2756.0,1948.0,0.707,13.017,135,60,20,40,75,39,36,2,0.0,0.0
1008,1103,2020-03-18 17:59:00,1,2783.0,1847.0,0.664,13.01,4,4,1,3,0,0,0,0,0.0,0.0
1008,1104,2020-03-18 18:02:00,0,2807.0,1810.0,0.645,13.066,6,6,1,5,0,0,0,0,0.0,0.0
1008,1105,2020-03-18 18:05:00,0,2585.0,1657.0,0.641,12.02,48,38,0,38,10,4,6,0,0.0,0.0
1008,1106,2020-03-18 18:08:00,0,2585.0,1701.0,0.658,12.071,1,1,0,1,0,0,0,0,0.0,0.0
1008,1107,2020-03-18 18:11:00,0,2581.0,1646.0,0.638,11.993,45,11,5,6,34,10,24,0,0.0,0.0
1008,1108,2020-03-18 18:14:00,0,2571.0,1705.0,0.663,12.017,361,169,138,31,192,131,61,46,0.0,0.0
1008,1109,2020-03-18 18:17:00,0,3090.0,2145.0,0.694,14.551,398,179,135,44,219,160,59,72,0.0,0.17
1008,1110,2020-03-18 18:20:00,0,2878.0,1999.0,0.695,13.555,438,208,154,54,230,177,53,119,0.0,0.0
1008,1111,2020-03-18 18:23:00,0,3111.0,2059.0,0.662,14.536,459,223,173,50,236,173,63,122,0.0,0.0
1008,1112,2020-03-18 18:26:00,0,3308.0,2270.0,0.686,15.547,275,126,70,56,149,88,61,68,0.0,0.0
1008,1113,2020-03-18 18:29:00,0,3407.0,2362.0,0.693,16.041,296,33,7,26,263,177,86,30,0.0,0.0
1008,1114,2020-03-18 18:32:00,0,3381.0,2437.0,0.721,16.022,388,92,48,44,296,228,68,40,0.0,0.0
1008,1115,2020-03-18 18:35:00,0,3397.0,2428.0,0.715,16.073,289,93,65,28,196,145,51,22,0.0,0.0
1008,1116,2020-03-18 18:38:00,0,3289.0,2329.0,0.708,15.538,56,0,0,0,56,14,42,0,0.0,0.0
1008,1117,2020-03-18 18:41:00,0,3078.0,2176.0,0.707,14.536,37,1,0,1,36,2,34,0,0.0,0.0
1008,1118,2020-03-18 18:44:00,0,2862.0,2048.0,0.716,13.544,10,0,0,0,10,2,8,0,0.0,0.0
1008,1119,2020-03-18 18:47:00,0,2758.0,1959.0,0.71,13.035,23,1,0,1,22,11,11,0,0.0,0.0
1008,1120,2020-03-18 18:50:00,0,2784.0,1853.0,0.666,13.019,45,3,1,2,42,13,29,0,0.0,0.0
1008,1121,2020-03-18 18:53:00,0,2579.0,1671.0,0.648,12.013,224,133,99,34,91,60,31,52,0.0,0.05
1008,1122,2020-03-18 18:56:00,0,3100.0,2108.0,0.68,14.548,333,187,135,52,146,102,44,62,0.03,0.03
1008,1123,2020-03-18 18:59:00,0,2769.0,1930.0,0.697,13.049,237,89,63,26,148,107,41,46,0.09,0.0
1008,1124,2020-03-18 19:02:00,0,3112.0,2077.0,0.668,14.561,555,238,195,43,317,234,83,146,0.03,0.0
1008,1125,2020-03-18 19:05:00,0,3045.0,2281.0,0.749,14.524,525,236,194,42,289,215,74,44,0.0,0.05
1008,1126,2020-03-18 19:08:00,0,3168.0,2320.0,0.732,15.052,429,145,104,41,284,204,80,38,0.0,0.0
1008,1127,2020-03-18 19:11:00,0,3373.0,2473.0,0.733,16.026,53,20,7,13,33,6,27,23,0.0,0.0
1008,1128,2020-03-18 19:14:00,0,3058.0,2273.0,0.743,14.563,7,3,0,3,4,0,4,0,0.0,0.0
1008,1129,2020-03-18 19:17:00,0,2967.0,2148.0,0.724,14.07,0,0,0,0,0,0,0,0,0.0,0.0
1008,1130,2020-03-18 19:20:00,0,2733.0,2033.0,0.744,13.018,135,78,65,13,57,44,13,14,0.0,0.0
1008,1131,2020-03-18 19:23:00,0,3095.0,2136.0,0.69,14.561,231,133,82,51,98,49,49,79,0.02,0.0
1008,1132,2020-03-18 19:26:00,0,2985.0,2061.0,0.691,14.042,432,131,85,46,301,214,87,100,0.34,0.01
1008,1133,2020-03-18 19:29:00,0,3098.0,2080.0,0.672,14.509,268,103,87,16,165,109,56,8,0.0,0.0
1008,1134,2020-03-18 19:32:00,0,3089.0,2114.0,0.684,14.514,81,5,2,3,76,34,42,0,0.0,0.01
1008,1135,2020-03-18 19:35:00,0,3074.0,2197.0,0.715,14.545,22,2,1,1,20,4,16,2,0.0,0.0
1008,1136,2020-03-18 19:38:00,0,3080.0,2143.0,0.696,14.507,32,9,4,5,23,8,15,4,0.0,0.0
1008,1137,2020-03-18 19:41:00,0,3089.0,2142.0,0.693,14.544,223,140,84,56,83,43,40,72,0.0,0.06
1008,1138,2020-03-18 19:44:00,0,3408.0,2369.0,0.695,16.052,216,115,82,33,101,67,34,27,0.21,0.06
1008,1139,2020-03-18 19:47:00,0,2993.0,2005.0,0.67,14.012,336,109,74,35,227,172,55,47,0.0,0.01
1008,1140,2020-03-18 19:50:00,0,3413.0,2352.0,0.689,16.053,166,50,23,27,116,53,63,51,0.0,0.0
1008,1141,2020-03-18 19:53:00,0,3607.0,2580.0,0.715,17.07,302,49,11,38,253,176,77,36,0.0,0.0
1008,1142,2020-03-18 19:56:00,0,3583.0,2659.0,0.742,17.062,234,114,88,26,120,85,35,12,0.0,0.0
1008,1143,2020-03-18 19:59:00,0,3609.0,2540.0,0.704,17.032,11,1,1,0,10,3,7,0,0.0,0.0
1008,1144,2020-03-18 20:02:00,0,3388.0,2453.0,0.724,16.066,124,69,48,21,55,39,16,29,0.0,0.04
1008,1145,2020-03-18 20:05:00,0,3391.0,2448.0,0.722,16.073,472,247,192,55,225,174,51,65,0.02,0.04
1008,1146,2020-03-18 20:08:00,0,3596.0,2626.0,0.73,17.076,433,246,206,40,187,151,36,97,0.15,0.01
1008,1147,2020-03-18 20:11:00,0,3171.5,2563.0,0.82,15.333,311,122,73,49,189,119,70,57,0.0,0.0
1008,1148,2020-03-18 20:14:00,0,2747.0,2500.0,0.91,13.59,197,55,20,35,142,98,44,35,0.0,0.0
1008,1149,2020-03-18 20:17:00,0,2970.0,2599.0,0.875,14.58,75,15,10,5,60,37,23,7,0.0,0.0
1008,1150,2020-03-18 20:20:00,0,2745.0,2496.0,0.909,13.577,47,0,0,0,47,4,43,0,0.0,0.0
1008,1151,2020-03-18 20:23:00,0,2782.0,2401.0,0.863,13.618,21,0,0,0,21,7,14,0,0.0,0.0
1008,1152,2020-03-18 20:26:00,0,2664.0,2302.0,0.864,13.045,189,70,53,17,119,92,27,2,0.0,0.0
1008,1153,2020-03-18 20:29:00,0,2433.0,2252.0,0.925,12.08,3,3,1,2,0,0,0,0,0.0,0.0
1008,1154,2020-03-18 20:32:00,0,2094.0,2073.0,0.99,10.546,4,4,1,3,0,0,0,0,0.0,0.0
1008,1155,2020-03-18 20:35:00,0,2119.0,2012.0,0.95,10.577,11,3,0,3,8,2,6,0,0.0,0.0
1008,1156,2020-03-18 20:38:00,0,2111.0,2009.0,0.952,10.54,3,0,0,0,3,1,2,0,0.0,0.0
1008,1157,2020-03-18 20:41:00,0,2005.0,1972.0,0.984,10.081,111,70,43,27,41,24,17,38,0.0,0.02
1008,1158,2020-03-18 20:44:00,0,2411.0,2339.0,0.97,12.088,357,164,124,40,193,143,50,64,0.3,0.1
1008,1159,2020-03-18 20:47:00,0,1994.0,1975.0,0.99,10.042,31,0,0,0,31,2,29,0,0.0,0.01
1008,1160,2020-03-18 20:50:00,0,2059.0,2206.0,1.071,10.555,146,0,0,0,146,120,26,0,0.0,0.01
1008,1161,2020-03-18 20:53:00,0,2060.0,2223.0,1.079,10.579,294,1,1,0,293,228,65,0,0.0,0.0
1008,1162,2020-03-18 20:56:00,0,2081.0,2148.0,1.032,10.578,470,256,203,53,214,151,63,45,0.0,0.03
1008,1163,2020-03-18 20:59:00,0,2038.0,2299.0,1.128,10.576,3,1,0,1,2,1,1,0,0.0,0.0
1008,1164,2020-03-18 21:02:00,0,2035.0,2304.0,1.132,10.569,2,2,2,0,0,0,0,0,0.0,0.0
1008,1165,2020-03-18 21:05:00,0,2050.0,2251.0,1.098,10.57,2,2,0,2,0,0,0,0,0.0,0.0
1008,1166,2020-03-18 21:08:00,0,2053.0,2250.0,1.096,10.581,14,14,1,13,0,0,0,0,0.0,0.0
1008,1167,2020-03-18 21:11:00,0,2046.0,2276.0,1.112,10.58,4,4,1,3,0,0,0,0,0.0,0.0
1008,1168,2020-03-18 21:14:00,0,2048.0,2260.0,1.103,10.572,216,97,50,47,119,67,52,81,0.0,0.04
1008,1169,2020-03-18 21:17:00,0,2384.0,2414.0,1.013,12.064,221,113,80,33,108,70,38,38,0.01,0.13
1008,1170,2020-03-18 21:20:00,0,2382.0,2430.0,1.02,12.075,323,166,139,27,157,115,42,92,0.0,0.01
1008,1171,2020-03-18 21:23:00,0,2331.0,2579.0,1.107,12.037,396,128,76,52,268,222,46,56,0.0,0.0
1008,1172,2020-03-18 21:26:00,0,2339.0,2600.0,1.111,12.096,407,223,191,32,184,147,37,108,0.0,0.0
1008,1173,2020-03-18 21:29:00,0,2682.0,2722.0,1.015,13.581,547,252,214,38,295,231,64,123,0.0,0.05
1008,1174,2020-03-18 21:32:00,0,2662.0,2784.0,1.046,13.572,400,196,153,43,204,152,52,96,0.0,0.0
1008,1175,2020-03-18 21:35:00,0,2462.0,2599.0,1.055,12.578,177,102,68,34,75,44,31,46,0.0,0.06
1008,1176,2020-03-18 21:38:00,0,2686.0,2714.0,1.01,13.587,620,317,273,44,303,224,79,164,0.0,0.0
1008,1177,2020-03-18 21:41:00,0,2347.0,2561.0,1.092,12.081,625,276,219,57,349,260,89,53,0.03,0.08
1008,1178,2020-03-18 21:44:00,0,2349.0,2557.0,1.088,12.087,356,136,90,46,220,150,70,45,0.05,0.0
1008,1179,2020-03-18 21:47:00,0,2654.0,2850.0,1.074,13.611,256,98,53,45,158,99,59,4,0.0,0.0
1008,1180,2020-03-18 21:50:00,0,2892.0,2905.0,1.004,14.612,170,44,20,24,126,74,52,12,0.0,0.0
1008,1181,2020-03-18 21:53:00,0,2667.0,2803.0,1.051,13.61,76,25,12,13,51,22,29,0,0.0,0.0
1008,1182,2020-03-18 21:56:00,0,2455.0,2615.0,1.065,12.566,63,5,2,3,58,24,34,0,0.0,0.0
1008,1183,2020-03-18 21:59:00,0,2366.0,2487.0,1.051,12.074,364,146,98,48,218,153,65,10,0.0,0.0
1008,1184,2020-03-18 22:02:00,0,2348.0,2530.0,1.077,12.05,116,72,47,25,44,24,20,38,0.0,0.12
1008,1185,2020-03-18 22:05:00,0,2345.0,2558.0,1.091,12.073,297,145,110,35,152,114,38,23,0.06,0.0
1008,1186,2020-03-18 22:08:00,0,2125.0,2474.0,1.164,11.113,374,181,123,58,193,130,63,11,0.02,0.0
1008,1187,2020-03-18 22:11:00,0,1874.0,1961.0,1.047,9.552,92,63,27,36,29,14,15,0,0.0,0.0
1008,1188,2020-03-18 22:14:00,0,2311.0,2698.0,1.167,12.091,161,76,46,30,85,45,40,0,0.0,0.0
1008,1189,2020-03-18 22:17:00,0,2550.0,2770.0,1.086,13.112,78,43,30,13,35,20,15,0,0.0,0.0
1008,1190,2020-03-18 22:20:00,0,2344.0,2604.0,1.111,12.117,91,42,27,15,49,26,23,0,0.0,0.0
1008,1191,2020-03-18 22:23:00,0,2364.0,2509.0,1.061,12.093,20,16,11,5,4,0,4,0,0.0,0.0
1008,1192,2020-03-18 22:26:00,0,2129.0,2428.0,1.141,11.075,25,10,0,10,15,1,14,0,0.0,0.0
1008,1193,2020-03-18 22:29:00,0,2026.0,2358.0,1.164,10.591,61,14,7,7,47,21,26,1,0.0,0.0
1008,1194,2020-03-18 22:32:00,0,2150.0,2363.0,1.099,11.087,263,156,114,42,107,71,36,76,0.0,0.23
1008,1195,2020-03-18 22:35:00,0,2939.0,2702.0,0.919,14.57,269,144,115,29,125,85,40,39,0.22,0.01
1008,1196,2020-03-18 22:38:00,0,2926.0,2735.0,0.935,14.555,525,226,175,51,299,221,78,70,0.0,0.0
1008,1197,2020-03-18 22:41:00,0,2756.0,2464.0,0.894,13.588,735,347,283,64,388,307,81,99,0.1,0.0
1008,1198,2020-03-18 22:44:00,0,2980.0,2549.0,0.855,14.562,36,15,9,6,21,11,10,1,0.0,0.0
1008,1199,2020-03-18 22:47:00,0,2975.0,2552.0,0.858,14.547,3,1,0,1,2,1,1,0,0.0,0.0
1008,1200,2020-03-18 22:50:00,0,3001.0,2489.0,0.83,14.578,9,1,0,1,8,4,4,0,0.0,0.0
1008,1201,2020-03-18 22:53:00,0,2880.0,2444.0,0.848,14.053,27,0,0,0,27,6,21,0,0.0,0.0
1008,1202,2020-03-18 22:56:00,0,2776.0,2338.0,0.842,13.525,198,34,25,9,164,116,48,11,0.0,0.0
1008,1203,2020-03-18 22:59:00,0,2768.0,2417.0,0.873,13.582,151,89,56,33,62,46,16,24,0.0,0.33
1008,1204,2020-03-18 23:02:00,0,2755.0,2411.0,0.875,13.525,352,176,109,67,176,120,56,17,0.16,0.0
1008,1205,2020-03-18 23:05:00,0,2749.0,2470.0,0.898,13.565,243,111,83,28,132,94,38,23,0.06,0.01
1008,1206,2020-03-18 23:08:00,0,3058.0,2753.0,0.9,15.095,285,77,46,31,208,126,82,23,0.0,0.0
1008,1207,2020-03-18 23:11:00,0,3109.0,2796.0,0.899,15.3435,245,73,41,32,172,120,52,4,0.0,0.0
1008,1208,2020-03-18 23:14:00,0,3160.0,2839.0,0.898,15.592,196,58,29,29,138,87,51,8,0.01,0.0
1008,1209,2020-03-18 23:17:00,0,2847.0,2570.0,0.903,14.063,7,5,0,5,2,1,1,0,0.0,0.0
1008,1210,2020-03-18 23:20:00,0,2871.0,2461.0,0.857,14.037,17,8,0,8,9,4,5,0,0.0,0.0
1008,1211,2020-03-18 23:23:00,0,2867.0,2493.0,0.87,14.056,41,1,0,1,40,4,36,0,0.0,0.0
1008,1212,2020-03-18 23:26:00,0,3170.0,2789.0,0.88,15.579,338,127,109,18,211,170,41,19,0.15,0.0
1008,1213,2020-03-18 23:29:00,0,3186.0,2705.0,0.849,15.55,8,2,0,2,6,4,2,0,0.0,0.0
1008,1214,2020-03-18 23:32:00,0,3166.0,2774.0,0.876,15.548,187,58,22,36,129,78,51,7,0.0,0.0
1008,1215,2020-03-18 23:35:00,0,3163.0,2825.0,0.893,15.591,130,45,18,27,85,50,35,3,0.0,0.0
1008,1216,2020-03-18 23:38:00,0,3265.0,2914.0,0.893,16.089,391,191,150,41,200,124,76,86,0.17,0.01
1008,1217,2020-03-18 23:41:00,0,3162.0,2822.0,0.893,15.581,514,253,210,43,261,178,83,65,0.0,0.0
1008,1218,2020-03-18 23:44:00,0,3164.0,2802.0,0.886,15.569,194,115,83,32,79,42,37,67,0.0,0.0
1008,1219,2020-03-18 23:47:00,0,3152.0,2838.0,0.9,15.56,116,66,38,28,50,24,26,39,0.0,0.0
1008,1220,2020-03-18 23:50:00,0,2856.0,2564.0,0.898,14.091,372,229,180,49,143,103,40,58,0.0,0.1
1008,1221,2020-03-18 23:53:00,0,2836.0,2593.0,0.914,14.046,376,174,121,53,202,141,61,69,0.0,0.02
1008,1222,2020-03-18 23:56:00,0,3066.0,2664.0,0.869,15.03,298,134,88,46,164,120,44,6,0.03,0.0
1008,1223,2020-03-18 23:59:00,0,3173.0,2767.0,0.872,15.565,250,105,76,29,145,100,45,50,0.06,0.0
1008,1224,2020-03-19 00:02:00,0,3188.0,2702.0,0.848,15.551,37,12,1,11,25,3,22,0,0.0,0.0
1008,1225,2020-03-19 00:05:00,0,2954.0,2623.0,0.888,14.543,33,23,10,13,10,4,6,0,0.0,0.0
1008,1226,2020-03-19 00:08:00,0,2958.0,2611.0,0.883,14.544,17,15,7,8,2,1,1,0,0.0,0.0
1008,1227,2020-03-19 00:11:00,0,2860.0,2548.0,0.891,14.089,70,29,25,4,41,31,10,2,0.0,0.0
1008,1228,2020-03-19 00:14:00,0,2848.0,2543.0,0.893,14.036,178,106,58,48,72,29,43,94,0.0,0.13
1008,1229,2020-03-19 00:17:00,0,2889.0,2408.0,0.834,14.05,223,98,64,34,125,76,49,23,0.17,0.0
1008,1230,2020-03-19 00:20:00,0,3183.0,2740.0,0.861,15.573,69,24,10,14,45,29,16,13,0.0,0.0
1008,1231,2020-03-19 00:23:00,0,3161.0,2823.0,0.893,15.58,381,205,155,50,176,122,54,50,0.01,0.02
1008,1232,2020-03-19 00:26:00,0,3474.0,3058.0,0.88,17.074,495,223,184,39,272,208,64,87,0.09,0.0
1008,1233,2020-03-19 00:29:00,0,3168.0,2785.0,0.879,15.567,115,70,50,20,45,26,19,34,0.0,0.0
1008,1234,2020-03-19 00:32:00,0,2872.0,2482.0,0.864,14.066,45,7,0,7,38,22,16,0,0.0,0.0
1008,1235,2020-03-19 00:35:00,0,3195.0,2700.0,0.845,15.579,191,71,54,17,120,85,35,1,0.0,0.0
1008,1236,2020-03-19 00:38:00,0,3096.0,2600.0,0.84,15.076,34,3,1,2,31,11,20,0,0.0,0.0
1008,1237,2020-03-19 00:41:00,0,2893.0,2395.0,0.828,14.051,37,4,3,1,33,9,24,0,0.0,0.0
1008,1238,2020-03-19 00:44:00,0,2894.0,2408.0,0.832,14.069,12,0,0,0,12,0,12,0,0.0,0.0
1008,1239,2020-03-19 00:47:00,0,3102.0,2575.0,0.83,15.071,53,23,21,2,30,20,10,9,0.0,0.0
1008,1240,2020-03-19 00:50:00,0,3208.0,2607.0,0.813,15.525,178,85,48,37,93,50,43,74,0.19,0.14
1008,1241,2020-03-19 00:53:00,0,2878.0,2444.0,0.849,14.045,374,159,109,50,215,146,69,38,0.0,0.02
1008,1242,2020-03-19 00:56:00,0,3164.0,2771.0,0.876,15.534,251,85,39,46,166,122,44,32,0.0,0.0
1008,1243,2020-03-19 00:59:00,0,3137.0,2906.0,0.926,15.576,403,212,183,29,191,146,45,101,0.01,0.0
1008,1244,2020-03-19 01:02:00,0,3131.0,2928.0,0.935,15.577,534,266,205,61,268,194,74,19,0.13,0.01
1008,1245,2020-03-19 01:05:00,0,3385.0,2929.0,0.866,16.579,617,371,308,63,246,189,57,49,0.25,0.04
1008,1246,2020-03-19 01:08:00,0,3374.0,2973.0,0.881,16.583,320,174,112,62,146,89,57,10,0.0,0.0
1008,1247,2020-03-19 01:11:00,0,3142.0,2889.0,0.92,15.575,75,46,26,20,29,11,18,0,0.0,0.0
1008,1248,2020-03-19 01:14:00,0,3168.0,2797.0,0.883,15.578,134,90,58,32,44,12,32,0,0.0,0.0
1008,1249,2020-03-19 01:17:00,0,2965.0,2637.0,0.889,14.603,224,97,68,29,127,82,45,72,0.0,0.29
1008,1250,2020-03-19 01:20:00,0,3166.0,2765.0,0.873,15.537,353,153,109,44,200,135,65,2,0.0,0.02
1008,1251,2020-03-19 01:23:00,0,3150.0,2888.0,0.917,15.607,128,73,36,37,55,31,24,19,0.0,0.0
1008,1252,2020-03-19 01:26:00,0,3153.0,2851.0,0.904,15.579,137,59,21,38,78,50,28,0,0.0,0.0
1008,1253,2020-03-19 01:29:00,0,3051.0,2754.0,0.903,15.07,135,31,11,20,104,64,40,0,0.0,0.0
1008,1254,2020-03-19 01:32:00,0,3060.0,2722.0,0.89,15.07,231,71,52,19,160,114,46,4,0.0,0.0
1008,1255,2020-03-19 01:35:00,0,2868.0,2466.0,0.86,14.031,532,288,237,51,244,193,51,87,0.0,0.0
1008,1256,2020-03-19 01:38:00,0,2948.0,2695.0,0.914,14.6,29,10,6,4,19,12,7,0,0.0,0.0
1008,1257,2020-03-19 01:41:00,0,2843.0,2606.0,0.917,14.085,30,16,3,13,14,5,9,0,0.0,0.0
1008,1258,2020-03-19 01:44:00,0,2867.0,2522.0,0.88,14.088,53,21,12,9,32,23,9,0,0.0,0.0
1008,1259,2020-03-19 01:47:00,0,2751.0,2429.0,0.883,13.527,74,35,29,6,39,30,9,0,0.0,0.0
1008,1260,2020-03-19 01:50:00,0,2842.0,2619.0,0.921,14.096,180,64,46,18,116,88,28,0,0.0,0.0
1008,1261,2020-03-19 01:53:00,0,2817.0,2678.0,0.951,14.062,217,137,88,49,80,49,31,64,0.16,0.0
1008,1262,2020-03-19 01:56:00,0,2826.0,2659.0,0.941,14.077,486,236,179,57,250,177,73,59,0.0,0.01
1008,1263,2020-03-19 01:59:00,0,3052.0,2742.0,0.898,15.063,76,7,5,2,69,17,52,0,0.0,0.0
1008,1264,2020-03-19 02:02:00,0,2823.0,2663.0,0.943,14.073,27,9,3,6,18,9,9,0,0.0,0.0
1008,1265,2020-03-19 02:05:00,0,2873.0,2498.0,0.869,14.087,145,79,60,19,66,49,17,1,0.0,0.0
1008,1266,2020-03-19 02:08:00,0,2869.0,2511.0,0.875,14.086,7,0,0,0,7,0,7,0,0.0,0.0
1008,1267,2020-03-19 02:11:00,0,2868.0,2502.0,0.8725,14.0715,6,0,0,0,6,3,3,0,0.0,0.0
1008,1268,2020-03-19 02:14:00,0,2867.0,2493.0,0.87,14.057,17,4,1,3,13,5,8,0,0.0,0.0
1008,1269,2020-03-19 02:17:00,0,2893.0,2415.0,0.835,14.072,22,14,0,14,8,7,1,0,0.0,0.0
1008,1270,2020-03-19 02:20:00,0,2887.0,2396.0,0.83,14.027,127,65,46,19,62,39,23,36,0.0,0.0
1008,1271,2020-03-19 02:23:00,0,3063.0,2661.0,0.869,15.016,198,73,31,42,125,67,58,24,0.02,0.0
1008,1272,2020-03-19 02:26:00,0,3165.0,2788.0,0.881,15.556,447,259,213,46,188,140,48,72,0.21,0.02
1008,1273,2020-03-19 02:29:00,0,3056.0,2722.0,0.891,15.055,361,177,125,52,184,139,45,65,0.0,0.0
1008,1274,2020-03-19 02:32:00,0,3077.0,2681.0,0.871,15.091,645,312,246,66,333,259,74,58,0.08,0.0
1008,1275,2020-03-19 02:35:00,0,3172.0,2773.0,0.874,15.567,479,289,237,52,190,135,55,134,0.0,0.0
1008,1276,2020-03-19 02:38:00,0,2828.0,2637.0,0.932,14.061,657,371,309,62,286,206,80,56,0.17,0.0
1008,1277,2020-03-19 02:41:00,0,3150.0,2857.0,0.907,15.573,822,539,441,98,283,217,66,19,0.0,0.01
1008,1278,2020-03-19 02:44:00,0,3164.0,2850.0,0.901,15.622,1091,660,554,106,431,335,96,47,0.0,0.0
1008,1279,2020-03-19 02:47:00,0,3151.0,2853.0,0.905,15.574,287,114,77,37,173,108,65,40,0.0,0.0
1008,1280,2020-03-19 02:50:00,0,3162.0,2844.0,0.899,15.606,329,153,115,38,176,122,54,63,0.0,0.0
1008,1281,2020-03-19 02:53:00,0,2944.0,2686.0,0.912,14.574,390,170,133,37,220,157,63,73,0.0,0.0
1008,1282,2020-03-19 02:56:00,0,3173.0,2775.0,0.875,15.575,140,42,20,22,98,58,40,21,0.0,0.0
1008,1283,2020-03-19 02:59:00,0,3058.0,2731.0,0.893,15.071,820,398,304,94,422,308,114,12,0.0,0.0
1008,1284,2020-03-19 03:02:00,0,2835.0,2578.0,0.909,14.025,644,312,246,66,332,270,62,99,0.0,0.0
1008,1285,2020-03-19 03:05:00,0,2834.0,2587.0,0.913,14.032,398,214,154,60,184,144,40,81,0.06,0.0
1008,1286,2020-03-19 03:08:00,0,2839.0,2593.0,0.913,14.057,405,188,140,48,217,164,53,110,0.0,0.0
1008,1287,2020-03-19 03:11:00,0,2842.0,2569.0,0.904,14.042,447,250,196,54,197,150,47,48,0.0,0.0
1008,1288,2020-03-19 03:14:00,0,2943.0,2689.0,0.914,14.571,635,277,206,71,358,271,87,50,0.0,0.0
1008,1289,2020-03-19 03:17:00,0,2941.0,2654.0,0.902,14.524,288,155,111,44,133,86,47,14,0.0,0.0
1008,1290,2020-03-19 03:20:00,0,2754.0,2447.0,0.888,13.56,565,318,261,57,247,176,71,31,0.01,0.0
1008,1291,2020-03-19 03:23:00,0,3187.0,2729.0,0.856,15.576,155,67,41,26,88,63,25,0,0.11,0.0
1008,1292,2020-03-19 03:26:00,0,2833.0,2601.0,0.918,14.041,12,1,0,1,11,3,8,0,0.0,0.0
1008,1293,2020-03-19 03:29:00,0,2851.0,2567.0,0.9,14.076,38,11,8,3,27,15,12,9,0.0,0.0
1008,1294,2020-03-19 03:32:00,0,2666.0,2328.0,0.873,13.081,329,182,130,52,147,93,54,93,0.0,0.02
1008,1295,2020-03-19 03:35:00,0,2655.0,2372.0,0.894,13.086,362,153,122,31,209,160,49,86,0.16,0.0
1008,1296,2020-03-19 03:38:00,0,2861.0,2547.0,0.89,14.091,415,190,148,42,225,169,56,123,0.14,0.01
1008,1297,2020-03-19 03:41:00,0,2846.0,2584.0,0.908,14.073,751,552,459,93,199,141,58,32,0.0,0.04
1008,1298,2020-03-19 03:44:00,0,2847.0,2579.0,0.906,14.073,1042,696,574,122,346,248,98,22,0.0,0.01
1008,1299,2020-03-19 03:47:00,0,3069.0,2728.0,0.889,15.11,874,506,415,91,368,274,94,1,0.01,0.0
1008,1300,2020-03-19 03:50:00,0,3179.0,2743.0,0.863,15.564,578,489,404,85,89,53,36,46,0.06,0.36
1008,1301,2020-03-19 03:53:00,0,2952.0,2663.0,0.902,14.578,497,420,329,91,77,33,44,13,0.0,0.97
1008,1302,2020-03-19 03:56:00,0,3078.0,2681.0,0.871,15.096,63,63,39,24,0,0,0,15,0.0,0.0
1008,1303,2020-03-19 03:59:00,0,3178.0,2766.0,0.87,15.585,134,108,77,31,26,12,14,28,0.0,0.03
1008,1304,2020-03-19 04:02:00,0,2977.0,2575.0,0.865,14.581,278,183,138,45,95,46,49,85,0.0,0.0
1008,1305,2020-03-19 04:05:00,0,2870.0,2511.0,0.875,14.09,174,111,83,28,63,34,29,67,0.0,0.0
1008,1306,2020-03-19 04:08:00,0,2975.0,2567.0,0.863,14.562,280,219,174,45,61,39,22,100,0.11,0.0
1008,1307,2020-03-19 04:11:00,0,2869.0,2514.0,0.876,14.087,638,396,317,79,242,169,73,13,0.0,0.0
1008,1308,2020-03-19 04:14:00,0,2858.0,2500.0,0.875,14.03,707,363,298,65,344,244,100,100,0.0,0.0
1008,1309,2020-03-19 04:17:00,0,2985.0,2545.0,0.853,14.577,153,84,57,27,69,31,38,8,0.0,0.0
1008,1310,2020-03-19 04:20:00,0,2865.0,2529.0,0.883,14.087,157,52,26,26,105,55,50,1,0.0,0.0
1008,1311,2020-03-19 04:23:00,0,2877.0,2461.0,0.855,14.059,144,37,17,20,107,45,62,0,0.0,0.0
1008,1312,2020-03-19 04:26:00,0,2885.0,2426.0,0.841,14.051,114,46,15,31,68,23,45,3,0.0,0.0
1008,1313,2020-03-19 04:29:00,0,2889.0,2386.0,0.826,14.025,28,16,8,8,12,6,6,0,0.0,0.0
1008,1314,2020-03-19 04:32:00,0,2692.0,2244.0,0.833,13.092,16,12,3,9,4,2,2,0,0.0,0.0
1008,1315,2020-03-19 04:35:00,0,2680.0,2225.0,0.83,13.025,20,0,0,0,20,5,15,0,0.0,0.0
1008,1316,2020-03-19 04:38:00,0,2706.0,2170.0,0.802,13.062,23,3,2,1,20,1,19,0,0.0,0.0
1008,1317,2020-03-19 04:41:00,0,2609.0,2050.0,0.786,12.55,212,142,99,43,70,35,35,85,0.0,0.0
1008,1318,2020-03-19 04:44:00,0,2674.0,2254.0,0.843,13.033,468,235,188,47,233,163,70,34,0.21,0.0
1008,1319,2020-03-19 04:47:00,0,2800.0,2288.0,0.817,13.566,236,118,53,65,118,62,56,11,0.0,0.0
1008,1320,2020-03-19 04:50:00,0,2914.0,2319.0,0.796,14.049,55,35,21,14,20,14,6,0,0.0,0.0
1008,1321,2020-03-19 04:53:00,0,2684.0,2240.0,0.835,13.053,19,12,5,7,7,1,6,0,0.0,0.0
1008,1322,2020-03-19 04:56:00,0,2712.0,2156.0,0.795,13.071,9,2,1,1,7,0,7,0,0.0,0.0
1008,1323,2020-03-19 04:59:00,0,2706.0,2152.0,0.795,13.043,8,8,2,6,0,0,0,0,0.0,0.0
1008,1324,2020-03-19 05:02:00,0,2718.0,2124.0,0.782,13.059,115,70,47,23,45,26,19,46,0.0,0.0
1008,1325,2020-03-19 05:05:00,0,2919.0,2336.0,0.8,14.085,182,115,54,61,67,32,35,66,0.0,0.0
1008,1326,2020-03-19 05:08:00,0,2900.0,2379.0,0.82,14.058,302,180,134,46,122,81,41,104,0.05,0.0
1008,1327,2020-03-19 05:11:00,0,2944.5,2451.0,0.832,14.3135,507,266,234,32,241,181,60,151,0.13,0.0
1008,1328,2020-03-19 05:14:00,0,2989.0,2523.0,0.844,14.569,678,309,255,54,369,287,82,122,0.0,0.0
1008,1329,2020-03-19 05:17:00,0,2974.0,2567.0,0.863,14.559,865,537,443,94,328,238,90,15,0.0,0.0
1008,1330,2020-03-19 05:20:00,0,3089.0,2589.0,0.838,15.037,317,241,195,46,76,45,31,34,0.0,0.0
1008,1331,2020-03-19 05:23:00,0,2854.0,2510.0,0.879,14.023,523,293,238,55,230,163,67,69,0.0,0.0
1008,1332,2020-03-19 05:26:00,0,2862.0,2488.0,0.869,14.032,385,231,172,59,154,104,50,71,0.0,0.0
1008,1333,2020-03-19 05:29:00,0,2869.0,2471.0,0.861,14.042,520,339,264,75,181,124,57,33,0.0,0.0
1008,1334,2020-03-19 05:32:00,0,2898.0,2386.0,0.823,14.06,966,418,339,79,548,404,144,6,0.0,0.0
1008,1335,2020-03-19 05:35:00,0,2889.0,2382.0,0.824,14.022,301,155,123,32,146,107,39,14,0.0,0.0
1008,1336,2020-03-19 05:38:00,0,2805.0,2271.0,0.81,13.568,4,3,2,1,1,1,0,0,0.0,0.0
1008,1337,2020-03-19 05:41:00,0,2718.0,2105.0,0.774,13.042,26,7,4,3,19,13,6,0,0.0,0.0
1008,1338,2020-03-19 05:44:00,0,2491.0,2014.0,0.808,12.043,9,7,4,3,2,1,1,0,0.0,0.0
1008,1339,2020-03-19 05:47:00,0,2379.0,1969.0,0.828,11.555,5,2,0,2,3,2,1,0,0.0,0.0
1008,1340,2020-03-19 05:50:00,0,2393.0,1911.0,0.799,11.544,159,90,58,32,69,40,29,39,0.0,0.0
1008,1341,2020-03-19 05:53:00,0,2709.0,2107.0,0.778,13.006,250,125,82,43,125,79,46,93,0.0,0.0
1008,1342,2020-03-19 05:56:00,0,2727.0,2064.0,0.757,13.031,356,178,126,52,178,119,59,35,0.03,0.0
1008,1343,2020-03-19 05:59:00,0,2931.0,2252.0,0.768,14.042,293,93,53,40,200,126,74,0,0.0,0.0
1008,1344,2020-03-19 06:02:00,1,2895.0,2408.0,0.832,14.072,367,228,174,54,139,85,54,45,0.0,0.0
1008,1345,2020-03-19 06:05:00,1,3107.0,2547.0,0.82,15.061,428,201,140,61,227,154,73,25,0.01,0.0
1008,1346,2020-03-19 06:08:00,1,3229.0,2547.0,0.789,15.542,354,176,126,50,178,117,61,7,0.0,0.0
1008,1347,2020-03-19 06:11:00,1,3019.0,2406.0,0.797,14.561,467,238,185,53,229,166,63,67,0.0,0.0
1008,1348,2020-03-19 06:14:00,1,2712.0,2144.0,0.79,13.06,517,280,206,74,237,172,65,37,0.0,0.0
1008,1349,2020-03-19 06:17:00,1,3021.0,2392.0,0.792,14.55,867,426,336,90,441,332,109,23,0.04,0.0
1008,1350,2020-03-19 06:20:00,1,3261.0,2431.0,0.745,15.542,798,373,280,93,425,323,102,3,0.0,0.0
1008,1351,2020-03-19 06:23:00,1,3150.0,2404.0,0.763,15.072,763,369,295,74,394,292,102,9,0.0,0.0
1008,1352,2020-03-19 06:26:00,1,2934.0,2237.0,0.762,14.037,216,172,115,57,44,22,22,0,0.0,0.0
1008,1353,2020-03-19 06:29:00,1,2958.0,2189.0,0.74,14.078,151,142,71,71,9,3,6,0,0.0,0.0
1008,1354,2020-03-19 06:32:00,1,2939.0,2197.0,0.748,14.013,371,338,242,96,33,6,27,0,0.0,0.0
1008,1355,2020-03-19 06:35:00,1,2951.0,2185.0,0.74,14.047,233,196,116,80,37,12,25,0,0.0,0.0
1008,1356,2020-03-19 06:38:00,1,2740.0,2029.0,0.741,13.043,117,117,58,59,0,0,0,0,0.0,0.0
1008,1357,2020-03-19 06:41:00,1,2756.0,1947.0,0.707,13.016,122,122,58,64,0,0,0,0,0.0,0.0
1008,1358,2020-03-19 06:44:00,1,2562.0,1781.0,0.695,12.066,88,88,44,44,0,0,0,0,0.0,0.0
1008,1359,2020-03-19 06:47:00,1,2452.0,1696.0,0.692,11.537,173,148,87,61,25,18,7,1,0.0,0.0
1008,1360,2020-03-19 06:50:00,1,2437.0,1750.0,0.718,11.54,113,107,46,61,6,5,1,0,0.0,0.0
1008,1361,2020-03-19 06:53:00,1,2672.0,1796.0,0.672,12.515,78,77,32,45,1,1,0,0,0.0,0.0
1008,1362,2020-03-19 06:56:00,1,2679.0,1769.0,0.66,12.512,124,109,60,49,15,3,12,0,0.0,0.0
1008,1363,2020-03-19 06:59:00,1,2560.0,1760.0,0.688,12.037,196,163,115,48,33,16,17,0,0.0,0.0
1008,1364,2020-03-19 07:02:00,1,2453.0,1678.0,0.684,11.523,126,82,30,52,44,14,30,0,0.0,0.0
1008,1365,2020-03-19 07:05:00,1,2445.0,1694.0,0.693,11.508,160,120,62,58,40,8,32,0,0.0,0.0
1008,1366,2020-03-19 07:08:00,1,2459.0,1669.0,0.679,11.537,107,90,35,55,17,4,13,0,0.0,0.0
1008,1367,2020-03-19 07:11:00,1,2468.0,1648.0,0.668,11.549,75,75,31,44,0,0,0,0,0.0,0.0
1008,1368,2020-03-19 07:14:00,1,2491.0,1528.0,0.614,11.506,192,191,120,71,1,1,0,0,0.0,0.0
1008,1369,2020-03-19 07:17:00,1,2489.0,1571.0,0.631,11.548,489,361,265,96,128,90,38,44,0.0,0.0
1008,1370,2020-03-19 07:20:00,1,2999.0,1990.0,0.663,14.018,319,160,108,52,159,111,48,39,0.08,0.0
1008,1371,2020-03-19 07:23:00,1,2799.0,1784.0,0.637,13.002,778,349,272,77,429,331,98,7,0.0,0.0
1008,1372,2020-03-19 07:26:00,1,2780.0,1853.0,0.666,13.007,604,296,236,60,308,247,61,50,0.0,0.0
1008,1373,2020-03-19 07:29:00,1,3004.0,1966.0,0.654,14.011,226,103,71,32,123,80,43,4,0.0,0.0
1008,1374,2020-03-19 07:32:00,1,2999.0,1994.0,0.665,14.024,115,45,16,29,70,37,33,0,0.02,0.0
1008,1375,2020-03-19 07:35:00,1,2798.0,1804.0,0.645,13.02,15,13,0,13,2,2,0,0,0.0,0.0
1008,1376,2020-03-19 07:38:00,1,2472.0,1604.0,0.649,11.517,27,20,9,11,7,0,7,0,0.0,0.0
1008,1377,2020-03-19 07:41:00,1,2505.0,1512.0,0.604,11.546,3,0,0,0,3,0,3,0,0.0,0.0
1008,1378,2020-03-19 07:44:00,1,2259.0,1454.0,0.644,10.51,9,0,0,0,9,0,9,0,0.0,0.0
1008,1379,2020-03-19 07:47:00,1,2148.0,1402.0,0.653,10.015,44,7,3,4,37,0,37,0,0.0,0.0
1008,1380,2020-03-19 07:50:00,1,2507.0,1494.0,0.596,11.531,81,35,22,13,46,23,23,0,0.0,0.0
1008,1381,2020-03-19 07:53:00,1,2370.0,1490.0,0.629,10.987,14,5,0,5,9,0,9,0,0.0,0.0
1008,1382,2020-03-19 07:56:00,1,2259.0,1458.0,0.645,10.515,8,7,3,4,1,0,1,0,0.0,0.0
1008,1383,2020-03-19 07:59:00,1,2146.0,1428.0,0.666,10.036,7,4,3,1,3,2,1,0,0.0,0.0
1008,1384,2020-03-19 08:02:00,1,2158.0,1370.0,0.635,10.02,10,2,1,1,8,1,7,0,0.0,0.0
1008,1385,2020-03-19 08:05:00,1,2138.0,1420.0,0.664,9.997,17,9,2,7,8,1,7,0,0.0,0.0
1008,1386,2020-03-19 08:08:00,1,2141.0,1435.0,0.67,10.026,57,29,20,9,28,16,12,0,0.0,0.0
1008,1387,2020-03-19 08:11:00,1,2015.5,1427.0,0.7105,9.523,9,2,1,1,7,3,4,0,0.0,0.0
1008,1388,2020-03-19 08:14:00,1,1890.0,1419.0,0.751,9.02,63,4,0,4,59,0,59,0,0.0,0.0
1008,1389,2020-03-19 08:17:00,1,2241.0,1531.0,0.683,10.524,132,49,19,30,83,32,51,0,0.0,0.0
1008,1390,2020-03-19 08:20:00,1,2219.0,1615.0,0.728,10.532,171,55,29,26,116,71,45,4,0.0,0.0
1008,1391,2020-03-19 08:23:00,1,2227.0,1594.0,0.716,10.538,7,2,0,2,5,0,5,0,0.0,0.0
1008,1392,2020-03-19 08:26:00,1,2001.0,1478.0,0.739,9.523,0,0,0,0,0,0,0,0,0.0,0.0
1008,1393,2020-03-19 08:29:00,1,1900.0,1385.0,0.729,9.02,31,8,0,8,23,1,22,0,0.0,0.0
1008,1394,2020-03-19 08:32:00,1,1905.0,1369.0,0.719,9.021,0,0,0,0,0,0,0,0,0.0,0.0
1008,1395,2020-03-19 08:35:00,1,1903.0,1362.0,0.716,9.005,117,58,47,11,59,37,22,0,0.0,0.0
1008,1396,2020-03-19 08:38:00,1,2007.0,1449.0,0.722,9.511,1,0,0,0,1,0,1,0,0.0,0.0
1008,1397,2020-03-19 08:41:00,1,2005.0,1452.0,0.724,9.506,21,0,0,0,21,0,21,0,0.0,0.0
1008,1398,2020-03-19 08:44:00,1,2007.0,1440.0,0.717,9.503,23,3,1,2,20,5,15,0,0.0,0.0
1008,1399,2020-03-19 08:47:00,1,1900.0,1388.0,0.731,9.022,39,10,5,5,29,10,19,0,0.0,0.0
1008,1400,2020-03-19 08:50:00,1,1919.0,1317.0,0.686,9.019,29,11,5,6,18,1,17,0,0.0,0.0
1008,1401,2020-03-19 08:53:00,1,1908.0,1347.0,0.706,9.01,196,95,62,33,101,56,45,11,0.0,0.0
1008,1402,2020-03-19 08:56:00,1,2343.0,1650.0,0.704,11.06,104,61,38,23,43,17,26,37,0.0,0.0
1008,1403,2020-03-19 08:59:00,1,2662.0,1865.0,0.701,12.554,63,35,17,18,28,13,15,20,0.0,0.0
1008,1404,2020-03-19 09:02:00,1,2556.0,1779.0,0.696,12.04,135,16,5,11,119,72,47,9,0.19,0.0
1008,1405,2020-03-19 09:05:00,1,2206.0,1656.0,0.751,10.527,358,174,128,46,184,112,72,4,0.0,0.0
1008,1406,2020-03-19 09:08:00,1,2742.0,2027.0,0.739,13.048,598,335,270,65,263,190,73,8,0.0,0.0
1008,1407,2020-03-19 09:11:00,1,2510.0,1954.0,0.779,12.052,851,416,340,76,435,338,97,7,0.0,0.0
1008,1408,2020-03-19 09:14:00,1,2609.0,2046.0,0.784,12.547,716,427,352,75,289,219,70,13,0.0,0.0
1008,1409,2020-03-19 09:17:00,1,2708.0,2096.0,0.774,12.988,1261,620,499,121,641,512,129,14,0.0,0.0
1008,1410,2020-03-19 09:20:00,1,2709.0,2162.0,0.798,13.066,807,440,350,90,367,272,95,4,0.0,0.0
1008,1411,2020-03-19 09:23:00,1,2727.0,2081.0,0.763,13.05,74,42,29,13,32,18,14,1,0.19,0.0
1008,1412,2020-03-19 09:26:00,1,2724.0,2099.0,0.771,13.055,157,65,31,34,92,39,53,0,0.0,0.0
1008,1413,2020-03-19 09:29:00,1,2739.0,2016.0,0.736,13.022,44,20,10,10,24,8,16,0,0.0,0.0
1008,1414,2020-03-19 09:32:00,1,2519.0,1915.0,0.76,12.043,18,15,6,9,3,2,1,0,0.0,0.0
1008,1415,2020-03-19 09:35:00,1,2448.0,1705.0,0.696,11.532,0,0,0,0,0,0,0,0,0.0,0.0
1008,1416,2020-03-19 09:38:00,1,2216.0,1607.0,0.725,10.51,51,27,2,25,24,18,6,0,0.0,0.0
1008,1417,2020-03-19 09:41:00,1,2227.0,1582.0,0.71,10.527,107,8,0,8,99,61,38,0,0.0,0.0
1008,1418,2020-03-19 09:44:00,1,2231.0,1563.0,0.7,10.521,49,6,2,4,43,13,30,0,0.0,0.0
1008,1419,2020-03-19 09:47:00,1,2233.0,1549.0,0.694,10.515,95,33,7,26,62,0,62,0,0.0,0.0
1008,1420,2020-03-19 09:50:00,1,2253.0,1471.0,0.653,10.507,41,4,3,1,37,0,37,0,0.0,0.0
1008,1421,2020-03-19 09:53:00,1,2260.0,1434.0,0.634,10.493,15,0,0,0,15,0,15,0,0.0,0.0
1008,1422,2020-03-19 09:56:00,1,2268.0,1431.0,0.631,10.52,1,0,0,0,1,0,1,0,0.0,0.0
1008,1423,2020-03-19 09:59:00,1,2264.0,1451.0,0.641,10.527,6,4,1,3,2,2,0,0,0.0,0.0
1008,1424,2020-03-19 10:02:00,1,2264.0,1464.0,0.647,10.543,4,0,0,0,4,2,2,0,0.0,0.0
1008,1425,2020-03-19 10:05:00,1,2265.0,1428.0,0.631,10.507,95,13,10,3,82,24,58,0,0.0,0.0
1008,1426,2020-03-19 10:08:00,1,2282.0,1408.0,0.617,10.549,49,8,0,8,41,6,35,0,0.0,0.0
1008,1427,2020-03-19 10:11:00,1,2274.0,1407.0,0.619,10.519,33,20,0,20,13,3,10,0,0.0,0.0
1008,1428,2020-03-19 10:14:00,1,2268.0,1410.0,0.622,10.497,4,2,0,2,2,0,2,0,0.0,0.0
1008,1429,2020-03-19 10:17:00,1,2270.0,1414.0,0.623,10.51,40,20,10,10,20,8,12,0,0.0,0.0
1008,1430,2020-03-19 10:20:00,1,2255.0,1478.0,0.655,10.522,263,131,84,47,132,66,66,18,0.0,0.0
1008,1431,2020-03-19 10:23:00,1,2479.0,1581.0,0.638,11.521,86,45,16,29,41,18,23,19,0.0,0.0
1008,1432,2020-03-19 10:26:00,1,2574.0,1710.0,0.664,12.037,211,83,49,34,128,75,53,3,0.0,0.0
1008,1433,2020-03-19 10:29:00,1,2796.0,1815.0,0.649,13.028,135,58,27,31,77,33,44,0,0.0,0.0
1008,1434,2020-03-19 10:32:00,1,2565.0,1739.0,0.678,12.031,79,8,4,4,71,8,63,0,0.0,0.0
1008,1435,2020-03-19 10:35:00,1,2602.0,1569.0,0.603,11.992,52,1,0,1,51,1,50,0,0.0,0.0
1008,1436,2020-03-19 10:38:00,1,2254.0,1493.0,0.662,10.533,89,15,9,6,74,15,59,0,0.0,0.0
1008,1437,2020-03-19 10:41:00,1,2256.0,1477.0,0.655,10.524,41,0,0,0,41,0,41,0,0.0,0.0
1008,1438,2020-03-19 10:44:00,1,2264.0,1464.0,0.647,10.542,30,0,0,0,30,0,30,0,0.0,0.0
1008,1439,2020-03-19 10:47:00,1,2254.0,1476.0,0.655,10.516,49,2,1,1,47,3,44,0,0.0,0.0
1008,1440,2020-03-19 10:50:00,1,2253.0,1480.0,0.657,10.517,153,48,36,12,105,64,41,0,0.0,0.0
1008,1441,2020-03-19 10:53:00,1,2481.0,1558.0,0.628,11.499,124,71,53,18,53,38,15,3,0.0,0.0
1008,1442,2020-03-19 10:56:00,1,2488.0,1530.0,0.615,11.495,3,2,0,2,1,0,1,0,0.0,0.0
1008,1443,2020-03-19 10:59:00,1,2253.0,1467.0,0.651,10.503,0,0,0,0,0,0,0,0,0.0,0.0
1008,1444,2020-03-19 11:02:00,1,2374.0,1469.0,0.619,10.982,6,6,1,5,0,0,0,0,0.0,0.0
1008,1445,2020-03-19 11:05:00,1,2278.0,1399.0,0.614,10.525,2,2,0,2,0,0,0,0,0.0,0.0
1008,1446,2020-03-19 11:08:00,1,2277.0,1400.0,0.615,10.523,3,1,0,1,2,1,1,0,0.0,0.0
1008,1447,2020-03-19 11:11:00,1,2085.0,1415.0,0.685,9.783,2,2,0,2,0,0,0,0,0.0,0.0
1008,1448,2020-03-19 11:14:00,1,1893.0,1430.0,0.755,9.043,3,2,0,2,1,0,1,0,0.0,0.0
1008,1449,2020-03-19 11:17:00,1,1895.0,1403.0,0.74,9.017,3,1,0,1,2,0,2,0,0.0,0.0
1008,1450,2020-03-19 11:20:00,1,1905.0,1374.0,0.721,9.027,11,4,2,2,7,0,7,0,0.0,0.0
1008,1451,2020-03-19 11:23:00,1,1891.0,1401.0,0.741,9.0,4,2,0,2,2,0,2,0,0.0,0.0
1008,1452,2020-03-19 11:26:00,1,1904.0,1370.0,0.719,9.02,3,0,0,0,3,0,3,0,0.0,0.0
1008,1453,2020-03-19 11:29:00,1,1905.0,1348.0,0.708,9.0,0,0,0,0,0,0,0,0,0.0,0.0
1008,1454,2020-03-19 11:32:00,1,1913.0,1333.0,0.697,9.012,1,1,0,1,0,0,0,0,0.0,0.0
1008,1455,2020-03-19 11:35:00,1,1668.0,1313.0,0.787,8.025,3,3,0,3,0,0,0,0,0.0,0.0
1008,1456,2020-03-19 11:38:00,1,1918.0,1323.0,0.69,9.022,3,3,0,3,0,0,0,0,0.0,0.0
1008,1457,2020-03-19 11:41:00,1,1918.0,1341.0,0.699,9.042,1,1,0,1,0,0,0,0,0.0,0.0
1008,1458,2020-03-19 11:44:00,1,1906.0,1343.0,0.705,8.998,6,1,0,1,5,0,5,0,0.0,0.0
1008,1459,2020-03-19 11:47:00,1,1794.0,1318.0,0.735,8.526,26,17,7,10,9,2,7,0,0.0,0.0
1008,1460,2020-03-19 11:50:00,1,1867.0,1495.0,0.801,9.013,147,132,58,74,15,5,10,5,0.0,0.0
1008,1461,2020-03-19 11:53:00,1,2223.0,1605.0,0.722,10.538,85,47,22,25,38,7,31,0,0.0,0.0
1008,1462,2020-03-19 11:56:00,1,2415.0,1836.0,0.761,11.547,399,235,186,49,164,124,40,14,0.0,0.0
1008,1463,2020-03-19 11:59:00,1,2178.0,1751.0,0.804,10.521,764,403,333,70,361,273,88,19,0.0,0.0
1008,1464,2020-03-19 12:02:00,1,2406.0,1859.0,0.773,11.539,647,261,206,55,386,295,91,34,0.12,0.0
1008,1465,2020-03-19 12:05:00,1,2427.0,1789.0,0.737,11.544,635,344,277,67,291,225,66,6,0.0,0.0
1008,1466,2020-03-19 12:08:00,1,2433.0,1787.0,0.734,11.564,889,456,351,105,433,331,102,34,0.0,0.0
1008,1467,2020-03-19 12:11:00,1,2406.0,1843.0,0.766,11.521,734,382,280,102,352,271,81,18,0.0,0.0
1008,1468,2020-03-19 12:14:00,1,2528.0,1885.0,0.746,12.047,823,500,415,85,323,246,77,27,0.0,0.0
1008,1469,2020-03-19 12:17:00,1,2412.0,1862.0,0.772,11.563,818,390,290,100,428,320,108,4,0.05,0.0
1008,1470,2020-03-19 12:20:00,1,2409.0,1815.0,0.753,11.501,777,475,381,94,302,216,86,13,0.0,0.0
1008,1471,2020-03-19 12:23:00,1,2425.0,1784.0,0.736,11.53,78,45,26,19,33,18,15,0,0.0,0.0
1008,1472,2020-03-19 12:26:00,1,2422.0,1807.0,0.746,11.542,176,45,3,42,131,84,47,0,0.0,0.0
1008,1473,2020-03-19 12:29:00,1,2422.0,1785.0,0.737,11.519,122,54,17,37,68,29,39,0,0.0,0.0
1008,1474,2020-03-19 12:32:00,1,2425.0,1782.0,0.735,11.527,171,35,7,28,136,117,19,0,0.0,0.0
1008,1475,2020-03-19 12:35:00,1,2437.0,1766.0,0.725,11.559,426,45,13,32,381,336,45,0,0.0,0.0
1008,1476,2020-03-19 12:38:00,1,2207.0,1664.0,0.754,10.539,146,27,7,20,119,96,23,0,0.0,0.0
1008,1477,2020-03-19 12:41:00,1,2218.0,1612.0,0.727,10.525,11,4,1,3,7,1,6,0,0.0,0.0
1008,1478,2020-03-19 12:44:00,1,2128.0,1477.0,0.694,10.02,16,4,2,2,12,4,8,0,0.0,0.0
1008,1479,2020-03-19 12:47:00,1,2127.0,1481.0,0.696,10.02,228,78,37,41,150,83,67,1,0.0,0.0
1008,1480,2020-03-19 12:50:00,1,2231.0,1560.0,0.699,10.516,127,66,34,32,61,19,42,0,0.0,0.0
1008,1481,2020-03-19 12:53:00,1,2216.0,1617.0,0.73,10.521,126,68,21,47,58,24,34,9,0.0,0.0
1008,1482,2020-03-19 12:56:00,1,2212.0,1648.0,0.745,10.54,127,42,22,20,85,23,62,0,0.0,0.0
1008,1483,2020-03-19 12:59:00,1,2006.0,1461.0,0.728,9.523,19,0,0,0,19,0,19,0,0.0,0.0
1008,1484,2020-03-19 13:02:00,1,1907.0,1353.0,0.71,9.012,67,35,7,28,32,18,14,0,0.0,0.0
1008,1485,2020-03-19 13:05:00,1,1902.0,1363.0,0.717,9.004,59,30,2,28,29,13,16,0,0.0,0.0
1008,1486,2020-03-19 13:08:00,1,1909.0,1357.0,0.711,9.025,87,67,28,39,20,2,18,0,0.0,0.0
1008,1487,2020-03-19 13:11:00,1,1907.0,1364.0,0.715,9.026,50,18,4,14,32,16,16,0,0.0,0.0
1008,1488,2020-03-19 13:14:00,1,1887.0,1420.0,0.752,9.009,16,0,0,0,16,0,16,0,0.0,0.0
1008,1489,2020-03-19 13:17:00,1,1899.0,1394.0,0.734,9.026,11,0,0,0,11,0,11,0,0.0,0.0
1008,1490,2020-03-19 13:20:00,1,1899.0,1385.0,0.729,9.015,21,3,0,3,18,4,14,0,0.0,0.0
1008,1491,2020-03-19 13:23:00,1,1903.0,1362.0,0.716,9.008,35,8,0,8,27,2,25,0,0.0,0.0
1008,1492,2020-03-19 13:26:00,1,1907.0,1370.0,0.719,9.031,39,5,1,4,34,2,32,0,0.0,0.0
1008,1493,2020-03-19 13:29:00,1,1902.0,1386.0,0.729,9.028,204,90,58,32,114,64,50,17,0.0,0.0
1008,1494,2020-03-19 13:32:00,1,2233.0,1569.0,0.703,10.534,111,64,31,33,47,16,31,15,0.0,0.0
1008,1495,2020-03-19 13:35:00,1,2233.0,1573.0,0.704,10.54,192,102,53,49,90,62,28,29,0.15,0.0
1008,1496,2020-03-19 13:38:00,1,2450.0,1709.0,0.698,11.546,40,27,9,18,13,0,13,5,0.0,0.0
1008,1497,2020-03-19 13:41:00,1,2212.0,1641.0,0.742,10.533,105,27,12,15,78,27,51,0,0.0,0.0
1008,1498,2020-03-19 13:44:00,1,1995.0,1497.0,0.75,9.52,33,0,0,0,33,15,18,0,0.0,0.0
1008,1499,2020-03-19 13:47:00,1,1903.0,1352.0,0.71,8.997,38,2,0,2,36,18,18,0,0.0,0.0
1008,1500,2020-03-19 13:50:00,1,1922.0,1304.0,0.679,9.018,25,8,1,7,17,4,13,0,0.0,0.0
1008,1501,2020-03-19 13:53:00,1,1906.0,1362.0,0.715,9.018,46,17,5,12,29,7,22,0,0.0,0.0
1008,1502,2020-03-19 13:56:00,1,1921.0,1304.0,0.679,9.014,25,0,0,0,25,0,25,0,0.0,0.0
1008,1503,2020-03-19 13:59:00,1,1689.0,1229.0,0.728,8.017,25,3,2,1,22,4,18,0,0.0,0.0
1008,1504,2020-03-19 14:02:00,1,1808.0,1259.0,0.696,8.516,30,11,7,4,19,6,13,0,0.0,0.0
1008,1505,2020-03-19 14:05:00,1,1931.0,1271.0,0.658,9.015,11,0,0,0,11,0,11,0,0.0,0.0
1008,1506,2020-03-19 14:08:00,1,1928.0,1294.0,0.671,9.028,20,6,0,6,14,0,14,0,0.0,0.0
1008,1507,2020-03-19 14:11:00,1,1906.0,1368.0,0.718,9.024,25,3,1,2,22,4,18,0,0.0,0.0
1008,1508,2020-03-19 14:14:00,1,1884.0,1442.0,0.765,9.02,131,75,57,18,56,33,23,9,0.0,0.0
1008,1509,2020-03-19 14:17:00,1,2519.0,1933.0,0.768,12.064,256,146,117,29,110,78,32,2,0.01,0.0
1008,1510,2020-03-19 14:20:00,1,2618.0,1983.0,0.758,12.51,500,190,146,44,310,221,89,57,0.05,0.0
1008,1511,2020-03-19 14:23:00,1,2743.0,2017.0,0.736,13.04,126,82,51,31,44,18,26,50,0.01,0.0
1008,1512,2020-03-19 14:26:00,1,2399.0,1881.0,0.784,11.536,250,122,78,44,128,74,54,0,0.0,0.0
1008,1513,2020-03-19 14:29:00,1,2932.0,2245.0,0.766,14.038,312,162,119,43,150,97,53,40,0.0,0.0
1008,1514,2020-03-19 14:32:00,1,2417.0,1811.0,0.749,11.529,260,62,19,43,198,127,71,3,0.0,0.0
1008,1515,2020-03-19 14:35:00,1,2412.0,1823.0,0.756,11.524,94,25,9,16,69,26,43,0,0.0,0.0
1008,1516,2020-03-19 14:38:00,1,2308.0,1755.0,0.76,11.036,5,0,0,0,5,0,5,0,0.0,0.0
1008,1517,2020-03-19 14:41:00,1,2217.0,1609.0,0.726,10.515,11,0,0,0,11,5,6,0,0.02,0.0
1008,1518,2020-03-19 14:44:00,1,1994.0,1516.0,0.76,9.536,9,0,0,0,9,4,5,0,0.01,0.0
1008,1519,2020-03-19 14:47:00,1,2446.0,1713.0,0.7,11.536,201,88,60,28,113,72,41,12,0.0,0.0
1008,1520,2020-03-19 14:50:00,1,1910.0,1355.0,0.709,9.025,32,4,0,4,28,0,28,0,0.0,0.0
1008,1521,2020-03-19 14:53:00,1,1911.0,1327.0,0.694,8.998,32,2,0,2,30,0,30,0,0.0,0.0
1008,1522,2020-03-19 14:56:00,1,2007.0,1439.0,0.717,9.502,67,0,0,0,67,23,44,0,0.0,0.0
1008,1523,2020-03-19 14:59:00,1,2257.0,1469.0,0.651,10.519,91,0,0,0,91,50,41,0,0.07,0.0
1008,1524,2020-03-19 15:02:00,1,2244.0,1507.0,0.671,10.509,107,10,0,10,97,46,51,0,0.0,0.0
1008,1525,2020-03-19 15:05:00,1,2236.0,1529.0,0.684,10.503,29,3,1,2,26,0,26,0,0.01,0.0
1008,1526,2020-03-19 15:08:00,1,2246.0,1517.0,0.676,10.529,28,3,2,1,25,0,25,0,0.0,0.0
1008,1527,2020-03-19 15:11:00,1,2246.0,1511.0,0.673,10.522,21,3,1,2,18,0,18,0,0.0,0.0
1008,1528,2020-03-19 15:14:00,1,2260.0,1459.0,0.646,10.518,81,25,9,16,56,28,28,0,0.09,0.0
1008,1529,2020-03-19 15:17:00,1,2206.0,1630.0,0.739,10.498,284,161,85,76,123,55,68,3,0.0,0.0
1008,1530,2020-03-19 15:20:00,1,2212.0,1643.0,0.743,10.535,184,80,45,35,104,55,49,1,0.0,0.0
1008,1531,2020-03-19 15:23:00,1,2219.0,1617.0,0.729,10.534,79,48,27,21,31,7,24,0,0.0,0.0
1008,1532,2020-03-19 15:26:00,1,2239.0,1547.0,0.691,10.534,3,3,0,3,0,0,0,0,0.0,0.0
1008,1533,2020-03-19 15:29:00,1,2014.0,1451.0,0.72,9.541,5,5,3,2,0,0,0,0,0.06,0.0
1008,1534,2020-03-19 15:32:00,1,2012.0,1437.0,0.714,9.518,6,4,2,2,2,1,1,0,0.0,0.0
1008,1535,2020-03-19 15:35:00,1,1906.0,1385.0,0.727,9.042,67,0,0,0,67,35,32,0,0.02,0.0
1008,1536,2020-03-19 15:38:00,1,2458.0,1712.0,0.696,11.581,134,72,46,26,62,38,24,33,0.0,0.0
1008,1537,2020-03-19 15:41:00,1,2417.0,1787.0,0.739,11.5,104,28,9,19,76,43,33,1,0.08,0.0
1008,1538,2020-03-19 15:44:00,1,2410.0,1835.0,0.762,11.526,315,145,108,37,170,126,44,43,0.0,0.0
1008,1539,2020-03-19 15:47:00,1,2530.0,1847.0,0.73,12.013,170,51,18,33,119,64,55,1,0.0,0.0
1008,1540,2020-03-19 15:50:00,1,2420.0,1830.0,0.756,11.56,122,45,20,25,77,27,50,0,0.0,0.0
1008,1541,2020-03-19 15:53:00,1,2443.0,1720.0,0.704,11.532,22,0,0,0,22,0,22,0,0.0,0.0
1008,1542,2020-03-19 15:56:00,1,2231.0,1577.0,0.707,10.537,3,0,0,0,3,0,3,0,0.0,0.0
1008,1543,2020-03-19 15:59:00,1,2013.0,1439.0,0.715,9.525,22,5,1,4,17,3,14,0,0.0,0.0
1008,1544,2020-03-19 16:02:00,1,1893.0,1413.0,0.746,9.022,9,6,3,3,3,2,1,0,0.0,0.0
1008,1545,2020-03-19 16:05:00,1,2136.0,1459.0,0.683,10.034,1,1,0,1,0,0,0,0,0.0,0.0
1008,1546,2020-03-19 16:08:00,1,2019.0,1425.0,0.706,9.532,3,3,0,3,0,0,0,0,0.05,0.0
1008,1547,2020-03-19 16:11:00,1,2014.0,1443.0,0.716,9.533,8,2,0,2,6,4,2,0,0.02,0.0
1008,1548,2020-03-19 16:14:00,1,2130.0,1457.0,0.684,10.003,1,1,0,1,0,0,0,0,0.0,0.0
1008,1549,2020-03-19 16:17:00,1,2143.0,1423.0,0.664,10.02,16,7,2,5,9,3,6,0,0.0,0.0
1008,1550,2020-03-19 16:20:00,1,2137.0,1442.0,0.675,10.016,0,0,0,0,0,0,0,0,0.0,0.0
1008,1551,2020-03-19 16:23:00,1,1896.0,1401.0,0.739,9.02,0,0,0,0,0,0,0,0,0.0,0.0
1008,1552,2020-03-19 16:26:00,1,2252.0,1472.0,0.654,10.503,64,23,13,10,41,15,26,0,0.01,0.0
1008,1553,2020-03-19 16:29:00,1,2262.0,1448.0,0.64,10.515,43,0,0,0,43,4,39,0,0.0,0.0
1008,1554,2020-03-19 16:32:00,1,1900.0,1380.0,0.726,9.014,46,0,0,0,46,15,31,0,0.0,0.0
1008,1555,2020-03-19 16:35:00,1,1904.0,1384.0,0.727,9.034,115,57,44,13,58,29,29,7,0.0,0.0
1008,1556,2020-03-19 16:38:00,1,2252.0,1475.0,0.655,10.507,201,78,40,38,123,66,57,2,0.07,0.0
1008,1557,2020-03-19 16:41:00,1,2342.0,1634.0,0.697,11.038,199,54,29,25,145,81,64,6,0.0,0.0
1008,1558,2020-03-19 16:44:00,1,2446.0,1709.0,0.699,11.532,182,57,20,37,125,56,69,6,0.0,0.0
1008,1559,2020-03-19 16:47:00,1,2432.0,1742.0,0.716,11.513,130,13,1,12,117,62,55,0,0.01,0.0
1008,1560,2020-03-19 16:50:00,1,2420.0,1808.0,0.747,11.536,151,42,7,35,109,50,59,1,0.0,0.0
1008,1561,2020-03-19 16:53:00,1,2417.0,1811.0,0.749,11.527,92,37,15,22,55,31,24,0,0.0,0.0
1008,1562,2020-03-19 16:56:00,1,2211.0,1648.0,0.746,10.535,20,20,0,20,0,0,0,0,0.0,0.0
1008,1563,2020-03-19 16:59:00,1,2236.0,1550.0,0.693,10.527,15,15,0,15,0,0,0,0,0.0,0.0
1008,1564,2020-03-19 17:02:00,1,2239.0,1552.0,0.693,10.54,18,15,3,12,3,2,1,0,0.0,0.0
1008,1565,2020-03-19 17:05:00,1,2007.0,1480.0,0.737,9.546,0,0,0,0,0,0,0,0,0.0,0.0
1008,1566,2020-03-19 17:08:00,1,1884.0,1433.0,0.761,9.008,25,2,2,0,23,2,21,0,0.0,0.0
1008,1567,2020-03-19 17:11:00,1,2063.0,1483.0,0.7225,9.7705,37,12,1,11,25,10,15,0,0.0,0.0
1008,1568,2020-03-19 17:14:00,1,2242.0,1533.0,0.684,10.533,241,119,73,46,122,75,47,18,0.0,0.0
1008,1569,2020-03-19 17:17:00,1,2447.0,1714.0,0.7,11.539,230,112,82,30,118,85,33,6,0.12,0.0
1008,1570,2020-03-19 17:20:00,1,2475.0,1618.0,0.654,11.543,26,5,3,2,21,7,14,0,0.0,0.0
1008,1571,2020-03-19 17:23:00,1,2233.0,1555.0,0.696,10.522,19,1,1,0,18,4,14,0,0.0,0.0
1008,1572,2020-03-19 17:26:00,1,2262.0,1438.0,0.636,10.504,23,0,0,0,23,0,23,0,0.0,0.0
1008,1573,2020-03-19 17:29:00,1,2141.0,1415.0,0.661,10.002,22,0,0,0,22,0,22,0,0.0,0.0
1008,1574,2020-03-19 17:32:00,1,2259.0,1429.0,0.632,10.484,28,1,0,1,27,4,23,0,0.0,0.0
1008,1575,2020-03-19 17:35:00,1,2275.0,1404.0,0.617,10.52,26,0,0,0,26,0,26,0,0.0,0.0
1008,1576,2020-03-19 17:38:00,1,2277.0,1400.0,0.615,10.523,32,11,6,5,21,9,12,0,0.0,0.0
1008,1577,2020-03-19 17:41:00,1,2162.0,1364.0,0.631,10.028,79,30,18,12,49,29,20,0,0.0,0.0
1008,1578,2020-03-19 17:44:00,1,2263.0,1432.0,0.633,10.503,1,0,0,0,1,0,1,0,0.0,0.0
1008,1579,2020-03-19 17:47:00,1,2249.0,1484.0,0.66,10.503,81,39,26,13,42,25,17,14,0.0,0.0
1008,1580,2020-03-19 17:50:00,1,2688.0,1740.0,0.647,12.517,242,114,69,45,128,78,50,33,0.0,0.0
1008,1581,2020-03-19 17:53:00,1,2693.0,1725.0,0.641,12.523,150,30,6,24,120,50,70,1,0.0,0.0
1008,1582,2020-03-19 17:56:00,1,2784.0,1867.0,0.671,13.036,320,170,110,60,150,95,55,3,0.0,0.0
1008,1583,2020-03-19 17:59:00,1,2770.0,1905.0,0.688,13.024,199,149,103,46,50,20,30,0,0.0,0.0
1008,1584,2020-03-19 18:02:00,0,2738.0,2062.0,0.753,13.069,582,432,345,87,150,100,50,20,0.0,0.0
1008,1585,2020-03-19 18:05:00,0,2943.0,2217.0,0.753,14.05,754,421,353,68,333,262,71,77,0.0,0.0
1008,1586,2020-03-19 18:08:00,0,2947.0,2213.0,0.751,14.063,220,97,57,40,123,70,53,21,0.0,0.0
1008,1587,2020-03-19 18:11:00,0,3154.0,2358.0,0.748,15.037,293,142,80,62,151,95,56,7,0.0,0.0
1008,1588,2020-03-19 18:14:00,0,3286.0,2342.0,0.713,15.541,336,208,129,79,128,80,48,24,0.0,0.0
1008,1589,2020-03-19 18:17:00,0,2941.0,2247.0,0.764,14.078,234,156,117,39,78,58,20,11,0.0,0.0
1008,1590,2020-03-19 18:20:00,0,2959.0,2170.0,0.733,14.06,52,51,7,44,1,1,0,0,0.06,0.0
1008,1591,2020-03-19 18:23:00,0,2990.0,2050.0,0.686,14.051,235,178,105,73,57,20,37,13,0.0,0.0
1008,1592,2020-03-19 18:26:00,0,2986.0,2046.0,0.685,14.031,685,418,323,95,267,199,68,50,0.01,0.0
1008,1593,2020-03-19 18:29:00,0,3087.0,2172.0,0.704,14.567,262,74,49,25,188,130,58,33,0.0,0.0
1008,1594,2020-03-19 18:32:00,0,2970.0,2114.0,0.712,14.042,507,261,181,80,246,181,65,41,0.01,0.0
1008,1595,2020-03-19 18:35:00,0,2879.0,2006.0,0.697,13.564,377,148,104,44,229,182,47,9,0.0,0.0
1008,1596,2020-03-19 18:38:00,0,3067.0,2179.0,0.71,14.498,582,331,260,71,251,198,53,54,0.0,0.0
1008,1597,2020-03-19 18:41:00,0,2875.0,1993.0,0.693,13.534,501,244,179,65,257,199,58,16,0.01,0.0
1008,1598,2020-03-19 18:44:00,0,2985.0,2048.0,0.686,14.028,300,199,122,77,101,49,52,22,0.0,0.0
1008,1599,2020-03-19 18:47:00,0,2979.0,2041.0,0.685,13.997,78,52,8,44,26,7,19,0,0.0,0.0
1008,1600,2020-03-19 18:50:00,0,2783.0,1875.0,0.674,13.043,92,56,5,51,36,12,24,0,0.0,0.0
1008,1601,2020-03-19 18:53:00,0,2471.0,1607.0,0.65,11.516,160,76,31,45,84,37,47,6,0.0,0.0
1008,1602,2020-03-19 18:56:00,0,2443.0,1699.0,0.695,11.508,441,226,146,80,215,142,73,24,0.0,0.0
1008,1603,2020-03-19 18:59:00,0,2759.0,1944.0,0.705,13.025,350,139,91,48,211,158,53,13,0.0,0.0
1008,1604,2020-03-19 19:02:00,0,2880.0,1982.0,0.688,13.542,297,167,111,56,130,94,36,20,0.01,0.0
1008,1605,2020-03-19 19:05:00,0,2763.0,1919.0,0.695,13.01,359,269,197,72,90,66,24,99,0.0,0.0
1008,1606,2020-03-19 19:08:00,0,2991.0,2031.0,0.679,14.036,412,190,132,58,222,166,56,40,0.02,0.0
1008,1607,2020-03-19 19:11:00,0,3009.0,1993.0,0.662,14.065,359,216,153,63,143,93,50,38,0.0,0.0
1008,1608,2020-03-19 19:14:00,0,2765.0,1885.0,0.682,12.983,275,163,99,64,112,64,48,0,0.0,0.0
1008,1609,2020-03-19 19:17:00,0,3092.0,2143.0,0.693,14.553,269,110,67,43,159,108,51,0,0.0,0.0
1008,1610,2020-03-19 19:20:00,0,2986.0,2075.0,0.695,14.061,407,101,54,47,306,238,68,3,0.0,0.0
1008,1611,2020-03-19 19:23:00,0,2860.0,2053.0,0.718,13.541,675,345,263,82,330,261,69,111,0.08,0.0
1008,1612,2020-03-19 19:26:00,0,2948.0,2161.0,0.733,14.01,533,193,126,67,340,280,60,15,0.0,0.0
1008,1613,2020-03-19 19:29:00,0,2932.0,2245.0,0.766,14.038,277,139,81,58,138,102,36,0,0.0,0.0
1008,1614,2020-03-19 19:32:00,0,3037.0,2317.0,0.763,14.53,396,151,89,62,245,198,47,0,0.0,0.0
1008,1615,2020-03-19 19:35:00,0,2925.0,2273.0,0.777,14.041,488,233,168,65,255,203,52,7,0.0,0.0
1008,1616,2020-03-19 19:38:00,0,2890.0,2382.0,0.824,14.022,521,229,175,54,292,232,60,31,0.0,0.0
1008,1617,2020-03-19 19:41:00,0,2911.0,2318.0,0.796,14.036,402,309,214,95,93,64,29,3,0.0,0.0
1008,1618,2020-03-19 19:44:00,0,2922.0,2305.0,0.789,14.064,486,217,142,75,269,208,61,0,0.0,0.0
1008,1619,2020-03-19 19:47:00,0,2924.0,2273.0,0.777,14.039,355,136,82,54,219,148,71,0,0.0,0.0
1008,1620,2020-03-19 19:50:00,0,2812.0,2258.0,0.803,13.578,207,152,79,73,55,32,23,4,0.0,0.0
1008,1621,2020-03-19 19:53:00,0,3197.0,2691.0,0.842,15.578,359,144,89,55,215,151,64,27,0.2,0.0
1008,1622,2020-03-19 19:56:00,0,3209.0,2629.0,0.819,15.553,201,81,36,45,120,87,33,6,0.0,0.0
1008,1623,2020-03-19 19:59:00,0,2889.0,2447.0,0.847,14.09,491,240,174,66,251,188,63,27,0.01,0.0
1008,1624,2020-03-19 20:02:00,0,3243.0,2509.0,0.774,15.557,208,135,67,68,73,44,29,15,0.0,0.0
1008,1625,2020-03-19 20:05:00,0,2935.0,2279.0,0.776,14.088,64,52,4,48,12,1,11,0,0.0,0.0
1008,1626,2020-03-19 20:08:00,0,2884.0,2377.0,0.824,13.997,83,64,4,60,19,4,15,0,0.0,0.0
1008,1627,2020-03-19 20:11:00,0,2683.0,2210.0,0.8235,13.0195,84,62,0,62,22,0,22,0,0.0,0.0
1008,1628,2020-03-19 20:14:00,0,2482.0,2043.0,0.823,12.042,464,227,150,77,237,174,63,2,0.0,0.0
1008,1629,2020-03-19 20:17:00,0,2463.0,2101.0,0.853,12.031,204,106,64,42,98,57,41,2,0.0,0.0
1008,1630,2020-03-19 20:20:00,0,2558.0,2226.0,0.87,12.542,240,167,115,52,73,36,37,4,0.0,0.0
1008,1631,2020-03-19 20:23:00,0,2863.0,2521.0,0.881,14.072,397,201,119,82,196,138,58,0,0.1,0.0
1008,1632,2020-03-19 20:26:00,0,2641.0,2377.0,0.9,13.035,714,343,267,76,371,280,91,93,0.0,0.0
1008,1633,2020-03-19 20:29:00,0,2973.0,2571.0,0.865,14.561,439,206,135,71,233,161,72,52,0.0,0.0
1008,1634,2020-03-19 20:32:00,0,2957.0,2619.0,0.886,14.551,321,171,114,57,150,110,40,1,0.0,0.0
1008,1635,2020-03-19 20:35:00,0,2744.0,2493.0,0.909,13.571,160,132,84,48,28,18,10,0,0.0,0.0
1008,1636,2020-03-19 20:38:00,0,2436.0,2219.0,0.911,12.056,104,65,16,49,39,17,22,0,0.0,0.0
1008,1637,2020-03-19 20:41:00,0,2438.0,2215.0,0.909,12.057,75,50,8,42,25,2,23,0,0.0,0.0
1008,1638,2020-03-19 20:44:00,0,2471.0,2108.0,0.853,12.069,122,88,44,44,34,6,28,0,0.0,0.0
1008,1639,2020-03-19 20:47:00,0,2146.0,1895.0,0.883,10.552,156,105,53,52,51,12,39,0,0.0,0.0
1008,1640,2020-03-19 20:50:00,0,2161.0,1830.0,0.847,10.539,395,181,112,69,214,147,67,4,0.0,0.0
1008,1641,2020-03-19 20:53:00,0,2384.0,1933.0,0.811,11.531,460,216,145,71,244,163,81,3,0.0,0.0
1008,1642,2020-03-19 20:56:00,0,2488.0,2033.0,0.817,12.054,771,452,362,90,319,245,74,94,0.0,0.0
1008,1643,2020-03-19 20:59:00,0,2705.0,2162.0,0.799,13.049,877,511,398,113,366,290,76,33,0.0,0.0
1008,1644,2020-03-19 21:02:00,0,3028.0,2342.0,0.774,14.522,728,436,341,95,292,211,81,49,0.0,0.0
1008,1645,2020-03-19 21:05:00,0,3048.0,2293.0,0.752,14.547,652,362,266,96,290,221,69,31,0.0,0.0
1008,1646,2020-03-19 21:08:00,0,3045.0,2309.0,0.758,14.555,332,126,76,50,206,142,64,1,0.0,0.0
1008,1647,2020-03-19 21:11:00,0,2701.0,2125.0,0.787,12.993,411,133,68,65,278,213,65,0,0.0,0.0
1008,1648,2020-03-19 21:14:00,0,3020.0,2382.0,0.789,14.536,474,220,161,59,254,194,60,22,0.0,0.0
1008,1649,2020-03-19 21:17:00,0,3001.0,2455.0,0.818,14.541,713,354,267,87,359,281,78,140,0.0,0.0
1008,1650,2020-03-19 21:20:00,0,2690.0,2211.0,0.822,13.046,529,213,142,71,316,245,71,0,0.0,0.0
1008,1651,2020-03-19 21:23:00,0,2920.0,2322.0,0.795,14.077,911,475,386,89,436,328,108,37,0.0,0.0
1008,1652,2020-03-19 21:26:00,0,3009.0,2459.0,0.817,14.578,686,405,300,105,281,209,72,27,0.0,0.0
1008,1653,2020-03-19 21:29:00,0,2692.0,2213.0,0.822,13.055,435,316,202,114,119,80,39,0,0.0,0.0
1008,1654,2020-03-19 21:32:00,0,2694.0,2195.0,0.815,13.046,683,294,206,88,389,304,85,0,0.0,0.0
1008,1655,2020-03-19 21:35:00,0,3041.0,2323.0,0.764,14.553,901,455,394,61,446,349,97,79,0.0,0.0
1008,1656,2020-03-19 21:38:00,0,2795.0,2287.0,0.818,13.543,580,277,206,71,303,249,54,96,0.0,0.0
1008,1657,2020-03-19 21:41:00,0,3024.0,2377.0,0.786,14.548,674,291,193,98,383,317,66,79,0.0,0.0
1008,1658,2020-03-19 21:44:00,0,2933.0,2269.0,0.774,14.068,450,324,214,110,126,75,51,0,0.0,0.0
1008,1659,2020-03-19 21:47:00,0,3029.0,2376.0,0.785,14.564,579,246,190,56,333,263,70,105,0.0,0.0
1008,1660,2020-03-19 21:50:00,0,3008.0,2411.0,0.802,14.523,690,290,228,62,400,307,93,137,0.0,0.0
1008,1661,2020-03-19 21:53:00,0,2931.0,2232.0,0.762,14.022,641,324,259,65,317,233,84,2,0.0,0.0
1008,1662,2020-03-19 21:56:00,0,2821.0,2185.0,0.775,13.535,531,276,220,56,255,192,63,1,0.0,0.0
1008,1663,2020-03-19 21:59:00,0,2707.0,2155.0,0.796,13.05,396,258,193,65,138,82,56,8,0.0,0.0
1008,1664,2020-03-19 22:02:00,0,2722.0,2102.0,0.772,13.054,552,369,307,62,183,122,61,0,0.0,0.0
1008,1665,2020-03-19 22:05:00,0,2807.0,2226.0,0.793,13.524,740,454,340,114,286,213,73,8,0.0,0.0
1008,1666,2020-03-19 22:08:00,0,2707.0,2139.0,0.79,13.034,773,351,256,95,422,326,96,36,0.0,0.0
1008,1667,2020-03-19 22:11:00,0,2933.0,2261.0,0.771,14.06,783,433,336,97,350,278,72,94,0.0,0.0
1008,1668,2020-03-19 22:14:00,0,2703.0,2150.0,0.796,13.03,383,244,167,77,139,104,35,26,0.0,0.0
1008,1669,2020-03-19 22:17:00,0,2724.0,2072.0,0.76,13.029,542,244,160,84,298,218,80,0,0.0,0.0
1008,1670,2020-03-19 22:20:00,0,2738.0,2018.0,0.737,13.021,437,145,93,52,292,208,84,0,0.0,0.0
1008,1671,2020-03-19 22:23:00,0,2528.0,1894.0,0.749,12.057,488,251,176,75,237,154,83,19,0.0,0.0
1008,1672,2020-03-19 22:26:00,0,2733.0,2086.0,0.763,13.079,565,374,291,83,191,133,58,6,0.0,0.0
1008,1673,2020-03-19 22:29:00,0,2704.0,2155.0,0.797,13.04,702,426,321,105,276,197,79,48,0.0,0.0
1008,1674,2020-03-19 22:32:00,0,2703.0,2153.0,0.796,13.035,858,468,382,86,390,318,72,201,0.0,0.0
1008,1675,2020-03-19 22:35:00,0,2698.0,2186.0,0.81,13.052,1026,657,555,102,369,298,71,406,0.0,0.0
1008,1676,2020-03-19 22:38:00,0,2932.0,2254.0,0.769,14.046,1089,685,587,98,404,330,74,341,0.0,0.0
1008,1677,2020-03-19 22:41:00,0,3050.0,2277.0,0.747,14.536,666,348,278,70,318,245,73,76,0.0,0.0
1008,1678,2020-03-19 22:44:00,0,2718.0,2114.0,0.778,13.049,319,211,145,66,108,74,34,0,0.0,0.0
1008,1679,2020-03-19 22:47:00,0,2725.0,2087.0,0.766,13.046,537,311,234,77,226,179,47,23,0.0,0.0
1008,1680,2020-03-19 22:50:00,0,2708.0,2123.0,0.784,13.021,903,478,383,95,425,333,92,123,0.03,0.0
1008,1681,2020-03-19 22:53:00,0,2612.0,2019.0,0.773,12.529,597,335,258,77,262,202,60,56,0.0,0.0
1008,1682,2020-03-19 22:56:00,0,2714.0,2128.0,0.784,13.048,617,312,222,90,305,223,82,12,0.0,0.0
1008,1683,2020-03-19 22:59:00,0,2730.0,2020.0,0.74,12.992,385,185,132,53,200,146,54,103,0.0,0.0
1008,1684,2020-03-19 23:02:00,0,2717.0,2078.0,0.765,13.006,332,152,101,51,180,120,60,28,0.0,0.0
1008,1685,2020-03-19 23:05:00,0,2497.0,1988.0,0.796,12.04,516,285,222,63,231,181,50,138,0.0,0.0
1008,1686,2020-03-19 23:08:00,0,2736.0,2011.0,0.735,13.005,219,131,88,43,88,56,32,36,0.0,0.0
1008,1687,2020-03-19 23:11:00,0,2747.0,1980.5,0.721,13.0155,711,405,329,76,306,247,59,259,0.0,0.0
1008,1688,2020-03-19 23:14:00,0,2758.0,1950.0,0.707,13.026,439,122,77,45,317,243,74,39,0.0,0.0
1008,1689,2020-03-19 23:17:00,0,2865.0,1994.0,0.696,13.498,588,284,234,50,304,228,76,214,0.0,0.0
1008,1690,2020-03-19 23:20:00,0,2767.0,1953.0,0.706,13.066,753,521,426,95,232,194,38,243,0.0,0.0
1008,1691,2020-03-19 23:23:00,0,3276.0,2413.0,0.737,15.581,561,361,286,75,200,162,38,60,0.0,0.0
1008,1692,2020-03-19 23:26:00,0,2355.0,1555.0,0.66,11.002,218,137,91,46,81,53,28,8,0.0,0.0
1008,1693,2020-03-19 23:29:00,0,2888.0,1984.0,0.687,13.576,262,209,142,67,53,14,39,42,0.0,0.0
1008,1694,2020-03-19 23:32:00,0,2659.0,1868.0,0.703,12.543,21,10,3,7,11,2,9,0,0.0,0.0
1008,1695,2020-03-19 23:35:00,0,2679.0,1773.0,0.662,12.517,281,244,175,69,37,19,18,0,0.0,0.0
1008,1696,2020-03-19 23:38:00,0,2679.0,1767.0,0.659,12.511,814,453,347,106,361,295,66,111,0.0,0.0
1008,1697,2020-03-19 23:41:00,0,2892.0,1939.0,0.67,13.542,926,554,464,90,372,311,61,309,0.0,0.0
1008,1698,2020-03-19 23:44:00,0,2895.0,1932.0,0.667,13.546,819,437,354,83,382,294,88,177,0.0,0.0
1008,1699,2020-03-19 23:47:00,0,2985.0,2053.0,0.688,14.034,479,179,127,52,300,219,81,14,0.09,0.0
1008,1700,2020-03-19 23:50:00,0,2663.0,1860.0,0.698,12.554,424,119,70,49,305,223,82,0,0.0,0.0
1008,1701,2020-03-19 23:53:00,0,2672.0,1814.0,0.679,12.537,791,349,270,79,442,358,84,65,0.0,0.0
1008,1702,2020-03-19 23:56:00,0,2781.0,1861.0,0.669,13.018,301,198,133,65,103,71,32,48,0.0,0.0
1008,1703,2020-03-19 23:59:00,0,2898.0,1883.0,0.65,13.502,100,63,6,57,37,12,25,0,0.0,0.0
1008,1704,2020-03-20 00:02:00,0,2688.0,1720.0,0.64,12.495,69,44,0,44,25,7,18,0,0.0,0.0
1008,1705,2020-03-20 00:05:00,0,2357.0,1562.0,0.663,11.015,58,45,0,45,13,0,13,0,0.0,0.0
1008,1706,2020-03-20 00:08:00,0,2389.0,1432.0,0.599,11.001,74,58,0,58,16,0,16,0,0.0,0.0
1008,1707,2020-03-20 00:11:00,0,2156.0,1342.0,0.622,9.983,131,92,34,58,39,17,22,9,0.0,0.0
1008,1708,2020-03-20 00:14:00,0,2148.0,1399.0,0.651,10.013,581,333,248,85,248,172,76,42,0.0,0.0
1008,1709,2020-03-20 00:17:00,0,2260.0,1462.0,0.647,10.525,619,269,193,76,350,274,76,84,0.0,0.0
1008,1710,2020-03-20 00:20:00,0,2347.0,1614.0,0.688,11.033,606,254,177,77,352,293,59,70,0.0,0.0
1008,1711,2020-03-20 00:23:00,0,2346.0,1591.0,0.678,11.006,364,180,121,59,184,151,33,109,0.0,0.0
1008,1712,2020-03-20 00:26:00,0,2583.0,1685.0,0.653,12.042,480,262,207,55,218,186,32,28,0.0,0.0
1008,1713,2020-03-20 00:29:00,0,2655.0,1849.0,0.697,12.507,554,268,216,52,286,216,70,80,0.0,0.0
1008,1714,2020-03-20 00:32:00,0,2706.0,1662.0,0.614,12.502,582,326,255,71,256,182,74,11,0.0,0.0
1008,1715,2020-03-20 00:35:00,0,2712.0,1662.0,0.613,12.528,314,183,117,66,131,94,37,66,0.0,0.0
1008,1716,2020-03-20 00:38:00,0,2720.0,1639.0,0.603,12.531,552,360,302,58,192,153,39,90,0.0,0.0
1008,1717,2020-03-20 00:41:00,0,2600.0,1618.0,0.623,12.035,254,157,115,42,97,78,19,0,0.04,0.0
1008,1718,2020-03-20 00:44:00,0,2687.0,1735.0,0.646,12.51,450,224,158,66,226,176,50,78,0.0,0.0
1008,1719,2020-03-20 00:47:00,0,2479.0,1572.0,0.634,11.511,281,99,48,51,182,136,46,0,0.0,0.0
1008,1720,2020-03-20 00:50:00,0,2479.0,1555.0,0.627,11.49,295,181,117,64,114,77,37,0,0.0,0.0
1008,1721,2020-03-20 00:53:00,0,2701.0,1706.0,0.632,12.53,568,294,229,65,274,212,62,110,0.0,0.0
1008,1722,2020-03-20 00:56:00,0,2712.0,1676.0,0.618,12.543,417,260,179,81,157,100,57,26,0.0,0.0
1008,1723,2020-03-20 00:59:00,0,2706.0,1679.0,0.62,12.52,229,146,90,56,83,57,26,11,0.0,0.0
1008,1724,2020-03-20 01:02:00,0,2360.0,1563.0,0.662,11.03,66,56,8,48,10,0,10,0,0.0,0.0
1008,1725,2020-03-20 01:05:00,0,2380.0,1481.0,0.622,11.017,46,37,0,37,9,0,9,0,0.0,0.0
1008,1726,2020-03-20 01:08:00,0,2164.0,1368.0,0.632,10.042,112,100,46,54,12,0,12,0,0.0,0.0
1008,1727,2020-03-20 01:11:00,0,2168.0,1311.0,0.605,9.996,65,57,5,52,8,0,8,0,0.0,0.0
1008,1728,2020-03-20 01:14:00,0,2178.0,1271.0,0.583,9.988,84,66,14,52,18,2,16,0,0.0,0.0
1008,1729,2020-03-20 01:17:00,0,1952.0,1184.0,0.607,9.001,107,69,12,57,38,4,34,0,0.0,0.0
1008,1730,2020-03-20 01:20:00,0,1832.0,1148.0,0.626,8.491,98,75,30,45,23,2,21,0,0.0,0.0
1008,1731,2020-03-20 01:23:00,0,1855.0,1085.0,0.585,8.509,91,58,12,46,33,6,27,0,0.0,0.0
1008,1732,2020-03-20 01:26:00,0,1842.0,1131.0,0.614,8.511,76,49,0,49,27,2,25,0,0.0,0.0
1008,1733,2020-03-20 01:29:00,0,1863.0,1056.0,0.567,8.511,297,183,112,71,114,66,48,23,0.0,0.0
1008,1734,2020-03-20 01:32:00,0,2178.0,1307.0,0.6,10.027,495,268,198,70,227,165,62,67,0.0,0.0
1008,1735,2020-03-20 01:35:00,0,2362.0,1514.0,0.641,10.985,344,240,158,82,104,68,36,72,0.0,0.0
1008,1736,2020-03-20 01:38:00,0,2695.0,1715.0,0.636,12.52,730,345,273,72,385,305,80,71,0.02,0.0
1008,1737,2020-03-20 01:41:00,0,2690.0,1740.0,0.647,12.525,233,100,65,35,133,98,35,39,0.0,0.0
1008,1738,2020-03-20 01:44:00,0,2714.0,1638.0,0.603,12.508,478,235,173,62,243,183,60,3,0.0,0.0
1008,1739,2020-03-20 01:47:00,0,2694.0,1734.0,0.644,12.533,279,190,110,80,89,56,33,23,0.0,0.0
1008,1740,2020-03-20 01:50:00,0,2678.0,1743.0,0.651,12.483,955,552,461,91,403,322,81,280,0.0,0.0
1008,1741,2020-03-20 01:53:00,0,2802.0,1794.0,0.64,13.025,701,389,312,77,312,255,57,216,0.0,0.0
1008,1742,2020-03-20 01:56:00,0,2917.0,1861.0,0.638,13.552,819,425,354,71,394,303,91,256,0.0,0.0
1008,1743,2020-03-20 01:59:00,0,2902.0,1851.0,0.638,13.483,696,429,340,89,267,219,48,212,0.0,0.0
1008,1744,2020-03-20 02:02:00,0,2907.0,1890.0,0.65,13.547,778,452,369,83,326,251,75,153,0.0,0.0
1008,1745,2020-03-20 02:05:00,0,3019.0,1947.0,0.645,14.051,751,445,349,96,306,246,60,173,0.0,0.0
1008,1746,2020-03-20 02:08:00,0,2892.0,1893.0,0.654,13.492,536,321,255,66,215,151,64,51,0.11,0.0
1008,1747,2020-03-20 02:11:00,0,2838.5,1852.5,0.6525,13.2355,236,192,119,73,44,30,14,3,0.0,0.0
1008,1748,2020-03-20 02:14:00,0,2785.0,1812.0,0.651,12.979,474,255,194,61,219,155,64,49,0.17,0.0
1008,1749,2020-03-20 02:17:00,0,2794.0,1784.0,0.639,12.983,904,496,422,74,408,326,82,265,0.0,0.0
1008,1750,2020-03-20 02:20:00,0,2776.0,1867.0,0.672,13.006,954,490,417,73,464,384,80,270,0.0,0.0
1008,1751,2020-03-20 02:23:00,0,2805.0,1778.0,0.634,13.022,266,157,101,56,109,71,38,8,0.0,0.0
1008,1752,2020-03-20 02:26:00,0,2685.0,1764.0,0.657,12.532,203,132,50,82,71,43,28,7,0.0,0.0
1008,1753,2020-03-20 02:29:00,0,2561.0,1738.0,0.679,12.016,115,76,6,70,39,10,29,0,0.0,0.0
1008,1754,2020-03-20 02:32:00,0,2248.0,1502.0,0.668,10.522,69,50,0,50,19,9,10,0,0.0,0.0
1008,1755,2020-03-20 02:35:00,0,2155.0,1369.0,0.635,10.008,363,58,4,54,305,272,33,0,0.0,0.0
1008,1756,2020-03-20 02:38:00,0,2061.0,1263.0,0.613,9.52,56,53,0,53,3,0,3,0,0.0,0.0
1008,1757,2020-03-20 02:41:00,0,1951.0,1202.0,0.616,9.018,70,58,6,52,12,5,7,0,0.0,0.0
1008,1758,2020-03-20 02:44:00,0,1714.0,1136.0,0.662,8.012,133,87,30,57,46,9,37,0,0.0,0.0
1008,1759,2020-03-20 02:47:00,0,1698.0,1186.0,0.698,8.005,153,47,0,47,106,31,75,0,0.0,0.0
1008,1760,2020-03-20 02:50:00,0,1714.0,1143.0,0.667,8.02,535,291,230,61,244,173,71,9,0.0,0.0
1008,1761,2020-03-20 02:53:00,0,1701.0,1194.0,0.702,8.024,478,184,126,58,294,208,86,23,0.0,0.0
1008,1762,2020-03-20 02:56:00,0,1822.0,1209.0,0.664,8.516,121,75,20,55,46,19,27,0,0.0,0.0
1008,1763,2020-03-20 02:59:00,0,1708.0,1163.0,0.681,8.018,91,59,6,53,32,2,30,0,0.0,0.0
1008,1764,2020-03-20 03:02:00,0,1721.0,1104.0,0.642,8.004,72,52,0,52,20,0,20,0,0.0,0.0
1008,1765,2020-03-20 03:05:00,0,1731.0,1063.0,0.614,8.0,74,58,0,58,16,0,16,0,0.0,0.0
1008,1766,2020-03-20 03:08:00,0,1716.0,1130.0,0.659,8.013,63,53,0,53,10,0,10,0,0.0,0.0
1008,1767,2020-03-20 03:11:00,0,1733.0,1063.0,0.614,8.004,73,64,6,58,9,2,7,0,0.0,0.0
1008,1768,2020-03-20 03:14:00,0,1500.0,997.0,0.664,7.015,76,67,5,62,9,2,7,0,0.0,0.0
1008,1769,2020-03-20 03:17:00,0,1377.0,967.0,0.702,6.495,252,160,99,61,92,62,30,6,0.0,0.0
1008,1770,2020-03-20 03:20:00,0,1705.0,1164.0,0.682,8.008,416,179,107,72,237,173,64,62,0.0,0.0
1008,1771,2020-03-20 03:23:00,0,2239.0,1534.0,0.685,10.521,441,219,160,59,222,171,51,29,0.0,0.0
1008,1772,2020-03-20 03:26:00,0,2575.0,1649.0,0.64,11.972,413,185,126,59,228,181,47,57,0.0,0.0
1008,1773,2020-03-20 03:29:00,0,2593.0,1628.0,0.628,12.019,365,141,106,35,224,172,52,44,0.0,0.0
1008,1774,2020-03-20 03:32:00,0,2587.0,1678.0,0.649,12.051,711,403,339,64,308,256,52,350,0.0,0.0
1008,1775,2020-03-20 03:35:00,0,2557.0,1741.0,0.681,12.004,1000,470,408,62,530,435,95,358,0.0,0.0
1008,1776,2020-03-20 03:38:00,0,2573.0,1720.0,0.669,12.041,377,240,161,79,137,96,41,37,0.0,0.0
1008,1777,2020-03-20 03:41:00,0,2786.0,1876.0,0.673,13.053,1054,550,467,83,504,425,79,278,0.0,0.0
1008,1778,2020-03-20 03:44:00,0,3013.0,1911.0,0.634,13.989,618,293,250,43,325,251,74,221,0.0,0.0
1008,1779,2020-03-20 03:47:00,0,2807.0,1768.0,0.63,13.017,418,214,167,47,204,152,52,105,0.0,0.0
1008,1780,2020-03-20 03:50:00,0,2794.0,1803.0,0.645,13.003,671,328,268,60,343,265,78,139,0.0,0.0
1008,1781,2020-03-20 03:53:00,0,2805.0,1786.0,0.637,13.031,95,56,19,37,39,22,17,12,0.0,0.0
1008,1782,2020-03-20 03:56:00,0,2596.0,1598.0,0.615,12.0,81,52,12,40,29,13,16,1,0.0,0.0
1008,1783,2020-03-20 03:59:00,0,2262.0,1456.0,0.644,10.523,46,35,6,29,11,4,7,0,0.0,0.0
1008,1784,2020-03-20 04:02:00,0,2165.0,1354.0,0.625,10.03,44,33,0,33,11,1,10,0,0.0,0.0
1008,1785,2020-03-20 04:05:00,0,2059.0,1271.0,0.617,9.52,271,151,103,48,120,83,37,3,0.0,0.0
1008,1786,2020-03-20 04:08:00,0,2280.0,1387.0,0.609,10.519,393,292,250,42,101,65,36,95,0.0,0.0
1008,1787,2020-03-20 04:11:00,0,2255.0,1449.0,0.643,10.49,523,295,231,64,228,179,49,83,0.0,0.0
1008,1788,2020-03-20 04:14:00,0,2268.0,1420.0,0.626,10.509,420,175,116,59,245,189,56,14,0.0,0.0
1008,1789,2020-03-20 04:17:00,0,2249.0,1478.0,0.657,10.5,555,287,224,63,268,206,62,152,0.0,0.0
1008,1790,2020-03-20 04:20:00,0,2478.0,1593.0,0.643,11.525,546,315,250,65,231,172,59,20,0.0,0.0
1008,1791,2020-03-20 04:23:00,0,2479.0,1574.0,0.635,11.511,118,97,33,64,21,1,20,0,0.0,0.0
1008,1792,2020-03-20 04:26:00,0,2252.0,1461.0,0.649,10.492,367,348,267,81,19,10,9,0,0.0,0.0
1008,1793,2020-03-20 04:29:00,0,2044.0,1310.0,0.641,9.505,604,604,520,84,0,0,0,0,0.0,0.0
1008,1794,2020-03-20 04:32:00,0,2059.0,1270.0,0.616,9.52,749,521,427,94,228,170,58,58,0.03,0.0
1008,1795,2020-03-20 04:35:00,0,2039.0,1333.0,0.653,9.512,281,210,141,69,71,9,62,20,0.01,0.0
1008,1796,2020-03-20 04:38:00,0,2040.0,1312.0,0.643,9.489,543,452,361,91,91,29,62,10,0.0,0.0
1008,1797,2020-03-20 04:41:00,0,2044.0,1335.0,0.653,9.532,533,495,390,105,38,18,20,1,0.0,0.0
1008,1798,2020-03-20 04:44:00,0,2050.0,1299.0,0.634,9.515,491,481,380,101,10,0,10,0,0.0,0.0
1008,1799,2020-03-20 04:47:00,0,2070.0,1210.0,0.585,9.496,418,405,320,85,13,0,13,0,0.0,0.0
1008,1800,2020-03-20 04:50:00,0,1728.0,1093.0,0.632,8.02,421,417,313,104,4,0,4,0,0.0,0.0
1008,1801,2020-03-20 04:53:00,0,1747.0,1013.0,0.58,8.004,475,475,368,107,0,0,0,0,0.0,0.0
1008,1802,2020-03-20 04:56:00,0,1634.0,958.0,0.586,7.498,413,338,255,83,75,43,32,2,0.0,0.0
1008,1803,2020-03-20 04:59:00,0,1744.0,1040.0,0.596,8.025,878,697,573,124,181,119,62,30,0.0,0.0
1008,1804,2020-03-20 05:02:00,0,2600.0,1631.0,0.627,12.049,1004,757,633,124,247,199,48,102,0.0,0.0
1008,1805,2020-03-20 05:05:00,0,2358.0,1566.0,0.664,11.023,804,593,491,102,211,168,43,184,0.0,0.0
1008,1806,2020-03-20 05:08:00,0,2589.0,1644.0,0.635,12.022,930,626,542,84,304,259,45,351,0.01,0.0
1008,1807,2020-03-20 05:11:00,0,2594.5,1630.5,0.6285,12.0295,417,350,277,73,67,40,27,3,0.01,0.0
1008,1808,2020-03-20 05:14:00,0,2600.0,1617.0,0.622,12.037,484,319,241,78,165,117,48,22,0.0,0.0
1008,1809,2020-03-20 05:17:00,0,2569.0,1711.0,0.666,12.016,614,358,276,82,256,197,59,136,0.0,0.0
1008,1810,2020-03-20 05:20:00,0,2791.0,1781.0,0.638,12.969,897,556,454,102,341,265,76,164,0.03,0.0
1008,1811,2020-03-20 05:23:00,0,2778.0,1882.0,0.677,13.028,550,335,278,57,215,172,43,107,0.0,0.0
1008,1812,2020-03-20 05:26:00,0,2811.0,1737.0,0.618,13.001,284,190,160,30,94,72,22,0,0.0,0.0
1008,1813,2020-03-20 05:29:00,0,2569.0,1725.0,0.671,12.033,557,291,236,55,266,214,52,36,0.0,0.0
1008,1814,2020-03-20 05:32:00,0,2566.0,1729.0,0.674,12.025,739,447,377,70,292,238,54,186,0.0,0.0
1008,1815,2020-03-20 05:35:00,0,2600.0,1633.0,0.628,12.052,305,169,126,43,136,88,48,12,0.01,0.0
1008,1816,2020-03-20 05:38:00,0,2576.0,1694.0,0.657,12.026,725,389,306,83,336,260,76,2,0.0,0.0
1008,1817,2020-03-20 05:41:00,0,2592.0,1640.0,0.633,12.027,178,143,93,50,35,23,12,0,0.0,0.0
1008,1818,2020-03-20 05:44:00,0,2256.0,1484.0,0.658,10.532,53,44,8,36,9,9,0,0,0.0,0.0
1008,1819,2020-03-20 05:47:00,0,2051.0,1315.0,0.641,9.537,88,72,4,68,16,10,6,0,0.0,0.0
1008,1820,2020-03-20 05:50:00,0,1956.0,1196.0,0.611,9.03,147,92,47,45,55,46,9,0,0.0,0.0
1008,1821,2020-03-20 05:53:00,0,1719.0,1127.0,0.655,8.021,229,101,37,64,128,99,29,0,0.0,0.0
1008,1822,2020-03-20 05:56:00,0,1729.0,1085.0,0.628,8.012,86,71,9,62,15,6,9,0,0.0,0.0
1008,1823,2020-03-20 05:59:00,0,1744.0,1036.0,0.594,8.019,65,56,5,51,9,2,7,0,0.0,0.0
1008,1824,2020-03-20 06:02:00,1,1739.0,1056.0,0.607,8.02,126,82,52,30,44,19,25,35,0.01,0.0
1008,1825,2020-03-20 06:05:00,1,2261.0,1445.0,0.639,10.509,147,99,50,49,48,19,29,90,0.0,0.0
1008,1826,2020-03-20 06:08:00,1,2803.0,1799.0,0.642,13.037,183,112,57,55,71,29,42,103,0.0,0.0
1008,1827,2020-03-20 06:11:00,1,2774.0,1889.0,0.681,13.02,115,93,48,45,22,9,13,58,0.0,0.0
1008,1828,2020-03-20 06:14:00,1,2761.0,1956.0,0.709,13.045,135,104,55,49,31,21,10,95,0.0,0.0
1008,1829,2020-03-20 06:17:00,1,3297.0,2307.0,0.7,15.543,322,134,101,33,188,141,47,29,0.29,0.0
1008,1830,2020-03-20 06:20:00,1,2756.0,1974.0,0.716,13.044,342,173,128,45,169,125,44,61,0.0,0.0
1008,1831,2020-03-20 06:23:00,1,2758.0,1965.0,0.712,13.042,242,108,76,32,134,97,37,16,0.18,0.0
1008,1832,2020-03-20 06:26:00,1,2727.0,2077.0,0.762,13.046,211,117,66,51,94,59,35,52,0.0,0.11
1008,1833,2020-03-20 06:29:00,1,2729.0,2078.0,0.762,13.053,269,133,97,36,136,101,35,13,0.0,0.03
1008,1834,2020-03-20 06:32:00,1,2720.0,2113.0,0.777,13.054,115,87,53,34,28,7,21,75,0.0,0.07
1008,1835,2020-03-20 06:35:00,1,2816.0,2190.0,0.778,13.521,430,214,162,52,216,156,60,81,0.0,0.12
1008,1836,2020-03-20 06:38:00,1,2736.0,2059.0,0.752,13.06,696,360,285,75,336,250,86,35,0.11,0.0
1008,1837,2020-03-20 06:41:00,1,2716.0,2093.0,0.771,13.02,45,29,0,29,16,6,10,1,0.0,0.0
1008,1838,2020-03-20 06:44:00,1,3062.0,2261.0,0.738,14.566,195,72,29,43,123,55,68,0,0.0,0.0
1008,1839,2020-03-20 06:47:00,1,2714.0,2146.0,0.791,13.068,68,41,21,20,27,15,12,0,0.0,0.0
1008,1840,2020-03-20 06:50:00,1,2503.0,1977.0,0.79,12.05,6,0,0,0,6,0,6,0,0.0,0.0
1008,1841,2020-03-20 06:53:00,1,2182.0,1752.0,0.803,10.536,49,7,3,4,42,22,20,0,0.0,0.0
1008,1842,2020-03-20 06:56:00,1,2513.0,1943.0,0.773,12.052,85,42,22,20,43,29,14,0,0.0,0.0
1008,1843,2020-03-20 06:59:00,1,2717.0,2114.0,0.778,13.047,63,35,15,20,28,14,14,0,0.0,0.06
1008,1844,2020-03-20 07:02:00,1,2600.0,2083.0,0.801,12.551,301,93,70,23,208,147,61,15,0.27,0.0
1008,1845,2020-03-20 07:05:00,1,2485.0,2013.0,0.81,12.019,4,0,0,0,4,0,4,0,0.0,0.0
1008,1846,2020-03-20 07:08:00,1,2491.0,2005.0,0.805,12.034,1,1,0,1,0,0,0,0,0.0,0.0
1008,1847,2020-03-20 07:11:00,1,2514.0,1936.0,0.77,12.051,2,2,0,2,0,0,0,0,0.0,0.0
1008,1848,2020-03-20 07:14:00,1,2394.0,1907.0,0.797,11.544,171,94,49,45,77,49,28,12,0.0,0.0
1008,1849,2020-03-20 07:17:00,1,2481.0,2066.0,0.833,12.061,252,128,98,30,124,90,34,34,0.0,0.0
1008,1850,2020-03-20 07:20:00,1,2466.0,2102.0,0.852,12.042,149,97,56,41,52,34,18,61,0.0,0.0
1008,1851,2020-03-20 07:23:00,1,2472.0,2090.0,0.845,12.055,204,135,80,55,69,40,29,84,0.0,0.03
1008,1852,2020-03-20 07:26:00,1,2161.0,1836.0,0.85,10.547,256,83,32,51,173,110,63,8,0.0,0.0
1008,1853,2020-03-20 07:29:00,1,2499.0,2013.0,0.806,12.073,163,78,33,45,85,41,44,0,0.0,0.0
1008,1854,2020-03-20 07:32:00,1,2496.0,1998.0,0.801,12.047,108,59,27,32,49,19,30,0,0.0,0.0
1008,1855,2020-03-20 07:35:00,1,2485.0,2070.0,0.833,12.083,61,0,0,0,61,1,60,0,0.0,0.0
1008,1856,2020-03-20 07:38:00,1,2411.0,1848.0,0.767,11.547,81,40,28,12,41,21,20,0,0.0,0.0
1008,1857,2020-03-20 07:41:00,1,2508.0,1953.0,0.779,12.043,84,60,21,39,24,6,18,53,0.0,0.07
1008,1858,2020-03-20 07:44:00,1,2704.0,2190.0,0.81,13.079,337,157,112,45,180,128,52,35,0.1,0.07
1008,1859,2020-03-20 07:47:00,1,2684.0,2272.0,0.846,13.092,169,77,50,27,92,68,24,1,0.0,0.0
1008,1860,2020-03-20 07:50:00,1,2693.0,2241.0,0.832,13.093,4,3,2,1,1,0,1,0,0.0,0.0
1008,1861,2020-03-20 07:53:00,1,2480.0,2043.0,0.824,12.034,3,2,0,2,1,0,1,0,0.01,0.01
1008,1862,2020-03-20 07:56:00,1,2497.0,1992.0,0.798,12.046,0,0,0,0,0,0,0,0,0.0,0.0
1008,1863,2020-03-20 07:59:00,1,2268.0,1897.0,0.837,11.034,10,8,1,7,2,0,2,0,0.01,0.01
1008,1864,2020-03-20 08:02:00,1,2154.0,1853.0,0.86,10.539,8,8,2,6,0,0,0,0,0.0,0.0
1008,1865,2020-03-20 08:05:00,1,2184.0,1741.0,0.797,10.535,68,30,21,9,38,17,21,9,0.0,0.0
1008,1866,2020-03-20 08:08:00,1,2496.0,1986.0,0.796,12.032,106,77,32,45,29,9,20,36,0.0,0.04
1008,1867,2020-03-20 08:11:00,1,2288.5,1811.5,0.7915,11.021,274,122,82,40,152,111,41,39,0.26,0.0
1008,1868,2020-03-20 08:14:00,1,2081.0,1637.0,0.787,10.01,71,42,33,9,29,25,4,9,0.0,0.0
1008,1869,2020-03-20 08:17:00,1,2385.0,1933.0,0.811,11.538,0,0,0,0,0,0,0,0,0.0,0.0
1008,1870,2020-03-20 08:20:00,1,2266.0,1932.0,0.853,11.065,6,6,4,2,0,0,0,0,0.0,0.0
1008,1871,2020-03-20 08:23:00,1,2157.0,1835.0,0.851,10.528,0,0,0,0,0,0,0,0,0.0,0.0
1008,1872,2020-03-20 08:26:00,1,2169.0,1791.0,0.826,10.529,2,1,0,1,1,0,1,0,0.0,0.0
1008,1873,2020-03-20 08:29:00,1,2179.0,1758.0,0.807,10.533,11,10,0,10,1,0,1,0,0.0,0.0
1008,1874,2020-03-20 08:32:00,1,2173.0,1790.0,0.824,10.543,93,43,9,34,50,25,25,1,0.0,0.0
1008,1875,2020-03-20 08:35:00,1,2253.0,1963.0,0.871,11.05,194,88,47,41,106,48,58,7,0.0,0.0
1008,1876,2020-03-20 08:38:00,1,2369.0,2009.0,0.848,11.56,207,97,55,42,110,58,52,39,0.0,0.16
1008,1877,2020-03-20 08:41:00,1,2691.0,2235.0,0.83,13.078,129,81,47,34,48,18,30,79,0.0,0.04
1008,1878,2020-03-20 08:44:00,1,2892.0,2433.0,0.841,14.09,110,53,34,19,57,38,19,1,0.0,0.02
1008,1879,2020-03-20 08:47:00,1,2689.0,2208.0,0.821,13.039,10,1,1,0,9,0,9,0,0.0,0.0
1008,1880,2020-03-20 08:50:00,1,2684.0,2211.0,0.824,13.023,15,3,2,1,12,0,12,0,0.0,0.01
1008,1881,2020-03-20 08:53:00,1,2500.0,2011.0,0.804,12.078,64,12,1,11,52,12,40,0,0.0,0.0
1008,1882,2020-03-20 08:56:00,1,2384.0,1957.0,0.821,11.559,190,86,54,32,104,41,63,36,0.0,0.0
1008,1883,2020-03-20 08:59:00,1,2456.0,2157.0,0.878,12.063,92,39,17,22,53,33,20,73,0.0,0.29
1008,1884,2020-03-20 09:02:00,1,2157.0,1844.0,0.855,10.542,241,85,53,32,156,104,52,5,0.03,0.0
1008,1885,2020-03-20 09:05:00,1,2460.0,2140.0,0.87,12.064,89,0,0,0,89,30,59,0,0.0,0.0
1008,1886,2020-03-20 09:08:00,1,2479.0,2041.0,0.823,12.029,12,1,0,1,11,8,3,0,0.0,0.0
1008,1887,2020-03-20 09:11:00,1,2486.0,2027.0,0.815,12.037,277,138,96,42,139,103,36,11,0.0,0.0
1008,1888,2020-03-20 09:14:00,1,2446.0,2198.0,0.899,12.07,42,15,2,13,27,1,26,0,0.02,0.0
1008,1889,2020-03-20 09:17:00,1,2563.0,2230.0,0.87,12.567,27,25,6,19,2,1,1,0,0.0,0.0
1008,1890,2020-03-20 09:20:00,1,2459.0,2149.0,0.874,12.066,9,9,3,6,0,0,0,0,0.0,0.0
1008,1891,2020-03-20 09:23:00,1,2487.0,2031.0,0.816,12.048,30,30,2,28,0,0,0,0,0.0,0.0
1008,1892,2020-03-20 09:26:00,1,2274.0,1891.0,0.831,11.054,302,302,250,52,0,0,0,0,0.0,0.0
1008,1893,2020-03-20 09:29:00,1,2147.0,1885.0,0.878,10.545,147,97,59,38,50,16,34,0,0.0,0.0
1008,1894,2020-03-20 09:32:00,1,2369.0,2002.0,0.845,11.551,216,81,47,34,135,81,54,2,0.0,0.0
1008,1895,2020-03-20 09:35:00,1,2244.0,1995.0,0.889,11.049,142,61,44,17,81,64,17,16,0.01,0.0
1008,1896,2020-03-20 09:38:00,1,2132.0,1953.0,0.916,10.562,63,0,0,0,63,17,46,0,0.0,0.0
1008,1897,2020-03-20 09:41:00,1,2166.0,1839.0,0.849,10.57,63,11,5,6,52,31,21,0,0.0,0.0
1008,1898,2020-03-20 09:44:00,1,2185.0,1733.0,0.793,10.528,133,27,10,17,106,64,42,0,0.0,0.0
1008,1899,2020-03-20 09:47:00,1,1959.0,1637.0,0.836,9.53,13,0,0,0,13,6,7,0,0.02,0.0
1008,1900,2020-03-20 09:50:00,1,2064.0,1719.0,0.833,10.035,46,6,3,3,40,28,12,0,0.0,0.0
1008,1901,2020-03-20 09:53:00,1,2171.0,1759.0,0.81,10.502,64,0,0,0,64,0,64,0,0.0,0.0
1008,1902,2020-03-20 09:56:00,1,1955.0,1674.0,0.856,9.556,146,38,32,6,108,32,76,0,0.0,0.0
1008,1903,2020-03-20 09:59:00,1,2370.0,1997.0,0.843,11.551,111,79,32,47,32,13,19,38,0.0,0.0
1008,1904,2020-03-20 10:02:00,1,2552.0,2275.0,0.892,12.573,194,110,73,37,84,56,28,47,0.1,0.02
1008,1905,2020-03-20 10:05:00,1,2482.0,2029.0,0.817,12.027,124,35,20,15,89,58,31,0,0.0,0.0
1008,1906,2020-03-20 10:08:00,1,2465.0,2131.0,0.864,12.071,25,8,3,5,17,9,8,0,0.0,0.0
1008,1907,2020-03-20 10:11:00,1,2466.0,2105.0,0.854,12.048,35,13,10,3,22,9,13,0,0.01,0.0
1008,1908,2020-03-20 10:14:00,1,2372.0,1990.0,0.839,11.548,184,123,68,55,61,30,31,69,0.0,0.09
1008,1909,2020-03-20 10:17:00,1,2675.0,2264.0,0.846,13.048,159,95,53,42,64,34,30,20,0.0,0.07
1008,1910,2020-03-20 10:20:00,1,2156.0,1868.0,0.866,10.565,64,24,17,7,40,15,25,0,0.25,0.0
1008,1911,2020-03-20 10:23:00,1,2137.0,1933.0,0.905,10.561,15,0,0,0,15,0,15,0,0.0,0.0
1008,1912,2020-03-20 10:26:00,1,2151.0,1866.0,0.868,10.54,19,0,0,0,19,0,19,0,0.0,0.0
1008,1913,2020-03-20 10:29:00,1,2259.0,1949.0,0.863,11.058,35,8,3,5,27,11,16,0,0.0,0.01
1008,1914,2020-03-20 10:32:00,1,2357.0,2005.0,0.85,11.508,37,3,0,3,34,16,18,0,0.0,0.0
1008,1915,2020-03-20 10:35:00,1,2132.0,1920.0,0.9,10.528,31,3,1,2,28,10,18,0,0.0,0.0
1008,1916,2020-03-20 10:38:00,1,2140.0,1910.0,0.893,10.546,11,0,0,0,11,2,9,0,0.0,0.0
1008,1917,2020-03-20 10:41:00,1,2157.0,1855.0,0.86,10.554,22,0,0,0,22,6,16,0,0.0,0.0
1008,1918,2020-03-20 10:44:00,1,2131.0,1920.0,0.901,10.521,12,0,0,0,12,0,12,0,0.0,0.0
1008,1919,2020-03-20 10:47:00,1,2370.0,1998.0,0.843,11.552,17,0,0,0,17,2,15,0,0.0,0.0
1008,1920,2020-03-20 10:50:00,1,2468.0,2118.0,0.858,12.069,43,15,9,6,28,10,18,0,0.0,0.0
1008,1921,2020-03-20 10:53:00,1,2444.0,2182.0,0.893,12.043,190,52,17,35,138,75,63,4,0.0,0.0
1008,1922,2020-03-20 10:56:00,1,2430.0,2257.0,0.929,12.071,242,66,27,39,176,123,53,3,0.0,0.0
1008,1923,2020-03-20 10:59:00,1,2659.0,2346.0,0.882,13.072,144,97,43,54,47,18,29,2,0.0,0.0
1008,1924,2020-03-20 11:02:00,1,2419.0,2278.0,0.942,12.054,7,7,5,2,0,0,0,0,0.0,0.0
1008,1925,2020-03-20 11:05:00,1,2462.0,2126.0,0.864,12.056,1,1,0,1,0,0,0,0,0.0,0.0
1008,1926,2020-03-20 11:08:00,1,2146.0,1861.0,0.867,10.517,38,11,4,7,27,12,15,0,0.0,0.0
1008,1927,2020-03-20 11:11:00,1,2162.5,1810.5,0.8375,10.526,7,3,0,3,4,0,4,0,0.0,0.0
1008,1928,2020-03-20 11:14:00,1,2179.0,1760.0,0.808,10.535,0,0,0,0,0,0,0,0,0.0,0.0
1008,1929,2020-03-20 11:17:00,1,2060.0,1735.0,0.842,10.037,8,5,1,4,3,0,3,0,0.0,0.0
1008,1930,2020-03-20 11:20:00,1,1959.0,1640.0,0.838,9.533,77,42,20,22,35,17,18,2,0.0,0.0
1008,1931,2020-03-20 11:23:00,1,2170.0,1810.0,0.834,10.552,154,101,60,41,53,29,24,39,0.0,0.03
1008,1932,2020-03-20 11:26:00,1,2173.0,1817.0,0.836,10.573,93,32,24,8,61,40,21,8,0.0,0.0
1008,1933,2020-03-20 11:29:00,1,2146.0,1890.0,0.881,10.547,17,1,1,0,16,0,16,0,0.0,0.0
1008,1934,2020-03-20 11:32:00,1,2183.0,1766.0,0.809,10.557,11,0,0,0,11,2,9,0,0.0,0.0
1008,1935,2020-03-20 11:35:00,1,2181.0,1758.0,0.806,10.542,24,17,3,14,7,1,6,0,0.0,0.0
1008,1936,2020-03-20 11:38:00,1,1947.0,1680.0,0.863,9.533,63,8,0,8,55,26,29,0,0.0,0.0
1008,1937,2020-03-20 11:41:00,1,1951.0,1695.0,0.869,9.563,233,1,1,0,232,206,26,0,0.0,0.0
1008,1938,2020-03-20 11:44:00,1,2071.0,1705.0,0.823,10.047,72,25,12,13,47,20,27,0,0.0,0.0
1008,1939,2020-03-20 11:47:00,1,2075.0,1691.0,0.815,10.049,52,21,10,11,31,16,15,0,0.0,0.0
1008,1940,2020-03-20 11:50:00,1,2071.0,1686.0,0.814,10.028,23,1,1,0,22,4,18,0,0.0,0.0
1008,1941,2020-03-20 11:53:00,1,1953.0,1650.0,0.845,9.523,64,8,2,6,56,8,48,0,0.0,0.0
1008,1942,2020-03-20 11:56:00,1,1969.0,1627.0,0.827,9.559,19,11,0,11,8,2,6,0,0.0,0.0
1008,1943,2020-03-20 11:59:00,1,1957.0,1666.0,0.851,9.556,135,56,42,14,79,36,43,18,0.0,0.0
1008,1944,2020-03-20 12:02:00,1,2494.0,2013.0,0.807,12.054,99,83,35,48,16,4,12,81,0.0,0.18
1008,1945,2020-03-20 12:05:00,1,2667.0,2303.0,0.863,13.059,125,73,46,27,52,31,21,8,0.0,0.12
1008,1946,2020-03-20 12:08:00,1,2558.0,2243.0,0.877,12.561,170,65,42,23,105,69,36,46,0.0,0.0
1009,1,2020-03-16 10:53:00,1,3771.0,3014.0,0.799,18.193,310,108,72,36,202,141,61,8,0.0,0.01
1009,2,2020-03-16 10:56:00,1,3816.0,2934.0,0.769,18.284,216,74,45,29,142,91,51,13,0.0,0.01
1009,3,2020-03-16 10:59:00,1,3793.0,2989.0,0.788,18.253,319,139,99,40,180,133,47,15,0.0,0.01
1009,4,2020-03-16 11:02:00,1,3548.0,2837.0,0.8,17.12,85,48,25,23,37,15,22,1,0.0,0.01
1009,5,2020-03-16 11:05:00,1,3729.0,2894.0,0.776,17.895,286,144,94,50,142,106,36,7,0.0,0.0
1009,6,2020-03-16 11:08:00,1,3615.0,2898.0,0.802,17.451,323,143,106,37,180,131,49,11,0.0,0.01
1009,7,2020-03-16 11:11:00,1,3456.0,2743.0,0.793,16.655,62,38,24,14,24,13,11,0,0.07,0.01
1009,8,2020-03-16 11:14:00,1,3271.5,2580.0,0.788,15.747,0,0,0,0,0,0,0,0,0.01,0.0
1009,9,2020-03-16 11:17:00,1,3087.0,2417.0,0.783,14.839,0,0,0,0,0,0,0,0,0.0,0.0
1009,10,2020-03-16 11:20:00,1,2999.0,2347.0,0.783,14.415,34,20,11,9,14,2,12,0,0.0,0.0
1009,11,2020-03-16 11:23:00,1,2762.0,2152.0,0.779,13.266,1,0,0,0,1,0,1,0,0.0,0.0
1009,12,2020-03-16 11:26:00,1,2600.0,2076.0,0.798,12.542,115,57,34,23,58,38,20,14,0.0,0.0
1009,13,2020-03-16 11:29:00,1,2835.0,2304.0,0.813,13.719,267,120,81,39,147,105,42,17,0.0,0.0
1009,14,2020-03-16 11:32:00,1,3001.0,2371.0,0.79,14.45,444,176,134,42,268,196,72,10,0.0,0.0
1009,15,2020-03-16 11:35:00,1,2995.0,2414.0,0.806,14.474,334,147,116,31,187,140,47,9,0.0,0.0
1009,16,2020-03-16 11:38:00,1,3015.0,2331.0,0.773,14.46,135,51,33,18,84,63,21,12,0.0,0.0
1009,17,2020-03-16 11:41:00,1,2863.0,2221.0,0.776,13.741,57,38,31,7,19,15,4,0,0.05,0.0
1009,18,2020-03-16 11:44:00,1,2836.0,2188.0,0.771,13.596,30,18,8,10,12,1,11,0,0.0,0.0
1009,19,2020-03-16 11:47:00,1,2587.0,2140.0,0.827,12.561,86,80,35,45,6,1,5,0,0.01,0.01
1009,20,2020-03-16 11:50:00,1,2613.0,2034.0,0.779,12.548,58,34,21,13,24,9,15,0,0.0,0.0
1009,21,2020-03-16 11:53:00,1,2608.0,2065.0,0.792,12.562,10,6,2,4,4,1,3,0,0.0,0.0
1009,22,2020-03-16 11:56:00,1,2454.0,1896.0,0.773,11.768,1,0,0,0,1,0,1,0,0.0,0.0
1009,23,2020-03-16 11:59:00,1,2297.0,1784.0,0.777,11.026,0,0,0,0,0,0,0,0,0.0,0.0
1009,24,2020-03-16 12:02:00,1,2033.0,1693.0,0.833,9.883,0,0,0,0,0,0,0,0,0.0,0.0
1009,25,2020-03-16 12:05:00,1,2046.0,1645.0,0.804,9.882,7,3,0,3,4,0,4,0,0.0,0.0
1009,26,2020-03-16 12:08:00,1,2044.0,1647.0,0.806,9.877,24,13,7,6,11,2,9,4,0.0,0.0
1009,27,2020-03-16 12:11:00,1,2042.0,1641.0,0.803,9.863,0,0,0,0,0,0,0,0,0.0,0.0
1009,28,2020-03-16 12:14:00,1,1872.0,1579.0,0.843,9.125,0,0,0,0,0,0,0,0,0.0,0.0
1009,29,2020-03-16 12:17:00,1,1878.0,1552.0,0.827,9.118,0,0,0,0,0,0,0,0,0.0,0.0
1009,30,2020-03-16 12:20:00,1,1898.0,1505.0,0.793,9.146,2,0,0,0,2,1,1,0,0.04,0.0
1009,31,2020-03-16 12:23:00,1,1891.0,1484.0,0.785,9.093,0,0,0,0,0,0,0,0,0.01,0.0
1009,32,2020-03-16 12:26:00,1,1899.0,1451.0,0.764,9.088,26,14,7,7,12,3,9,2,0.0,0.0
1009,33,2020-03-16 12:29:00,1,1893.0,1505.0,0.795,9.126,28,18,13,5,10,4,6,0,0.0,0.0
1009,34,2020-03-16 12:32:00,1,2055.0,1622.0,0.789,9.893,24,21,3,18,3,0,3,0,0.0,0.0
1009,35,2020-03-16 12:35:00,1,2286.0,1824.0,0.798,11.027,131,70,47,23,61,32,29,7,0.0,0.0
1009,36,2020-03-16 12:38:00,1,2295.0,1803.0,0.786,11.039,18,11,5,6,7,1,6,0,0.0,0.0
1009,37,2020-03-16 12:41:00,1,2023.0,1698.0,0.839,9.85,96,81,39,42,15,5,10,1,0.0,0.0
1009,38,2020-03-16 12:44:00,1,2026.0,1701.0,0.84,9.868,139,118,64,54,21,4,17,0,0.0,0.0
1009,39,2020-03-16 12:47:00,1,2297.0,1787.0,0.778,11.03,58,27,4,23,31,2,29,0,0.0,0.0
1009,40,2020-03-16 12:50:00,1,2022.0,1737.0,0.859,9.89,7,7,0,7,0,0,0,0,0.0,0.0
1009,41,2020-03-16 12:53:00,1,2040.0,1607.0,0.788,9.816,18,18,0,18,0,0,0,0,0.0,0.0
1009,42,2020-03-16 12:56:00,1,1881.0,1516.0,0.806,9.09,18,18,0,18,0,0,0,0,0.0,0.0
1009,43,2020-03-16 12:59:00,1,1908.0,1470.0,0.771,9.145,0,0,0,0,0,0,0,0,0.0,0.0
1009,44,2020-03-16 13:02:00,1,1816.0,1431.0,0.788,8.738,8,0,0,0,8,0,8,0,0.0,0.0
1009,45,2020-03-16 13:05:00,1,1721.0,1437.0,0.835,8.371,14,10,5,5,4,2,2,0,0.0,0.0
1009,46,2020-03-16 13:08:00,1,1724.0,1412.0,0.819,8.358,0,0,0,0,0,0,0,0,0.0,0.0
1009,47,2020-03-16 13:11:00,1,1636.0,1351.0,0.826,7.942,0,0,0,0,0,0,0,0,0.0,0.0
1009,48,2020-03-16 13:14:00,1,1661.0,1295.0,0.779,7.979,27,9,5,4,18,4,14,0,0.0,0.0
1009,49,2020-03-16 13:17:00,1,1637.0,1386.0,0.846,7.985,3,0,0,0,3,1,2,0,0.0,0.0
1009,50,2020-03-16 13:20:00,1,1716.0,1419.0,0.827,8.332,0,0,0,0,0,0,0,0,0.0,0.0
1009,51,2020-03-16 13:23:00,1,1721.0,1442.0,0.838,8.377,0,0,0,0,0,0,0,0,0.01,0.0
1009,52,2020-03-16 13:26:00,1,1721.0,1438.0,0.835,8.374,0,0,0,0,0,0,0,0,0.0,0.0
1009,53,2020-03-16 13:29:00,1,1634.0,1393.0,0.853,7.98,1,1,0,1,0,0,0,0,0.0,0.0
1009,54,2020-03-16 13:32:00,1,1651.0,1335.0,0.808,7.985,5,5,0,5,0,0,0,0,0.0,0.0
1009,55,2020-03-16 13:35:00,1,1650.0,1352.0,0.819,7.999,0,0,0,0,0,0,0,0,0.0,0.0
1009,56,2020-03-16 13:38:00,1,1570.0,1281.0,0.816,7.604,30,20,7,13,10,4,6,0,0.0,0.0
1009,57,2020-03-16 13:41:00,1,1711.0,1463.0,0.855,8.362,5,2,0,2,3,0,3,2,0.0,0.0
1009,58,2020-03-16 13:44:00,1,1627.0,1432.0,0.88,7.995,6,0,0,0,6,0,6,0,0.0,0.0
1009,59,2020-03-16 13:47:00,1,1634.0,1409.0,0.862,7.999,11,0,0,0,11,0,11,0,0.0,0.0
1009,60,2020-03-16 13:50:00,1,1631.0,1403.0,0.86,7.981,10,7,3,4,3,2,1,0,0.0,0.0
1009,61,2020-03-16 13:53:00,1,1654.0,1328.0,0.803,7.988,17,15,6,9,2,0,2,0,0.0,0.0
1009,62,2020-03-16 13:56:00,1,1641.0,1348.0,0.821,7.959,15,14,9,5,1,0,1,0,0.0,0.0
1009,63,2020-03-16 13:59:00,1,1657.0,1324.0,0.799,7.994,6,0,0,0,6,0,6,0,0.0,0.0
1009,64,2020-03-16 14:02:00,1,1628.0,1395.0,0.857,7.958,33,29,6,23,4,1,3,0,0.0,0.0
1009,65,2020-03-16 14:05:00,1,1636.0,1404.0,0.858,8.003,8,7,5,2,1,0,1,0,0.0,0.0
1009,66,2020-03-16 14:08:00,1,1648.0,1353.0,0.821,7.991,12,11,3,8,1,0,1,0,0.0,0.0
1009,67,2020-03-16 14:11:00,1,1645.0,1365.0,0.829,7.994,50,29,19,10,21,2,19,1,0.0,0.0
1009,68,2020-03-16 14:14:00,1,1777.5,1390.5,0.785,8.544,0,0,0,0,0,0,0,0,0.0,0.0
1009,69,2020-03-16 14:17:00,1,1910.0,1416.0,0.741,9.094,27,24,1,23,3,0,3,0,0.0,0.0
1009,70,2020-03-16 14:20:00,1,1912.0,1419.0,0.742,9.103,0,0,0,0,0,0,0,0,0.0,0.0
1009,71,2020-03-16 14:23:00,1,1924.0,1383.0,0.719,9.114,6,5,0,5,1,0,1,0,0.0,0.0
1009,72,2020-03-16 14:26:00,1,1908.0,1433.0,0.751,9.104,42,30,9,21,12,0,12,0,0.0,0.0
1009,73,2020-03-16 14:29:00,1,2242.0,1669.0,0.744,10.683,40,18,6,12,22,1,21,0,0.01,0.0
1009,74,2020-03-16 14:32:00,1,2479.0,1828.0,0.737,11.79,194,92,60,32,102,68,34,5,0.0,0.0
1009,75,2020-03-16 14:35:00,1,2561.0,1864.0,0.728,12.153,106,41,25,16,65,37,28,5,0.0,0.0
1009,76,2020-03-16 14:38:00,1,2306.0,1741.0,0.755,11.013,2,2,1,1,0,0,0,0,0.0,0.0
1009,77,2020-03-16 14:41:00,1,2151.0,1608.0,0.748,10.255,10,8,5,3,2,0,2,0,0.0,0.0
1009,78,2020-03-16 14:44:00,1,2169.0,1524.0,0.703,10.232,24,19,10,9,5,0,5,0,0.0,0.0
1009,79,2020-03-16 14:47:00,1,1995.0,1472.0,0.738,9.491,4,4,3,1,0,0,0,0,0.0,0.0
1009,80,2020-03-16 14:50:00,1,1913.0,1421.0,0.743,9.113,10,7,1,6,3,0,3,0,0.0,0.0
1009,81,2020-03-16 14:53:00,1,1917.0,1422.0,0.742,9.129,7,3,0,3,4,0,4,0,0.0,0.0
1009,82,2020-03-16 14:56:00,1,1923.0,1377.0,0.716,9.103,91,80,52,28,11,0,11,0,0.0,0.0
1009,83,2020-03-16 14:59:00,1,1934.0,1335.0,0.69,9.098,22,17,0,17,5,0,5,0,0.0,0.0
1009,84,2020-03-16 15:02:00,1,1914.0,1408.0,0.736,9.099,139,97,47,50,42,4,38,2,0.0,0.0
1009,85,2020-03-16 15:05:00,1,2236.0,1658.0,0.742,10.646,83,52,30,22,31,11,20,2,0.0,0.0
1009,86,2020-03-16 15:08:00,1,2171.0,1522.0,0.701,10.239,76,71,55,16,5,0,5,0,0.0,0.0
1009,87,2020-03-16 15:11:00,1,1911.0,1437.0,0.752,9.12,52,41,29,12,11,1,10,0,0.0,0.0
1009,88,2020-03-16 15:14:00,1,1927.0,1412.0,0.733,9.155,18,10,2,8,8,0,8,0,0.02,0.0
1009,89,2020-03-16 15:17:00,1,1910.0,1415.0,0.741,9.091,24,12,3,9,12,0,12,0,0.0,0.0
1009,90,2020-03-16 15:20:00,1,1934.0,1375.0,0.711,9.142,12,2,0,2,10,0,10,0,0.0,0.0
1009,91,2020-03-16 15:23:00,1,1926.0,1378.0,0.716,9.115,3,1,0,1,2,0,2,0,0.0,0.0
1009,92,2020-03-16 15:26:00,1,1938.0,1377.0,0.71,9.158,30,23,4,19,7,0,7,0,0.0,0.0
1009,93,2020-03-16 15:29:00,1,1932.0,1351.0,0.7,9.107,53,48,35,13,5,0,5,0,0.0,0.0
1009,94,2020-03-16 15:32:00,1,1950.0,1327.0,0.681,9.151,12,7,4,3,5,0,5,0,0.0,0.0
1009,95,2020-03-16 15:35:00,1,1773.0,1262.0,0.712,8.383,14,8,4,4,6,0,6,0,0.0,0.0
1009,96,2020-03-16 15:38:00,1,1850.0,1326.0,0.717,8.757,11,10,5,5,1,0,1,0,0.0,0.0
1009,97,2020-03-16 15:41:00,1,1848.0,1336.0,0.723,8.759,85,47,27,20,38,9,29,2,0.0,0.0
1009,98,2020-03-16 15:44:00,1,2169.0,1545.0,0.712,10.259,44,27,10,17,17,2,15,0,0.0,0.0
1009,99,2020-03-16 15:47:00,1,1904.0,1440.0,0.756,9.097,23,23,1,22,0,0,0,0,0.0,0.0
1009,100,2020-03-16 15:50:00,1,1745.0,1318.0,0.755,8.335,26,22,7,15,4,1,3,0,0.0,0.0
1009,101,2020-03-16 15:53:00,1,1778.0,1218.0,0.685,8.355,17,8,3,5,9,0,9,0,0.0,0.0
1009,102,2020-03-16 15:56:00,1,1767.0,1263.0,0.715,8.361,13,0,0,0,13,0,13,0,0.0,0.0
1009,103,2020-03-16 15:59:00,1,1753.0,1322.0,0.754,8.371,11,0,0,0,11,0,11,0,0.0,0.0
1009,104,2020-03-16 16:02:00,1,1931.0,1342.0,0.695,9.095,3,0,0,0,3,0,3,0,0.0,0.0
1009,105,2020-03-16 16:05:00,1,1924.0,1357.0,0.705,9.082,13,10,6,4,3,0,3,0,0.0,0.0
1009,106,2020-03-16 16:08:00,1,1924.0,1382.0,0.718,9.112,0,0,0,0,0,0,0,0,0.0,0.0
1009,107,2020-03-16 16:11:00,1,1926.0,1390.0,0.722,9.128,0,0,0,0,0,0,0,0,0.0,0.0
1009,108,2020-03-16 16:14:00,1,1922.0,1404.0,0.73,9.129,0,0,0,0,0,0,0,0,0.0,0.0
1009,109,2020-03-16 16:17:00,1,1919.0,1395.0,0.727,9.105,8,8,4,4,0,0,0,0,0.0,0.0
1009,110,2020-03-16 16:20:00,1,1925.0,1385.0,0.719,9.119,28,28,9,19,0,0,0,0,0.0,0.0
1009,111,2020-03-16 16:23:00,1,1841.0,1338.0,0.727,8.734,4,4,2,2,0,0,0,0,0.0,0.0
1009,112,2020-03-16 16:26:00,1,1843.0,1337.0,0.725,8.742,8,8,3,5,0,0,0,0,0.0,0.0
1009,113,2020-03-16 16:29:00,1,1909.0,1408.0,0.738,9.079,35,31,2,29,4,1,3,0,0.0,0.0
1009,114,2020-03-16 16:32:00,1,2179.0,1538.0,0.706,10.287,80,53,15,38,27,2,25,0,0.0,0.0
1009,115,2020-03-16 16:35:00,1,2296.0,1727.0,0.752,10.959,188,127,70,57,61,41,20,10,0.0,0.0
1009,116,2020-03-16 16:38:00,1,2470.0,1864.0,0.755,11.795,267,114,76,38,153,111,42,11,0.0,0.0
1009,117,2020-03-16 16:41:00,1,2460.0,1858.0,0.755,11.749,147,91,47,44,56,22,34,0,0.0,0.0
1009,118,2020-03-16 16:44:00,1,2556.0,1876.0,0.734,12.147,77,55,32,23,22,0,22,0,0.01,0.0
1009,119,2020-03-16 16:47:00,1,2556.0,1872.0,0.732,12.145,168,82,48,34,86,39,47,6,0.0,0.0
1009,120,2020-03-16 16:50:00,1,2560.0,1880.0,0.734,12.166,225,103,59,44,122,80,42,8,0.0,0.0
1009,121,2020-03-16 16:53:00,1,2485.0,1827.0,0.735,11.815,31,11,1,10,20,0,20,0,0.0,0.0
1009,122,2020-03-16 16:56:00,1,2467.0,1818.0,0.737,11.735,21,13,2,11,8,2,6,0,0.0,0.0
1009,123,2020-03-16 16:59:00,1,2142.0,1615.0,0.754,10.226,4,4,0,4,0,0,0,0,0.0,0.0
1009,124,2020-03-16 17:02:00,1,1995.0,1472.0,0.738,9.492,0,0,0,0,0,0,0,0,0.0,0.0
1009,125,2020-03-16 17:05:00,1,1915.0,1414.0,0.739,9.111,0,0,0,0,0,0,0,0,0.0,0.0
1009,126,2020-03-16 17:08:00,1,1935.0,1360.0,0.703,9.129,0,0,0,0,0,0,0,0,0.0,0.0
1009,127,2020-03-16 17:11:00,1,1847.0,1328.0,0.719,8.748,0,0,0,0,0,0,0,0,0.0,0.0
1009,128,2020-03-16 17:14:00,1,1894.5,1309.0,0.6915,8.9145,0,0,0,0,0,0,0,0,0.0,0.0
1009,129,2020-03-16 17:17:00,1,1942.0,1290.0,0.664,9.081,0,0,0,0,0,0,0,0,0.0,0.0
1009,130,2020-03-16 17:20:00,1,1950.0,1323.0,0.678,9.148,38,21,16,5,17,12,5,0,0.01,0.0
1009,131,2020-03-16 17:23:00,1,2096.0,1436.0,0.685,9.848,114,66,49,17,48,34,14,0,0.0,0.0
1009,132,2020-03-16 17:26:00,1,2099.0,1434.0,0.683,9.858,2,0,0,0,2,1,1,0,0.0,0.0
1009,133,2020-03-16 17:29:00,1,2115.0,1390.0,0.657,9.871,2,0,0,0,2,0,2,0,0.0,0.0
1009,134,2020-03-16 17:32:00,1,1941.0,1357.0,0.7,9.149,1,0,0,0,1,0,1,3,0.0,0.0
1009,135,2020-03-16 17:35:00,1,1943.0,1278.0,0.658,9.071,0,0,0,0,0,0,0,0,0.0,0.0
1009,136,2020-03-16 17:38:00,1,1945.0,1276.0,0.656,9.074,23,4,2,2,19,4,15,2,0.0,0.0
1009,137,2020-03-16 17:41:00,1,2095.0,1424.0,0.68,9.831,77,42,9,33,35,5,30,3,0.0,0.0
1009,138,2020-03-16 17:44:00,1,2354.0,1537.0,0.653,10.975,175,88,44,44,87,51,36,7,0.0,0.0
1009,139,2020-03-16 17:47:00,1,2331.0,1646.0,0.706,11.005,92,53,32,21,39,27,12,0,0.0,0.0
1009,140,2020-03-16 17:50:00,1,2356.0,1574.0,0.668,11.028,60,44,22,22,16,6,10,0,0.0,0.0
1009,141,2020-03-16 17:53:00,1,2339.0,1638.0,0.7,11.03,163,135,82,53,28,0,28,0,0.0,0.0
1009,142,2020-03-16 17:56:00,1,2264.0,1509.0,0.667,10.591,79,34,17,17,45,28,17,3,0.0,0.0
1009,143,2020-03-16 17:59:00,1,2351.0,1591.0,0.677,11.026,207,91,52,39,116,86,30,4,0.0,0.0
1009,144,2020-03-16 18:02:00,0,2507.0,1706.0,0.681,11.768,415,153,119,34,262,198,64,14,0.0,0.0
1009,145,2020-03-16 18:05:00,0,2743.0,1893.0,0.69,12.902,506,266,222,44,240,190,50,19,0.0,0.0
1009,146,2020-03-16 18:08:00,0,2829.0,1951.0,0.69,13.308,339,179,132,47,160,115,45,8,0.0,0.0
1009,147,2020-03-16 18:11:00,0,2739.0,1916.0,0.699,12.914,362,195,130,65,167,109,58,5,0.0,0.0
1009,148,2020-03-16 18:14:00,0,2733.0,1936.0,0.708,12.914,372,208,143,65,164,109,55,10,0.0,0.0
1009,149,2020-03-16 18:17:00,0,2828.0,1953.0,0.691,13.305,288,124,71,53,164,99,65,15,0.0,0.0
1009,150,2020-03-16 18:20:00,0,2925.0,1977.0,0.676,13.712,400,219,145,74,181,118,63,7,0.0,0.0
1009,151,2020-03-16 18:23:00,0,2905.0,1986.0,0.684,13.645,379,210,134,76,169,99,70,8,0.0,0.0
1009,152,2020-03-16 18:26:00,0,2922.0,1976.0,0.676,13.7,383,221,153,68,162,101,61,16,0.0,0.0
1009,153,2020-03-16 18:29:00,0,2917.0,1986.0,0.681,13.693,437,251,173,78,186,131,55,24,0.0,0.0
1009,154,2020-03-16 18:32:00,0,2908.0,1988.0,0.684,13.66,319,124,71,53,195,122,73,13,0.0,0.0
1009,155,2020-03-16 18:35:00,0,2911.0,1986.0,0.682,13.669,305,180,111,69,125,76,49,2,0.0,0.0
1009,156,2020-03-16 18:38:00,0,2925.0,1960.0,0.67,13.696,242,114,59,55,128,73,55,2,0.0,0.0
1009,157,2020-03-16 18:41:00,0,2737.0,1932.0,0.706,12.924,85,63,35,28,22,12,10,0,0.0,0.0
1009,158,2020-03-16 18:44:00,0,2498.0,1738.0,0.696,11.768,2,1,1,0,1,0,1,0,0.0,0.0
1009,159,2020-03-16 18:47:00,0,2342.0,1561.0,0.666,10.958,69,41,25,16,28,17,11,3,0.0,0.0
1009,160,2020-03-16 18:50:00,0,2355.0,1536.0,0.652,10.982,1,1,0,1,0,0,0,0,0.0,0.0
1009,161,2020-03-16 18:53:00,0,2096.0,1458.0,0.696,9.871,6,5,1,4,1,1,0,0,0.0,0.0
1009,162,2020-03-16 18:56:00,0,2093.0,1442.0,0.689,9.843,20,17,1,16,3,0,3,0,0.0,0.0
1009,163,2020-03-16 18:59:00,0,2107.0,1439.0,0.683,9.897,105,52,24,28,53,22,31,0,0.0,0.0
1009,164,2020-03-16 19:02:00,0,2353.0,1586.0,0.674,11.029,107,65,26,39,42,22,20,1,0.0,0.0
1009,165,2020-03-16 19:05:00,0,2479.0,1791.0,0.723,11.749,321,176,119,57,145,91,54,13,0.0,0.0
1009,166,2020-03-16 19:08:00,0,2720.0,1939.0,0.713,12.865,393,230,162,68,163,110,53,29,0.0,0.0
1009,167,2020-03-16 19:11:00,0,2905.0,2011.0,0.692,13.674,767,350,266,84,417,322,95,17,0.0,0.0
1009,168,2020-03-16 19:14:00,0,2883.0,2094.0,0.727,13.677,692,339,268,71,353,263,90,40,0.0,0.0
1009,169,2020-03-16 19:17:00,0,3052.0,2127.0,0.697,14.38,748,354,258,96,394,300,94,30,0.0,0.0
1009,170,2020-03-16 19:20:00,0,3070.0,2126.0,0.692,14.449,741,374,286,88,367,282,85,11,0.0,0.0
1009,171,2020-03-16 19:23:00,0,2973.0,2096.0,0.705,14.035,704,315,240,75,389,303,86,11,0.0,0.0
1009,172,2020-03-16 19:26:00,0,2983.0,2079.0,0.697,14.053,333,194,123,71,139,78,61,12,0.0,0.0
1009,173,2020-03-16 19:29:00,0,3072.0,2110.0,0.687,14.441,224,118,66,52,106,51,55,2,0.0,0.0
1009,174,2020-03-16 19:32:00,0,3049.0,2129.0,0.698,14.371,214,80,51,29,134,89,45,3,0.0,0.0
1009,175,2020-03-16 19:35:00,0,2980.0,2090.0,0.701,14.056,102,42,14,28,60,29,31,4,0.0,0.0
1009,176,2020-03-16 19:38:00,0,2973.0,2104.0,0.708,14.043,296,95,47,48,201,137,64,7,0.0,0.0
1009,177,2020-03-16 19:41:00,0,3040.0,2192.0,0.721,14.404,246,118,72,46,128,84,44,9,0.0,0.0
1009,178,2020-03-16 19:44:00,0,3039.0,2235.0,0.736,14.449,244,111,82,29,133,95,38,8,0.0,0.0
1009,179,2020-03-16 19:47:00,0,2893.0,2071.0,0.716,13.691,47,16,11,5,31,18,13,0,0.0,0.0
1009,180,2020-03-16 19:50:00,0,2747.0,1843.0,0.671,12.865,59,17,4,13,42,12,30,0,0.0,0.0
1009,181,2020-03-16 19:53:00,0,2502.0,1737.0,0.694,11.779,66,19,11,8,47,22,25,0,0.0,0.0
1009,182,2020-03-16 19:56:00,0,2342.0,1621.0,0.692,11.023,262,94,64,30,168,128,40,4,0.0,0.0
1009,183,2020-03-16 19:59:00,0,2490.0,1762.0,0.707,11.763,621,312,244,68,309,241,68,6,0.0,0.0
1009,184,2020-03-16 20:02:00,0,2722.0,1938.0,0.712,12.872,950,449,339,110,501,382,119,22,0.0,0.0
1009,185,2020-03-16 20:05:00,0,2903.0,2041.0,0.703,13.696,985,485,383,102,500,392,108,50,0.0,0.0
1009,186,2020-03-16 20:08:00,0,2987.0,2108.0,0.706,14.104,1066,468,369,99,598,481,117,37,0.0,0.0
1009,187,2020-03-16 20:11:00,0,3064.0,2132.0,0.696,14.432,932,434,344,90,498,394,104,41,0.0,0.0
1009,188,2020-03-16 20:14:00,0,3071.5,2114.5,0.6885,14.444,419,201,153,48,218,159,59,12,0.0,0.0
1009,189,2020-03-16 20:17:00,0,3079.0,2097.0,0.681,14.456,375,206,144,62,169,114,55,7,0.0,0.0
1009,190,2020-03-16 20:20:00,0,2982.0,2090.0,0.701,14.066,274,101,49,52,173,110,63,7,0.0,0.0
1009,191,2020-03-16 20:23:00,0,3054.0,2105.0,0.689,14.366,357,156,108,48,201,144,57,13,0.0,0.0
1009,192,2020-03-16 20:26:00,0,2898.0,1979.0,0.683,13.609,27,19,9,10,8,3,5,0,0.0,0.0
1009,193,2020-03-16 20:29:00,0,2581.0,1783.0,0.691,12.143,8,5,3,2,3,2,1,0,0.0,0.0
1009,194,2020-03-16 20:32:00,0,2330.0,1630.0,0.7,10.983,20,14,0,14,6,3,3,0,0.0,0.0
1009,195,2020-03-16 20:35:00,0,2362.0,1496.0,0.633,10.965,111,55,30,25,56,36,20,0,0.0,0.0
1009,196,2020-03-16 20:38:00,0,2343.0,1592.0,0.679,10.996,406,177,126,51,229,163,66,22,0.0,0.0
1009,197,2020-03-16 20:41:00,0,2499.0,1738.0,0.695,11.771,273,140,93,47,133,81,52,17,0.0,0.0
1009,198,2020-03-16 20:44:00,0,2749.0,1883.0,0.685,12.917,837,396,314,82,441,337,104,44,0.0,0.0
1009,199,2020-03-16 20:47:00,0,2899.0,1983.0,0.684,13.617,997,473,374,99,524,422,102,21,0.0,0.0
1009,200,2020-03-16 20:50:00,0,2900.0,2066.0,0.712,13.715,962,488,390,98,474,372,102,17,0.0,0.0
1009,201,2020-03-16 20:53:00,0,2973.0,2091.0,0.703,14.029,924,442,348,94,482,369,113,30,0.0,0.0
1009,202,2020-03-16 20:56:00,0,2980.0,2094.0,0.703,14.061,491,214,155,59,277,210,67,18,0.0,0.0
1009,203,2020-03-16 20:59:00,0,2887.0,2066.0,0.715,13.664,256,149,76,73,107,49,58,18,0.0,0.0
1009,204,2020-03-16 21:02:00,0,3045.0,2134.0,0.701,14.359,412,178,130,48,234,164,70,17,0.0,0.0
1009,205,2020-03-16 21:05:00,0,2877.0,2080.0,0.723,13.638,540,257,186,71,283,214,69,7,0.0,0.0
1009,206,2020-03-16 21:08:00,0,2896.0,1988.0,0.686,13.613,38,17,2,15,21,2,19,3,0.0,0.0
1009,207,2020-03-16 21:11:00,0,2580.0,1782.0,0.691,12.14,20,3,1,2,17,5,12,0,0.0,0.0
1009,208,2020-03-16 21:14:00,0,2335.0,1627.0,0.697,11.001,17,0,0,0,17,2,15,0,0.0,0.0
1009,209,2020-03-16 21:17:00,0,2275.0,1499.0,0.659,10.624,114,43,26,17,71,38,33,2,0.0,0.0
1009,210,2020-03-16 21:20:00,0,2359.0,1542.0,0.653,11.002,157,72,31,41,85,37,48,9,0.0,0.0
1009,211,2020-03-16 21:23:00,0,2493.0,1752.0,0.703,11.762,516,259,202,57,257,196,61,31,0.0,0.0
1009,212,2020-03-16 21:26:00,0,2748.0,1837.0,0.669,12.86,606,320,254,66,286,208,78,4,0.0,0.0
1009,213,2020-03-16 21:29:00,0,2820.0,1949.0,0.691,13.267,863,411,312,99,452,349,103,17,0.0,0.0
1009,214,2020-03-16 21:32:00,0,2901.0,2005.0,0.691,13.652,828,410,319,91,418,329,89,25,0.0,0.0
1009,215,2020-03-16 21:35:00,0,2908.0,2044.0,0.703,13.722,950,430,338,92,520,425,95,35,0.0,0.0
1009,216,2020-03-16 21:38:00,0,2892.0,2038.0,0.705,13.652,421,204,148,56,217,161,56,8,0.0,0.0
1009,217,2020-03-16 21:41:00,0,2891.0,2055.0,0.711,13.666,340,196,120,76,144,97,47,26,0.0,0.0
1009,218,2020-03-16 21:44:00,0,2960.0,2083.0,0.704,13.968,412,206,162,44,206,155,51,7,0.0,0.0
1009,219,2020-03-16 21:47:00,0,2896.0,2038.0,0.704,13.668,369,197,141,56,172,129,43,20,0.0,0.0
1009,220,2020-03-16 21:50:00,0,2916.0,1979.0,0.679,13.68,614,319,245,74,295,219,76,16,0.0,0.0
1009,221,2020-03-16 21:53:00,0,2829.0,1938.0,0.685,13.293,371,169,105,64,202,146,56,9,0.0,0.0
1009,222,2020-03-16 21:56:00,0,2748.0,1885.0,0.686,12.915,147,76,40,36,71,39,32,11,0.0,0.0
1009,223,2020-03-16 21:59:00,0,2742.0,1873.0,0.683,12.878,302,120,72,48,182,130,52,6,0.0,0.0
1009,224,2020-03-16 22:02:00,0,2768.0,1843.0,0.666,12.947,189,67,34,33,122,72,50,4,0.0,0.0
1009,225,2020-03-16 22:05:00,0,2764.0,1840.0,0.666,12.927,173,88,48,40,85,47,38,1,0.0,0.0
1009,226,2020-03-16 22:08:00,0,2503.0,1741.0,0.695,11.791,0,0,0,0,0,0,0,0,0.0,0.0
1009,227,2020-03-16 22:11:00,0,2347.0,1583.0,0.674,11.002,3,0,0,0,3,1,2,0,0.0,0.0
1009,228,2020-03-16 22:14:00,0,2097.0,1460.0,0.696,9.878,32,0,0,0,32,0,32,0,0.0,0.0
1009,229,2020-03-16 22:17:00,0,2019.0,1343.0,0.665,9.442,14,0,0,0,14,0,14,0,0.0,0.0
1009,230,2020-03-16 22:20:00,0,1943.0,1274.0,0.656,9.065,8,0,0,0,8,0,8,0,0.0,0.0
1009,231,2020-03-16 22:23:00,0,1966.0,1247.0,0.634,9.127,14,1,1,0,13,6,7,0,0.0,0.0
1009,232,2020-03-16 22:26:00,0,1975.0,1238.0,0.627,9.152,77,33,27,6,44,26,18,0,0.0,0.0
1009,233,2020-03-16 22:29:00,0,1949.0,1306.0,0.67,9.127,579,316,251,65,263,197,66,10,0.0,0.0
1009,234,2020-03-16 22:32:00,0,2348.0,1612.0,0.687,11.035,557,265,200,65,292,217,75,5,0.0,0.0
1009,235,2020-03-16 22:35:00,0,2508.0,1766.0,0.704,11.836,765,371,304,67,394,310,84,16,0.0,0.0
1009,236,2020-03-16 22:38:00,0,2744.0,1876.0,0.684,12.891,807,397,313,84,410,328,82,10,0.0,0.0
1009,237,2020-03-16 22:41:00,0,2828.0,1927.0,0.681,13.277,454,220,160,60,234,171,63,19,0.0,0.0
1009,238,2020-03-16 22:44:00,0,2900.0,1986.0,0.685,13.625,331,195,140,55,136,96,40,12,0.0,0.0
1009,239,2020-03-16 22:47:00,0,2904.0,2004.0,0.69,13.661,326,146,100,46,180,133,47,8,0.0,0.0
1009,240,2020-03-16 22:50:00,0,2913.0,1987.0,0.682,13.679,335,186,125,61,149,91,58,5,0.0,0.0
1009,241,2020-03-16 22:53:00,0,2831.0,1954.0,0.69,13.316,379,198,142,56,181,135,46,0,0.0,0.0
1009,242,2020-03-16 22:56:00,0,2740.0,1907.0,0.696,12.907,482,240,183,57,242,167,75,5,0.0,0.0
1009,243,2020-03-16 22:59:00,0,2756.0,1855.0,0.673,12.911,84,44,21,23,40,14,26,0,0.0,0.0
1009,244,2020-03-16 23:02:00,0,2518.0,1681.0,0.668,11.781,11,1,0,1,10,0,10,0,0.0,0.0
1009,245,2020-03-16 23:05:00,0,2365.0,1527.0,0.645,11.01,40,4,2,2,36,2,34,0,0.0,0.0
1009,246,2020-03-16 23:08:00,0,2104.0,1417.0,0.674,9.861,18,13,1,12,5,1,4,0,0.0,0.0
1009,247,2020-03-16 23:11:00,0,2028.0,1356.0,0.669,9.492,71,33,25,8,38,23,15,0,0.0,0.0
1009,248,2020-03-16 23:14:00,0,1946.0,1287.5,0.6615,9.0935,26,16,8,8,10,3,7,0,0.0,0.0
1009,249,2020-03-16 23:17:00,0,1864.0,1219.0,0.654,8.695,27,2,0,2,25,0,25,0,0.0,0.0
1009,250,2020-03-16 23:20:00,0,1774.0,1192.0,0.672,8.311,53,0,0,0,53,0,53,0,0.0,0.0
1009,251,2020-03-16 23:23:00,0,1950.0,1239.0,0.635,9.056,464,226,165,61,238,169,69,5,0.0,0.0
1009,252,2020-03-16 23:26:00,0,2347.0,1569.0,0.669,10.987,738,386,295,91,352,273,79,25,0.0,0.0
1009,253,2020-03-16 23:29:00,0,2565.0,1820.0,0.71,12.12,1138,569,470,99,569,444,125,20,0.0,0.0
1009,254,2020-03-16 23:32:00,0,2718.0,1943.0,0.715,12.861,1019,540,445,95,479,380,99,27,0.0,0.0
1009,255,2020-03-16 23:35:00,0,2918.0,1999.0,0.685,13.709,365,159,94,65,206,137,69,12,0.0,0.0
1009,256,2020-03-16 23:38:00,0,2904.0,2008.0,0.692,13.665,420,219,151,68,201,133,68,1,0.0,0.0
1009,257,2020-03-16 23:41:00,0,2884.0,2027.0,0.703,13.606,297,141,90,51,156,101,55,11,0.0,0.0
1009,258,2020-03-16 23:44:00,0,2895.0,2020.0,0.698,13.646,391,190,160,30,201,143,58,12,0.0,0.0
1009,259,2020-03-16 23:47:00,0,2904.0,2015.0,0.694,13.674,635,323,259,64,312,221,91,11,0.0,0.0
1009,260,2020-03-16 23:50:00,0,2908.0,1982.0,0.682,13.653,400,205,144,61,195,140,55,3,0.0,0.0
1009,261,2020-03-16 23:53:00,0,2738.0,1915.0,0.699,12.91,633,302,233,69,331,246,85,24,0.0,0.0
1009,262,2020-03-16 23:56:00,0,2758.0,1871.0,0.679,12.938,490,256,187,69,234,174,60,7,0.0,0.0
1009,263,2020-03-16 23:59:00,0,2763.0,1875.0,0.679,12.963,474,288,208,80,186,136,50,15,0.0,0.0
1009,264,2020-03-17 00:02:00,0,2757.0,1873.0,0.679,12.936,321,183,125,58,138,93,45,7,0.0,0.0
1009,265,2020-03-17 00:05:00,0,2742.0,1860.0,0.678,12.865,541,236,165,71,305,217,88,19,0.0,0.0
1009,266,2020-03-17 00:08:00,0,2760.0,1847.0,0.669,12.921,375,161,100,61,214,142,72,8,0.0,0.0
1009,267,2020-03-17 00:11:00,0,2580.0,1800.0,0.698,12.157,277,119,75,44,158,108,50,7,0.0,0.0
1009,268,2020-03-17 00:14:00,0,2588.0,1781.0,0.688,12.169,318,154,109,45,164,120,44,14,0.0,0.0
1009,269,2020-03-17 00:17:00,0,2522.0,1676.0,0.664,11.792,22,19,2,17,3,2,1,0,0.0,0.0
1009,270,2020-03-17 00:20:00,0,2260.0,1502.0,0.665,10.569,6,3,2,1,3,2,1,0,0.0,0.0
1009,271,2020-03-17 00:23:00,0,2116.0,1388.0,0.656,9.873,36,32,1,31,4,3,1,0,0.0,0.0
1009,272,2020-03-17 00:26:00,0,1950.0,1298.0,0.666,9.121,46,16,9,7,30,12,18,0,0.0,0.0
1009,273,2020-03-17 00:29:00,0,1949.0,1270.0,0.652,9.085,451,239,178,61,212,158,54,7,0.0,0.0
1009,274,2020-03-17 00:32:00,0,2184.0,1483.0,0.679,10.247,735,412,324,88,323,243,80,47,0.0,0.0
1009,275,2020-03-17 00:35:00,0,2504.0,1725.0,0.689,11.775,844,409,329,80,435,335,100,31,0.0,0.0
1009,276,2020-03-17 00:38:00,0,2583.0,1789.0,0.693,12.159,697,333,257,76,364,282,82,22,0.0,0.0
1009,277,2020-03-17 00:41:00,0,2749.0,1837.0,0.668,12.864,293,132,79,53,161,96,65,27,0.0,0.0
1009,278,2020-03-17 00:44:00,0,2754.0,1863.0,0.676,12.914,362,162,124,38,200,142,58,19,0.0,0.0
1009,279,2020-03-17 00:47:00,0,2766.0,1816.0,0.657,12.91,120,44,19,25,76,36,40,3,0.0,0.0
1009,280,2020-03-17 00:50:00,0,2580.0,1789.0,0.694,12.145,245,136,84,52,109,71,38,7,0.0,0.0
1009,281,2020-03-17 00:53:00,0,2498.0,1755.0,0.703,11.788,440,201,144,57,239,180,59,21,0.0,0.0
1009,282,2020-03-17 00:56:00,0,2485.0,1752.0,0.705,11.733,161,74,31,43,87,55,32,7,0.0,0.0
1009,283,2020-03-17 00:59:00,0,2502.0,1757.0,0.702,11.806,338,145,103,42,193,145,48,14,0.0,0.0
1009,284,2020-03-17 01:02:00,0,2506.0,1691.0,0.675,11.745,31,8,2,6,23,10,13,0,0.0,0.0
1009,285,2020-03-17 01:05:00,0,2352.0,1509.0,0.642,10.938,4,0,0,0,4,0,4,0,0.0,0.0
1009,286,2020-03-17 01:08:00,0,2108.0,1396.0,0.662,9.85,7,5,1,4,2,1,1,0,0.0,0.0
1009,287,2020-03-17 01:11:00,0,1941.0,1311.0,0.675,9.099,349,183,133,50,166,125,41,9,0.0,0.0
1009,288,2020-03-17 01:14:00,0,2114.0,1395.0,0.66,9.875,394,218,162,56,176,123,53,26,0.0,0.0
1009,289,2020-03-17 01:17:00,0,2089.0,1488.0,0.712,9.877,716,348,264,84,368,280,88,35,0.0,0.0
1009,290,2020-03-17 01:20:00,0,2345.0,1608.0,0.686,11.02,727,402,329,73,325,243,82,41,0.0,0.0
1009,291,2020-03-17 01:23:00,0,2494.0,1732.0,0.695,11.744,358,146,112,34,212,155,57,4,0.0,0.0
1009,292,2020-03-17 01:26:00,0,2499.0,1754.0,0.702,11.788,289,95,66,29,194,138,56,21,0.0,0.0
1009,293,2020-03-17 01:29:00,0,2506.0,1687.0,0.673,11.744,275,114,70,44,161,98,63,4,0.0,0.0
1009,294,2020-03-17 01:32:00,0,2501.0,1721.0,0.688,11.762,70,43,11,32,27,7,20,3,0.0,0.0
1009,295,2020-03-17 01:35:00,0,2506.0,1685.0,0.672,11.738,118,49,14,35,69,43,26,0,0.0,0.0
1009,296,2020-03-17 01:38:00,0,2419.0,1662.0,0.687,11.371,41,5,0,5,36,19,17,0,0.0,0.0
1009,297,2020-03-17 01:41:00,0,2270.0,1504.0,0.663,10.611,1,0,0,0,1,1,0,0,0.0,0.0
1009,298,2020-03-17 01:44:00,0,2121.0,1359.0,0.641,9.862,206,84,65,19,122,82,40,6,0.0,0.0
1009,299,2020-03-17 01:47:00,0,2122.0,1379.0,0.65,9.888,52,14,5,9,38,9,29,0,0.0,0.0
1009,300,2020-03-17 01:50:00,0,1964.0,1285.0,0.654,9.16,213,91,65,26,122,61,61,2,0.0,0.0
1009,301,2020-03-17 01:53:00,0,1961.0,1251.0,0.638,9.111,27,10,5,5,17,11,6,0,0.0,0.0
1009,302,2020-03-17 01:56:00,0,1786.0,1163.0,0.651,8.327,7,4,0,4,3,1,2,0,0.0,0.0
1009,303,2020-03-17 01:59:00,0,1709.0,1117.0,0.653,7.97,15,8,2,6,7,4,3,0,0.0,0.0
1009,304,2020-03-17 02:02:00,0,1614.0,1100.0,0.682,7.577,45,17,16,1,28,18,10,0,0.0,0.0
1009,305,2020-03-17 02:05:00,0,1541.0,1044.0,0.678,7.226,44,2,1,1,42,10,32,0,0.0,0.0
1009,306,2020-03-17 02:08:00,0,1543.0,1027.0,0.666,7.217,12,0,0,0,12,4,8,0,0.0,0.0
1009,307,2020-03-17 02:11:00,0,1534.0,1049.0,0.684,7.207,20,3,0,3,17,11,6,0,0.0,0.0
1009,308,2020-03-17 02:14:00,0,1535.0,1057.5,0.689,7.2195,18,0,0,0,18,2,16,0,0.0,0.0
1009,309,2020-03-17 02:17:00,0,1536.0,1066.0,0.694,7.232,34,15,0,15,19,7,12,0,0.0,0.0
1009,310,2020-03-17 02:20:00,0,1530.0,1076.0,0.703,7.22,16,2,0,2,14,5,9,0,0.0,0.0
1009,311,2020-03-17 02:23:00,0,1795.0,1147.0,0.639,8.344,27,11,2,9,16,6,10,0,0.0,0.0
1009,312,2020-03-17 02:26:00,0,1799.0,1131.0,0.629,8.339,13,6,0,6,7,2,5,0,0.0,0.0
1009,313,2020-03-17 02:29:00,0,1708.0,1138.0,0.666,7.991,12,3,0,3,9,5,4,0,0.0,0.0
1009,314,2020-03-17 02:32:00,0,1794.0,1145.0,0.639,8.336,14,1,0,1,13,6,7,0,0.0,0.0
1009,315,2020-03-17 02:35:00,0,1797.0,1153.0,0.642,8.358,39,17,0,17,22,10,12,0,0.0,0.0
1009,316,2020-03-17 02:38:00,0,1789.0,1151.0,0.643,8.324,18,0,0,0,18,6,12,0,0.0,0.0
1009,317,2020-03-17 02:41:00,0,1795.0,1138.0,0.634,8.332,5,0,0,0,5,0,5,0,0.0,0.0
1009,318,2020-03-17 02:44:00,0,1798.0,1176.0,0.654,8.387,3,0,0,0,3,0,3,0,0.0,0.0
1009,319,2020-03-17 02:47:00,0,1784.0,1189.0,0.667,8.345,340,147,120,27,193,140,53,17,0.0,0.0
1009,320,2020-03-17 02:50:00,0,2099.0,1472.0,0.701,9.9,504,214,161,53,290,210,80,26,0.0,0.0
1009,321,2020-03-17 02:53:00,0,2415.0,1676.0,0.694,11.37,330,196,164,32,134,85,49,27,0.0,0.0
1009,322,2020-03-17 02:56:00,0,2509.0,1708.0,0.681,11.778,427,231,187,44,196,146,50,21,0.0,0.0
1009,323,2020-03-17 02:59:00,0,2663.0,1810.0,0.68,12.499,190,132,91,41,58,27,31,58,0.0,0.0
1009,324,2020-03-17 03:02:00,0,2764.0,1841.0,0.666,12.931,385,195,146,49,190,125,65,24,0.0,0.0
1009,325,2020-03-17 03:05:00,0,2745.0,1911.0,0.696,12.93,386,175,125,50,211,143,68,29,0.0,0.0
1009,326,2020-03-17 03:08:00,0,2915.0,1989.0,0.682,13.689,322,96,57,39,226,157,69,18,0.0,0.0
1009,327,2020-03-17 03:11:00,0,2748.0,1867.0,0.68,12.893,258,137,93,44,121,88,33,8,0.0,0.0
1009,328,2020-03-17 03:14:00,0,2734.0,1879.0,0.687,12.854,165,70,25,45,95,52,43,1,0.0,0.0
1009,329,2020-03-17 03:17:00,0,2761.0,1842.0,0.667,12.918,213,113,76,37,100,60,40,4,0.0,0.0
1009,330,2020-03-17 03:20:00,0,2503.0,1734.0,0.693,11.782,14,6,1,5,8,2,6,0,0.0,0.0
1009,331,2020-03-17 03:23:00,0,2353.0,1568.0,0.666,11.007,7,7,0,7,0,0,0,0,0.0,0.0
1009,332,2020-03-17 03:26:00,0,2097.0,1458.0,0.695,9.875,174,55,46,9,119,82,37,5,0.0,0.0
1009,333,2020-03-17 03:29:00,0,2102.0,1377.0,0.655,9.809,35,0,0,0,35,1,34,0,0.0,0.0
1009,334,2020-03-17 03:32:00,0,1949.0,1269.0,0.651,9.085,34,0,0,0,34,3,31,0,0.0,0.0
1009,335,2020-03-17 03:35:00,0,1787.0,1187.0,0.665,8.354,62,18,14,4,44,23,21,0,0.0,0.0
1009,336,2020-03-17 03:38:00,0,1801.0,1129.0,0.627,8.346,55,0,0,0,55,0,55,0,0.0,0.0
1009,337,2020-03-17 03:41:00,0,1528.0,1083.0,0.709,7.218,55,1,0,1,54,2,52,0,0.0,0.0
1009,338,2020-03-17 03:44:00,0,1525.0,1076.0,0.706,7.199,322,148,106,42,174,118,56,22,0.0,0.0
1009,339,2020-03-17 03:47:00,0,1948.0,1300.0,0.668,9.114,215,90,46,44,125,70,55,14,0.0,0.0
1009,340,2020-03-17 03:50:00,0,2087.0,1487.0,0.713,9.869,426,216,168,48,210,149,61,22,0.0,0.0
1009,341,2020-03-17 03:53:00,0,2270.0,1531.0,0.674,10.639,169,92,58,34,77,39,38,38,0.0,0.0
1009,342,2020-03-17 03:56:00,0,2362.0,1560.0,0.661,11.034,252,136,96,40,116,51,65,26,0.0,0.0
1009,343,2020-03-17 03:59:00,0,2341.0,1642.0,0.701,11.041,161,60,25,35,101,60,41,11,0.0,0.0
1009,344,2020-03-17 04:02:00,0,2347.0,1583.0,0.674,11.001,3,0,0,0,3,0,3,0,0.0,0.0
1009,345,2020-03-17 04:05:00,0,2100.0,1422.0,0.677,9.849,0,0,0,0,0,0,0,0,0.0,0.0
1009,346,2020-03-17 04:08:00,0,1944.0,1302.0,0.67,9.103,9,0,0,0,9,0,9,0,0.0,0.0
1009,347,2020-03-17 04:11:00,0,1869.0,1211.0,0.648,8.706,7,0,0,0,7,2,5,0,0.0,0.0
1009,348,2020-03-17 04:14:00,0,1790.0,1139.0,0.636,8.314,55,13,10,3,42,16,26,1,0.0,0.0
1009,349,2020-03-17 04:17:00,0,1789.0,1154.0,0.645,8.329,5,0,0,0,5,1,4,0,0.0,0.0
1009,350,2020-03-17 04:20:00,0,1706.0,1113.0,0.652,7.952,25,0,0,0,25,10,15,0,0.0,0.0
1009,351,2020-03-17 04:23:00,0,1524.0,1071.0,0.703,7.19,38,16,5,11,22,9,13,7,0.0,0.0
1009,352,2020-03-17 04:26:00,0,1776.0,1216.0,0.685,8.344,284,161,105,56,123,71,52,30,0.0,0.0
1009,353,2020-03-17 04:29:00,0,2114.0,1397.0,0.661,9.875,206,121,76,45,85,52,33,2,0.0,0.0
1009,354,2020-03-17 04:32:00,0,2103.0,1451.0,0.69,9.894,1,1,0,1,0,0,0,0,0.0,0.0
1009,355,2020-03-17 04:35:00,0,1944.0,1276.0,0.656,9.073,0,0,0,0,0,0,0,0,0.0,0.0
1009,356,2020-03-17 04:38:00,0,1876.0,1222.0,0.651,8.746,14,10,6,4,4,1,3,0,0.0,0.0
1009,357,2020-03-17 04:41:00,0,1791.0,1161.0,0.648,8.342,13,10,1,9,3,0,3,0,0.0,0.0
1009,358,2020-03-17 04:44:00,0,1715.0,1118.0,0.652,7.994,79,34,15,19,45,26,19,8,0.0,0.0
1009,359,2020-03-17 04:47:00,0,1961.0,1246.0,0.635,9.105,364,194,143,51,170,116,54,30,0.0,0.0
1009,360,2020-03-17 04:50:00,0,2186.0,1491.0,0.682,10.263,327,170,129,41,157,109,48,25,0.0,0.0
1009,361,2020-03-17 04:53:00,0,2343.0,1580.0,0.674,10.982,132,52,11,41,80,50,30,2,0.0,0.0
1009,362,2020-03-17 04:56:00,0,2342.0,1567.0,0.669,10.963,193,67,25,42,126,77,49,2,0.0,0.0
1009,363,2020-03-17 04:59:00,0,2355.0,1602.0,0.68,11.054,206,62,37,25,144,96,48,1,0.0,0.0
1009,364,2020-03-17 05:02:00,0,2347.0,1583.0,0.674,11.0,321,165,121,44,156,105,51,8,0.0,0.0
1009,365,2020-03-17 05:05:00,0,2355.0,1576.0,0.669,11.023,94,74,19,55,20,7,13,0,0.0,0.0
1009,366,2020-03-17 05:08:00,0,2346.0,1583.0,0.675,10.995,196,100,69,31,96,57,39,16,0.0,0.0
1009,367,2020-03-17 05:11:00,0,2355.0,1546.0,0.656,10.99,268,117,74,43,151,105,46,11,0.0,0.0
1009,368,2020-03-17 05:14:00,0,2150.5,1432.0,0.6665,10.059,2,0,0,0,2,1,1,0,0.0,0.0
1009,369,2020-03-17 05:17:00,0,1946.0,1318.0,0.677,9.128,14,5,0,5,9,1,8,0,0.0,0.0
1009,370,2020-03-17 05:20:00,0,1869.0,1221.0,0.653,8.717,203,107,73,34,96,57,39,11,0.0,0.0
1009,371,2020-03-17 05:23:00,0,1959.0,1268.0,0.647,9.125,6,1,1,0,5,1,4,0,0.0,0.0
1009,372,2020-03-17 05:26:00,0,1784.0,1182.0,0.662,8.339,38,20,11,9,18,11,7,0,0.0,0.0
1009,373,2020-03-17 05:29:00,0,1861.0,1241.0,0.667,8.707,214,115,84,31,99,60,39,53,0.0,0.0
1009,374,2020-03-17 05:32:00,0,2108.0,1417.0,0.672,9.876,416,223,174,49,193,143,50,52,0.0,0.0
1009,375,2020-03-17 05:35:00,0,2275.0,1514.0,0.666,10.641,327,181,132,49,146,110,36,23,0.0,0.0
1009,376,2020-03-17 05:38:00,0,2348.0,1633.0,0.696,11.058,64,30,19,11,34,7,27,34,0.0,0.0
1009,377,2020-03-17 05:41:00,0,2335.0,1612.0,0.69,10.985,343,173,132,41,170,125,45,19,0.0,0.0
1009,378,2020-03-17 05:44:00,0,2333.0,1655.0,0.709,11.027,323,162,132,30,161,118,43,41,0.0,0.0
1009,379,2020-03-17 05:47:00,0,2335.0,1647.0,0.706,11.024,313,87,54,33,226,161,65,5,0.0,0.0
1009,380,2020-03-17 05:50:00,0,2325.0,1617.0,0.695,10.952,74,31,13,18,43,16,27,15,0.0,0.0
1009,381,2020-03-17 05:53:00,0,2357.0,1564.0,0.664,11.02,69,24,6,18,45,20,25,0,0.0,0.0
1009,382,2020-03-17 05:56:00,0,2352.0,1564.0,0.665,10.999,169,52,25,27,117,62,55,0,0.0,0.0
1009,383,2020-03-17 05:59:00,0,2350.0,1561.0,0.664,10.986,347,156,102,54,191,138,53,1,0.0,0.0
1009,384,2020-03-17 06:02:00,1,2353.0,1573.0,0.669,11.013,334,156,121,35,178,137,41,28,0.0,0.0
1009,385,2020-03-17 06:05:00,1,2173.0,1508.0,0.694,10.232,15,5,1,4,10,4,6,1,0.0,0.0
1009,386,2020-03-17 06:08:00,1,2107.0,1383.0,0.656,9.834,18,12,0,12,6,3,3,0,0.0,0.0
1009,387,2020-03-17 06:11:00,1,1939.0,1303.0,0.672,9.084,111,67,45,22,44,31,13,0,0.0,0.0
1009,388,2020-03-17 06:14:00,1,1938.0,1327.0,0.685,9.105,331,168,120,48,163,116,47,9,0.0,0.0
1009,389,2020-03-17 06:17:00,1,2026.0,1363.0,0.673,9.491,253,145,103,42,108,77,31,25,0.0,0.0
1009,390,2020-03-17 06:20:00,1,2101.0,1425.0,0.678,9.856,321,176,120,56,145,101,44,31,0.0,0.0
1009,391,2020-03-17 06:23:00,1,2187.0,1499.0,0.686,10.276,120,63,44,19,57,19,38,77,0.0,0.0
1009,392,2020-03-17 06:26:00,1,2512.0,1694.0,0.674,11.773,123,70,47,23,53,7,46,118,0.0,0.0
1009,393,2020-03-17 06:29:00,1,2511.0,1695.0,0.675,11.771,309,154,118,36,155,112,43,46,0.0,0.0
1009,394,2020-03-17 06:32:00,1,2362.0,1542.0,0.653,11.013,84,46,29,17,38,10,28,44,0.0,0.0
1009,395,2020-03-17 06:35:00,1,2669.0,1823.0,0.683,12.536,280,112,85,27,168,110,58,53,0.0,0.0
1009,396,2020-03-17 06:38:00,1,2114.0,1436.0,0.679,9.921,211,88,64,24,123,81,42,11,0.0,0.0
1009,397,2020-03-17 06:41:00,1,1965.0,1263.0,0.643,9.14,143,29,14,15,114,60,54,0,0.0,0.0
1009,398,2020-03-17 06:44:00,1,2355.0,1554.0,0.66,10.999,82,56,24,32,26,14,12,0,0.0,0.0
1009,399,2020-03-17 06:47:00,1,2367.0,1539.0,0.65,11.031,11,5,1,4,6,3,3,0,0.0,0.0
1009,400,2020-03-17 06:50:00,1,2101.0,1430.0,0.681,9.863,8,5,0,5,3,1,2,0,0.0,0.0
1009,401,2020-03-17 06:53:00,1,1935.0,1350.0,0.698,9.118,16,0,0,0,16,0,16,0,0.0,0.0
1009,402,2020-03-17 06:56:00,1,1961.0,1256.0,0.64,9.116,12,0,0,0,12,0,12,0,0.0,0.0
1009,403,2020-03-17 06:59:00,1,1787.0,1196.0,0.67,8.366,9,1,1,0,8,0,8,0,0.0,0.0
1009,404,2020-03-17 07:02:00,1,1784.0,1163.0,0.652,8.316,18,6,2,4,12,1,11,0,0.0,0.0
1009,405,2020-03-17 07:05:00,1,1704.0,1147.0,0.673,7.983,23,5,2,3,18,8,10,0,0.0,0.0
1009,406,2020-03-17 07:08:00,1,1800.0,1161.0,0.645,8.379,17,9,3,6,8,1,7,0,0.0,0.0
1009,407,2020-03-17 07:11:00,1,1866.0,1237.0,0.663,8.722,202,95,48,47,107,57,50,13,0.0,0.0
1009,408,2020-03-17 07:14:00,1,2079.0,1485.0,0.714,9.837,212,110,76,34,102,61,41,42,0.0,0.0
1009,409,2020-03-17 07:17:00,1,2317.0,1684.0,0.727,10.994,284,131,102,29,153,103,50,36,0.0,0.0
1009,410,2020-03-17 07:20:00,1,2496.0,1713.0,0.686,11.73,268,140,109,31,128,85,43,50,0.0,0.0
1009,411,2020-03-17 07:23:00,1,2758.0,1845.0,0.669,12.909,217,106,77,29,111,71,40,28,0.0,0.0
1009,412,2020-03-17 07:26:00,1,2565.0,1814.0,0.707,12.114,439,219,170,49,220,159,61,62,0.0,0.0
1009,413,2020-03-17 07:29:00,1,2761.0,1848.0,0.669,12.926,289,132,97,35,157,105,52,63,0.0,0.0
1009,414,2020-03-17 07:32:00,1,2514.0,1696.0,0.675,11.782,283,125,90,35,158,99,59,10,0.0,0.0
1009,415,2020-03-17 07:35:00,1,2267.0,1516.0,0.669,10.609,539,245,178,67,294,211,83,3,0.0,0.0
1009,416,2020-03-17 07:38:00,1,2411.0,1693.0,0.702,11.374,597,355,274,81,242,171,71,14,0.0,0.0
1009,417,2020-03-17 07:41:00,1,2485.0,1791.0,0.721,11.773,505,281,214,67,224,161,63,2,0.0,0.0
1009,418,2020-03-17 07:44:00,1,2351.0,1572.0,0.669,11.002,91,78,31,47,13,4,9,0,0.0,0.0
1009,419,2020-03-17 07:47:00,1,2350.0,1588.0,0.676,11.018,144,122,61,61,22,1,21,0,0.0,0.0
1009,420,2020-03-17 07:50:00,1,2329.0,1652.0,0.709,11.004,110,94,45,49,16,5,11,0,0.0,0.0
1009,421,2020-03-17 07:53:00,1,2181.0,1508.0,0.691,10.264,2,1,0,1,1,0,1,0,0.0,0.0
1009,422,2020-03-17 07:56:00,1,2114.0,1387.0,0.656,9.864,14,14,5,9,0,0,0,0,0.0,0.0
1009,423,2020-03-17 07:59:00,1,1943.0,1335.0,0.687,9.133,39,37,20,17,2,0,2,0,0.0,0.0
1009,424,2020-03-17 08:02:00,1,1957.0,1246.0,0.637,9.092,38,29,10,19,9,0,9,0,0.0,0.0
1009,425,2020-03-17 08:05:00,1,1794.0,1157.0,0.645,8.35,21,18,4,14,3,0,3,0,0.0,0.0
1009,426,2020-03-17 08:08:00,1,1526.0,1076.0,0.705,7.205,13,13,1,12,0,0,0,0,0.0,0.0
1009,427,2020-03-17 08:11:00,1,1522.0,1100.0,0.722,7.215,119,101,55,46,18,3,15,0,0.0,0.0
1009,428,2020-03-17 08:14:00,1,1805.0,1278.5,0.71,8.5285,114,82,37,45,32,12,20,6,0.0,0.0
1009,429,2020-03-17 08:17:00,1,2088.0,1457.0,0.698,9.842,229,150,109,41,79,46,33,53,0.0,0.0
1009,430,2020-03-17 08:20:00,1,2329.0,1651.0,0.709,11.004,195,124,82,42,71,40,31,42,0.0,0.0
1009,431,2020-03-17 08:23:00,1,2491.0,1785.0,0.717,11.79,308,149,111,38,159,119,40,57,0.0,0.0
1009,432,2020-03-17 08:26:00,1,2509.0,1716.0,0.684,11.787,280,187,137,50,93,55,38,40,0.0,0.0
1009,433,2020-03-17 08:29:00,1,2501.0,1709.0,0.683,11.747,438,268,204,64,170,111,59,10,0.0,0.0
1009,434,2020-03-17 08:32:00,1,2344.0,1612.0,0.688,11.02,378,219,148,71,159,116,43,7,0.0,0.0
1009,435,2020-03-17 08:35:00,1,2500.0,1727.0,0.691,11.762,252,123,80,43,129,83,46,8,0.0,0.0
1009,436,2020-03-17 08:38:00,1,2496.0,1776.0,0.712,11.8,447,226,180,46,221,151,70,1,0.0,0.0
1009,437,2020-03-17 08:41:00,1,2500.0,1719.0,0.688,11.752,335,138,89,49,197,131,66,6,0.0,0.0
1009,438,2020-03-17 08:44:00,1,2331.0,1652.0,0.709,11.013,491,287,225,62,204,140,64,6,0.0,0.0
1009,439,2020-03-17 08:47:00,1,2337.0,1592.0,0.681,10.972,182,102,83,19,80,45,35,4,0.0,0.0
1009,440,2020-03-17 08:50:00,1,2346.0,1596.0,0.68,11.012,124,107,62,45,17,0,17,3,0.0,0.0
1009,441,2020-03-17 08:53:00,1,2343.0,1614.0,0.689,11.017,53,20,8,12,33,8,25,1,0.0,0.0
1009,442,2020-03-17 08:56:00,1,2119.0,1424.0,0.672,9.925,1,0,0,0,1,0,1,0,0.0,0.0
1009,443,2020-03-17 08:59:00,1,1942.0,1337.0,0.689,9.132,7,0,0,0,7,0,7,0,0.0,0.0
1009,444,2020-03-17 09:02:00,1,1958.0,1270.0,0.648,9.121,2,0,0,0,2,0,2,0,0.0,0.0
1009,445,2020-03-17 09:05:00,1,1787.0,1191.0,0.666,8.36,0,0,0,0,0,0,0,0,0.0,0.0
1009,446,2020-03-17 09:08:00,1,1523.0,1097.0,0.72,7.216,2,0,0,0,2,0,2,0,0.0,0.0
1009,447,2020-03-17 09:11:00,1,1544.0,1041.0,0.675,7.235,0,0,0,0,0,0,0,0,0.0,0.0
1009,448,2020-03-17 09:14:00,1,1459.0,983.0,0.674,6.835,20,16,8,8,4,1,3,0,0.0,0.0
1009,449,2020-03-17 09:17:00,1,1526.0,1087.0,0.712,7.216,31,20,12,8,11,4,7,3,0.0,0.0
1009,450,2020-03-17 09:20:00,1,1777.0,1220.0,0.686,8.354,181,118,80,38,63,37,26,26,0.0,0.0
1009,451,2020-03-17 09:23:00,1,2100.0,1447.0,0.689,9.877,190,142,72,70,48,8,40,96,0.0,0.0
1009,452,2020-03-17 09:26:00,1,2320.0,1671.0,0.72,10.99,207,116,57,59,91,40,51,70,0.0,0.0
1009,453,2020-03-17 09:29:00,1,2095.0,1446.0,0.69,9.857,420,250,198,52,170,110,60,26,0.0,0.0
1009,454,2020-03-17 09:32:00,1,2105.0,1451.0,0.689,9.9,103,53,40,13,50,33,17,1,0.0,0.0
1009,455,2020-03-17 09:35:00,1,2480.0,1799.0,0.726,11.764,77,53,26,27,24,15,9,0,0.0,0.0
1009,456,2020-03-17 09:38:00,1,2342.0,1603.0,0.685,11.001,0,0,0,0,0,0,0,0,0.0,0.0
1009,457,2020-03-17 09:41:00,1,2112.0,1413.0,0.669,9.886,26,16,0,16,10,0,10,0,0.0,0.0
1009,458,2020-03-17 09:44:00,1,1954.0,1276.0,0.653,9.11,58,58,0,58,0,0,0,0,0.0,0.0
1009,459,2020-03-17 09:47:00,1,1789.0,1167.0,0.652,8.341,68,58,11,47,10,0,10,0,0.0,0.0
1009,460,2020-03-17 09:50:00,1,1698.0,1133.0,0.667,7.944,6,6,3,3,0,0,0,0,0.0,0.0
1009,461,2020-03-17 09:53:00,1,1527.0,1085.0,0.71,7.216,11,11,3,8,0,0,0,0,0.0,0.0
1009,462,2020-03-17 09:56:00,1,1536.0,1039.0,0.677,7.204,15,12,0,12,3,1,2,0,0.0,0.0
1009,463,2020-03-17 09:59:00,1,1529.0,1040.0,0.68,7.177,6,6,0,6,0,0,0,0,0.0,0.0
1009,464,2020-03-17 10:02:00,1,1539.0,1031.0,0.67,7.204,4,4,0,4,0,0,0,0,0.0,0.0
1009,465,2020-03-17 10:05:00,1,1538.0,1053.0,0.684,7.226,33,25,13,12,8,0,8,0,0.0,0.0
1009,466,2020-03-17 10:08:00,1,1521.0,1105.0,0.726,7.217,17,15,4,11,2,0,2,0,0.0,0.0
1009,467,2020-03-17 10:11:00,1,1605.0,1109.0,0.691,7.551,8,5,3,2,3,0,3,0,0.0,0.0
1009,468,2020-03-17 10:14:00,1,1619.0,1122.0,0.693,7.62,8,8,2,6,0,0,0,0,0.0,0.0
1009,469,2020-03-17 10:17:00,1,1528.0,1098.0,0.718,7.237,0,0,0,0,0,0,0,0,0.0,0.0
1009,470,2020-03-17 10:20:00,1,1704.0,1159.0,0.68,7.996,103,67,36,31,36,9,27,17,0.0,0.0
1009,471,2020-03-17 10:23:00,1,1865.0,1261.0,0.676,8.746,84,72,38,34,12,0,12,6,0.0,0.0
1009,472,2020-03-17 10:26:00,1,1919.0,1388.0,0.723,9.098,286,157,118,39,129,81,48,15,0.0,0.0
1009,473,2020-03-17 10:29:00,1,2097.0,1475.0,0.703,9.896,206,132,101,31,74,50,24,26,0.0,0.0
1009,474,2020-03-17 10:32:00,1,2092.0,1472.0,0.704,9.873,485,285,214,71,200,143,57,4,0.0,0.0
1009,475,2020-03-17 10:35:00,1,2089.0,1504.0,0.72,9.894,848,409,337,72,439,337,102,11,0.0,0.0
1009,476,2020-03-17 10:38:00,1,2084.0,1507.0,0.723,9.879,780,307,249,58,473,386,87,15,0.0,0.0
1009,477,2020-03-17 10:41:00,1,2094.0,1474.0,0.704,9.884,369,205,143,62,164,116,48,11,0.0,0.0
1009,478,2020-03-17 10:44:00,1,2099.0,1452.0,0.692,9.876,82,40,5,35,42,4,38,3,0.0,0.0
1009,479,2020-03-17 10:47:00,1,2099.0,1444.0,0.688,9.868,68,39,2,37,29,1,28,5,0.0,0.0
1009,480,2020-03-17 10:50:00,1,2101.0,1454.0,0.692,9.886,45,35,0,35,10,0,10,0,0.0,0.0
1009,481,2020-03-17 10:53:00,1,1934.0,1354.0,0.7,9.118,0,0,0,0,0,0,0,0,0.0,0.0
1009,482,2020-03-17 10:56:00,1,1781.0,1211.0,0.68,8.357,5,4,1,3,1,1,0,0,0.0,0.0
1009,483,2020-03-17 10:59:00,1,1797.0,1154.0,0.642,8.358,1,1,0,1,0,0,0,0,0.0,0.0
1009,484,2020-03-17 11:02:00,1,1526.0,1072.0,0.703,7.201,14,14,5,9,0,0,0,0,0.0,0.0
1009,485,2020-03-17 11:05:00,1,1525.0,1098.0,0.72,7.224,36,35,11,24,1,0,1,0,0.0,0.0
1009,486,2020-03-17 11:08:00,1,1609.0,1120.0,0.696,7.581,29,29,17,12,0,0,0,0,0.0,0.0
1009,487,2020-03-17 11:11:00,1,1526.0,1086.0,0.712,7.215,6,6,1,5,0,0,0,0,0.0,0.0
1009,488,2020-03-17 11:14:00,1,1491.5,1031.5,0.691,7.0185,1,1,1,0,0,0,0,0,0.0,0.0
1009,489,2020-03-17 11:17:00,1,1457.0,977.0,0.67,6.822,3,3,0,3,0,0,0,0,0.0,0.0
1009,490,2020-03-17 11:20:00,1,1468.0,953.0,0.649,6.839,24,19,1,18,5,0,5,0,0.0,0.0
1009,491,2020-03-17 11:23:00,1,1460.0,981.0,0.672,6.841,22,13,0,13,9,0,9,0,0.0,0.0
1009,492,2020-03-17 11:26:00,1,1554.0,986.0,0.635,7.213,7,5,0,5,2,0,2,0,0.0,0.0
1009,493,2020-03-17 11:29:00,1,1546.0,1009.0,0.653,7.207,9,5,1,4,4,0,4,0,0.0,0.0
1009,494,2020-03-17 11:32:00,1,1550.0,1004.0,0.648,7.218,7,5,0,5,2,0,2,0,0.0,0.0
1009,495,2020-03-17 11:35:00,1,1551.0,1009.0,0.651,7.228,17,10,2,8,7,0,7,0,0.0,0.0
1009,496,2020-03-17 11:38:00,1,1550.0,1004.0,0.648,7.219,13,13,0,13,0,0,0,0,0.0,0.0
1009,497,2020-03-17 11:41:00,1,1454.0,986.0,0.678,6.82,16,12,2,10,4,2,2,0,0.0,0.0
1009,498,2020-03-17 11:44:00,1,1552.0,1001.0,0.645,7.222,30,22,10,12,8,3,5,4,0.0,0.0
1009,499,2020-03-17 11:47:00,1,1539.0,1033.0,0.671,7.209,8,6,0,6,2,0,2,0,0.0,0.0
1009,500,2020-03-17 11:50:00,1,1541.0,1010.0,0.655,7.191,10,6,3,3,4,0,4,0,0.0,0.0
1009,501,2020-03-17 11:53:00,1,1462.0,972.0,0.665,6.838,16,16,1,15,0,0,0,0,0.0,0.0
1009,502,2020-03-17 11:56:00,1,1378.0,920.0,0.668,6.449,19,9,3,6,10,0,10,0,0.0,0.0
1009,503,2020-03-17 11:59:00,1,1374.0,939.0,0.684,6.453,65,58,34,24,7,1,6,2,0.0,0.0
1009,504,2020-03-17 12:02:00,1,1542.0,1023.0,0.664,7.208,42,42,26,16,0,0,0,0,0.0,0.0
1009,505,2020-03-17 12:05:00,1,1701.0,1168.0,0.687,7.998,242,164,107,57,78,57,21,22,0.0,0.0
1009,506,2020-03-17 12:08:00,1,1860.0,1273.0,0.684,8.739,19,0,0,0,19,0,19,0,0.0,0.0
1009,507,2020-03-17 12:11:00,1,1777.0,1191.0,0.67,8.322,4,1,0,1,3,0,3,0,0.0,0.0
1009,508,2020-03-17 12:14:00,1,1519.0,1103.0,0.726,7.206,2,2,0,2,0,0,0,0,0.0,0.0
1009,509,2020-03-17 12:17:00,1,1522.0,1074.0,0.706,7.185,0,0,0,0,0,0,0,0,0.0,0.0
1009,510,2020-03-17 12:20:00,1,1534.0,1040.0,0.678,7.194,8,8,0,8,0,0,0,0,0.0,0.0
1009,511,2020-03-17 12:23:00,1,1546.0,1015.0,0.657,7.214,51,37,15,22,14,9,5,0,0.0,0.0
1009,512,2020-03-17 12:26:00,1,1530.0,1049.0,0.686,7.192,4,4,0,4,0,0,0,0,0.0,0.0
1009,513,2020-03-17 12:29:00,1,1547.0,1028.0,0.664,7.234,0,0,0,0,0,0,0,0,0.0,0.0
1009,514,2020-03-17 12:32:00,1,1552.0,1010.0,0.651,7.232,0,0,0,0,0,0,0,0,0.0,0.0
1009,515,2020-03-17 12:35:00,1,1542.0,1035.0,0.671,7.223,8,7,1,6,1,0,1,0,0.0,0.0
1009,516,2020-03-17 12:38:00,1,1538.0,1046.0,0.68,7.217,15,15,2,13,0,0,0,0,0.0,0.0
1009,517,2020-03-17 12:41:00,1,1546.0,1011.0,0.654,7.21,5,5,1,4,0,0,0,0,0.0,0.0
1009,518,2020-03-17 12:44:00,1,1542.0,1017.0,0.66,7.202,95,40,27,13,55,32,23,0,0.0,0.0
1009,519,2020-03-17 12:47:00,1,1791.0,1187.0,0.663,8.371,167,74,38,36,93,59,34,20,0.0,0.0
1009,520,2020-03-17 12:50:00,1,1943.0,1289.0,0.664,9.084,49,33,15,18,16,4,12,10,0.0,0.0
1009,521,2020-03-17 12:53:00,1,1931.0,1349.0,0.698,9.101,229,98,63,35,131,77,54,41,0.0,0.0
1009,522,2020-03-17 12:56:00,1,2008.0,1411.0,0.703,9.474,624,302,239,63,322,240,82,11,0.0,0.0
1009,523,2020-03-17 12:59:00,1,2104.0,1447.0,0.688,9.892,405,198,145,53,207,175,32,11,0.0,0.0
1009,524,2020-03-17 13:02:00,1,2100.0,1449.0,0.69,9.88,211,125,87,38,86,54,32,63,0.0,0.0
1009,525,2020-03-17 13:05:00,1,2019.0,1372.0,0.68,9.474,59,36,16,20,23,5,18,22,0.0,0.0
1009,526,2020-03-17 13:08:00,1,2104.0,1431.0,0.68,9.874,35,34,10,24,1,1,0,0,0.0,0.0
1009,527,2020-03-17 13:11:00,1,1931.0,1347.0,0.697,9.1,5,5,1,4,0,0,0,0,0.0,0.0
1009,528,2020-03-17 13:14:00,1,1962.0,1234.0,0.629,9.098,8,8,4,4,0,0,0,0,0.0,0.0
1009,529,2020-03-17 13:17:00,1,1790.0,1145.0,0.64,8.322,0,0,0,0,0,0,0,0,0.0,0.0
1009,530,2020-03-17 13:20:00,1,1540.0,1053.0,0.684,7.235,71,61,32,29,10,2,8,2,0.0,0.0
1009,531,2020-03-17 13:23:00,1,1530.0,1092.0,0.714,7.237,1,1,0,1,0,0,0,0,0.0,0.0
1009,532,2020-03-17 13:26:00,1,1525.0,1091.0,0.716,7.215,0,0,0,0,0,0,0,0,0.0,0.0
1009,533,2020-03-17 13:29:00,1,1545.0,1033.0,0.669,7.231,1,0,0,0,1,0,1,0,0.0,0.0
1009,534,2020-03-17 13:32:00,1,1544.0,1015.0,0.657,7.208,0,0,0,0,0,0,0,0,0.0,0.0
1009,535,2020-03-17 13:35:00,1,1536.0,1013.0,0.66,7.173,14,13,0,13,1,0,1,0,0.0,0.0
1009,536,2020-03-17 13:38:00,1,1533.0,1046.0,0.682,7.198,5,5,0,5,0,0,0,0,0.0,0.0
1009,537,2020-03-17 13:41:00,1,1537.0,1043.0,0.679,7.211,5,5,0,5,0,0,0,0,0.0,0.0
1009,538,2020-03-17 13:44:00,1,1544.0,1036.0,0.671,7.23,5,3,0,3,2,0,2,0,0.0,0.0
1009,539,2020-03-17 13:47:00,1,1544.0,1001.0,0.648,7.194,10,9,2,7,1,0,1,0,0.0,0.0
1009,540,2020-03-17 13:50:00,1,1368.0,953.0,0.697,6.445,19,13,4,9,6,1,5,0,0.0,0.0
1009,541,2020-03-17 13:53:00,1,1557.0,985.0,0.633,7.224,2,2,1,1,0,0,0,0,0.0,0.0
1009,542,2020-03-17 13:56:00,1,1458.0,971.0,0.666,6.82,10,9,2,7,1,0,1,0,0.0,0.0
1009,543,2020-03-17 13:59:00,1,1466.0,979.0,0.668,6.86,9,9,2,7,0,0,0,0,0.0,0.0
1009,544,2020-03-17 14:02:00,1,1461.0,972.0,0.665,6.834,40,39,28,11,1,0,1,0,0.0,0.0
1009,545,2020-03-17 14:05:00,1,1457.0,984.0,0.675,6.829,22,20,13,7,2,0,2,0,0.0,0.0
1009,546,2020-03-17 14:08:00,1,1530.0,1044.0,0.682,7.184,10,10,2,8,0,0,0,0,0.0,0.0
1009,547,2020-03-17 14:11:00,1,1533.0,1026.0,0.669,7.177,14,12,1,11,2,0,2,0,0.0,0.0
1009,548,2020-03-17 14:14:00,1,1529.5,1050.5,0.687,7.19,54,45,26,19,9,2,7,0,0.0,0.0
1009,549,2020-03-17 14:17:00,1,1526.0,1075.0,0.705,7.203,2,2,1,1,0,0,0,0,0.0,0.0
1009,550,2020-03-17 14:20:00,1,1538.0,1057.0,0.687,7.232,19,13,6,7,6,3,3,0,0.0,0.0
1009,551,2020-03-17 14:23:00,1,1547.0,1024.0,0.662,7.228,1,0,0,0,1,0,1,0,0.0,0.0
1009,552,2020-03-17 14:26:00,1,1448.0,1002.0,0.692,6.816,10,1,0,1,9,0,9,0,0.0,0.0
1009,553,2020-03-17 14:29:00,1,1546.0,1008.0,0.652,7.209,35,33,0,33,2,0,2,0,0.0,0.0
1009,554,2020-03-17 14:32:00,1,1543.0,1012.0,0.655,7.201,12,6,0,6,6,0,6,0,0.0,0.0
1009,555,2020-03-17 14:35:00,1,1539.0,1038.0,0.675,7.212,29,27,1,26,2,0,2,0,0.0,0.0
1009,556,2020-03-17 14:38:00,1,1533.0,1061.0,0.692,7.213,53,41,6,35,12,0,12,0,0.0,0.0
1009,557,2020-03-17 14:41:00,1,1529.0,1054.0,0.689,7.193,3,1,0,1,2,0,2,0,0.0,0.0
1009,558,2020-03-17 14:44:00,1,1550.0,1021.0,0.659,7.236,10,8,1,7,2,0,2,0,0.0,0.0
1009,559,2020-03-17 14:47:00,1,1467.0,968.0,0.66,6.852,12,7,3,4,5,0,5,0,0.0,0.0
1009,560,2020-03-17 14:50:00,1,1462.0,976.0,0.668,6.841,0,0,0,0,0,0,0,0,0.0,0.0
1009,561,2020-03-17 14:53:00,1,1458.0,973.0,0.667,6.823,0,0,0,0,0,0,0,0,0.0,0.0
1009,562,2020-03-17 14:56:00,1,1552.0,978.0,0.63,7.199,22,20,13,7,2,1,1,5,0.0,0.0
1009,563,2020-03-17 14:59:00,1,1693.0,1159.0,0.685,7.953,339,172,124,48,167,138,29,32,0.0,0.0
1009,564,2020-03-17 15:02:00,1,1935.0,1380.0,0.713,9.152,198,110,73,37,88,66,22,33,0.0,0.0
1009,565,2020-03-17 15:05:00,1,2017.0,1415.0,0.702,9.514,236,169,114,55,67,34,33,39,0.0,0.0
1009,566,2020-03-17 15:08:00,1,2082.0,1476.0,0.709,9.836,566,298,240,58,268,203,65,15,0.0,0.0
1009,567,2020-03-17 15:11:00,1,2084.0,1472.0,0.706,9.842,379,210,175,35,169,129,40,22,0.0,0.0
1009,568,2020-03-17 15:14:00,1,2095.0,1475.0,0.704,9.887,345,207,153,54,138,99,39,13,0.0,0.0
1009,569,2020-03-17 15:17:00,1,2107.0,1447.0,0.686,9.905,243,129,110,19,114,85,29,22,0.0,0.0
1009,570,2020-03-17 15:20:00,1,2088.0,1483.0,0.71,9.869,40,16,9,7,24,6,18,15,0.0,0.0
1009,571,2020-03-17 15:23:00,1,2085.0,1492.0,0.716,9.868,86,60,30,30,26,5,21,8,0.0,0.0
1009,572,2020-03-17 15:26:00,1,2171.0,1509.0,0.695,10.224,44,21,6,15,23,4,19,3,0.0,0.0
1009,573,2020-03-17 15:29:00,1,2097.0,1463.0,0.698,9.881,0,0,0,0,0,0,0,0,0.0,0.0
1009,574,2020-03-17 15:32:00,1,1934.0,1314.0,0.679,9.077,1,1,1,0,0,0,0,0,0.0,0.0
1009,575,2020-03-17 15:35:00,1,1780.0,1205.0,0.677,8.348,0,0,0,0,0,0,0,0,0.0,0.0
1009,576,2020-03-17 15:38:00,1,1609.0,1126.0,0.7,7.585,0,0,0,0,0,0,0,0,0.0,0.0
1009,577,2020-03-17 15:41:00,1,1526.0,1033.0,0.677,7.157,0,0,0,0,0,0,0,0,0.0,0.0
1009,578,2020-03-17 15:44:00,1,1544.0,1027.0,0.665,7.219,0,0,0,0,0,0,0,0,0.0,0.0
1009,579,2020-03-17 15:47:00,1,1545.0,1020.0,0.66,7.218,3,3,0,3,0,0,0,0,0.0,0.0
1009,580,2020-03-17 15:50:00,1,1552.0,994.0,0.641,7.215,1,1,0,1,0,0,0,0,0.0,0.0
1009,581,2020-03-17 15:53:00,1,1546.0,1001.0,0.647,7.201,23,19,11,8,4,2,2,0,0.0,0.0
1009,582,2020-03-17 15:56:00,1,1542.0,1002.0,0.65,7.185,0,0,0,0,0,0,0,0,0.0,0.0
1009,583,2020-03-17 15:59:00,1,1548.0,982.0,0.634,7.187,6,6,1,5,0,0,0,0,0.0,0.0
1009,584,2020-03-17 16:02:00,1,1556.0,987.0,0.634,7.224,1,1,1,0,0,0,0,0,0.0,0.0
1009,585,2020-03-17 16:05:00,1,1551.0,999.0,0.644,7.219,0,0,0,0,0,0,0,0,0.0,0.0
1009,586,2020-03-17 16:08:00,1,1550.0,993.0,0.641,7.208,10,10,5,5,0,0,0,0,0.01,0.0
1009,587,2020-03-17 16:11:00,1,1548.0,1008.0,0.652,7.215,8,8,7,1,0,0,0,0,0.0,0.0
1009,588,2020-03-17 16:14:00,1,1534.0,1070.0,0.698,7.228,1,1,1,0,0,0,0,0,0.0,0.0
1009,589,2020-03-17 16:17:00,1,1531.0,1082.0,0.707,7.232,9,7,3,4,2,1,1,0,0.0,0.0
1009,590,2020-03-17 16:20:00,1,1529.0,1069.0,0.699,7.207,0,0,0,0,0,0,0,0,0.0,0.0
1009,591,2020-03-17 16:23:00,1,1541.0,1016.0,0.659,7.198,13,11,4,7,2,0,2,0,0.01,0.0
1009,592,2020-03-17 16:26:00,1,1536.0,1037.0,0.675,7.2,16,9,1,8,7,0,7,1,0.0,0.0
1009,593,2020-03-17 16:29:00,1,1617.0,1140.0,0.705,7.632,47,25,19,6,22,12,10,0,0.01,0.0
1009,594,2020-03-17 16:32:00,1,1611.0,1122.0,0.696,7.589,0,0,0,0,0,0,0,0,0.0,0.0
1009,595,2020-03-17 16:35:00,1,1521.0,1078.0,0.709,7.186,0,0,0,0,0,0,0,0,0.0,0.0
1009,596,2020-03-17 16:38:00,1,1532.0,1060.0,0.692,7.209,0,0,0,0,0,0,0,0,0.0,0.0
1009,597,2020-03-17 16:41:00,1,1531.0,1095.0,0.715,7.246,2,0,0,0,2,0,2,0,0.0,0.0
1009,598,2020-03-17 16:44:00,1,1525.0,1073.0,0.704,7.197,1,0,0,0,1,0,1,0,0.0,0.0
1009,599,2020-03-17 16:47:00,1,1519.0,1080.0,0.711,7.181,3,0,0,0,3,0,3,0,0.0,0.0
1009,600,2020-03-17 16:50:00,1,1521.0,1087.0,0.714,7.197,0,0,0,0,0,0,0,0,0.0,0.0
1009,601,2020-03-17 16:53:00,1,1530.0,1067.0,0.697,7.21,5,3,1,2,2,0,2,0,0.0,0.0
1009,602,2020-03-17 16:56:00,1,1546.0,1022.0,0.661,7.223,1,1,1,0,0,0,0,0,0.0,0.0
1009,603,2020-03-17 16:59:00,1,1546.0,1015.0,0.657,7.217,2,2,1,1,0,0,0,0,0.0,0.0
1009,604,2020-03-17 17:02:00,1,1546.0,1025.0,0.663,7.225,27,24,8,16,3,3,0,0,0.0,0.0
1009,605,2020-03-17 17:05:00,1,1533.0,1062.0,0.693,7.218,114,94,45,49,20,7,13,7,0.0,0.0
1009,606,2020-03-17 17:08:00,1,1773.0,1239.0,0.699,8.359,238,153,103,50,85,45,40,15,0.0,0.0
1009,607,2020-03-17 17:11:00,1,1942.0,1340.0,0.69,9.136,51,25,2,23,26,5,21,1,0.0,0.0
1009,608,2020-03-17 17:14:00,1,2026.0,1382.5,0.6825,9.5145,75,42,17,25,33,12,21,2,0.0,0.0
1009,609,2020-03-17 17:17:00,1,2110.0,1425.0,0.675,9.893,106,55,19,36,51,18,33,1,0.0,0.0
1009,610,2020-03-17 17:20:00,1,2112.0,1426.0,0.675,9.902,16,3,0,3,13,0,13,0,0.0,0.0
1009,611,2020-03-17 17:23:00,1,1950.0,1300.0,0.667,9.124,9,3,0,3,6,0,6,0,0.0,0.0
1009,612,2020-03-17 17:26:00,1,1776.0,1232.0,0.694,8.362,0,0,0,0,0,0,0,0,0.0,0.0
1009,613,2020-03-17 17:29:00,1,1610.0,1138.0,0.707,7.603,0,0,0,0,0,0,0,0,0.0,0.0
1009,614,2020-03-17 17:32:00,1,1526.0,1103.0,0.723,7.233,3,0,0,0,3,1,2,0,0.0,0.0
1009,615,2020-03-17 17:35:00,1,1524.0,1104.0,0.724,7.226,16,3,0,3,13,8,5,0,0.0,0.0
1009,616,2020-03-17 17:38:00,1,1517.0,1107.0,0.73,7.203,4,3,0,3,1,0,1,0,0.0,0.0
1009,617,2020-03-17 17:41:00,1,1614.0,1129.0,0.7,7.609,9,9,2,7,0,0,0,0,0.0,0.0
1009,618,2020-03-17 17:44:00,1,1697.0,1141.0,0.672,7.95,15,15,0,15,0,0,0,0,0.0,0.0
1009,619,2020-03-17 17:47:00,1,1603.0,1133.0,0.707,7.57,8,8,0,8,0,0,0,0,0.0,0.0
1009,620,2020-03-17 17:50:00,1,1607.0,1131.0,0.704,7.585,56,36,25,11,20,8,12,0,0.0,0.0
1009,621,2020-03-17 17:53:00,1,1700.0,1159.0,0.681,7.983,2,1,1,0,1,0,1,0,0.0,0.0
1009,622,2020-03-17 17:56:00,1,1702.0,1151.0,0.676,7.982,0,0,0,0,0,0,0,0,0.0,0.0
1009,623,2020-03-17 17:59:00,1,1705.0,1153.0,0.676,7.993,0,0,0,0,0,0,0,0,0.0,0.0
1009,624,2020-03-17 18:02:00,0,1798.0,1164.0,0.647,8.372,37,11,4,7,26,16,10,2,0.0,0.0
1009,625,2020-03-17 18:05:00,0,1926.0,1367.0,0.71,9.103,509,272,218,54,237,177,60,72,0.0,0.0
1009,626,2020-03-17 18:08:00,0,2336.0,1598.0,0.684,10.972,357,227,169,58,130,94,36,88,0.0,0.0
1009,627,2020-03-17 18:11:00,0,2334.0,1598.0,0.685,10.964,349,217,152,65,132,69,63,77,0.0,0.0
1009,628,2020-03-17 18:14:00,0,2110.0,1388.0,0.658,9.85,334,174,124,50,160,102,58,48,0.13,0.0
1009,629,2020-03-17 18:17:00,0,2504.0,1739.0,0.695,11.79,396,244,181,63,152,90,62,94,0.07,0.0
1009,630,2020-03-17 18:20:00,0,2027.0,1385.0,0.683,9.521,263,144,100,44,119,79,40,42,0.0,0.0
1009,631,2020-03-17 18:23:00,0,1539.0,1014.0,0.659,7.188,145,38,4,34,107,35,72,1,0.0,0.0
1009,632,2020-03-17 18:26:00,0,2335.0,1634.0,0.7,11.009,216,98,51,47,118,73,45,0,0.0,0.0
1009,633,2020-03-17 18:29:00,0,2503.0,1713.0,0.684,11.759,135,37,13,24,98,56,42,0,0.0,0.0
1009,634,2020-03-17 18:32:00,0,2326.0,1651.0,0.71,10.991,30,3,1,2,27,0,27,0,0.0,0.0
1009,635,2020-03-17 18:35:00,0,2267.0,1530.0,0.675,10.628,17,0,0,0,17,2,15,0,0.0,0.0
1009,636,2020-03-17 18:38:00,0,2101.0,1462.0,0.696,9.896,10,0,0,0,10,0,10,0,0.0,0.0
1009,637,2020-03-17 18:41:00,0,2016.0,1365.0,0.677,9.453,11,4,2,2,7,2,5,0,0.0,0.0
1009,638,2020-03-17 18:44:00,0,1942.0,1304.0,0.671,9.097,290,112,78,34,178,122,56,14,0.0,0.0
1009,639,2020-03-17 18:47:00,0,2177.0,1514.0,0.695,10.254,237,44,13,31,193,120,73,9,0.0,0.0
1009,640,2020-03-17 18:50:00,0,2332.0,1645.0,0.705,11.011,388,167,111,56,221,145,76,23,0.0,0.0
1009,641,2020-03-17 18:53:00,0,2495.0,1722.0,0.69,11.738,367,180,131,49,187,128,59,76,0.0,0.0
1009,642,2020-03-17 18:56:00,0,2340.0,1590.0,0.68,10.979,437,237,178,59,200,145,55,73,0.0,0.0
1009,643,2020-03-17 18:59:00,0,2480.0,1765.0,0.711,11.726,129,63,39,24,66,0,66,94,0.0,0.0
1009,644,2020-03-17 19:02:00,0,2487.0,1762.0,0.709,11.749,87,45,6,39,42,3,39,81,0.0,0.0
1009,645,2020-03-17 19:05:00,0,2501.0,1748.0,0.699,11.788,250,141,79,62,109,69,40,103,0.0,0.0
1009,646,2020-03-17 19:08:00,0,2763.0,1853.0,0.671,12.94,144,66,31,35,78,9,69,127,0.0,0.0
1009,647,2020-03-17 19:11:00,0,2899.0,1957.0,0.675,13.588,138,68,37,31,70,0,70,110,0.0,0.0
1009,648,2020-03-17 19:14:00,0,2493.0,1733.0,0.695,11.741,374,174,134,40,200,134,66,99,0.0,0.0
1009,649,2020-03-17 19:17:00,0,2276.0,1546.0,0.679,10.677,440,231,174,57,209,167,42,162,0.0,0.0
1009,650,2020-03-17 19:20:00,0,2913.0,1951.0,0.67,13.638,178,101,64,37,77,26,51,161,0.0,0.0
1009,651,2020-03-17 19:23:00,0,2650.0,1890.0,0.713,12.532,434,197,156,41,237,181,56,113,0.0,0.0
1009,652,2020-03-17 19:26:00,0,2485.0,1768.0,0.711,11.75,178,87,62,25,91,32,59,160,0.0,0.0
1009,653,2020-03-17 19:29:00,0,2740.0,1881.0,0.687,12.877,167,80,52,28,87,33,54,92,0.0,0.0
1009,654,2020-03-17 19:32:00,0,2328.0,1622.0,0.697,10.967,337,170,140,30,167,116,51,102,0.0,0.0
1009,655,2020-03-17 19:35:00,0,2490.0,1757.0,0.705,11.756,261,127,89,38,134,100,34,25,0.0,0.0
1009,656,2020-03-17 19:38:00,0,1548.0,965.0,0.623,7.169,178,81,39,42,97,59,38,10,0.0,0.0
1009,657,2020-03-17 19:41:00,0,1371.0,921.0,0.672,6.422,57,37,12,25,20,11,9,0,0.0,0.0
1009,658,2020-03-17 19:44:00,0,1384.0,923.0,0.667,6.473,11,11,0,11,0,0,0,0,0.0,0.0
1009,659,2020-03-17 19:47:00,0,1386.0,897.0,0.647,6.455,25,17,1,16,8,2,6,0,0.0,0.0
1009,660,2020-03-17 19:50:00,0,1390.0,866.0,0.623,6.435,25,4,2,2,21,5,16,0,0.0,0.0
1009,661,2020-03-17 19:53:00,0,1396.0,855.0,0.612,6.445,37,1,0,1,36,11,25,0,0.0,0.0
1009,662,2020-03-17 19:56:00,0,1394.0,860.0,0.617,6.445,64,0,0,0,64,3,61,0,0.0,0.0
1009,663,2020-03-17 19:59:00,0,2425.0,1619.0,0.668,11.348,234,104,69,35,130,81,49,44,0.0,0.0
1009,664,2020-03-17 20:02:00,0,2814.0,1989.0,0.707,13.289,272,129,96,33,143,79,64,107,0.0,0.0
1009,665,2020-03-17 20:05:00,0,3050.0,2162.0,0.709,14.413,129,64,33,31,65,2,63,113,0.0,0.0
1009,666,2020-03-17 20:08:00,0,2967.0,2139.0,0.721,14.057,165,116,64,52,49,8,41,108,0.0,0.0
1009,667,2020-03-17 20:11:00,0,2901.0,2021.0,0.697,13.666,254,131,100,31,123,74,49,125,0.0,0.0
1009,668,2020-03-17 20:14:00,0,2903.0,2012.5,0.6935,13.6645,438,231,183,48,207,162,45,45,0.27,0.0
1009,669,2020-03-17 20:17:00,0,2905.0,2004.0,0.69,13.663,371,191,156,35,180,126,54,84,0.0,0.08
1009,670,2020-03-17 20:20:00,0,2905.0,1998.0,0.688,13.658,196,131,66,65,65,21,44,123,0.0,0.0
1009,671,2020-03-17 20:23:00,0,2894.0,2051.0,0.709,13.674,163,98,48,50,65,25,40,83,0.0,0.0
1009,672,2020-03-17 20:26:00,0,2895.0,2069.0,0.715,13.697,154,74,33,41,80,38,42,53,0.0,0.0
1009,673,2020-03-17 20:29:00,0,2889.0,2034.0,0.704,13.633,292,159,112,47,133,77,56,94,0.0,0.0
1009,674,2020-03-17 20:32:00,0,2879.0,2102.0,0.73,13.67,131,82,35,47,49,9,40,82,0.0,0.0
1009,675,2020-03-17 20:35:00,0,2495.0,1735.0,0.695,11.753,404,179,133,46,225,161,64,39,0.0,0.0
1009,676,2020-03-17 20:38:00,0,1930.0,1378.0,0.714,9.131,292,98,54,44,194,125,69,15,0.0,0.0
1009,677,2020-03-17 20:41:00,0,1946.0,1280.0,0.658,9.084,197,60,23,37,137,69,68,5,0.0,0.0
1009,678,2020-03-17 20:44:00,0,1790.0,1175.0,0.657,8.353,191,85,45,40,106,58,48,51,0.0,0.0
1009,679,2020-03-17 20:47:00,0,2959.0,2157.0,0.729,14.048,180,93,41,52,87,38,49,93,0.0,0.0
1009,680,2020-03-17 20:50:00,0,3025.0,2233.0,0.738,14.391,161,77,35,42,84,33,51,102,0.0,0.0
1009,681,2020-03-17 20:53:00,0,2864.0,2100.0,0.733,13.609,263,129,98,31,134,81,53,88,0.0,0.0
1009,682,2020-03-17 20:56:00,0,2855.0,2102.0,0.736,13.578,193,99,57,42,94,38,56,93,0.0,0.0
1009,683,2020-03-17 20:59:00,0,2862.0,2137.0,0.747,13.642,214,99,61,38,115,53,62,94,0.0,0.0
1009,684,2020-03-17 21:02:00,0,2883.0,2115.0,0.734,13.701,192,93,48,45,99,54,45,55,0.3,0.0
1009,685,2020-03-17 21:05:00,0,2107.0,1425.0,0.676,9.881,207,94,54,40,113,67,46,49,0.0,0.0
1009,686,2020-03-17 21:08:00,0,3042.0,2244.0,0.738,14.472,170,80,37,43,90,9,81,109,0.0,0.0
1009,687,2020-03-17 21:11:00,0,3035.0,2274.0,0.749,14.474,133,60,31,29,73,9,64,94,0.0,0.0
1009,688,2020-03-17 21:14:00,0,2868.0,2148.0,0.749,13.678,99,58,30,28,41,12,29,85,0.0,0.0
1009,689,2020-03-17 21:17:00,0,3024.0,2252.0,0.745,14.408,137,83,35,48,54,15,39,93,0.0,0.0
1009,690,2020-03-17 21:20:00,0,2790.0,2011.0,0.721,13.218,254,135,84,51,119,64,55,102,0.0,0.0
1009,691,2020-03-17 21:23:00,0,2909.0,2049.0,0.704,13.732,126,90,49,41,36,21,15,64,0.0,0.0
1009,692,2020-03-17 21:26:00,0,3051.0,2185.0,0.716,14.441,260,132,83,49,128,78,50,69,0.0,0.0
1009,693,2020-03-17 21:29:00,0,2723.0,1985.0,0.729,12.928,229,139,78,61,90,51,39,83,0.0,0.02
1009,694,2020-03-17 21:32:00,0,2885.0,2089.0,0.724,13.678,127,72,30,42,55,8,47,89,0.0,0.0
1009,695,2020-03-17 21:35:00,0,2745.0,1920.0,0.699,12.943,211,100,59,41,111,53,58,115,0.0,0.0
1009,696,2020-03-17 21:38:00,0,2873.0,2089.0,0.727,13.632,97,37,13,24,60,29,31,47,0.0,0.0
1009,697,2020-03-17 21:41:00,0,2862.0,2205.0,0.771,13.718,187,65,36,29,122,58,64,82,0.0,0.0
1009,698,2020-03-17 21:44:00,0,2702.0,2022.0,0.748,12.886,303,130,102,28,173,113,60,29,0.21,0.0
1009,699,2020-03-17 21:47:00,0,2456.0,1889.0,0.769,11.767,691,332,271,61,359,283,76,93,0.0,0.0
1009,700,2020-03-17 21:50:00,0,2721.0,1938.0,0.712,12.867,717,338,274,64,379,293,86,152,0.0,0.0
1009,701,2020-03-17 21:53:00,0,2314.0,1674.0,0.723,10.971,528,273,207,66,255,188,67,161,0.0,0.0
1009,702,2020-03-17 21:56:00,0,2470.0,1824.0,0.739,11.751,513,267,202,65,246,173,73,172,0.0,0.0
1009,703,2020-03-17 21:59:00,0,1776.0,1229.0,0.692,8.358,339,201,127,74,138,85,53,56,0.0,0.0
1009,704,2020-03-17 22:02:00,0,2883.0,2056.0,0.713,13.636,311,205,145,60,106,65,41,3,0.0,0.0
1009,705,2020-03-17 22:05:00,0,3020.0,2233.0,0.74,14.371,332,165,115,50,167,101,66,13,0.0,0.0
1009,706,2020-03-17 22:08:00,0,2880.0,2143.0,0.744,13.721,421,243,173,70,178,110,68,4,0.0,0.0
1009,707,2020-03-17 22:11:00,0,2883.0,2076.0,0.72,13.66,440,200,150,50,240,181,59,25,0.0,0.0
1009,708,2020-03-17 22:14:00,0,2872.0,2095.0,0.73,13.634,458,227,171,56,231,170,61,101,0.02,0.0
1009,709,2020-03-17 22:17:00,0,2875.0,2138.0,0.744,13.696,356,188,142,46,168,131,37,80,0.0,0.0
1009,710,2020-03-17 22:20:00,0,3008.0,2330.0,0.775,14.43,180,111,66,45,69,44,25,47,0.0,0.0
1009,711,2020-03-17 22:23:00,0,2708.0,1970.0,0.727,12.853,318,155,114,41,163,110,53,70,0.0,0.0
1009,712,2020-03-17 22:26:00,0,2473.0,1815.0,0.734,11.754,442,263,200,63,179,123,56,86,0.0,0.0
1009,713,2020-03-17 22:29:00,0,2960.0,2170.0,0.733,14.064,404,196,142,54,208,145,63,22,0.01,0.0
1009,714,2020-03-17 22:32:00,0,3018.0,2302.0,0.763,14.439,219,114,90,24,105,77,28,62,0.0,0.0
1009,715,2020-03-17 22:35:00,0,2391.0,1750.0,0.732,11.358,467,224,165,59,243,173,70,7,0.0,0.0
1009,716,2020-03-17 22:38:00,0,1546.0,1021.0,0.66,7.22,348,137,97,40,211,153,58,37,0.0,0.0
1009,717,2020-03-17 22:41:00,0,2881.0,2069.0,0.718,13.642,431,199,141,58,232,159,73,63,0.0,0.07
1009,718,2020-03-17 22:44:00,0,3045.0,2142.0,0.704,14.369,51,28,25,3,23,10,13,1,0.0,0.0
1009,719,2020-03-17 22:47:00,0,3284.0,2358.0,0.718,15.552,69,34,23,11,35,27,8,7,0.0,0.0
1009,720,2020-03-17 22:50:00,0,2497.0,1782.0,0.713,11.813,335,168,126,42,167,122,45,52,0.0,0.0
1009,721,2020-03-17 22:53:00,0,2903.0,2044.0,0.704,13.703,491,234,174,60,257,189,68,14,0.0,0.0
1009,722,2020-03-17 22:56:00,0,1948.0,1256.0,0.645,9.068,537,259,213,46,278,209,69,92,0.0,0.0
1009,723,2020-03-17 22:59:00,0,3451.0,2438.0,0.706,16.298,41,40,4,36,1,0,1,0,0.0,0.0
1009,724,2020-03-17 23:02:00,0,3132.0,2250.0,0.718,14.83,24,21,4,17,3,1,2,1,0.0,0.0
1009,725,2020-03-17 23:05:00,0,2498.0,1740.0,0.697,11.77,247,139,94,45,108,75,33,70,0.0,0.0
1009,726,2020-03-17 23:08:00,0,2525.0,1647.0,0.652,11.773,305,163,105,58,142,79,63,108,0.0,0.0
1009,727,2020-03-17 23:11:00,0,2356.0,1546.0,0.656,10.993,241,123,75,48,118,72,46,95,0.0,0.0
1009,728,2020-03-17 23:14:00,0,2377.5,1638.5,0.6885,11.1805,281,161,106,55,120,70,50,92,0.0,0.0
1009,729,2020-03-17 23:17:00,0,2399.0,1731.0,0.721,11.368,249,106,51,55,143,80,63,86,0.0,0.0
1009,730,2020-03-17 23:20:00,0,2477.0,1814.0,0.732,11.769,249,150,93,57,99,50,49,88,0.0,0.0
1009,731,2020-03-17 23:23:00,0,2475.0,1843.0,0.745,11.794,175,116,51,65,59,15,44,95,0.0,0.0
1009,732,2020-03-17 23:26:00,0,2652.0,1880.0,0.709,12.531,178,116,51,65,62,16,46,87,0.0,0.0
1009,733,2020-03-17 23:29:00,0,2474.0,1821.0,0.736,11.763,212,103,67,36,109,65,44,78,0.0,0.0
1009,734,2020-03-17 23:32:00,0,2654.0,1892.0,0.713,12.551,187,91,36,55,96,50,46,83,0.0,0.0
1009,735,2020-03-17 23:35:00,0,2644.0,1922.0,0.727,12.546,141,76,24,52,65,13,52,79,0.0,0.0
1009,736,2020-03-17 23:38:00,0,2467.0,1854.0,0.752,11.772,591,316,232,84,275,211,64,34,0.0,0.0
1009,737,2020-03-17 23:41:00,0,2797.0,2085.0,0.745,13.331,302,119,70,49,183,125,58,14,0.16,0.01
1009,738,2020-03-17 23:44:00,0,2631.0,1992.0,0.757,12.574,182,94,50,44,88,44,44,99,0.0,0.0
1009,739,2020-03-17 23:47:00,0,2799.0,2046.0,0.731,13.295,160,97,51,46,63,16,47,103,0.0,0.0
1009,740,2020-03-17 23:50:00,0,2619.0,1987.0,0.759,12.517,167,83,35,48,84,39,45,76,0.0,0.0
1009,741,2020-03-17 23:53:00,0,2638.0,1960.0,0.743,12.565,207,96,54,42,111,70,41,69,0.0,0.0
1009,742,2020-03-17 23:56:00,0,2614.0,2022.0,0.773,12.537,146,45,20,25,101,17,84,105,0.0,0.0
1009,743,2020-03-17 23:59:00,0,2622.0,2029.0,0.774,12.575,105,41,17,24,64,6,58,99,0.0,0.0
1009,744,2020-03-18 00:02:00,0,2636.0,1936.0,0.735,12.528,115,51,15,36,64,6,58,95,0.0,0.0
1009,745,2020-03-18 00:05:00,0,2612.0,2033.0,0.778,12.542,155,62,25,37,93,22,71,107,0.0,0.0
1009,746,2020-03-18 00:08:00,0,2608.0,2028.0,0.778,12.521,191,68,30,38,123,52,71,111,0.0,0.0
1009,747,2020-03-18 00:11:00,0,2606.0,2022.0,0.776,12.506,187,96,55,41,91,40,51,85,0.0,0.02
1009,748,2020-03-18 00:14:00,0,2467.0,1819.0,0.737,11.732,438,243,175,68,195,123,72,97,0.0,0.07
1009,749,2020-03-18 00:17:00,0,2609.0,2027.0,0.777,12.524,191,98,61,37,93,41,52,114,0.0,0.0
1009,750,2020-03-18 00:20:00,0,2793.0,2082.0,0.745,13.309,148,75,30,45,73,17,56,112,0.0,0.0
1009,751,2020-03-18 00:23:00,0,2772.0,2128.0,0.768,13.278,364,173,125,48,191,120,71,95,0.0,0.0
1009,752,2020-03-18 00:26:00,0,2775.0,2141.0,0.772,13.304,447,216,163,53,231,177,54,124,0.11,0.0
1009,753,2020-03-18 00:29:00,0,2469.0,1840.0,0.745,11.764,814,407,331,76,407,317,90,213,0.0,0.0
1009,754,2020-03-18 00:32:00,0,2632.0,1981.0,0.753,12.562,772,382,317,65,390,302,88,283,0.0,0.0
1009,755,2020-03-18 00:35:00,0,2653.0,1918.0,0.723,12.577,772,406,346,60,366,293,73,272,0.0,0.0
1009,756,2020-03-18 00:38:00,0,2706.0,2006.0,0.741,12.882,543,289,246,43,254,199,55,314,0.0,0.0
1009,757,2020-03-18 00:41:00,0,2645.0,1920.0,0.726,12.547,465,246,207,39,219,167,52,307,0.0,0.0
1009,758,2020-03-18 00:44:00,0,2650.0,1874.0,0.707,12.514,351,174,136,38,177,128,49,261,0.0,0.0
1009,759,2020-03-18 00:47:00,0,2801.0,2025.0,0.723,13.279,286,151,117,34,135,93,42,203,0.0,0.0
1009,760,2020-03-18 00:50:00,0,2795.0,2060.0,0.737,13.292,312,148,109,39,164,91,73,123,0.0,0.0
1009,761,2020-03-18 00:53:00,0,2796.0,2027.0,0.725,13.262,120,61,27,34,59,6,53,100,0.17,0.0
1009,762,2020-03-18 00:56:00,0,2637.0,1886.0,0.715,12.476,614,228,175,53,386,297,89,65,0.14,0.0
1009,763,2020-03-18 00:59:00,0,2242.0,1591.0,0.71,10.594,450,177,131,46,273,203,70,14,0.0,0.0
1009,764,2020-03-18 01:02:00,0,2483.0,1783.0,0.718,11.758,191,93,66,27,98,68,30,87,0.0,0.0
1009,765,2020-03-18 01:05:00,0,2790.0,2105.0,0.754,13.323,294,132,86,46,162,118,44,29,0.0,0.0
1009,766,2020-03-18 01:08:00,0,2697.0,2060.0,0.764,12.908,524,235,198,37,289,226,63,207,0.0,0.0
1009,767,2020-03-18 01:11:00,0,2659.0,1904.0,0.716,12.585,701,376,309,67,325,252,73,342,0.0,0.0
1009,768,2020-03-18 01:14:00,0,2721.0,1991.0,0.732,12.927,374,189,142,47,185,132,53,187,0.0,0.0
1009,769,2020-03-18 01:17:00,0,2491.0,1763.0,0.708,11.768,324,135,86,49,189,130,59,4,0.0,0.0
1009,770,2020-03-18 01:20:00,0,2253.0,1592.0,0.707,10.64,98,24,5,19,74,21,53,1,0.0,0.0
1009,771,2020-03-18 01:23:00,0,2480.0,1795.0,0.724,11.758,275,111,68,43,164,105,59,37,0.0,0.0
1009,772,2020-03-18 01:26:00,0,2578.0,1836.0,0.712,12.19,381,201,145,56,180,131,49,72,0.0,0.08
1009,773,2020-03-18 01:29:00,0,2320.0,1703.0,0.734,11.028,225,131,103,28,94,65,29,165,0.0,0.0
1009,774,2020-03-18 01:32:00,0,2405.0,1717.0,0.714,11.378,286,148,106,42,138,76,62,171,0.0,0.0
1009,775,2020-03-18 01:35:00,0,2636.0,1938.0,0.735,12.531,174,84,37,47,90,14,76,131,0.0,0.0
1009,776,2020-03-18 01:38:00,0,2632.0,1907.0,0.725,12.484,141,69,36,33,72,7,65,117,0.0,0.0
1009,777,2020-03-18 01:41:00,0,2643.0,1903.0,0.72,12.523,222,105,65,40,117,52,65,74,0.0,0.0
1009,778,2020-03-18 01:44:00,0,2088.0,1479.0,0.708,9.866,168,55,32,23,113,57,56,105,0.0,0.0
1009,779,2020-03-18 01:47:00,0,2661.0,1847.0,0.694,12.528,125,68,40,28,57,21,36,47,0.0,0.0
1009,780,2020-03-18 01:50:00,0,2272.0,1538.0,0.677,10.656,239,108,73,35,131,92,39,27,0.37,0.0
1009,781,2020-03-18 01:53:00,0,1865.0,1249.0,0.669,8.733,190,74,43,31,116,93,23,72,0.0,0.0
1009,782,2020-03-18 01:56:00,0,2245.0,1588.0,0.707,10.605,405,210,154,56,195,149,46,179,0.0,0.0
1009,783,2020-03-18 01:59:00,0,2251.0,1564.0,0.695,10.601,401,149,99,50,252,171,81,17,0.0,0.0
1009,784,2020-03-18 02:02:00,0,2235.0,1679.0,0.751,10.664,423,196,147,49,227,159,68,41,0.0,0.0
1009,785,2020-03-18 02:05:00,0,2403.0,1722.0,0.717,11.374,252,133,112,21,119,84,35,241,0.0,0.0
1009,786,2020-03-18 02:08:00,0,2237.0,1666.0,0.745,10.66,293,154,130,24,139,107,32,247,0.0,0.0
1009,787,2020-03-18 02:11:00,0,2499.0,1753.0,0.701,11.786,417,205,168,37,212,162,50,106,0.0,0.0
1009,788,2020-03-18 02:14:00,0,2448.0,1758.0,0.7185,11.5905,394,180,132,48,214,167,47,123,0.0,0.0
1009,789,2020-03-18 02:17:00,0,2397.0,1763.0,0.736,11.395,105,55,29,26,50,15,35,0,0.0,0.0
1009,790,2020-03-18 02:20:00,0,1992.0,1451.0,0.728,9.457,46,7,4,3,39,9,30,0,0.0,0.0
1009,791,2020-03-18 02:23:00,0,1755.0,1319.0,0.751,8.376,68,17,2,15,51,15,36,0,0.0,0.0
1009,792,2020-03-18 02:26:00,0,1765.0,1259.0,0.713,8.348,20,8,3,5,12,6,6,0,0.0,0.0
1009,793,2020-03-18 02:29:00,0,1595.0,1202.0,0.754,7.618,9,0,0,0,9,2,7,0,0.0,0.0
1009,794,2020-03-18 02:32:00,0,1605.0,1175.0,0.732,7.625,27,2,1,1,25,8,17,0,0.0,0.0
1009,795,2020-03-18 02:35:00,0,1599.0,1193.0,0.746,7.622,67,29,16,13,38,15,23,0,0.0,0.0
1009,796,2020-03-18 02:38:00,0,1592.0,1214.0,0.763,7.618,7,0,0,0,7,0,7,0,0.0,0.0
1009,797,2020-03-18 02:41:00,0,1618.0,1121.0,0.693,7.614,18,1,1,0,17,4,13,0,0.0,0.0
1009,798,2020-03-18 02:44:00,0,1760.0,1284.0,0.73,8.355,46,9,4,5,37,0,37,0,0.0,0.0
1009,799,2020-03-18 02:47:00,0,1601.0,1180.0,0.737,7.615,28,0,0,0,28,0,28,0,0.0,0.0
1009,800,2020-03-18 02:50:00,0,1514.0,1102.0,0.728,7.186,31,0,0,0,31,0,31,0,0.0,0.0
1009,801,2020-03-18 02:53:00,0,1435.0,1100.0,0.766,6.87,60,19,4,15,41,13,28,0,0.0,0.0
1009,802,2020-03-18 02:56:00,0,1591.0,1208.0,0.759,7.608,25,1,0,1,24,0,24,0,0.0,0.0
1009,803,2020-03-18 02:59:00,0,1435.0,1060.0,0.738,6.828,32,0,0,0,32,0,32,0,0.0,0.0
1009,804,2020-03-18 03:02:00,0,1455.0,1003.0,0.69,6.842,32,0,0,0,32,0,32,0,0.0,0.0
1009,805,2020-03-18 03:05:00,0,1597.0,1195.0,0.748,7.616,150,75,42,33,75,47,28,0,0.0,0.0
1009,806,2020-03-18 03:08:00,0,1910.0,1432.0,0.75,9.113,110,42,28,14,68,30,38,0,0.0,0.0
1009,807,2020-03-18 03:11:00,0,1989.0,1482.0,0.745,9.476,38,1,0,1,37,0,37,0,0.0,0.0
1009,808,2020-03-18 03:14:00,0,1730.0,1371.0,0.793,8.334,111,39,24,15,72,40,32,1,0.0,0.0
1009,809,2020-03-18 03:17:00,0,1914.0,1405.0,0.734,9.098,308,174,129,45,134,97,37,16,0.0,0.01
1009,810,2020-03-18 03:20:00,0,1732.0,1381.0,0.797,8.352,236,115,78,37,121,89,32,112,0.0,0.0
1009,811,2020-03-18 03:23:00,0,1982.0,1527.0,0.77,9.501,67,37,22,15,30,18,12,0,0.0,0.0
1009,812,2020-03-18 03:26:00,0,2139.0,1661.0,0.777,10.267,0,0,0,0,0,0,0,0,0.0,0.0
1009,813,2020-03-18 03:29:00,0,1768.0,1240.0,0.701,8.339,27,11,0,11,16,2,14,0,0.0,0.0
1009,814,2020-03-18 03:32:00,0,1608.0,1151.0,0.716,7.611,24,10,0,10,14,0,14,0,0.0,0.0
1009,815,2020-03-18 03:35:00,0,1527.0,1108.0,0.726,7.245,0,0,0,0,0,0,0,0,0.0,0.0
1009,816,2020-03-18 03:38:00,0,1768.0,1226.0,0.694,8.322,16,5,0,5,11,7,4,0,0.0,0.0
1009,817,2020-03-18 03:41:00,0,1597.0,1175.0,0.736,7.595,0,0,0,0,0,0,0,0,0.0,0.0
1009,818,2020-03-18 03:44:00,0,1518.0,1093.0,0.72,7.192,0,0,0,0,0,0,0,0,0.0,0.0
1009,819,2020-03-18 03:47:00,0,1443.0,1055.0,0.731,6.855,0,0,0,0,0,0,0,0,0.0,0.0
1009,820,2020-03-18 03:50:00,0,1436.0,1046.0,0.728,6.817,5,4,2,2,1,1,0,0,0.0,0.0
1009,821,2020-03-18 03:53:00,0,1581.0,1225.0,0.775,7.586,20,18,0,18,2,1,1,0,0.0,0.0
1009,822,2020-03-18 03:56:00,0,1436.0,1071.0,0.746,6.844,41,41,0,41,0,0,0,0,0.0,0.0
1009,823,2020-03-18 03:59:00,0,1453.0,1008.0,0.694,6.839,7,6,0,6,1,0,1,0,0.0,0.0
1009,824,2020-03-18 04:02:00,0,1433.0,1042.0,0.727,6.8,16,8,2,6,8,5,3,1,0.0,0.0
1009,825,2020-03-18 04:05:00,0,1430.0,1073.0,0.75,6.822,0,0,0,0,0,0,0,0,0.0,0.0
1009,826,2020-03-18 04:08:00,0,1433.0,1091.0,0.761,6.854,0,0,0,0,0,0,0,0,0.0,0.0
1009,827,2020-03-18 04:11:00,0,1612.0,1142.0,0.708,7.615,19,8,0,8,11,0,11,0,0.0,0.0
1009,828,2020-03-18 04:14:00,0,1437.0,1085.0,0.755,6.864,11,2,0,2,9,1,8,0,0.0,0.0
1009,829,2020-03-18 04:17:00,0,1430.0,1074.0,0.751,6.823,5,5,0,5,0,0,0,0,0.0,0.0
1009,830,2020-03-18 04:20:00,0,1451.0,1021.0,0.703,6.847,6,1,0,1,5,2,3,0,0.0,0.0
1009,831,2020-03-18 04:23:00,0,1442.0,1040.0,0.721,6.833,35,24,6,18,11,6,5,0,0.0,0.0
1009,832,2020-03-18 04:26:00,0,1442.0,1046.0,0.725,6.841,0,0,0,0,0,0,0,0,0.0,0.0
1009,833,2020-03-18 04:29:00,0,1436.0,1074.0,0.748,6.846,34,30,12,18,4,2,2,0,0.0,0.0
1009,834,2020-03-18 04:32:00,0,1422.0,1113.0,0.783,6.835,188,87,61,26,101,71,30,56,0.0,0.0
1009,835,2020-03-18 04:35:00,0,1580.0,1240.0,0.785,7.6,122,71,49,22,51,34,17,10,0.0,0.0
1009,836,2020-03-18 04:38:00,0,1037.0,780.0,0.752,4.948,44,36,22,14,8,3,5,0,0.0,0.0
1009,837,2020-03-18 04:41:00,0,1365.0,994.0,0.728,6.48,5,5,3,2,0,0,0,0,0.0,0.0
1009,838,2020-03-18 04:44:00,0,1744.0,1343.0,0.77,8.36,0,0,0,0,0,0,0,0,0.0,0.0
1009,839,2020-03-18 04:47:00,0,1663.0,1261.0,0.758,7.948,18,17,3,14,1,0,1,0,0.0,0.0
1009,840,2020-03-18 04:50:00,0,1585.0,1242.0,0.784,7.621,12,12,0,12,0,0,0,0,0.0,0.0
1009,841,2020-03-18 04:53:00,0,1588.0,1172.0,0.738,7.556,25,21,8,13,4,0,4,0,0.0,0.0
1009,842,2020-03-18 04:56:00,0,1590.0,1196.0,0.752,7.59,11,11,3,8,0,0,0,0,0.0,0.0
1009,843,2020-03-18 04:59:00,0,1595.0,1161.0,0.728,7.569,0,0,0,0,0,0,0,0,0.0,0.0
1009,844,2020-03-18 05:02:00,0,1602.0,1129.0,0.705,7.561,5,4,2,2,1,1,0,4,0.0,0.0
1009,845,2020-03-18 05:05:00,0,1607.0,1164.0,0.725,7.62,1,1,1,0,0,0,0,0,0.0,0.0
1009,846,2020-03-18 05:08:00,0,1601.0,1158.0,0.723,7.59,3,2,0,2,1,0,1,1,0.0,0.0
1009,847,2020-03-18 05:11:00,0,1613.0,1125.0,0.697,7.602,3,1,0,1,2,0,2,0,0.0,0.0
1009,848,2020-03-18 05:14:00,0,1646.5,1167.5,0.7085,7.781,33,24,6,18,9,2,7,0,0.0,0.0
1009,849,2020-03-18 05:17:00,0,1680.0,1210.0,0.72,7.96,240,128,100,28,112,83,29,44,0.0,0.0
1009,850,2020-03-18 05:20:00,0,1844.0,1357.0,0.736,8.767,24,22,11,11,2,1,1,0,0.0,0.0
1009,851,2020-03-18 05:23:00,0,1835.0,1316.0,0.717,8.688,56,45,32,13,11,0,11,0,0.0,0.0
1009,852,2020-03-18 05:26:00,0,1862.0,1266.0,0.68,8.738,0,0,0,0,0,0,0,0,0.0,0.0
1009,853,2020-03-18 05:29:00,0,1691.0,1184.0,0.7,7.975,0,0,0,0,0,0,0,0,0.0,0.0
1009,854,2020-03-18 05:32:00,0,1701.0,1132.0,0.666,7.955,2,2,0,2,0,0,0,0,0.0,0.0
1009,855,2020-03-18 05:35:00,0,1610.0,1123.0,0.698,7.586,1,0,0,0,1,0,1,0,0.0,0.0
1009,856,2020-03-18 05:38:00,0,1526.0,1089.0,0.714,7.219,9,1,0,1,8,0,8,0,0.0,0.0
1009,857,2020-03-18 05:41:00,0,1690.0,1168.0,0.691,7.952,15,5,1,4,10,0,10,0,0.0,0.0
1009,858,2020-03-18 05:44:00,0,1687.0,1175.0,0.696,7.948,17,6,4,2,11,1,10,0,0.0,0.0
1009,859,2020-03-18 05:47:00,0,1682.0,1191.0,0.708,7.946,9,0,0,0,9,0,9,0,0.0,0.0
1009,860,2020-03-18 05:50:00,0,1704.0,1140.0,0.669,7.977,2,0,0,0,2,0,2,0,0.0,0.0
1009,861,2020-03-18 05:53:00,0,1529.0,1087.0,0.711,7.229,35,15,7,8,20,0,20,4,0.0,0.0
1009,862,2020-03-18 05:56:00,0,1672.0,1230.0,0.735,7.949,154,80,57,23,74,50,24,30,0.0,0.0
1009,863,2020-03-18 05:59:00,0,2022.0,1395.0,0.69,9.51,132,77,49,28,55,24,31,36,0.0,0.0
1009,864,2020-03-18 06:02:00,1,2253.0,1617.0,0.718,10.668,203,117,82,35,86,58,28,95,0.0,0.0
1009,865,2020-03-18 06:05:00,1,2076.0,1527.0,0.736,9.869,240,129,102,27,111,76,35,119,0.0,0.0
1009,866,2020-03-18 06:08:00,1,2091.0,1486.0,0.711,9.884,256,132,107,25,124,97,27,65,0.0,0.0
1009,867,2020-03-18 06:11:00,1,2172.0,1526.0,0.703,10.249,269,145,122,23,124,85,39,112,0.0,0.0
1009,868,2020-03-18 06:14:00,1,2330.0,1666.0,0.715,11.025,338,158,119,39,180,129,51,64,0.0,0.0
1009,869,2020-03-18 06:17:00,1,2237.0,1638.0,0.732,10.626,355,153,102,51,202,131,71,12,0.0,0.0
1009,870,2020-03-18 06:20:00,1,2252.0,1583.0,0.703,10.627,318,139,97,42,179,122,57,2,0.0,0.0
1009,871,2020-03-18 06:23:00,1,2078.0,1507.0,0.725,9.855,341,182,133,49,159,118,41,3,0.0,0.0
1009,872,2020-03-18 06:26:00,1,1867.0,1237.0,0.663,8.728,38,10,1,9,28,7,21,0,0.0,0.0
1009,873,2020-03-18 06:29:00,1,1788.0,1159.0,0.648,8.329,52,28,2,26,24,8,16,0,0.0,0.0
1009,874,2020-03-18 06:32:00,1,1707.0,1150.0,0.674,7.998,12,9,1,8,3,0,3,0,0.0,0.0
1009,875,2020-03-18 06:35:00,1,1716.0,1062.0,0.619,7.938,13,13,0,13,0,0,0,0,0.0,0.0
1009,876,2020-03-18 06:38:00,1,1859.0,1268.0,0.682,8.729,331,143,99,44,188,133,55,4,0.0,0.0
1009,877,2020-03-18 06:41:00,1,2110.0,1438.0,0.681,9.907,189,73,43,30,116,85,31,11,0.0,0.0
1009,878,2020-03-18 06:44:00,1,1697.0,1165.0,0.687,7.977,16,7,1,6,9,7,2,0,0.0,0.0
1009,879,2020-03-18 06:47:00,1,1723.0,1071.0,0.622,7.975,0,0,0,0,0,0,0,0,0.0,0.0
1009,880,2020-03-18 06:50:00,1,1716.0,1092.0,0.636,7.971,47,3,1,2,44,20,24,0,0.0,0.0
1009,881,2020-03-18 06:53:00,1,1708.0,1094.0,0.64,7.941,11,0,0,0,11,0,11,0,0.0,0.0
1009,882,2020-03-18 06:56:00,1,1640.0,1041.0,0.635,7.615,0,0,0,0,0,0,0,0,0.0,0.0
1009,883,2020-03-18 06:59:00,1,1527.0,1053.0,0.69,7.184,24,1,1,0,23,12,11,0,0.0,0.0
1009,884,2020-03-18 07:02:00,1,1722.0,1082.0,0.628,7.982,0,0,0,0,0,0,0,0,0.0,0.0
1009,885,2020-03-18 07:05:00,1,1719.0,1065.0,0.62,7.955,0,0,0,0,0,0,0,0,0.0,0.0
1009,886,2020-03-18 07:08:00,1,1543.0,1033.0,0.67,7.222,0,0,0,0,0,0,0,0,0.0,0.0
1009,887,2020-03-18 07:11:00,1,1551.0,1006.0,0.648,7.224,2,0,0,0,2,1,1,0,0.0,0.0
1009,888,2020-03-18 07:14:00,1,1716.0,1085.0,0.632,7.965,9,2,0,2,7,4,3,0,0.0,0.0
1009,889,2020-03-18 07:17:00,1,1872.0,1209.0,0.646,8.714,21,5,0,5,16,2,14,0,0.0,0.0
1009,890,2020-03-18 07:20:00,1,1859.0,1290.0,0.694,8.755,12,1,0,1,11,4,7,0,0.0,0.0
1009,891,2020-03-18 07:23:00,1,1886.0,1179.0,0.625,8.736,1,0,0,0,1,0,1,0,0.0,0.0
1009,892,2020-03-18 07:26:00,1,1707.0,1139.0,0.667,7.988,36,8,1,7,28,10,18,0,0.0,0.0
1009,893,2020-03-18 07:29:00,1,1695.0,1159.0,0.684,7.961,7,0,0,0,7,2,5,0,0.0,0.0
1009,894,2020-03-18 07:32:00,1,1712.0,1098.0,0.641,7.964,0,0,0,0,0,0,0,0,0.0,0.0
1009,895,2020-03-18 07:35:00,1,1709.0,1100.0,0.644,7.952,3,0,0,0,3,0,3,0,0.0,0.0
1009,896,2020-03-18 07:38:00,1,1700.0,1128.0,0.663,7.945,11,3,1,2,8,4,4,0,0.0,0.0
1009,897,2020-03-18 07:41:00,1,1699.0,1148.0,0.676,7.967,26,8,0,8,18,10,8,0,0.0,0.0
1009,898,2020-03-18 07:44:00,1,1858.0,1286.0,0.692,8.744,25,8,1,7,17,9,8,0,0.0,0.0
1009,899,2020-03-18 07:47:00,1,2097.0,1454.0,0.693,9.874,106,54,33,21,52,38,14,34,0.0,0.0
1009,900,2020-03-18 07:50:00,1,2022.0,1370.0,0.677,9.486,33,18,8,10,15,9,6,2,0.0,0.0
1009,901,2020-03-18 07:53:00,1,2023.0,1361.0,0.673,9.477,82,21,11,10,61,29,32,8,0.0,0.0
1009,902,2020-03-18 07:56:00,1,2030.0,1347.0,0.664,9.488,11,6,0,6,5,3,2,0,0.0,0.0
1009,903,2020-03-18 07:59:00,1,1875.0,1209.0,0.645,8.726,5,5,0,5,0,0,0,0,0.0,0.0
1009,904,2020-03-18 08:02:00,1,1694.0,1159.0,0.684,7.959,0,0,0,0,0,0,0,0,0.0,0.0
1009,905,2020-03-18 08:05:00,1,1630.0,1064.0,0.653,7.6,39,12,7,5,27,19,8,0,0.0,0.0
1009,906,2020-03-18 08:08:00,1,1715.0,1087.0,0.633,7.962,0,0,0,0,0,0,0,0,0.0,0.0
1009,907,2020-03-18 08:11:00,1,1538.0,1042.0,0.677,7.212,21,8,1,7,13,6,7,0,0.0,0.0
1009,908,2020-03-18 08:14:00,1,1454.5,1000.0,0.6875,6.838,10,7,2,5,3,2,1,0,0.0,0.0
1009,909,2020-03-18 08:17:00,1,1371.0,958.0,0.698,6.464,9,0,0,0,9,1,8,0,0.0,0.0
1009,910,2020-03-18 08:20:00,1,1203.0,843.0,0.701,5.674,1,0,0,0,1,0,1,0,0.0,0.0
1009,911,2020-03-18 08:23:00,1,1465.0,963.0,0.658,6.839,18,5,0,5,13,3,10,0,0.0,0.0
1009,912,2020-03-18 08:26:00,1,2006.0,1399.0,0.697,9.453,44,17,11,6,27,9,18,8,0.0,0.0
1009,913,2020-03-18 08:29:00,1,1524.0,1085.0,0.712,7.206,100,55,27,28,45,30,15,11,0.0,0.0
1009,914,2020-03-18 08:32:00,1,2147.0,1615.0,0.752,10.248,77,32,12,20,45,27,18,3,0.0,0.0
1009,915,2020-03-18 08:35:00,1,2152.0,1571.0,0.73,10.218,257,126,81,45,131,96,35,24,0.0,0.0
1009,916,2020-03-18 08:38:00,1,1925.0,1341.0,0.697,9.071,362,147,107,40,215,154,61,30,0.0,0.0
1009,917,2020-03-18 08:41:00,1,1839.0,1328.0,0.722,8.717,420,217,168,49,203,144,59,3,0.0,0.0
1009,918,2020-03-18 08:44:00,1,2004.0,1442.0,0.719,9.494,521,268,211,57,253,196,57,8,0.0,0.0
1009,919,2020-03-18 08:47:00,1,2025.0,1366.0,0.675,9.491,193,81,51,30,112,74,38,32,0.0,0.0
1009,920,2020-03-18 08:50:00,1,1767.0,1233.0,0.698,8.327,45,0,0,0,45,8,37,0,0.0,0.0
1009,921,2020-03-18 08:53:00,1,1762.0,1269.0,0.72,8.346,15,0,0,0,15,5,10,0,0.0,0.0
1009,922,2020-03-18 08:56:00,1,1700.0,1177.0,0.692,8.001,5,0,0,0,5,2,3,0,0.0,0.0
1009,923,2020-03-18 08:59:00,1,1615.0,1112.0,0.688,7.596,33,8,3,5,25,10,15,0,0.0,0.0
1009,924,2020-03-18 09:02:00,1,1615.0,1117.0,0.692,7.6,5,0,0,0,5,3,2,0,0.0,0.0
1009,925,2020-03-18 09:05:00,1,1466.0,959.0,0.654,6.837,9,2,1,1,7,2,5,0,0.0,0.0
1009,926,2020-03-18 09:08:00,1,1454.0,979.0,0.673,6.815,8,0,0,0,8,2,6,0,0.0,0.0
1009,927,2020-03-18 09:11:00,1,1456.0,988.0,0.679,6.832,14,2,0,2,12,2,10,0,0.0,0.0
1009,928,2020-03-18 09:14:00,1,1777.0,1252.0,0.704,8.388,26,6,2,4,20,14,6,0,0.0,0.0
1009,929,2020-03-18 09:17:00,1,1598.0,1153.0,0.721,7.573,10,3,0,3,7,4,3,0,0.0,0.0
1009,930,2020-03-18 09:20:00,1,1618.0,1095.0,0.677,7.589,1,0,0,0,1,0,1,0,0.0,0.0
1009,931,2020-03-18 09:23:00,1,1536.0,1063.0,0.692,7.23,1,0,0,0,1,0,1,0,0.0,0.0
1009,932,2020-03-18 09:26:00,1,1611.0,1107.0,0.687,7.572,1,0,0,0,1,1,0,0,0.0,0.0
1009,933,2020-03-18 09:29:00,1,1619.0,1092.0,0.674,7.59,1,0,0,0,1,1,0,0,0.0,0.0
1009,934,2020-03-18 09:32:00,1,1448.0,1025.0,0.708,6.84,0,0,0,0,0,0,0,0,0.0,0.0
1009,935,2020-03-18 09:35:00,1,1441.0,1053.0,0.73,6.845,0,0,0,0,0,0,0,0,0.0,0.0
1009,936,2020-03-18 09:38:00,1,1457.0,979.0,0.672,6.824,7,0,0,0,7,0,7,0,0.0,0.0
1009,937,2020-03-18 09:41:00,1,1453.0,1014.0,0.698,6.846,5,0,0,0,5,0,5,0,0.0,0.0
1009,938,2020-03-18 09:44:00,1,1436.0,1059.0,0.737,6.83,6,1,0,1,5,2,3,0,0.0,0.0
1009,939,2020-03-18 09:47:00,1,1460.0,972.0,0.666,6.827,4,0,0,0,4,2,2,0,0.0,0.0
1009,940,2020-03-18 09:50:00,1,1284.0,914.0,0.711,6.072,0,0,0,0,0,0,0,0,0.0,0.0
1009,941,2020-03-18 09:53:00,1,1203.0,848.0,0.704,5.68,19,12,0,12,7,1,6,0,0.0,0.0
1009,942,2020-03-18 09:56:00,1,1623.0,1077.0,0.663,7.589,6,2,0,2,4,2,2,0,0.0,0.0
1009,943,2020-03-18 09:59:00,1,1453.0,1016.0,0.699,6.852,21,7,0,7,14,7,7,0,0.0,0.0
1009,944,2020-03-18 10:02:00,1,1461.0,979.0,0.67,6.84,2,0,0,0,2,0,2,0,0.0,0.0
1009,945,2020-03-18 10:05:00,1,1459.0,973.0,0.667,6.825,32,6,0,6,26,11,15,0,0.0,0.0
1009,946,2020-03-18 10:08:00,1,1452.0,1013.0,0.697,6.843,22,0,0,0,22,0,22,0,0.0,0.0
1009,947,2020-03-18 10:11:00,1,1455.0,993.0,0.683,6.833,20,1,0,1,19,0,19,0,0.0,0.0
1009,948,2020-03-18 10:14:00,1,1374.0,942.0,0.686,6.455,0,0,0,0,0,0,0,0,0.0,0.0
1009,949,2020-03-18 10:17:00,1,1372.0,943.0,0.687,6.45,22,5,0,5,17,5,12,0,0.0,0.0
1009,950,2020-03-18 10:20:00,1,1374.0,960.0,0.698,6.477,30,11,2,9,19,10,9,0,0.0,0.0
1009,951,2020-03-18 10:23:00,1,2013.0,1419.0,0.705,9.504,151,73,51,22,78,45,33,7,0.0,0.0
1009,952,2020-03-18 10:26:00,1,1190.0,916.0,0.769,5.704,155,57,47,10,98,56,42,70,0.0,0.0
1009,953,2020-03-18 10:29:00,1,2005.0,1436.0,0.716,9.491,197,89,60,29,108,72,36,99,0.0,0.0
1009,954,2020-03-18 10:32:00,1,2003.0,1475.0,0.736,9.527,308,162,130,32,146,99,47,62,0.0,0.0
1009,955,2020-03-18 10:35:00,1,1935.0,1353.0,0.699,9.122,104,49,27,22,55,28,27,46,0.0,0.0
1009,956,2020-03-18 10:38:00,1,1937.0,1345.0,0.694,9.12,97,60,11,49,37,3,34,61,0.0,0.0
1009,957,2020-03-18 10:41:00,1,1760.0,1245.0,0.707,8.313,24,20,1,19,4,1,3,13,0.0,0.0
1009,958,2020-03-18 10:44:00,1,1781.0,1220.0,0.685,8.366,4,4,0,4,0,0,0,4,0.0,0.0
1009,959,2020-03-18 10:47:00,1,1603.0,1152.0,0.719,7.592,31,10,1,9,21,10,11,1,0.0,0.0
1009,960,2020-03-18 10:50:00,1,1446.0,1028.0,0.711,6.838,1,1,0,1,0,0,0,0,0.0,0.0
1009,961,2020-03-18 10:53:00,1,1377.0,930.0,0.675,6.457,1,0,0,0,1,0,1,0,0.0,0.0
1009,962,2020-03-18 10:56:00,1,1287.0,905.0,0.703,6.072,22,9,2,7,13,5,8,0,0.0,0.0
1009,963,2020-03-18 10:59:00,1,1209.0,843.0,0.697,5.699,1,1,0,1,0,0,0,0,0.0,0.0
1009,964,2020-03-18 11:02:00,1,1214.0,825.0,0.68,5.696,3,3,0,3,0,0,0,0,0.0,0.0
1009,965,2020-03-18 11:05:00,1,1209.0,847.0,0.701,5.701,3,0,0,0,3,1,2,0,0.0,0.0
1009,966,2020-03-18 11:08:00,1,1211.0,848.0,0.7,5.709,1,0,0,0,1,0,1,0,0.0,0.0
1009,967,2020-03-18 11:11:00,1,1201.0,874.0,0.728,5.7,19,5,0,5,14,4,10,0,0.0,0.0
1009,968,2020-03-18 11:14:00,1,1285.5,929.0,0.723,6.0925,24,11,0,11,13,3,10,0,0.0,0.0
1009,969,2020-03-18 11:17:00,1,1370.0,984.0,0.718,6.485,183,0,0,0,183,135,48,0,0.0,0.0
1009,970,2020-03-18 11:20:00,1,1371.0,953.0,0.695,6.456,39,3,0,3,36,12,24,0,0.0,0.0
1009,971,2020-03-18 11:23:00,1,1524.0,1062.0,0.697,7.18,13,2,0,2,11,5,6,0,0.0,0.0
1009,972,2020-03-18 11:26:00,1,1362.0,955.0,0.701,6.425,41,14,7,7,27,16,11,1,0.0,0.0
1009,973,2020-03-18 11:29:00,1,1358.0,1020.0,0.752,6.479,92,56,41,15,36,15,21,5,0.0,0.0
1009,974,2020-03-18 11:32:00,1,1377.0,932.0,0.677,6.456,9,2,0,2,7,0,7,0,0.0,0.0
1009,975,2020-03-18 11:35:00,1,1368.0,932.0,0.681,6.422,14,7,0,7,7,0,7,0,0.0,0.0
1009,976,2020-03-18 11:38:00,1,1377.0,919.0,0.667,6.441,2,1,0,1,1,0,1,0,0.0,0.0
1009,977,2020-03-18 11:41:00,1,1360.0,955.0,0.702,6.416,13,7,0,7,6,2,4,0,0.0,0.0
1009,978,2020-03-18 11:44:00,1,1368.0,963.0,0.704,6.457,26,25,0,25,1,0,1,0,0.0,0.0
1009,979,2020-03-18 11:47:00,1,1108.0,848.0,0.765,5.304,20,10,0,10,10,2,8,0,0.0,0.0
1009,980,2020-03-18 11:50:00,1,1354.0,1014.0,0.749,6.456,5,4,0,4,1,0,1,0,0.0,0.0
1009,981,2020-03-18 11:53:00,1,1442.0,1033.0,0.717,6.825,0,0,0,0,0,0,0,0,0.0,0.0
1009,982,2020-03-18 11:56:00,1,1366.0,975.0,0.714,6.461,14,12,0,12,2,0,2,0,0.0,0.0
1009,983,2020-03-18 11:59:00,1,1537.0,1051.0,0.684,7.22,0,0,0,0,0,0,0,0,0.0,0.0
1009,984,2020-03-18 12:02:00,1,1350.0,1021.0,0.756,6.45,4,2,0,2,2,1,1,0,0.0,0.0
1009,985,2020-03-18 12:05:00,1,1373.0,953.0,0.694,6.463,3,3,0,3,0,0,0,0,0.0,0.0
1009,986,2020-03-18 12:08:00,1,1371.0,956.0,0.698,6.461,2,2,0,2,0,0,0,0,0.0,0.0
1009,987,2020-03-18 12:11:00,1,1294.0,872.0,0.674,6.063,2,2,0,2,0,0,0,0,0.0,0.0
1009,988,2020-03-18 12:14:00,1,1295.0,863.0,0.667,6.058,43,17,3,14,26,10,16,2,0.0,0.05
1009,989,2020-03-18 12:17:00,1,1379.0,921.0,0.668,6.454,2,2,0,2,0,0,0,0,0.0,0.0
1009,990,2020-03-18 12:20:00,1,1371.0,939.0,0.685,6.443,1,1,0,1,0,0,0,0,0.0,0.0
1009,991,2020-03-18 12:23:00,1,1375.0,944.0,0.687,6.463,4,2,0,2,2,0,2,0,0.0,0.02
1009,992,2020-03-18 12:26:00,1,1372.0,921.0,0.671,6.426,0,0,0,0,0,0,0,0,0.0,0.0
1009,993,2020-03-18 12:29:00,1,1297.0,870.0,0.67,6.075,10,1,0,1,9,4,5,0,0.0,0.0
1009,994,2020-03-18 12:32:00,1,1553.0,1000.0,0.644,7.229,0,0,0,0,0,0,0,0,0.0,0.0
1009,995,2020-03-18 12:35:00,1,1374.0,907.0,0.66,6.417,29,7,3,4,22,13,9,2,0.0,0.0
1009,996,2020-03-18 12:38:00,1,1679.0,1237.0,0.737,7.986,230,107,77,30,123,88,35,11,0.0,0.0
1009,997,2020-03-18 12:41:00,1,1930.0,1396.0,0.724,9.151,74,52,40,12,22,15,7,72,0.0,0.0
1009,998,2020-03-18 12:44:00,1,1601.0,1181.0,0.738,7.618,178,77,47,30,101,72,29,24,0.0,0.0
1009,999,2020-03-18 12:47:00,1,1755.0,1282.0,0.731,8.335,582,226,170,56,356,268,88,10,0.0,0.0
1009,1000,2020-03-18 12:50:00,1,1925.0,1381.0,0.718,9.112,436,210,154,56,226,170,56,45,0.0,0.0
1009,1001,2020-03-18 12:53:00,1,1931.0,1379.0,0.714,9.137,499,225,173,52,274,203,71,10,0.0,0.0
1009,1002,2020-03-18 12:56:00,1,1848.0,1329.0,0.719,8.753,271,136,102,34,135,99,36,14,0.0,0.0
1009,1003,2020-03-18 12:59:00,1,1767.0,1263.0,0.715,8.362,127,93,59,34,34,0,34,56,0.0,0.0
1009,1004,2020-03-18 13:02:00,1,1679.0,1235.0,0.736,7.983,49,10,4,6,39,6,33,0,0.0,0.0
1009,1005,2020-03-18 13:05:00,1,1696.0,1166.0,0.687,7.972,2,2,0,2,0,0,0,0,0.0,0.0
1009,1006,2020-03-18 13:08:00,1,1529.0,1067.0,0.698,7.205,0,0,0,0,0,0,0,0,0.0,0.0
1009,1007,2020-03-18 13:11:00,1,1452.0,984.0,0.678,6.809,3,3,1,2,0,0,0,0,0.0,0.0
1009,1008,2020-03-18 13:14:00,1,1376.0,897.0,0.651,6.416,2,2,0,2,0,0,0,0,0.0,0.0
1009,1009,2020-03-18 13:17:00,1,1377.0,948.0,0.689,6.474,0,0,0,0,0,0,0,0,0.0,0.0
1009,1010,2020-03-18 13:20:00,1,1284.0,900.0,0.701,6.055,0,0,0,0,0,0,0,0,0.0,0.0
1009,1011,2020-03-18 13:23:00,1,1113.0,837.0,0.752,5.313,0,0,0,0,0,0,0,0,0.0,0.0
1009,1012,2020-03-18 13:26:00,1,1272.0,947.0,0.744,6.061,11,8,0,8,3,1,2,0,0.0,0.0
1009,1013,2020-03-18 13:29:00,1,1362.0,981.0,0.72,6.454,1,1,0,1,0,0,0,0,0.0,0.0
1009,1014,2020-03-18 13:32:00,1,1357.0,1004.0,0.74,6.46,10,6,0,6,4,1,3,0,0.0,0.0
1009,1015,2020-03-18 13:35:00,1,1188.0,916.0,0.771,5.695,16,9,2,7,7,0,7,0,0.0,0.0
1009,1016,2020-03-18 13:38:00,1,1112.0,846.0,0.761,5.318,12,10,2,8,2,0,2,0,0.0,0.0
1009,1017,2020-03-18 13:41:00,1,1095.0,896.0,0.818,5.306,0,0,0,0,0,0,0,0,0.0,0.0
1009,1018,2020-03-18 13:44:00,1,1109.0,859.0,0.775,5.32,16,13,5,8,3,0,3,0,0.0,0.0
1009,1019,2020-03-18 13:47:00,1,1099.0,895.0,0.815,5.32,66,64,29,35,2,0,2,0,0.0,0.0
1009,1020,2020-03-18 13:50:00,1,1109.0,862.0,0.778,5.322,11,8,3,5,3,0,3,0,0.0,0.0
1009,1021,2020-03-18 13:53:00,1,1270.0,955.0,0.752,6.062,68,32,12,20,36,13,23,0,0.0,0.0
1009,1022,2020-03-18 13:56:00,1,1094.0,908.0,0.831,5.315,8,8,0,8,0,0,0,0,0.0,0.0
1009,1023,2020-03-18 13:59:00,1,1095.0,904.0,0.826,5.315,11,7,1,6,4,1,3,0,0.0,0.0
1009,1024,2020-03-18 14:02:00,1,1105.0,884.0,0.8,5.332,27,27,14,13,0,0,0,0,0.0,0.0
1009,1025,2020-03-18 14:05:00,1,1090.0,923.0,0.847,5.316,57,51,29,22,6,0,6,0,0.0,0.0
1009,1026,2020-03-18 14:08:00,1,1089.0,928.0,0.852,5.319,48,44,25,19,4,0,4,0,0.0,0.0
1009,1027,2020-03-18 14:11:00,1,1095.0,906.0,0.828,5.318,3,3,1,2,0,0,0,0,0.0,0.0
1009,1028,2020-03-18 14:14:00,1,1275.0,956.5,0.76,6.0835,53,27,11,16,26,8,18,0,0.0,0.0
1009,1029,2020-03-18 14:17:00,1,1455.0,1007.0,0.692,6.849,33,16,2,14,17,3,14,0,0.0,0.0
1009,1030,2020-03-18 14:20:00,1,1696.0,1169.0,0.689,7.978,31,10,0,10,21,14,7,0,0.0,0.0
1009,1031,2020-03-18 14:23:00,1,1526.0,1067.0,0.699,7.192,8,5,0,5,3,0,3,0,0.0,0.0
1009,1032,2020-03-18 14:26:00,1,1537.0,1016.0,0.661,7.182,17,11,0,11,6,1,5,0,0.0,0.0
1009,1033,2020-03-18 14:29:00,1,1273.0,962.0,0.755,6.081,8,1,0,1,7,1,6,0,0.0,0.0
1009,1034,2020-03-18 14:32:00,1,1454.0,974.0,0.67,6.807,4,2,1,1,2,0,2,0,0.0,0.0
1009,1035,2020-03-18 14:35:00,1,1365.0,970.0,0.711,6.454,0,0,0,0,0,0,0,0,0.0,0.0
1009,1036,2020-03-18 14:38:00,1,1286.0,913.0,0.71,6.077,8,2,1,1,6,2,4,0,0.0,0.0
1009,1037,2020-03-18 14:41:00,1,1282.0,940.0,0.733,6.092,4,0,0,0,4,0,4,0,0.0,0.0
1009,1038,2020-03-18 14:44:00,1,1278.0,919.0,0.719,6.052,4,0,0,0,4,0,4,0,0.0,0.0
1009,1039,2020-03-18 14:47:00,1,1273.0,948.0,0.745,6.064,3,0,0,0,3,0,3,0,0.0,0.0
1009,1040,2020-03-18 14:50:00,1,1296.0,875.0,0.675,6.076,0,0,0,0,0,0,0,0,0.0,0.0
1009,1041,2020-03-18 14:53:00,1,1294.0,874.0,0.675,6.068,2,0,0,0,2,0,2,0,0.0,0.0
1009,1042,2020-03-18 14:56:00,1,1294.0,861.0,0.666,6.052,3,3,1,2,0,0,0,0,0.0,0.0
1009,1043,2020-03-18 14:59:00,1,1366.0,975.0,0.714,6.462,69,31,19,12,38,12,26,0,0.0,0.0
1009,1044,2020-03-18 15:02:00,1,1670.0,1283.0,0.768,7.999,228,115,92,23,113,82,31,46,0.0,0.0
1009,1045,2020-03-18 15:05:00,1,2066.0,1533.0,0.742,9.837,72,48,39,9,24,14,10,26,0.0,0.0
1009,1046,2020-03-18 15:08:00,1,1276.0,943.0,0.739,6.072,298,141,103,38,157,114,43,18,0.0,0.0
1009,1047,2020-03-18 15:11:00,1,1702.0,1160.0,0.681,7.992,151,78,57,21,73,47,26,3,0.0,0.0
1009,1048,2020-03-18 15:14:00,1,1711.0,1130.0,0.66,7.991,16,13,5,8,3,1,2,1,0.0,0.0
1009,1049,2020-03-18 15:17:00,1,1769.0,1247.0,0.705,8.349,16,15,0,15,1,1,0,0,0.0,0.0
1009,1050,2020-03-18 15:20:00,1,1697.0,1178.0,0.694,7.989,0,0,0,0,0,0,0,0,0.0,0.0
1009,1051,2020-03-18 15:23:00,1,1621.0,1103.0,0.68,7.608,27,15,5,10,12,0,12,0,0.0,0.0
1009,1052,2020-03-18 15:26:00,1,1612.0,1107.0,0.687,7.578,13,0,0,0,13,0,13,0,0.0,0.0
1009,1053,2020-03-18 15:29:00,1,1453.0,1017.0,0.7,6.851,22,1,1,0,21,6,15,0,0.0,0.0
1009,1054,2020-03-18 15:32:00,1,1528.0,1078.0,0.705,7.216,4,0,0,0,4,0,4,0,0.0,0.0
1009,1055,2020-03-18 15:35:00,1,1536.0,1064.0,0.693,7.23,4,3,1,2,1,0,1,0,0.0,0.0
1009,1056,2020-03-18 15:38:00,1,1443.0,1029.0,0.713,6.827,14,2,0,2,12,3,9,0,0.0,0.0
1009,1057,2020-03-18 15:41:00,1,1281.0,931.0,0.727,6.08,11,0,0,0,11,0,11,0,0.0,0.0
1009,1058,2020-03-18 15:44:00,1,1283.0,892.0,0.695,6.043,11,1,0,1,10,2,8,0,0.0,0.0
1009,1059,2020-03-18 15:47:00,1,1280.0,935.0,0.731,6.077,7,0,0,0,7,0,7,0,0.0,0.0
1009,1060,2020-03-18 15:50:00,1,1453.0,1008.0,0.694,6.84,20,11,0,11,9,2,7,0,0.0,0.0
1009,1061,2020-03-18 15:53:00,1,1352.0,1001.0,0.74,6.436,22,9,5,4,13,2,11,0,0.0,0.0
1009,1062,2020-03-18 15:56:00,1,1283.0,922.0,0.719,6.076,9,0,0,0,9,0,9,0,0.0,0.0
1009,1063,2020-03-18 15:59:00,1,1531.0,1055.0,0.689,7.199,214,117,76,41,97,62,35,7,0.0,0.0
1009,1064,2020-03-18 16:02:00,1,1354.0,991.0,0.732,6.431,14,6,2,4,8,6,2,2,0.0,0.0
1009,1065,2020-03-18 16:05:00,1,1300.0,869.0,0.669,6.083,4,1,0,1,3,1,2,0,0.0,0.0
1009,1066,2020-03-18 16:08:00,1,1275.0,947.0,0.743,6.072,20,6,2,4,14,8,6,0,0.0,0.0
1009,1067,2020-03-18 16:11:00,1,1302.0,859.0,0.66,6.082,12,1,1,0,11,4,7,0,0.0,0.0
1009,1068,2020-03-18 16:14:00,1,1527.0,1071.0,0.701,7.2,0,0,0,0,0,0,0,0,0.0,0.0
1009,1069,2020-03-18 16:17:00,1,1545.0,1030.0,0.666,7.23,0,0,0,0,0,0,0,0,0.0,0.0
1009,1070,2020-03-18 16:20:00,1,1360.0,985.0,0.725,6.449,0,0,0,0,0,0,0,0,0.0,0.0
1009,1071,2020-03-18 16:23:00,1,1517.0,1097.0,0.723,7.19,16,4,3,1,12,8,4,0,0.0,0.0
1009,1072,2020-03-18 16:26:00,1,1695.0,1156.0,0.682,7.959,0,0,0,0,0,0,0,0,0.0,0.0
1009,1073,2020-03-18 16:29:00,1,1530.0,1061.0,0.694,7.202,0,0,0,0,0,0,0,0,0.0,0.0
1009,1074,2020-03-18 16:32:00,1,1529.0,1082.0,0.707,7.223,0,0,0,0,0,0,0,0,0.0,0.0
1009,1075,2020-03-18 16:35:00,1,1521.0,1083.0,0.712,7.194,6,5,0,5,1,1,0,0,0.0,0.0
1009,1076,2020-03-18 16:38:00,1,1533.0,1038.0,0.677,7.19,2,2,0,2,0,0,0,0,0.0,0.0
1009,1077,2020-03-18 16:41:00,1,1534.0,1052.0,0.686,7.208,14,3,1,2,11,4,7,0,0.0,0.0
1009,1078,2020-03-18 16:44:00,1,1515.0,1100.0,0.726,7.187,1,0,0,0,1,0,1,0,0.0,0.0
1009,1079,2020-03-18 16:47:00,1,1607.0,1135.0,0.706,7.588,57,12,3,9,45,4,41,0,0.0,0.0
1009,1080,2020-03-18 16:50:00,1,1684.0,1229.0,0.73,7.995,50,16,0,16,34,6,28,0,0.0,0.0
1009,1081,2020-03-18 16:53:00,1,1516.0,1114.0,0.735,7.208,12,0,0,0,12,5,7,0,0.0,0.0
1009,1082,2020-03-18 16:56:00,1,1524.0,1061.0,0.696,7.181,9,0,0,0,9,4,5,0,0.0,0.0
1009,1083,2020-03-18 16:59:00,1,1268.0,987.0,0.779,6.088,3,0,0,0,3,0,3,0,0.0,0.0
1009,1084,2020-03-18 17:02:00,1,1277.0,943.0,0.739,6.076,47,11,7,4,36,17,19,1,0.0,0.0
1009,1085,2020-03-18 17:05:00,1,1272.0,940.0,0.739,6.051,5,1,0,1,4,0,4,0,0.0,0.0
1009,1086,2020-03-18 17:08:00,1,1284.0,914.0,0.712,6.07,1,1,0,1,0,0,0,0,0.0,0.0
1009,1087,2020-03-18 17:11:00,1,1282.0,925.0,0.721,6.076,1,1,0,1,0,0,0,0,0.0,0.0
1009,1088,2020-03-18 17:14:00,1,1281.0,934.5,0.729,6.083,1,1,0,1,0,0,0,0,0.0,0.0
1009,1089,2020-03-18 17:17:00,1,1280.0,944.0,0.737,6.09,0,0,0,0,0,0,0,0,0.0,0.0
1009,1090,2020-03-18 17:20:00,1,1258.0,995.0,0.791,6.057,14,8,1,7,6,4,2,0,0.0,0.0
1009,1091,2020-03-18 17:23:00,1,1527.0,1083.0,0.709,7.214,55,17,9,8,38,22,16,0,0.0,0.0
1009,1092,2020-03-18 17:26:00,1,1350.0,1001.0,0.742,6.428,6,6,2,4,0,0,0,0,0.0,0.0
1009,1093,2020-03-18 17:29:00,1,1530.0,1089.0,0.712,7.233,18,12,0,12,6,1,5,0,0.0,0.0
1009,1094,2020-03-18 17:32:00,1,1297.0,883.0,0.681,6.089,13,7,0,7,6,2,4,0,0.0,0.0
1009,1095,2020-03-18 17:35:00,1,1288.0,907.0,0.704,6.078,21,8,1,7,13,8,5,0,0.0,0.0
1009,1096,2020-03-18 17:38:00,1,1271.0,963.0,0.758,6.076,2,2,1,1,0,0,0,0,0.0,0.0
1009,1097,2020-03-18 17:41:00,1,1352.0,1015.0,0.751,6.451,42,15,0,15,27,5,22,0,0.0,0.0
1009,1098,2020-03-18 17:44:00,1,1750.0,1316.0,0.752,8.354,45,18,0,18,27,3,24,2,0.0,0.61
1009,1099,2020-03-18 17:47:00,1,1603.0,1158.0,0.722,7.599,21,20,2,18,1,1,0,0,0.0,0.0
1009,1100,2020-03-18 17:50:00,1,1672.0,1232.0,0.737,7.953,42,24,2,22,18,5,13,0,0.0,0.13
1009,1101,2020-03-18 17:53:00,1,2077.0,1525.0,0.734,9.872,309,124,75,49,185,122,63,30,0.0,0.0
1009,1102,2020-03-18 17:56:00,1,1821.0,1404.0,0.771,8.731,145,76,48,28,69,34,35,89,0.0,0.0
1009,1103,2020-03-18 17:59:00,1,1670.0,1263.0,0.757,7.978,257,112,76,36,145,96,49,84,0.0,0.0
1009,1104,2020-03-18 18:02:00,0,1821.0,1380.0,0.758,8.702,368,197,160,37,171,126,45,117,0.0,0.0
1009,1105,2020-03-18 18:05:00,0,2082.0,1477.0,0.709,9.84,315,168,132,36,147,103,44,93,0.0,0.0
1009,1106,2020-03-18 18:08:00,0,2088.0,1442.0,0.691,9.823,112,60,27,33,52,22,30,1,0.0,0.0
1009,1107,2020-03-18 18:11:00,0,2153.0,1592.0,0.739,10.248,148,75,44,31,73,38,35,4,0.0,0.0
1009,1108,2020-03-18 18:14:00,0,1823.0,1407.0,0.772,8.742,318,151,109,42,167,121,46,39,0.0,0.0
1009,1109,2020-03-18 18:17:00,0,2101.0,1462.0,0.696,9.898,108,74,35,39,34,22,12,36,0.0,0.0
1009,1110,2020-03-18 18:20:00,0,2105.0,1445.0,0.686,9.893,35,1,0,1,34,5,29,1,0.0,0.0
1009,1111,2020-03-18 18:23:00,0,1855.0,1297.0,0.699,8.745,0,0,0,0,0,0,0,0,0.0,0.0
1009,1112,2020-03-18 18:26:00,0,1687.0,1218.0,0.722,7.994,6,1,1,0,5,2,3,0,0.0,0.0
1009,1113,2020-03-18 18:29:00,0,1685.0,1219.0,0.723,7.99,8,2,1,1,6,4,2,0,0.0,0.0
1009,1114,2020-03-18 18:32:00,0,1611.0,1123.0,0.697,7.593,0,0,0,0,0,0,0,0,0.0,0.0
1009,1115,2020-03-18 18:35:00,0,1527.0,1085.0,0.711,7.22,0,0,0,0,0,0,0,0,0.0,0.0
1009,1116,2020-03-18 18:38:00,0,1356.0,1003.0,0.74,6.455,21,11,4,7,10,1,9,0,0.0,0.0
1009,1117,2020-03-18 18:41:00,0,1674.0,1221.0,0.729,7.946,215,93,64,29,122,83,39,38,0.0,0.0
1009,1118,2020-03-18 18:44:00,0,1847.0,1321.0,0.715,8.742,61,20,5,15,41,19,22,0,0.0,0.0
1009,1119,2020-03-18 18:47:00,0,1840.0,1328.0,0.722,8.719,281,144,107,37,137,86,51,99,0.0,0.0
1009,1120,2020-03-18 18:50:00,0,2074.0,1538.0,0.742,9.875,202,118,79,39,84,41,43,75,0.0,0.0
1009,1121,2020-03-18 18:53:00,0,2085.0,1446.0,0.693,9.817,171,122,55,67,49,19,30,96,0.0,0.0
1009,1122,2020-03-18 18:56:00,0,2227.0,1620.0,0.727,10.57,124,59,25,34,65,17,48,70,0.0,0.0
1009,1123,2020-03-18 18:59:00,0,2233.0,1637.0,0.733,10.612,152,92,44,48,60,16,44,82,0.0,0.0
1009,1124,2020-03-18 19:02:00,0,2488.0,1782.0,0.716,11.775,216,112,59,53,104,44,60,104,0.0,0.0
1009,1125,2020-03-18 19:05:00,0,2557.0,1858.0,0.727,12.132,150,78,27,51,72,10,62,85,0.0,0.0
1009,1126,2020-03-18 19:08:00,0,2480.0,1820.0,0.734,11.788,134,72,26,46,62,12,50,61,0.0,0.0
1009,1127,2020-03-18 19:11:00,0,2377.0,1793.0,0.754,11.35,338,194,143,51,144,87,57,116,0.11,0.0
1009,1128,2020-03-18 19:14:00,0,2636.0,1898.0,0.72,12.488,146,63,19,44,83,10,73,86,0.0,0.0
1009,1129,2020-03-18 19:17:00,0,2640.0,1964.0,0.744,12.576,298,171,117,54,127,81,46,75,0.0,0.0
1009,1130,2020-03-18 19:20:00,0,2643.0,1923.0,0.727,12.544,181,81,42,39,100,47,53,85,0.0,0.0
1009,1131,2020-03-18 19:23:00,0,2601.0,2037.0,0.783,12.505,133,54,18,36,79,10,69,76,0.0,0.0
1009,1132,2020-03-18 19:26:00,0,2450.0,1903.0,0.777,11.761,269,120,73,47,149,96,53,105,0.0,0.0
1009,1133,2020-03-18 19:29:00,0,2456.0,1864.0,0.759,11.739,282,186,139,47,96,50,46,102,0.0,0.0
1009,1134,2020-03-18 19:32:00,0,2632.0,1949.0,0.74,12.53,125,55,10,45,70,12,58,87,0.0,0.0
1009,1135,2020-03-18 19:35:00,0,2475.0,1834.0,0.741,11.784,131,75,17,58,56,10,46,70,0.0,0.0
1009,1136,2020-03-18 19:38:00,0,2457.0,1914.0,0.779,11.8,317,163,116,47,154,107,47,48,0.0,0.0
1009,1137,2020-03-18 19:41:00,0,2089.0,1493.0,0.715,9.886,408,69,40,29,339,251,88,35,0.0,0.0
1009,1138,2020-03-18 19:44:00,0,2487.0,1840.0,0.74,11.834,308,154,101,53,154,94,60,66,0.0,0.0
1009,1139,2020-03-18 19:47:00,0,2694.0,2082.0,0.773,12.919,121,49,11,38,72,11,61,66,0.0,0.0
1009,1140,2020-03-18 19:50:00,0,2603.0,2050.0,0.787,12.525,95,44,15,29,51,16,35,45,0.0,0.0
1009,1141,2020-03-18 19:53:00,0,2288.0,1785.0,0.78,10.992,144,77,33,44,67,31,36,26,0.0,0.0
1009,1142,2020-03-18 19:56:00,0,2059.0,1617.0,0.785,9.903,153,71,34,37,82,43,39,75,0.0,0.0
1009,1143,2020-03-18 19:59:00,0,2297.0,1786.0,0.778,11.029,107,67,23,44,40,17,23,50,0.0,0.0
1009,1144,2020-03-18 20:02:00,0,2292.0,1810.0,0.79,11.034,98,79,24,55,19,6,13,1,0.0,0.0
1009,1145,2020-03-18 20:05:00,0,2386.0,1837.0,0.77,11.433,63,41,2,39,22,3,19,1,0.0,0.0
1009,1146,2020-03-18 20:08:00,0,1826.0,1390.0,0.761,8.732,10,1,1,0,9,5,4,0,0.0,0.0
1009,1147,2020-03-18 20:11:00,0,1824.0,1380.0,0.756,8.715,5,1,0,1,4,2,2,0,0.0,0.0
1009,1148,2020-03-18 20:14:00,0,1743.0,1327.0,0.7615,8.3365,12,4,1,3,8,1,7,0,0.0,0.0
1009,1149,2020-03-18 20:17:00,0,1662.0,1274.0,0.767,7.958,28,6,2,4,22,8,14,0,0.0,0.0
1009,1150,2020-03-18 20:20:00,0,1683.0,1222.0,0.726,7.983,3,0,0,0,3,2,1,0,0.0,0.0
1009,1151,2020-03-18 20:23:00,0,1509.0,1145.0,0.758,7.215,9,0,0,0,9,5,4,0,0.0,0.0
1009,1152,2020-03-18 20:26:00,0,1515.0,1126.0,0.744,7.214,17,3,0,3,14,4,10,0,0.0,0.0
1009,1153,2020-03-18 20:29:00,0,1686.0,1182.0,0.702,7.95,59,19,13,6,40,24,16,5,0.0,0.0
1009,1154,2020-03-18 20:32:00,0,1691.0,1182.0,0.699,7.973,10,0,0,0,10,0,10,0,0.0,0.0
1009,1155,2020-03-18 20:35:00,0,1509.0,1152.0,0.763,7.222,16,6,3,3,10,0,10,0,0.0,0.0
1009,1156,2020-03-18 20:38:00,0,1837.0,1327.0,0.722,8.707,35,20,10,10,15,10,5,1,0.0,0.0
1009,1157,2020-03-18 20:41:00,0,1756.0,1323.0,0.754,8.384,12,7,0,7,5,0,5,0,0.0,0.0
1009,1158,2020-03-18 20:44:00,0,1676.0,1221.0,0.729,7.954,17,2,1,1,15,5,10,0,0.0,0.0
1009,1159,2020-03-18 20:47:00,0,1681.0,1210.0,0.72,7.962,107,26,2,24,81,24,57,0,0.0,0.0
1009,1160,2020-03-18 20:50:00,0,2051.0,1586.0,0.773,9.838,238,82,61,21,156,109,47,17,0.0,0.0
1009,1161,2020-03-18 20:53:00,0,2085.0,1496.0,0.718,9.871,134,46,20,26,88,25,63,95,0.0,0.0
1009,1162,2020-03-18 20:56:00,0,2233.0,1614.0,0.723,10.585,135,61,20,41,74,4,70,117,0.0,0.0
1009,1163,2020-03-18 20:59:00,0,2471.0,1849.0,0.748,11.782,166,77,40,37,89,26,63,126,0.0,0.0
1009,1164,2020-03-18 21:02:00,0,2547.0,1887.0,0.741,12.124,171,82,34,48,89,16,73,98,0.0,0.0
1009,1165,2020-03-18 21:05:00,0,2612.0,2020.0,0.773,12.527,141,60,20,40,81,11,70,88,0.0,0.0
1009,1166,2020-03-18 21:08:00,0,2299.0,1757.0,0.764,11.004,308,151,116,35,157,103,54,74,0.01,0.0
1009,1167,2020-03-18 21:11:00,0,2216.0,1704.0,0.769,10.617,200,89,53,36,111,48,63,102,0.0,0.0
1009,1168,2020-03-18 21:14:00,0,2788.0,2069.0,0.742,13.276,137,57,18,39,80,26,54,85,0.0,0.0
1009,1169,2020-03-18 21:17:00,0,2646.0,1934.0,0.731,12.567,116,58,25,33,58,17,41,53,0.0,0.0
1009,1170,2020-03-18 21:20:00,0,2475.0,1848.0,0.746,11.799,249,125,72,53,124,64,60,75,0.0,0.0
1009,1171,2020-03-18 21:23:00,0,2605.0,2036.0,0.782,12.518,136,66,28,38,70,31,39,93,0.0,0.0
1009,1172,2020-03-18 21:26:00,0,2922.0,2304.0,0.789,14.064,151,53,21,32,98,24,74,114,0.0,0.0
1009,1173,2020-03-18 21:29:00,0,2695.0,2095.0,0.777,12.936,137,66,32,34,71,21,50,54,0.0,0.0
1009,1174,2020-03-18 21:32:00,0,2749.0,2230.0,0.811,13.299,161,73,32,41,88,24,64,70,0.0,0.0
1009,1175,2020-03-18 21:35:00,0,2823.0,2299.0,0.814,13.666,139,77,40,37,62,17,45,86,0.0,0.0
1009,1176,2020-03-18 21:38:00,0,2762.0,2168.0,0.785,13.283,163,73,30,43,90,24,66,95,0.0,0.0
1009,1177,2020-03-18 21:41:00,0,2597.0,2093.0,0.806,12.55,143,54,18,36,89,50,39,94,0.36,0.0
1009,1178,2020-03-18 21:44:00,0,2756.0,2239.0,0.812,13.339,287,146,90,56,141,93,48,77,0.0,0.0
1009,1179,2020-03-18 21:47:00,0,2759.0,2228.0,0.807,13.339,162,82,21,61,80,24,56,90,0.0,0.0
1009,1180,2020-03-18 21:50:00,0,2741.0,2275.0,0.83,13.32,173,91,39,52,82,20,62,102,0.0,0.0
1009,1181,2020-03-18 21:53:00,0,2757.0,2217.0,0.804,13.317,159,62,20,42,97,22,75,95,0.0,0.0
1009,1182,2020-03-18 21:56:00,0,2738.0,2294.0,0.838,13.327,164,61,18,43,103,21,82,99,0.0,0.0
1009,1183,2020-03-18 21:59:00,0,2750.0,2269.0,0.825,13.345,132,43,10,33,89,16,73,80,0.0,0.0
1009,1184,2020-03-18 22:02:00,0,2749.0,2243.0,0.816,13.315,110,33,9,24,77,11,66,97,0.0,0.0
1009,1185,2020-03-18 22:05:00,0,2728.0,2302.0,0.844,13.297,126,45,14,31,81,4,77,94,0.0,0.0
1009,1186,2020-03-18 22:08:00,0,2569.0,2141.0,0.834,12.491,164,40,10,30,124,53,71,55,0.16,0.0
1009,1187,2020-03-18 22:11:00,0,2588.0,2122.0,0.82,12.546,362,157,128,29,205,138,67,102,0.0,0.0
1009,1188,2020-03-18 22:14:00,0,1952.0,1608.0,0.824,9.47,259,125,93,32,134,90,44,27,0.0,0.0
1009,1189,2020-03-18 22:17:00,0,2589.0,2129.0,0.822,12.557,531,264,207,57,267,199,68,104,0.0,0.0
1009,1190,2020-03-18 22:20:00,0,2573.0,2154.0,0.837,12.521,345,169,136,33,176,90,86,138,0.0,0.0
1009,1191,2020-03-18 22:23:00,0,2674.0,2204.0,0.824,12.978,141,45,13,32,96,23,73,116,0.0,0.0
1009,1192,2020-03-18 22:26:00,0,2174.0,1883.0,0.866,10.651,177,84,50,34,93,56,37,10,0.0,0.0
1009,1193,2020-03-18 22:29:00,0,2047.0,1614.0,0.788,9.854,354,194,153,41,160,115,45,49,0.0,0.0
1009,1194,2020-03-18 22:32:00,0,1882.0,1572.0,0.835,9.155,279,133,90,43,146,114,32,68,0.0,0.0
1009,1195,2020-03-18 22:35:00,0,2575.0,2158.0,0.838,12.534,153,86,43,43,67,24,43,11,0.0,0.0
1009,1196,2020-03-18 22:38:00,0,2558.0,2202.0,0.861,12.517,27,11,0,11,16,8,8,1,0.0,0.0
1009,1197,2020-03-18 22:41:00,0,2578.0,2134.0,0.828,12.521,53,23,8,15,30,6,24,0,0.0,0.0
1009,1198,2020-03-18 22:44:00,0,2608.0,2071.0,0.794,12.569,25,11,2,9,14,2,12,0,0.0,0.0
1009,1199,2020-03-18 22:47:00,0,2206.0,1768.0,0.802,10.649,11,4,1,3,7,0,7,0,0.0,0.0
1009,1200,2020-03-18 22:50:00,0,2059.0,1574.0,0.765,9.855,14,5,1,4,9,0,9,0,0.0,0.0
1009,1201,2020-03-18 22:53:00,0,1887.0,1494.0,0.791,9.09,0,0,0,0,0,0,0,0,0.0,0.0
1009,1202,2020-03-18 22:56:00,0,1799.0,1483.0,0.824,8.73,222,99,59,40,123,80,43,17,0.0,0.0
1009,1203,2020-03-18 22:59:00,0,2364.0,1896.0,0.802,11.414,180,103,75,28,77,51,26,73,0.0,0.0
1009,1204,2020-03-18 23:02:00,0,2057.0,1607.0,0.781,9.884,225,112,69,43,113,34,79,103,0.0,0.0
1009,1205,2020-03-18 23:05:00,0,2199.0,1756.0,0.798,10.609,96,39,19,20,57,6,51,85,0.0,0.0
1009,1206,2020-03-18 23:08:00,0,2428.0,1990.0,0.819,11.77,148,61,20,41,87,12,75,90,0.0,0.0
1009,1207,2020-03-18 23:11:00,0,2608.0,2041.0,0.783,12.534,108,36,9,27,72,9,63,96,0.0,0.0
1009,1208,2020-03-18 23:14:00,0,2553.0,2060.0,0.8075,12.339,122,53,16,37,69,5,64,89,0.0,0.0
1009,1209,2020-03-18 23:17:00,0,2498.0,2079.0,0.832,12.144,166,80,20,60,86,20,66,102,0.0,0.0
1009,1210,2020-03-18 23:20:00,0,2504.0,2093.0,0.836,12.183,133,67,19,48,66,6,60,70,0.0,0.0
1009,1211,2020-03-18 23:23:00,0,2497.0,2095.0,0.839,12.156,209,90,61,29,119,67,52,40,0.04,0.0
1009,1212,2020-03-18 23:26:00,0,2323.0,2020.0,0.869,11.39,390,180,122,58,210,156,54,42,0.0,0.0
1009,1213,2020-03-18 23:29:00,0,2034.0,1693.0,0.833,9.887,283,156,112,44,127,97,30,19,0.0,0.0
1009,1214,2020-03-18 23:32:00,0,2355.0,1959.0,0.832,11.447,179,82,49,33,97,29,68,113,0.0,0.0
1009,1215,2020-03-18 23:35:00,0,2653.0,2238.0,0.844,12.931,131,75,23,52,56,7,49,92,0.0,0.0
1009,1216,2020-03-18 23:38:00,0,2659.0,2236.0,0.841,12.952,122,50,11,39,72,9,63,84,0.0,0.0
1009,1217,2020-03-18 23:41:00,0,2629.0,2330.0,0.886,12.937,177,88,22,66,89,20,69,90,0.0,0.0
1009,1218,2020-03-18 23:44:00,0,2472.0,2171.0,0.878,12.144,145,61,8,53,84,9,75,81,0.0,0.0
1009,1219,2020-03-18 23:47:00,0,2651.0,2212.0,0.834,12.893,145,58,14,44,87,31,56,38,0.0,0.0
1009,1220,2020-03-18 23:50:00,0,2476.0,2180.0,0.881,12.168,164,77,30,47,87,22,65,77,0.0,0.0
1009,1221,2020-03-18 23:53:00,0,2652.0,2234.0,0.842,12.923,164,82,23,59,82,9,73,90,0.0,0.0
1009,1222,2020-03-18 23:56:00,0,2481.0,2152.0,0.867,12.156,164,66,20,46,98,28,70,88,0.0,0.0
1009,1223,2020-03-18 23:59:00,0,2635.0,2273.0,0.862,12.899,149,69,20,49,80,10,70,87,0.0,0.0
1009,1224,2020-03-19 00:02:00,0,2810.0,2380.0,0.847,13.706,142,47,10,37,95,7,88,95,0.0,0.0
1009,1225,2020-03-19 00:05:00,0,2610.0,2385.0,0.914,12.925,101,29,4,25,72,0,72,77,0.0,0.0
1009,1226,2020-03-19 00:08:00,0,2620.0,2376.0,0.907,12.953,126,41,12,29,85,12,73,83,0.0,0.0
1009,1227,2020-03-19 00:11:00,0,2632.0,2298.0,0.873,12.913,78,24,1,23,54,0,54,74,0.0,0.0
1009,1228,2020-03-19 00:14:00,0,2707.0,2402.0,0.888,13.324,120,38,18,20,82,14,68,93,0.0,0.0
1009,1229,2020-03-19 00:17:00,0,2615.0,2338.0,0.894,12.89,110,39,9,30,71,0,71,98,0.0,0.0
1009,1230,2020-03-19 00:20:00,0,2628.0,2341.0,0.891,12.945,205,89,56,33,116,44,72,99,0.0,0.0
1009,1231,2020-03-19 00:23:00,0,2684.0,2434.0,0.907,13.27,165,76,34,42,89,11,78,102,0.0,0.01
1009,1232,2020-03-19 00:26:00,0,2861.0,2527.0,0.883,14.069,115,44,13,31,71,0,71,102,0.0,0.08
1009,1233,2020-03-19 00:29:00,0,2863.0,2518.0,0.879,14.069,168,44,19,25,124,47,77,83,0.1,0.09
1009,1234,2020-03-19 00:32:00,0,2856.0,2515.0,0.881,14.037,139,38,16,22,101,38,63,92,0.0,0.03
1009,1235,2020-03-19 00:35:00,0,2623.0,2352.0,0.897,12.94,318,141,105,36,177,105,72,84,0.23,0.02
1009,1236,2020-03-19 00:38:00,0,2850.0,2539.0,0.891,14.04,333,146,113,33,187,137,50,130,0.33,0.08
1009,1237,2020-03-19 00:41:00,0,2847.0,2579.0,0.906,14.072,124,52,36,16,72,34,38,67,0.0,0.23
1009,1238,2020-03-19 00:44:00,0,2593.0,2466.0,0.951,12.946,6,0,0,0,6,4,2,0,0.0,0.0
1009,1239,2020-03-19 00:47:00,0,2679.0,2544.0,0.95,13.37,186,100,79,21,86,66,20,45,0.2,0.01
1009,1240,2020-03-19 00:50:00,0,2291.0,2174.0,0.949,11.435,532,250,197,53,282,221,61,101,0.19,0.0
1009,1241,2020-03-19 00:53:00,0,2447.0,2304.0,0.942,12.192,460,210,172,38,250,190,60,138,0.0,0.0
1009,1242,2020-03-19 00:56:00,0,2440.0,2298.0,0.942,12.158,223,123,84,39,100,54,46,10,0.0,0.02
1009,1243,2020-03-19 00:59:00,0,2381.0,2213.0,0.93,11.832,479,248,186,62,231,170,61,36,0.0,0.02
1009,1244,2020-03-19 01:02:00,0,2312.0,2092.0,0.905,11.423,443,196,147,49,247,187,60,143,0.0,0.0
1009,1245,2020-03-19 01:05:00,0,2436.0,2323.0,0.954,12.169,346,168,135,33,178,135,43,295,0.0,0.0
1009,1246,2020-03-19 01:08:00,0,2296.0,2101.0,0.915,11.374,185,90,78,12,95,74,21,325,0.0,0.0
1009,1247,2020-03-19 01:11:00,0,2294.0,2144.0,0.935,11.411,257,132,109,23,125,94,31,302,0.0,0.0
1009,1248,2020-03-19 01:14:00,0,2443.0,2323.0,0.951,12.196,233,106,65,41,127,88,39,68,0.0,0.0
1009,1249,2020-03-19 01:17:00,0,2296.0,2154.0,0.938,11.431,240,108,75,33,132,91,41,9,0.0,0.0
1009,1250,2020-03-19 01:20:00,0,2427.0,2385.0,0.983,12.202,415,169,126,43,246,184,62,3,0.0,0.01
1009,1251,2020-03-19 01:23:00,0,2442.0,2273.0,0.931,12.138,622,265,194,71,357,272,85,5,0.0,0.0
1009,1252,2020-03-19 01:26:00,0,2029.0,2044.0,1.007,10.259,640,305,240,65,335,251,84,105,0.0,0.0
1009,1253,2020-03-19 01:29:00,0,2285.0,2158.0,0.945,11.393,324,170,133,37,154,111,43,181,0.0,0.0
1009,1254,2020-03-19 01:32:00,0,2044.0,2027.0,0.992,10.296,166,81,68,13,85,59,26,241,0.0,0.0
1009,1255,2020-03-19 01:35:00,0,2280.0,2204.0,0.967,11.425,193,88,59,29,105,42,63,150,0.0,0.0
1009,1256,2020-03-19 01:38:00,0,2307.0,2142.0,0.928,11.462,505,227,167,60,278,199,79,45,0.0,0.0
1009,1257,2020-03-19 01:41:00,0,2451.0,2286.0,0.932,12.189,519,243,176,67,276,215,61,12,0.0,0.0
1009,1258,2020-03-19 01:44:00,0,2460.0,2263.0,0.92,12.197,719,319,241,78,400,298,102,1,0.0,0.0
1009,1259,2020-03-19 01:47:00,0,1692.0,1566.0,0.926,8.402,367,139,104,35,228,166,62,3,0.0,0.0
1009,1260,2020-03-19 01:50:00,0,2293.0,2136.0,0.932,11.4,47,13,4,9,34,7,27,1,0.0,0.0
1009,1261,2020-03-19 01:53:00,0,2077.0,1880.0,0.905,10.267,70,4,0,4,66,19,47,1,0.0,0.0
1009,1262,2020-03-19 01:56:00,0,2298.0,2165.0,0.942,11.451,167,104,42,62,63,19,44,1,0.0,0.0
1009,1263,2020-03-19 01:59:00,0,2300.0,2142.0,0.931,11.434,64,17,6,11,47,4,43,0,0.0,0.0
1009,1264,2020-03-19 02:02:00,0,2075.0,1908.0,0.92,10.287,62,28,16,12,34,15,19,0,0.0,0.0
1009,1265,2020-03-19 02:05:00,0,1906.0,1782.0,0.935,9.481,21,16,5,11,5,1,4,0,0.0,0.0
1009,1266,2020-03-19 02:08:00,0,1758.0,1628.0,0.926,8.728,5,5,0,5,0,0,0,0,0.0,0.0
1009,1267,2020-03-19 02:11:00,0,1696.0,1539.0,0.907,8.387,542,309,228,81,233,179,54,8,0.0,0.0
1009,1268,2020-03-19 02:14:00,0,1845.5,1690.5,0.915,9.144,922,416,322,94,506,388,118,20,0.0,0.0
1009,1269,2020-03-19 02:17:00,0,1995.0,1842.0,0.923,9.901,135,81,38,43,54,32,22,0,0.0,0.0
1009,1270,2020-03-19 02:20:00,0,2026.0,1733.0,0.855,9.903,0,0,0,0,0,0,0,0,0.0,0.0
1009,1271,2020-03-19 02:23:00,0,1764.0,1616.0,0.916,8.738,0,0,0,0,0,0,0,0,0.0,0.0
1009,1272,2020-03-19 02:26:00,0,1798.0,1507.0,0.839,8.751,1,1,0,1,0,0,0,0,0.0,0.0
1009,1273,2020-03-19 02:29:00,0,1620.0,1457.0,0.9,7.995,17,17,0,17,0,0,0,0,0.0,0.0
1009,1274,2020-03-19 02:32:00,0,1631.0,1424.0,0.873,8.002,0,0,0,0,0,0,0,0,0.0,0.0
1009,1275,2020-03-19 02:35:00,0,1634.0,1408.0,0.861,7.997,29,28,1,27,1,1,0,0,0.0,0.0
1009,1276,2020-03-19 02:38:00,0,1645.0,1368.0,0.832,7.994,14,14,0,14,0,0,0,0,0.0,0.0
1009,1277,2020-03-19 02:41:00,0,1463.0,1282.0,0.877,7.184,2,2,1,1,0,0,0,0,0.0,0.0
1009,1278,2020-03-19 02:44:00,0,1472.0,1289.0,0.876,7.228,17,11,5,6,6,3,3,0,0.0,0.0
1009,1279,2020-03-19 02:47:00,0,1470.0,1280.0,0.871,7.21,1,0,0,0,1,0,1,0,0.0,0.0
1009,1280,2020-03-19 02:50:00,0,1462.0,1319.0,0.902,7.22,12,7,2,5,5,1,4,0,0.0,0.0
1009,1281,2020-03-19 02:53:00,0,1461.0,1336.0,0.914,7.237,13,13,7,6,0,0,0,0,0.0,0.0
1009,1282,2020-03-19 02:56:00,0,1553.0,1356.0,0.874,7.62,30,27,7,20,3,3,0,0,0.0,0.0
1009,1283,2020-03-19 02:59:00,0,1635.0,1428.0,0.873,8.021,39,25,15,10,14,2,12,0,0.0,0.0
1009,1284,2020-03-19 03:02:00,0,2005.0,1790.0,0.893,9.88,313,195,145,50,118,72,46,109,0.0,0.0
1009,1285,2020-03-19 03:05:00,0,2008.0,1781.0,0.887,9.882,155,84,47,37,71,52,19,23,0.0,0.0
1009,1286,2020-03-19 03:08:00,0,1997.0,1831.0,0.917,9.895,90,48,20,28,42,9,33,8,0.0,0.0
1009,1287,2020-03-19 03:11:00,0,2158.0,1970.0,0.913,10.683,72,31,18,13,41,12,29,0,0.0,0.0
1009,1288,2020-03-19 03:14:00,0,1951.0,1638.0,0.839,9.5,1,1,0,1,0,0,0,0,0.0,0.0
1009,1289,2020-03-19 03:17:00,0,2024.0,1734.0,0.856,9.895,158,81,52,29,77,60,17,6,0.0,0.0
1009,1290,2020-03-19 03:20:00,0,1761.0,1654.0,0.939,8.771,1,1,0,1,0,0,0,0,0.0,0.0
1009,1291,2020-03-19 03:23:00,0,1788.0,1551.0,0.867,8.761,3,3,2,1,0,0,0,0,0.0,0.0
1009,1292,2020-03-19 03:26:00,0,1610.0,1507.0,0.936,8.01,2,2,0,2,0,0,0,0,0.0,0.0
1009,1293,2020-03-19 03:29:00,0,1636.0,1359.0,0.83,7.952,12,12,0,12,0,0,0,0,0.0,0.0
1009,1294,2020-03-19 03:32:00,0,1635.0,1410.0,0.862,8.003,1,1,0,1,0,0,0,0,0.0,0.0
1009,1295,2020-03-19 03:35:00,0,1468.0,1319.0,0.899,7.242,0,0,0,0,0,0,0,0,0.0,0.0
1009,1296,2020-03-19 03:38:00,0,1471.0,1255.0,0.853,7.185,7,7,0,7,0,0,0,0,0.0,0.0
1009,1297,2020-03-19 03:41:00,0,1468.0,1306.0,0.89,7.229,0,0,0,0,0,0,0,0,0.0,0.0
1009,1298,2020-03-19 03:44:00,0,1466.0,1318.0,0.899,7.235,4,4,0,4,0,0,0,0,0.0,0.0
1009,1299,2020-03-19 03:47:00,0,1463.0,1333.0,0.911,7.24,4,4,0,4,0,0,0,0,0.0,0.0
1009,1300,2020-03-19 03:50:00,0,1469.0,1320.0,0.899,7.247,4,0,0,0,4,0,4,0,0.0,0.0
1009,1301,2020-03-19 03:53:00,0,1448.0,1390.0,0.96,7.242,7,2,0,2,5,0,5,0,0.0,0.0
1009,1302,2020-03-19 03:56:00,0,1456.0,1370.0,0.941,7.253,17,11,7,4,6,2,4,0,0.0,0.0
1009,1303,2020-03-19 03:59:00,0,1549.0,1371.0,0.885,7.622,18,17,1,16,1,0,1,0,0.0,0.0
1009,1304,2020-03-19 04:02:00,0,1625.0,1421.0,0.875,7.975,25,13,5,8,12,5,7,0,0.0,0.0
1009,1305,2020-03-19 04:05:00,0,1636.0,1374.0,0.84,7.968,5,0,0,0,5,2,3,0,0.0,0.0
1009,1306,2020-03-19 04:08:00,0,1644.0,1333.0,0.811,7.954,4,0,0,0,4,0,4,0,0.0,0.0
1009,1307,2020-03-19 04:11:00,0,1645.0,1343.0,0.816,7.969,17,5,2,3,12,3,9,1,0.0,0.0
1009,1308,2020-03-19 04:14:00,0,1777.0,1592.0,0.896,8.764,342,149,113,36,193,136,57,79,0.0,0.0
1009,1309,2020-03-19 04:17:00,0,2080.0,1904.0,0.915,10.302,245,113,89,24,132,91,41,110,0.0,0.0
1009,1310,2020-03-19 04:20:00,0,2401.0,2083.0,0.868,11.766,167,90,46,44,77,16,61,118,0.0,0.0
1009,1311,2020-03-19 04:23:00,0,2557.0,2245.0,0.878,12.558,133,48,15,33,85,16,69,108,0.0,0.0
1009,1312,2020-03-19 04:26:00,0,2535.0,2320.0,0.915,12.556,136,55,25,30,81,34,47,108,0.0,0.0
1009,1313,2020-03-19 04:29:00,0,2531.0,2298.0,0.908,12.518,439,235,187,48,204,138,66,114,0.0,0.01
1009,1314,2020-03-19 04:32:00,0,2536.0,2318.0,0.914,12.56,292,123,97,26,169,113,56,103,0.0,0.12
1009,1315,2020-03-19 04:35:00,0,2688.0,2451.0,0.912,13.304,352,132,101,31,220,153,67,112,0.0,0.0
1009,1316,2020-03-19 04:38:00,0,2667.0,2552.0,0.957,13.335,239,118,76,42,121,62,59,105,0.0,0.05
1009,1317,2020-03-19 04:41:00,0,2534.0,2334.0,0.921,12.57,142,65,40,25,77,18,59,111,0.0,0.04
1009,1318,2020-03-19 04:44:00,0,2527.0,2399.0,0.949,12.61,143,69,42,27,74,16,58,90,0.0,0.06
1009,1319,2020-03-19 04:47:00,0,2754.0,2601.0,0.944,13.732,365,163,128,35,202,141,61,102,0.07,0.01
1009,1320,2020-03-19 04:50:00,0,2561.0,2244.0,0.876,12.574,178,74,50,24,104,57,47,78,0.08,0.04
1009,1321,2020-03-19 04:53:00,0,2829.0,2609.0,0.922,14.035,200,122,90,32,78,45,33,74,0.0,0.05
1009,1322,2020-03-19 04:56:00,0,2514.0,2387.0,0.949,12.547,202,108,75,33,94,64,30,69,0.12,0.0
1009,1323,2020-03-19 04:59:00,0,2538.0,2302.0,0.907,12.547,109,67,40,27,42,20,22,16,0.0,0.0
1009,1324,2020-03-19 05:02:00,0,2529.0,2348.0,0.928,12.565,158,66,43,23,92,47,45,53,0.01,0.0
1009,1325,2020-03-19 05:05:00,0,2685.0,2535.0,0.944,13.386,197,86,40,46,111,27,84,90,0.0,0.0
1009,1326,2020-03-19 05:08:00,0,2587.0,2449.0,0.947,12.904,206,85,57,28,121,64,57,71,0.0,0.08
1009,1327,2020-03-19 05:11:00,0,2512.0,2373.0,0.945,12.523,178,86,66,20,92,55,37,60,0.12,0.0
1009,1328,2020-03-19 05:14:00,0,2524.0,2370.5,0.9395,12.568,145,82,60,22,63,26,37,78,0.0,0.0
1009,1329,2020-03-19 05:17:00,0,2536.0,2368.0,0.934,12.613,134,69,50,19,65,24,41,86,0.0,0.0
1009,1330,2020-03-19 05:20:00,0,2701.0,2431.0,0.9,13.335,225,99,73,26,126,73,53,33,0.16,0.0
1009,1331,2020-03-19 05:23:00,0,2220.0,2046.0,0.922,11.013,631,285,220,65,346,268,78,33,0.0,0.0
1009,1332,2020-03-19 05:26:00,0,2370.0,2190.0,0.924,11.761,676,319,243,76,357,257,100,2,0.0,0.0
1009,1333,2020-03-19 05:29:00,0,2523.0,2346.0,0.93,12.537,263,118,82,36,145,105,40,216,0.0,0.0
1009,1334,2020-03-19 05:32:00,0,2220.0,2047.0,0.922,11.014,306,169,143,26,137,110,27,306,0.0,0.0
1009,1335,2020-03-19 05:35:00,0,2556.0,2257.0,0.883,12.57,157,81,67,14,76,61,15,366,0.0,0.0
1009,1336,2020-03-19 05:38:00,0,2550.0,2231.0,0.875,12.515,266,131,107,24,135,112,23,346,0.0,0.0
1009,1337,2020-03-19 05:41:00,0,2695.0,2455.0,0.911,13.337,150,69,59,10,81,62,19,279,0.0,0.0
1009,1338,2020-03-19 05:44:00,0,2525.0,2337.0,0.926,12.535,338,165,129,36,173,121,52,193,0.0,0.0
1009,1339,2020-03-19 05:47:00,0,2402.0,2116.0,0.881,11.806,548,233,184,49,315,240,75,6,0.0,0.0
1009,1340,2020-03-19 05:50:00,0,2149.0,1997.0,0.929,10.677,319,119,71,48,200,140,60,37,0.0,0.0
1009,1341,2020-03-19 05:53:00,0,2311.0,2056.0,0.89,11.38,818,342,263,79,476,363,113,13,0.0,0.0
1009,1342,2020-03-19 05:56:00,0,2544.0,2293.0,0.901,12.561,952,406,312,94,546,424,122,7,0.0,0.02
1009,1343,2020-03-19 05:59:00,0,2386.0,2167.0,0.908,11.802,745,317,244,73,428,326,102,25,0.0,0.0
1009,1344,2020-03-19 06:02:00,1,2365.0,2246.0,0.95,11.803,356,150,129,21,206,157,49,264,0.0,0.0
1009,1345,2020-03-19 06:05:00,1,2305.0,2124.0,0.922,11.432,247,117,92,25,130,96,34,152,0.0,0.0
1009,1346,2020-03-19 06:08:00,1,2152.0,1975.0,0.918,10.667,159,130,64,66,29,2,27,0,0.0,0.0
1009,1347,2020-03-19 06:11:00,1,2158.0,1963.0,0.91,10.675,77,34,17,17,43,2,41,0,0.0,0.0
1009,1348,2020-03-19 06:14:00,1,2180.0,1864.0,0.855,10.652,14,4,1,3,10,0,10,0,0.0,0.0
1009,1349,2020-03-19 06:17:00,1,2050.0,1643.0,0.801,9.897,23,9,2,7,14,0,14,0,0.0,0.0
1009,1350,2020-03-19 06:20:00,1,1868.0,1603.0,0.858,9.134,9,2,0,2,7,0,7,0,0.0,0.0
1009,1351,2020-03-19 06:23:00,1,1802.0,1484.0,0.824,8.741,0,0,0,0,0,0,0,0,0.0,0.0
1009,1352,2020-03-19 06:26:00,1,1784.0,1552.0,0.87,8.748,19,10,4,6,9,5,4,0,0.0,0.0
1009,1353,2020-03-19 06:29:00,1,1619.0,1436.0,0.887,7.968,10,7,2,5,3,1,2,0,0.0,0.0
1009,1354,2020-03-19 06:32:00,1,1635.0,1397.0,0.854,7.987,29,25,7,18,4,2,2,0,0.0,0.0
1009,1355,2020-03-19 06:35:00,1,1693.0,1523.0,0.9,8.356,58,35,14,21,23,3,20,2,0.0,0.0
1009,1356,2020-03-19 06:38:00,1,1788.0,1568.0,0.877,8.78,0,0,0,0,0,0,0,0,0.0,0.0
1009,1357,2020-03-19 06:41:00,1,1637.0,1393.0,0.851,7.992,1,0,0,0,1,0,1,0,0.0,0.0
1009,1358,2020-03-19 06:44:00,1,1638.0,1384.0,0.845,7.987,4,0,0,0,4,2,2,0,0.0,0.0
1009,1359,2020-03-19 06:47:00,1,1545.0,1372.0,0.888,7.605,36,13,4,9,23,11,12,0,0.0,0.0
1009,1360,2020-03-19 06:50:00,1,1783.0,1592.0,0.892,8.789,237,124,77,47,113,79,34,31,0.0,0.0
1009,1361,2020-03-19 06:53:00,1,2024.0,1741.0,0.861,9.902,149,90,62,28,59,33,26,69,0.0,0.0
1009,1362,2020-03-19 06:56:00,1,1993.0,1840.0,0.923,9.889,158,98,74,24,60,21,39,54,0.0,0.0
1009,1363,2020-03-19 06:59:00,1,2164.0,1923.0,0.888,10.655,116,61,45,16,55,17,38,85,0.0,0.0
1009,1364,2020-03-19 07:02:00,1,2149.0,1985.0,0.924,10.664,158,79,54,25,79,37,42,57,0.0,0.0
1009,1365,2020-03-19 07:05:00,1,2333.0,2034.0,0.872,11.443,159,69,41,28,90,20,70,78,0.0,0.0
1009,1366,2020-03-19 07:08:00,1,2010.0,1782.0,0.886,9.894,649,308,248,60,341,256,85,34,0.0,0.01
1009,1367,2020-03-19 07:11:00,1,2086.0,1861.0,0.892,10.281,403,225,158,67,178,134,44,0,0.0,0.0
1009,1368,2020-03-19 07:14:00,1,2164.0,1942.0,0.898,10.675,624,336,256,80,288,209,79,20,0.0,0.0
1009,1369,2020-03-19 07:17:00,1,1993.0,1808.0,0.907,9.854,118,65,41,24,53,30,23,22,0.0,0.0
1009,1370,2020-03-19 07:20:00,1,2010.0,1743.0,0.867,9.851,190,91,42,49,99,55,44,0,0.0,0.0
1009,1371,2020-03-19 07:23:00,1,1949.0,1658.0,0.851,9.515,36,13,0,13,23,15,8,0,0.0,0.0
1009,1372,2020-03-19 07:26:00,1,1778.0,1556.0,0.875,8.729,30,28,7,21,2,1,1,0,0.0,0.0
1009,1373,2020-03-19 07:29:00,1,1806.0,1498.0,0.83,8.773,16,11,4,7,5,2,3,0,0.0,0.0
1009,1374,2020-03-19 07:32:00,1,1633.0,1430.0,0.876,8.017,0,0,0,0,0,0,0,0,0.0,0.0
1009,1375,2020-03-19 07:35:00,1,1634.0,1394.0,0.853,7.981,5,2,0,2,3,1,2,0,0.0,0.0
1009,1376,2020-03-19 07:38:00,1,1632.0,1401.0,0.859,7.981,4,0,0,0,4,0,4,0,0.0,0.0
1009,1377,2020-03-19 07:41:00,1,1543.0,1381.0,0.895,7.609,1,0,0,0,1,1,0,0,0.0,0.0
1009,1378,2020-03-19 07:44:00,1,1478.0,1277.0,0.864,7.236,7,0,0,0,7,0,7,0,0.0,0.0
1009,1379,2020-03-19 07:47:00,1,1397.0,1207.0,0.864,6.84,5,3,1,2,2,2,0,0,0.0,0.0
1009,1380,2020-03-19 07:50:00,1,1300.0,1208.0,0.929,6.458,1,1,0,1,0,0,0,0,0.0,0.0
1009,1381,2020-03-19 07:53:00,1,1300.0,1230.0,0.946,6.485,12,6,2,4,6,3,3,0,0.0,0.0
1009,1382,2020-03-19 07:56:00,1,1387.0,1235.0,0.89,6.83,11,1,0,1,10,1,9,0,0.0,0.0
1009,1383,2020-03-19 07:59:00,1,1206.0,1206.0,1.0,6.086,10,2,0,2,8,4,4,0,0.0,0.0
1009,1384,2020-03-19 08:02:00,1,1216.0,1208.0,0.994,6.127,16,8,2,6,8,2,6,0,0.0,0.0
1009,1385,2020-03-19 08:05:00,1,1643.0,1382.0,0.841,8.004,52,23,11,12,29,4,25,0,0.0,0.0
1009,1386,2020-03-19 08:08:00,1,1762.0,1626.0,0.923,8.743,208,102,65,37,106,65,41,56,0.0,0.0
1009,1387,2020-03-19 08:11:00,1,2066.0,1908.0,0.924,10.251,270,162,127,35,108,79,29,226,0.0,0.0
1009,1388,2020-03-19 08:14:00,1,2191.5,1987.0,0.908,10.833,137,59,46,13,78,55,23,280,0.0,0.0
1009,1389,2020-03-19 08:17:00,1,2317.0,2066.0,0.892,11.415,459,221,181,40,238,187,51,140,0.0,0.0
1009,1390,2020-03-19 08:20:00,1,2254.0,1943.0,0.862,11.031,595,288,228,60,307,226,81,42,0.0,0.0
1009,1391,2020-03-19 08:23:00,1,2328.0,2021.0,0.868,11.409,171,107,91,16,64,49,15,319,0.0,0.0
1009,1392,2020-03-19 08:26:00,1,2258.0,1931.0,0.855,11.035,159,74,58,16,85,63,22,254,0.0,0.0
1009,1393,2020-03-19 08:29:00,1,2096.0,1811.0,0.864,10.263,87,49,42,7,38,29,9,170,0.0,0.0
1009,1394,2020-03-19 08:32:00,1,2119.0,1727.0,0.815,10.262,63,31,12,19,32,12,20,67,0.0,0.0
1009,1395,2020-03-19 08:35:00,1,2292.0,1832.0,0.799,11.058,73,38,7,31,35,1,34,0,0.0,0.0
1009,1396,2020-03-19 08:38:00,1,2275.0,1887.0,0.83,11.053,57,29,9,20,28,2,26,0,0.0,0.0
1009,1397,2020-03-19 08:41:00,1,2055.0,1616.0,0.786,9.888,32,7,0,7,25,0,25,0,0.0,0.0
1009,1398,2020-03-19 08:44:00,1,1913.0,1426.0,0.745,9.118,54,18,8,10,36,6,30,0,0.0,0.0
1009,1399,2020-03-19 08:47:00,1,1763.0,1280.0,0.726,8.365,2,0,0,0,2,0,2,0,0.0,0.0
1009,1400,2020-03-19 08:50:00,1,1512.0,1136.0,0.752,7.216,20,6,0,6,14,0,14,0,0.0,0.0
1009,1401,2020-03-19 08:53:00,1,1746.0,1312.0,0.751,8.332,91,51,24,27,40,17,23,0,0.0,0.0
1009,1402,2020-03-19 08:56:00,1,1734.0,1388.0,0.801,8.368,90,11,0,11,79,32,47,0,0.0,0.0
1009,1403,2020-03-19 08:59:00,1,1754.0,1314.0,0.749,8.366,144,1,0,1,143,101,42,0,0.0,0.0
1009,1404,2020-03-19 09:02:00,1,1674.0,1247.0,0.745,7.977,71,2,0,2,69,10,59,0,0.0,0.0
1009,1405,2020-03-19 09:05:00,1,1582.0,1221.0,0.771,7.585,77,0,0,0,77,14,63,0,0.0,0.0
1009,1406,2020-03-19 09:08:00,1,1596.0,1170.0,0.733,7.584,68,0,0,0,68,2,66,0,0.0,0.0
1009,1407,2020-03-19 09:11:00,1,1657.0,1289.0,0.778,7.954,114,39,23,16,75,25,50,0,0.0,0.0
1009,1408,2020-03-19 09:14:00,1,1499.0,1179.0,0.787,7.211,101,4,0,4,97,30,67,0,0.0,0.0
1009,1409,2020-03-19 09:17:00,1,1506.0,1140.0,0.757,7.198,33,9,4,5,24,9,15,0,0.0,0.0
1009,1410,2020-03-19 09:20:00,1,1330.0,1107.0,0.832,6.466,7,0,0,0,7,0,7,0,0.0,0.0
1009,1411,2020-03-19 09:23:00,1,1337.0,1066.0,0.797,6.449,3,0,0,0,3,0,3,0,0.0,0.0
1009,1412,2020-03-19 09:26:00,1,1334.0,1098.0,0.823,6.472,15,12,7,5,3,2,1,0,0.0,0.0
1009,1413,2020-03-19 09:29:00,1,1325.0,1132.0,0.854,6.475,17,0,0,0,17,3,14,0,0.0,0.0
1009,1414,2020-03-19 09:32:00,1,1513.0,1157.0,0.764,7.243,37,7,2,5,30,2,28,0,0.0,0.0
1009,1415,2020-03-19 09:35:00,1,1725.0,1433.0,0.83,8.384,142,99,50,49,43,16,27,2,0.0,0.0
1009,1416,2020-03-19 09:38:00,1,1895.0,1492.0,0.787,9.118,9,8,0,8,1,0,1,0,0.0,0.0
1009,1417,2020-03-19 09:41:00,1,1743.0,1336.0,0.766,8.346,9,3,0,3,6,0,6,0,0.0,0.0
1009,1418,2020-03-19 09:44:00,1,1580.0,1249.0,0.791,7.606,10,2,0,2,8,0,8,0,0.0,0.0
1009,1419,2020-03-19 09:47:00,1,1585.0,1244.0,0.785,7.62,5,0,0,0,5,0,5,0,0.0,0.0
1009,1420,2020-03-19 09:50:00,1,1586.0,1227.0,0.773,7.609,40,5,1,4,35,8,27,0,0.0,0.0
1009,1421,2020-03-19 09:53:00,1,1594.0,1176.0,0.738,7.581,71,22,0,22,49,15,34,0,0.0,0.0
1009,1422,2020-03-19 09:56:00,1,1407.0,1143.0,0.812,6.81,34,4,1,3,30,16,14,0,0.0,0.0
1009,1423,2020-03-19 09:59:00,1,1414.0,1157.0,0.818,6.851,43,2,0,2,41,2,39,0,0.0,0.0
1009,1424,2020-03-19 10:02:00,1,1596.0,1190.0,0.746,7.605,46,1,0,1,45,2,43,0,0.0,0.0
1009,1425,2020-03-19 10:05:00,1,1422.0,1126.0,0.792,6.848,52,5,1,4,47,14,33,0,0.0,0.0
1009,1426,2020-03-19 10:08:00,1,1415.0,1145.0,0.809,6.844,58,18,14,4,40,13,27,0,0.0,0.0
1009,1427,2020-03-19 10:11:00,1,1723.0,1409.0,0.818,8.348,161,73,55,18,88,62,26,110,0.0,0.0
1009,1428,2020-03-19 10:14:00,1,2128.0,1681.0,0.79,10.245,0,0,0,0,0,0,0,67,0.0,0.0
1009,1429,2020-03-19 10:17:00,1,2285.0,1818.0,0.795,11.016,124,72,51,21,52,30,22,36,0.0,0.0
1009,1430,2020-03-19 10:20:00,1,2109.0,1728.0,0.819,10.222,124,75,37,38,49,16,33,71,0.0,0.0
1009,1431,2020-03-19 10:23:00,1,2202.0,1781.0,0.809,10.649,177,92,70,22,85,57,28,94,0.0,0.0
1009,1432,2020-03-19 10:26:00,1,2132.0,1675.0,0.786,10.256,327,155,95,60,172,119,53,5,0.0,0.03
1009,1433,2020-03-19 10:29:00,1,2533.0,1952.0,0.77,12.142,261,121,87,34,140,105,35,3,0.0,0.0
1009,1434,2020-03-19 10:32:00,1,1748.0,1342.0,0.768,8.372,298,148,103,45,150,102,48,56,0.0,0.0
1009,1435,2020-03-19 10:35:00,1,2130.0,1699.0,0.798,10.272,733,387,314,73,346,269,77,46,0.0,0.0
1009,1436,2020-03-19 10:38:00,1,1890.0,1520.0,0.804,9.13,149,87,70,17,62,46,16,50,0.0,0.0
1009,1437,2020-03-19 10:41:00,1,1743.0,1357.0,0.778,8.372,5,3,1,2,2,0,2,67,0.0,0.0
1009,1438,2020-03-19 10:44:00,1,2127.0,1676.0,0.788,10.238,91,62,24,38,29,18,11,32,0.0,0.0
1009,1439,2020-03-19 10:47:00,1,2299.0,1750.0,0.761,10.994,67,18,3,15,49,18,31,0,0.0,0.0
1009,1440,2020-03-19 10:50:00,1,2152.0,1601.0,0.744,10.25,40,0,0,0,40,0,40,0,0.0,0.0
1009,1441,2020-03-19 10:53:00,1,1915.0,1425.0,0.744,9.124,62,10,0,10,52,20,32,0,0.0,0.0
1009,1442,2020-03-19 10:56:00,1,1946.0,1344.0,0.691,9.157,28,9,0,9,19,0,19,0,0.0,0.0
1009,1443,2020-03-19 10:59:00,1,1774.0,1221.0,0.688,8.342,33,19,0,19,14,1,13,0,0.0,0.0
1009,1444,2020-03-19 11:02:00,1,1696.0,1149.0,0.677,7.953,59,17,0,17,42,5,37,0,0.0,0.0
1009,1445,2020-03-19 11:05:00,1,1782.0,1214.0,0.681,8.367,45,1,0,1,44,0,44,0,0.0,0.0
1009,1446,2020-03-19 11:08:00,1,1791.0,1154.0,0.644,8.333,58,2,0,2,56,5,51,0,0.0,0.0
1009,1447,2020-03-19 11:11:00,1,1622.0,1093.0,0.674,7.601,42,4,0,4,38,8,30,0,0.0,0.0
1009,1448,2020-03-19 11:14:00,1,1475.0,1095.5,0.7505,7.0235,14,0,0,0,14,4,10,0,0.0,0.0
1009,1449,2020-03-19 11:17:00,1,1328.0,1098.0,0.827,6.446,12,2,0,2,10,5,5,0,0.0,0.0
1009,1450,2020-03-19 11:20:00,1,1349.0,1034.0,0.766,6.46,0,0,0,0,0,0,0,0,0.0,0.0
1009,1451,2020-03-19 11:23:00,1,1261.0,994.0,0.788,6.07,0,0,0,0,0,0,0,0,0.0,0.0
1009,1452,2020-03-19 11:26:00,1,1267.0,982.0,0.775,6.08,17,3,1,2,14,3,11,0,0.0,0.0
1009,1453,2020-03-19 11:29:00,1,1348.0,1025.0,0.76,6.445,18,0,0,0,18,1,17,0,0.0,0.0
1009,1454,2020-03-19 11:32:00,1,1339.0,1059.0,0.791,6.449,8,2,1,1,6,3,3,0,0.0,0.0
1009,1455,2020-03-19 11:35:00,1,1333.0,1056.0,0.792,6.424,15,8,0,8,7,0,7,0,0.0,0.0
1009,1456,2020-03-19 11:38:00,1,1503.0,1152.0,0.766,7.198,14,0,0,0,14,0,14,0,0.0,0.0
1009,1457,2020-03-19 11:41:00,1,1424.0,1110.0,0.779,6.842,20,14,7,7,6,1,5,0,0.0,0.0
1009,1458,2020-03-19 11:44:00,1,1573.0,1253.0,0.797,7.586,74,50,21,29,24,17,7,0,0.0,0.0
1009,1459,2020-03-19 11:47:00,1,1649.0,1328.0,0.805,7.968,141,63,51,12,78,57,21,8,0.0,0.0
1009,1460,2020-03-19 11:50:00,1,1519.0,1121.0,0.738,7.226,1,0,0,0,1,0,1,0,0.0,0.0
1009,1461,2020-03-19 11:53:00,1,1347.0,1004.0,0.745,6.42,2,2,2,0,0,0,0,0,0.0,0.0
1009,1462,2020-03-19 11:56:00,1,1522.0,1122.0,0.737,7.239,11,11,2,9,0,0,0,0,0.0,0.0
1009,1463,2020-03-19 11:59:00,1,1521.0,1101.0,0.724,7.21,5,5,0,5,0,0,0,0,0.0,0.0
1009,1464,2020-03-19 12:02:00,1,1355.0,992.0,0.732,6.436,3,3,1,2,0,0,0,0,0.0,0.0
1009,1465,2020-03-19 12:05:00,1,1275.0,951.0,0.746,6.075,0,0,0,0,0,0,0,0,0.0,0.0
1009,1466,2020-03-19 12:08:00,1,1275.0,938.0,0.736,6.06,12,5,3,2,7,2,5,0,0.0,0.0
1009,1467,2020-03-19 12:11:00,1,1358.0,1006.0,0.741,6.465,2,2,0,2,0,0,0,0,0.0,0.0
1009,1468,2020-03-19 12:14:00,1,1357.0,1002.0,0.739,6.456,0,0,0,0,0,0,0,0,0.0,0.0
1009,1469,2020-03-19 12:17:00,1,1351.0,1021.0,0.756,6.455,0,0,0,0,0,0,0,0,0.0,0.0
1009,1470,2020-03-19 12:20:00,1,1349.0,1037.0,0.769,6.463,0,0,0,0,0,0,0,0,0.0,0.0
1009,1471,2020-03-19 12:23:00,1,1347.0,1055.0,0.783,6.476,1,1,0,1,0,0,0,0,0.0,0.0
1009,1472,2020-03-19 12:26:00,1,1506.0,1144.0,0.76,7.2,4,4,1,3,0,0,0,0,0.0,0.0
1009,1473,2020-03-19 12:29:00,1,1508.0,1159.0,0.768,7.226,0,0,0,0,0,0,0,0,0.0,0.0
1009,1474,2020-03-19 12:32:00,1,1519.0,1101.0,0.725,7.204,36,21,11,10,15,12,3,0,0.0,0.0
1009,1475,2020-03-19 12:35:00,1,1514.0,1103.0,0.728,7.187,0,0,0,0,0,0,0,0,0.0,0.0
1009,1476,2020-03-19 12:38:00,1,1430.0,1096.0,0.766,6.846,25,13,5,8,12,4,8,0,0.0,0.0
1009,1477,2020-03-19 12:41:00,1,1352.0,1018.0,0.753,6.454,7,0,0,0,7,0,7,0,0.0,0.0
1009,1478,2020-03-19 12:44:00,1,1346.0,1049.0,0.779,6.464,11,1,0,1,10,3,7,0,0.0,0.0
1009,1479,2020-03-19 12:47:00,1,1269.0,987.0,0.778,6.094,46,25,3,22,21,2,19,0,0.0,0.0
1009,1480,2020-03-19 12:50:00,1,1336.0,1069.0,0.8,6.449,37,25,1,24,12,1,11,0,0.0,0.0
1009,1481,2020-03-19 12:53:00,1,1508.0,1136.0,0.754,7.198,112,44,28,16,68,39,29,5,0.0,0.0
1009,1482,2020-03-19 12:56:00,1,1644.0,1386.0,0.843,8.01,58,15,12,3,43,20,23,2,0.0,0.0
1009,1483,2020-03-19 12:59:00,1,1652.0,1361.0,0.824,8.015,310,177,128,49,133,87,46,32,0.0,0.0
1009,1484,2020-03-19 13:02:00,1,1879.0,1544.0,0.822,9.114,43,28,18,10,15,12,3,165,0.0,0.0
1009,1485,2020-03-19 13:05:00,1,1951.0,1639.0,0.84,9.5,3,2,1,1,1,1,0,119,0.0,0.0
1009,1486,2020-03-19 13:08:00,1,1899.0,1487.0,0.783,9.127,0,0,0,0,0,0,0,72,0.0,0.0
1009,1487,2020-03-19 13:11:00,1,1897.0,1473.0,0.776,9.107,0,0,0,0,0,0,0,51,0.0,0.0
1009,1488,2020-03-19 13:14:00,1,1627.0,1395.0,0.858,7.956,2,1,0,1,1,1,0,18,0.0,0.0
1009,1489,2020-03-19 13:17:00,1,1669.0,1297.0,0.777,8.011,0,0,0,0,0,0,0,3,0.0,0.0
1009,1490,2020-03-19 13:20:00,1,1492.0,1206.0,0.808,7.215,0,0,0,0,0,0,0,8,0.0,0.0
1009,1491,2020-03-19 13:23:00,1,1570.0,1248.0,0.795,7.569,0,0,0,0,0,0,0,6,0.0,0.0
1009,1492,2020-03-19 13:26:00,1,1502.0,1193.0,0.794,7.239,0,0,0,0,0,0,0,0,0.0,0.0
1009,1493,2020-03-19 13:29:00,1,1520.0,1123.0,0.738,7.233,0,0,0,0,0,0,0,0,0.0,0.0
1009,1494,2020-03-19 13:32:00,1,1425.0,1098.0,0.771,6.831,0,0,0,0,0,0,0,31,0.0,0.0
1009,1495,2020-03-19 13:35:00,1,1334.0,1083.0,0.812,6.457,0,0,0,0,0,0,0,11,0.0,0.0
1009,1496,2020-03-19 13:38:00,1,1340.0,1056.0,0.788,6.448,0,0,0,0,0,0,0,28,0.0,0.0
1009,1497,2020-03-19 13:41:00,1,1354.0,997.0,0.737,6.439,0,0,0,0,0,0,0,19,0.0,0.0
1009,1498,2020-03-19 13:44:00,1,1356.0,1014.0,0.748,6.466,0,0,0,0,0,0,0,20,0.0,0.0
1009,1499,2020-03-19 13:47:00,1,1359.0,966.0,0.711,6.426,0,0,0,0,0,0,0,6,0.0,0.0
1009,1500,2020-03-19 13:50:00,1,1279.0,920.0,0.719,6.057,0,0,0,0,0,0,0,4,0.0,0.0
1009,1501,2020-03-19 13:53:00,1,1367.0,983.0,0.719,6.473,82,46,31,15,36,27,9,22,0.0,0.0
1009,1502,2020-03-19 13:56:00,1,1193.0,871.0,0.73,5.666,3,3,0,3,0,0,0,0,0.0,0.0
1009,1503,2020-03-19 13:59:00,1,1110.0,851.0,0.767,5.318,1,1,0,1,0,0,0,0,0.0,0.0
1009,1504,2020-03-19 14:02:00,1,1201.0,888.0,0.739,5.716,4,4,0,4,0,0,0,0,0.0,0.0
1009,1505,2020-03-19 14:05:00,1,1287.0,909.0,0.706,6.078,0,0,0,0,0,0,0,0,0.0,0.0
1009,1506,2020-03-19 14:08:00,1,1375.0,934.0,0.679,6.453,5,5,0,5,0,0,0,0,0.0,0.0
1009,1507,2020-03-19 14:11:00,1,1378.0,923.0,0.669,6.453,36,17,0,17,19,7,12,0,0.0,0.0
1009,1508,2020-03-19 14:14:00,1,1526.5,1074.5,0.7005,7.204,24,11,0,11,13,0,13,0,0.0,0.0
1009,1509,2020-03-19 14:17:00,1,1675.0,1226.0,0.732,7.955,60,39,7,32,21,3,18,1,0.0,0.0
1009,1510,2020-03-19 14:20:00,1,1912.0,1423.0,0.745,9.109,155,99,68,31,56,31,25,8,0.0,0.0
1009,1511,2020-03-19 14:23:00,1,2123.0,1711.0,0.806,10.26,54,29,19,10,25,14,11,73,0.0,0.0
1009,1512,2020-03-19 14:26:00,1,2281.0,1826.0,0.8,11.01,175,98,65,33,77,48,29,1,0.0,0.0
1009,1513,2020-03-19 14:29:00,1,2320.0,1713.0,0.739,11.037,84,39,17,22,45,19,26,9,0.0,0.0
1009,1514,2020-03-19 14:32:00,1,2306.0,1748.0,0.758,11.022,96,43,18,25,53,6,47,84,0.0,0.0
1009,1515,2020-03-19 14:35:00,1,2306.0,1757.0,0.762,11.03,145,71,48,23,74,12,62,95,0.0,0.0
1009,1516,2020-03-19 14:38:00,1,2036.0,1642.0,0.806,9.839,159,80,64,16,79,63,16,98,0.0,0.0
1009,1517,2020-03-19 14:41:00,1,1908.0,1437.0,0.753,9.107,0,0,0,0,0,0,0,41,0.0,0.0
1009,1518,2020-03-19 14:44:00,1,1902.0,1444.0,0.759,9.094,0,0,0,0,0,0,0,72,0.0,0.0
1009,1519,2020-03-19 14:47:00,1,1896.0,1468.0,0.774,9.094,0,0,0,0,0,0,0,59,0.0,0.0
1009,1520,2020-03-19 14:50:00,1,1749.0,1337.0,0.765,8.371,0,0,0,0,0,0,0,14,0.0,0.0
1009,1521,2020-03-19 14:53:00,1,1580.0,1209.0,0.765,7.563,0,0,0,0,0,0,0,7,0.0,0.0
1009,1522,2020-03-19 14:56:00,1,1520.0,1122.0,0.738,7.231,0,0,0,0,0,0,0,0,0.0,0.0
1009,1523,2020-03-19 14:59:00,1,1512.0,1177.0,0.779,7.26,0,0,0,0,0,0,0,10,0.0,0.0
1009,1524,2020-03-19 15:02:00,1,1500.0,1194.0,0.796,7.233,0,0,0,0,0,0,0,5,0.0,0.0
1009,1525,2020-03-19 15:05:00,1,1580.0,1256.0,0.795,7.615,0,0,0,0,0,0,0,8,0.0,0.0
1009,1526,2020-03-19 15:08:00,1,1492.0,1220.0,0.817,7.231,0,0,0,0,0,0,0,4,0.0,0.0
1009,1527,2020-03-19 15:11:00,1,1500.0,1184.0,0.789,7.22,0,0,0,0,0,0,0,0,0.0,0.0
1009,1528,2020-03-19 15:14:00,1,1507.0,1140.0,0.756,7.2,0,0,0,0,0,0,0,2,0.0,0.0
1009,1529,2020-03-19 15:17:00,1,1425.0,1126.0,0.79,6.861,0,0,0,0,0,0,0,0,0.0,0.0
1009,1530,2020-03-19 15:20:00,1,1505.0,1136.0,0.755,7.188,20,20,1,19,0,0,0,3,0.0,0.0
1009,1531,2020-03-19 15:23:00,1,1428.0,1101.0,0.771,6.847,2,1,0,1,1,1,0,1,0.0,0.0
1009,1532,2020-03-19 15:26:00,1,1341.0,1072.0,0.799,6.47,0,0,0,0,0,0,0,3,0.0,0.0
1009,1533,2020-03-19 15:29:00,1,1343.0,1075.0,0.801,6.482,0,0,0,0,0,0,0,1,0.0,0.0
1009,1534,2020-03-19 15:32:00,1,1336.0,1063.0,0.796,6.439,1,1,0,1,0,0,0,5,0.0,0.0
1009,1535,2020-03-19 15:35:00,1,1333.0,1089.0,0.817,6.458,0,0,0,0,0,0,0,0,0.0,0.0
1009,1536,2020-03-19 15:38:00,1,1336.0,1060.0,0.794,6.437,0,0,0,0,0,0,0,0,0.0,0.0
1009,1537,2020-03-19 15:41:00,1,1261.0,1016.0,0.806,6.093,0,0,0,0,0,0,0,3,0.0,0.0
1009,1538,2020-03-19 15:44:00,1,1328.0,1093.0,0.824,6.442,76,44,33,11,32,23,9,27,0.0,0.0
1009,1539,2020-03-19 15:47:00,1,1488.0,1221.0,0.821,7.214,0,0,0,0,0,0,0,84,0.0,0.0
1009,1540,2020-03-19 15:50:00,1,1472.0,1274.0,0.865,7.211,0,0,0,0,0,0,0,9,0.0,0.0
1009,1541,2020-03-19 15:53:00,1,1412.0,1160.0,0.821,6.849,0,0,0,0,0,0,0,0,0.0,0.0
1009,1542,2020-03-19 15:56:00,1,1329.0,1121.0,0.843,6.479,0,0,0,0,0,0,0,4,0.0,0.0
1009,1543,2020-03-19 15:59:00,1,1247.0,1033.0,0.828,6.056,0,0,0,0,0,0,0,8,0.0,0.0
1009,1544,2020-03-19 16:02:00,1,1094.0,905.0,0.827,5.313,0,0,0,0,0,0,0,0,0.0,0.0
1009,1545,2020-03-19 16:05:00,1,1009.0,877.0,0.869,4.945,0,0,0,0,0,0,0,1,0.0,0.0
1009,1546,2020-03-19 16:08:00,1,1008.0,872.0,0.865,4.939,0,0,0,0,0,0,0,1,0.0,0.0
1009,1547,2020-03-19 16:11:00,1,921.0,826.0,0.897,4.542,0,0,0,0,0,0,0,0,0.0,0.0
1009,1548,2020-03-19 16:14:00,1,922.0,831.0,0.901,4.554,0,0,0,0,0,0,0,3,0.0,0.0
1009,1549,2020-03-19 16:17:00,1,1013.0,864.0,0.853,4.95,0,0,0,0,0,0,0,2,0.0,0.0
1009,1550,2020-03-19 16:20:00,1,1086.0,965.0,0.888,5.346,0,0,0,0,0,0,0,9,0.0,0.0
1009,1551,2020-03-19 16:23:00,1,1082.0,957.0,0.884,5.324,0,0,0,0,0,0,0,7,0.0,0.0
1009,1552,2020-03-19 16:26:00,1,1087.0,941.0,0.866,5.326,0,0,0,0,0,0,0,8,0.0,0.0
1009,1553,2020-03-19 16:29:00,1,1083.0,956.0,0.883,5.326,0,0,0,0,0,0,0,12,0.0,0.0
1009,1554,2020-03-19 16:32:00,1,1085.0,933.0,0.86,5.308,0,0,0,0,0,0,0,14,0.0,0.0
1009,1555,2020-03-19 16:35:00,1,1090.0,928.0,0.851,5.321,1,1,1,0,0,0,0,3,0.0,0.0
1009,1556,2020-03-19 16:38:00,1,1004.0,895.0,0.892,4.945,0,0,0,0,0,0,0,18,0.0,0.0
1009,1557,2020-03-19 16:41:00,1,1405.0,1167.0,0.831,6.825,147,72,56,16,75,54,21,84,0.0,0.0
1009,1558,2020-03-19 16:44:00,1,1496.0,1199.0,0.801,7.223,4,1,1,0,3,2,1,75,0.0,0.0
1009,1559,2020-03-19 16:47:00,1,1334.0,1078.0,0.808,6.451,1,1,0,1,0,0,0,36,0.0,0.0
1009,1560,2020-03-19 16:50:00,1,1164.0,1023.0,0.879,5.717,2,0,0,0,2,1,1,75,0.0,0.0
1009,1561,2020-03-19 16:53:00,1,1720.0,1444.0,0.84,8.376,80,34,23,11,46,10,36,71,0.0,0.0
1009,1562,2020-03-19 16:56:00,1,1956.0,1640.0,0.838,9.522,117,52,10,42,65,9,56,72,0.0,0.0
1009,1563,2020-03-19 16:59:00,1,2109.0,1728.0,0.819,10.221,131,65,20,45,66,11,55,73,0.0,0.0
1009,1564,2020-03-19 17:02:00,1,2113.0,1765.0,0.835,10.279,161,80,41,39,81,16,65,91,0.0,0.0
1009,1565,2020-03-19 17:05:00,1,2284.0,1817.0,0.795,11.01,152,67,29,38,85,21,64,73,0.0,0.0
1009,1566,2020-03-19 17:08:00,1,2103.0,1783.0,0.848,10.259,172,92,32,60,80,16,64,86,0.0,0.0
1009,1567,2020-03-19 17:11:00,1,2282.0,1840.0,0.806,11.027,153,96,39,57,57,22,35,90,0.0,0.0
1009,1568,2020-03-19 17:14:00,1,2446.5,1933.5,0.7915,11.779,186,72,24,48,114,35,79,70,0.0,0.0
1009,1569,2020-03-19 17:17:00,1,2611.0,2027.0,0.777,12.531,127,56,24,32,71,30,41,48,0.0,0.0
1009,1570,2020-03-19 17:20:00,1,2513.0,2055.0,0.818,12.174,160,79,36,43,81,21,60,75,0.0,0.0
1009,1571,2020-03-19 17:23:00,1,2571.0,2164.0,0.842,12.528,166,68,26,42,98,36,62,63,0.0,0.0
1009,1572,2020-03-19 17:26:00,1,2564.0,2210.0,0.862,12.548,281,96,51,45,185,127,58,39,0.0,0.03
1009,1573,2020-03-19 17:29:00,1,2339.0,1932.0,0.826,11.356,157,57,34,23,100,49,51,71,0.0,0.0
1009,1574,2020-03-19 17:32:00,1,2553.0,2252.0,0.882,12.554,139,61,28,33,78,33,45,45,0.0,0.0
1009,1575,2020-03-19 17:35:00,1,2724.0,2341.0,0.859,13.324,237,50,29,21,187,125,62,38,0.0,0.06
1009,1576,2020-03-19 17:38:00,1,2543.0,2290.0,0.9,12.556,124,59,25,34,65,22,43,47,0.01,0.0
1009,1577,2020-03-19 17:41:00,1,2560.0,2249.0,0.878,12.576,176,63,29,34,113,55,58,58,0.0,0.05
1009,1578,2020-03-19 17:44:00,1,2710.0,2385.0,0.88,13.317,169,77,36,41,92,39,53,69,0.05,0.0
1009,1579,2020-03-19 17:47:00,1,2678.0,2468.0,0.922,13.285,152,83,37,46,69,32,37,71,0.02,0.08
1009,1580,2020-03-19 17:50:00,1,2550.0,2278.0,0.893,12.568,118,42,20,22,76,32,44,42,0.0,0.12
1009,1581,2020-03-19 17:53:00,1,2667.0,2521.0,0.945,13.301,306,152,86,66,154,89,65,105,0.0,0.0
1009,1582,2020-03-19 17:56:00,1,2700.0,2430.0,0.9,13.327,199,91,47,44,108,62,46,79,0.23,0.08
1009,1583,2020-03-19 17:59:00,1,2748.0,2590.0,0.942,13.696,544,263,220,43,281,214,67,81,0.03,0.02
1009,1584,2020-03-19 18:02:00,0,2746.0,2596.0,0.945,13.695,397,215,180,35,182,134,48,191,0.01,0.0
1009,1585,2020-03-19 18:05:00,0,2927.0,2632.0,0.899,14.444,461,276,234,42,185,141,44,326,0.01,0.0
1009,1586,2020-03-19 18:08:00,0,2984.0,2762.0,0.926,14.813,453,251,213,38,202,158,44,303,0.01,0.0
1009,1587,2020-03-19 18:11:00,0,3064.0,2867.0,0.936,15.247,299,171,137,34,128,96,32,287,0.04,0.01
1009,1588,2020-03-19 18:14:00,0,3069.0,2828.0,0.922,15.223,348,203,168,35,145,106,39,233,0.03,0.0
1009,1589,2020-03-19 18:17:00,0,2993.0,2746.0,0.917,14.834,159,107,82,25,52,44,8,124,0.03,0.0
1009,1590,2020-03-19 18:20:00,0,2996.0,2797.0,0.934,14.899,133,88,50,38,45,32,13,37,0.0,0.0
1009,1591,2020-03-19 18:23:00,0,2666.0,2529.0,0.949,13.302,90,29,12,17,61,17,44,0,0.0,0.0
1009,1592,2020-03-19 18:26:00,0,2528.0,2355.0,0.931,12.569,40,21,11,10,19,8,11,0,0.03,0.0
1009,1593,2020-03-19 18:29:00,0,2418.0,2073.0,0.857,11.82,2,2,0,2,0,0,0,0,0.0,0.0
1009,1594,2020-03-19 18:32:00,0,2169.0,1904.0,0.878,10.652,9,8,0,8,1,0,1,0,0.0,0.0
1009,1595,2020-03-19 18:35:00,0,2239.0,2028.0,0.906,11.067,1,1,0,1,0,0,0,0,0.0,0.0
1009,1596,2020-03-19 18:38:00,0,2213.0,2077.0,0.939,11.016,8,3,3,0,5,2,3,0,0.0,0.0
1009,1597,2020-03-19 18:41:00,0,2393.0,2145.0,0.897,11.802,79,9,5,4,70,3,67,0,0.0,0.0
1009,1598,2020-03-19 18:44:00,0,2352.0,2265.0,0.963,11.774,287,177,127,50,110,76,34,35,0.0,0.0
1009,1599,2020-03-19 18:47:00,0,2658.0,2606.0,0.981,13.356,342,230,178,52,112,80,32,78,0.0,0.0
1009,1600,2020-03-19 18:50:00,0,2642.0,2620.0,0.992,13.312,377,225,171,54,152,104,48,18,0.0,0.08
1009,1601,2020-03-19 18:53:00,0,2684.0,2490.0,0.928,13.331,380,206,152,54,174,119,55,39,0.0,0.0
1009,1602,2020-03-19 18:56:00,0,2517.0,2397.0,0.952,12.569,172,112,81,31,60,28,32,40,0.0,0.0
1009,1603,2020-03-19 18:59:00,0,2677.0,2463.0,0.92,13.274,350,218,148,70,132,98,34,13,0.0,0.0
1009,1604,2020-03-19 19:02:00,0,2402.0,2098.0,0.874,11.786,304,196,149,47,108,71,37,44,0.0,0.0
1009,1605,2020-03-19 19:05:00,0,2652.0,2585.0,0.975,13.312,263,141,109,32,122,81,41,68,0.0,0.0
1009,1606,2020-03-19 19:08:00,0,2678.0,2472.0,0.923,13.289,304,212,145,67,92,56,36,29,0.0,0.0
1009,1607,2020-03-19 19:11:00,0,2528.0,2286.0,0.904,12.491,332,181,133,48,151,107,44,43,0.0,0.0
1009,1608,2020-03-19 19:14:00,0,2547.0,2289.0,0.899,12.568,252,121,91,30,131,82,49,11,0.0,0.0
1009,1609,2020-03-19 19:17:00,0,2367.0,2210.0,0.934,11.771,126,86,32,54,40,9,31,0,0.0,0.0
1009,1610,2020-03-19 19:20:00,0,2538.0,2341.0,0.922,12.593,103,49,10,39,54,26,28,0,0.0,0.0
1009,1611,2020-03-19 19:23:00,0,2510.0,2351.0,0.936,12.492,96,25,9,16,71,29,42,0,0.0,0.0
1009,1612,2020-03-19 19:26:00,0,2535.0,2373.0,0.936,12.614,50,25,12,13,25,5,20,0,0.0,0.0
1009,1613,2020-03-19 19:29:00,0,2387.0,2168.0,0.909,11.804,16,8,2,6,8,1,7,0,0.0,0.0
1009,1614,2020-03-19 19:32:00,0,2139.0,1977.0,0.924,10.618,13,8,4,4,5,0,5,0,0.0,0.0
1009,1615,2020-03-19 19:35:00,0,2383.0,2199.0,0.923,11.823,293,180,143,37,113,78,35,9,0.0,0.0
1009,1616,2020-03-19 19:38:00,0,2536.0,2304.0,0.908,12.543,305,182,122,60,123,86,37,47,0.0,0.03
1009,1617,2020-03-19 19:41:00,0,2390.0,2143.0,0.897,11.788,264,161,112,49,103,69,34,15,0.0,0.0
1009,1618,2020-03-19 19:44:00,0,2455.0,2266.0,0.923,12.182,186,127,100,27,59,37,22,33,0.0,0.0
1009,1619,2020-03-19 19:47:00,0,2146.0,1960.0,0.914,10.624,102,57,24,33,45,24,21,0,0.0,0.0
1009,1620,2020-03-19 19:50:00,0,2388.0,2187.0,0.916,11.828,291,159,114,45,132,91,41,31,0.0,0.0
1009,1621,2020-03-19 19:53:00,0,2526.0,2324.0,0.92,12.527,186,113,66,47,73,55,18,2,0.0,0.0
1009,1622,2020-03-19 19:56:00,0,2159.0,1948.0,0.902,10.663,194,82,43,39,112,60,52,2,0.0,0.0
1009,1623,2020-03-19 19:59:00,0,2530.0,2331.0,0.921,12.547,27,16,9,7,11,6,5,0,0.0,0.0
1009,1624,2020-03-19 20:02:00,0,2395.0,2116.0,0.884,11.778,0,0,0,0,0,0,0,0,0.0,0.0
1009,1625,2020-03-19 20:05:00,0,2156.0,1976.0,0.917,10.684,285,159,123,36,126,81,45,52,0.0,0.0
1009,1626,2020-03-19 20:08:00,0,2398.0,2086.0,0.87,11.757,75,40,15,25,35,20,15,3,0.05,0.0
1009,1627,2020-03-19 20:11:00,0,2141.0,2016.0,0.942,10.667,56,16,10,6,40,9,31,0,0.0,0.0
1009,1628,2020-03-19 20:14:00,0,2086.0,1860.5,0.8905,10.279,11,5,4,1,6,3,3,0,0.0,0.0
1009,1629,2020-03-19 20:17:00,0,2031.0,1705.0,0.839,9.891,61,51,28,23,10,6,4,0,0.0,0.0
1009,1630,2020-03-19 20:20:00,0,2162.0,1903.0,0.88,10.626,202,60,24,36,142,81,61,1,0.0,0.0
1009,1631,2020-03-19 20:23:00,0,2078.0,1861.0,0.896,10.245,20,13,2,11,7,1,6,0,0.0,0.0
1009,1632,2020-03-19 20:26:00,0,2016.0,1785.0,0.886,9.919,8,5,2,3,3,0,3,0,0.0,0.0
1009,1633,2020-03-19 20:29:00,0,2012.0,1758.0,0.874,9.873,4,4,2,2,0,0,0,0,0.0,0.0
1009,1634,2020-03-19 20:32:00,0,2026.0,1733.0,0.855,9.901,26,22,12,10,4,1,3,0,0.0,0.0
1009,1635,2020-03-19 20:35:00,0,2031.0,1686.0,0.83,9.871,67,30,24,6,37,27,10,23,0.0,0.0
1009,1636,2020-03-19 20:38:00,0,1860.0,1616.0,0.869,9.117,142,75,46,29,67,26,41,0,0.0,0.0
1009,1637,2020-03-19 20:41:00,0,2008.0,1788.0,0.89,9.892,193,134,85,49,59,35,24,7,0.0,0.0
1009,1638,2020-03-19 20:44:00,0,2158.0,1917.0,0.888,10.626,199,122,91,31,77,51,26,43,0.0,0.0
1009,1639,2020-03-19 20:47:00,0,2085.0,1820.0,0.873,10.229,125,75,55,20,50,33,17,15,0.0,0.0
1009,1640,2020-03-19 20:50:00,0,2419.0,2027.0,0.838,11.776,268,142,90,52,126,86,40,78,0.0,0.0
1009,1641,2020-03-19 20:53:00,0,2172.0,1901.0,0.875,10.662,136,69,40,29,67,37,30,27,0.0,0.0
1009,1642,2020-03-19 20:56:00,0,2568.0,2195.0,0.855,12.549,233,160,105,55,73,40,33,6,0.0,0.0
1009,1643,2020-03-19 20:59:00,0,2428.0,2018.0,0.831,11.801,277,174,125,49,103,68,35,45,0.0,0.0
1009,1644,2020-03-19 21:02:00,0,2581.0,2126.0,0.824,12.521,143,72,35,37,71,38,33,5,0.14,0.0
1009,1645,2020-03-19 21:05:00,0,2557.0,2181.0,0.853,12.488,294,158,119,39,136,95,41,13,0.0,0.0
1009,1646,2020-03-19 21:08:00,0,2572.0,2187.0,0.85,12.556,226,128,79,49,98,56,42,6,0.0,0.0
1009,1647,2020-03-19 21:11:00,0,2588.0,2140.0,0.827,12.564,306,167,124,43,139,93,46,24,0.0,0.0
1009,1648,2020-03-19 21:14:00,0,2580.0,2131.0,0.826,12.523,428,234,163,71,194,144,50,25,0.0,0.0
1009,1649,2020-03-19 21:17:00,0,2743.0,2233.0,0.814,13.281,659,394,292,102,265,194,71,13,0.0,0.01
1009,1650,2020-03-19 21:20:00,0,2724.0,2299.0,0.844,13.276,510,318,219,99,192,141,51,12,0.0,0.0
1009,1651,2020-03-19 21:23:00,0,2276.0,1878.0,0.825,11.045,374,207,148,59,167,128,39,45,0.0,0.0
1009,1652,2020-03-19 21:26:00,0,2220.0,1718.0,0.774,10.648,135,90,54,36,45,22,23,1,0.0,0.02
1009,1653,2020-03-19 21:29:00,0,2462.0,1821.0,0.739,11.717,143,81,42,39,62,26,36,0,0.0,0.0
1009,1654,2020-03-19 21:32:00,0,2746.0,2253.0,0.82,13.313,56,23,13,10,33,16,17,0,0.0,0.0
1009,1655,2020-03-19 21:35:00,0,2600.0,2104.0,0.809,12.575,132,81,56,25,51,36,15,32,0.0,0.0
1009,1656,2020-03-19 21:38:00,0,2460.0,1897.0,0.771,11.794,163,91,59,32,72,51,21,86,0.0,0.0
1009,1657,2020-03-19 21:41:00,0,2600.0,2080.0,0.8,12.546,274,132,79,53,142,103,39,30,0.0,0.0
1009,1658,2020-03-19 21:44:00,0,2451.0,1945.0,0.793,11.809,258,171,111,60,87,50,37,1,0.0,0.0
1009,1659,2020-03-19 21:47:00,0,2584.0,2105.0,0.815,12.51,489,315,226,89,174,125,49,25,0.0,0.0
1009,1660,2020-03-19 21:50:00,0,2770.0,2179.0,0.787,13.325,634,380,283,97,254,184,70,60,0.0,0.0
1009,1661,2020-03-19 21:53:00,0,2775.0,2188.0,0.788,13.354,537,350,260,90,187,135,52,37,0.0,0.0
1009,1662,2020-03-19 21:56:00,0,2760.0,2177.0,0.789,13.287,323,156,109,47,167,122,45,60,0.0,0.0
1009,1663,2020-03-19 21:59:00,0,2748.0,2197.0,0.8,13.261,179,94,65,29,85,51,34,23,0.0,0.0
1009,1664,2020-03-19 22:02:00,0,2545.0,1910.0,0.751,12.143,220,159,118,41,61,36,25,52,0.0,0.0
1009,1665,2020-03-19 22:05:00,0,2466.0,1864.0,0.756,11.778,94,62,25,37,32,9,23,1,0.0,0.0
1009,1666,2020-03-19 22:08:00,0,2779.0,2089.0,0.752,13.264,207,127,75,52,80,45,35,1,0.0,0.0
1009,1667,2020-03-19 22:11:00,0,2779.0,2126.0,0.765,13.301,301,197,138,59,104,63,41,9,0.0,0.0
1009,1668,2020-03-19 22:14:00,0,2615.0,1982.0,0.758,12.497,19,12,6,6,7,6,1,1,0.0,0.0
1009,1669,2020-03-19 22:17:00,0,2476.0,1837.0,0.742,11.79,0,0,0,0,0,0,0,0,0.0,0.0
1009,1670,2020-03-19 22:20:00,0,2401.0,1737.0,0.723,11.385,0,0,0,0,0,0,0,0,0.0,0.0
1009,1671,2020-03-19 22:23:00,0,1917.0,1389.0,0.725,9.093,33,18,15,3,15,8,7,0,0.0,0.0
1009,1672,2020-03-19 22:26:00,0,1926.0,1385.0,0.719,9.123,2,1,0,1,1,0,1,0,0.0,0.0
1009,1673,2020-03-19 22:29:00,0,1849.0,1306.0,0.706,8.731,16,12,6,6,4,0,4,0,0.0,0.0
1009,1674,2020-03-19 22:32:00,0,1833.0,1339.0,0.73,8.706,8,5,2,3,3,1,2,0,0.0,0.0
1009,1675,2020-03-19 22:35:00,0,1849.0,1323.0,0.716,8.75,29,18,5,13,11,5,6,0,0.0,0.0
1009,1676,2020-03-19 22:38:00,0,1829.0,1341.0,0.733,8.692,5,5,1,4,0,0,0,0,0.0,0.0
1009,1677,2020-03-19 22:41:00,0,1857.0,1300.0,0.7,8.755,74,25,6,19,49,25,24,1,0.0,0.0
1009,1678,2020-03-19 22:44:00,0,2065.0,1563.0,0.757,9.868,354,222,175,47,132,101,31,68,0.0,0.0
1009,1679,2020-03-19 22:47:00,0,2409.0,1741.0,0.723,11.417,382,237,165,72,145,98,47,16,0.0,0.0
1009,1680,2020-03-19 22:50:00,0,2168.0,1571.0,0.724,10.283,288,139,95,44,149,96,53,49,0.0,0.0
1009,1681,2020-03-19 22:53:00,0,2483.0,1831.0,0.737,11.811,58,34,17,17,24,7,17,73,0.0,0.0
1009,1682,2020-03-19 22:56:00,0,2640.0,1925.0,0.729,12.534,445,306,219,87,139,99,40,6,0.0,0.0
1009,1683,2020-03-19 22:59:00,0,2644.0,1954.0,0.739,12.582,108,72,48,24,36,24,12,8,0.0,0.0
1009,1684,2020-03-19 23:02:00,0,2488.0,1791.0,0.72,11.786,178,112,70,42,66,39,27,71,0.0,0.0
1009,1685,2020-03-19 23:05:00,0,2550.0,1861.0,0.73,12.107,271,178,135,43,93,62,31,5,0.0,0.0
1009,1686,2020-03-19 23:08:00,0,2626.0,1985.0,0.756,12.546,98,51,32,19,47,32,15,17,0.0,0.0
1009,1687,2020-03-19 23:11:00,0,2491.0,1790.0,0.719,11.795,50,31,20,11,19,15,4,0,0.0,0.0
1009,1688,2020-03-19 23:14:00,0,2431.5,1821.5,0.75,11.5955,171,112,66,46,59,31,28,30,0.0,0.0
1009,1689,2020-03-19 23:17:00,0,2372.0,1853.0,0.781,11.396,407,193,135,58,214,153,61,80,0.0,0.0
1009,1690,2020-03-19 23:20:00,0,2401.0,1753.0,0.73,11.4,463,225,164,61,238,171,67,18,0.0,0.0
1009,1691,2020-03-19 23:23:00,0,2401.0,1783.0,0.742,11.435,92,61,44,17,31,19,12,135,0.0,0.0
1009,1692,2020-03-19 23:26:00,0,2384.0,1817.0,0.762,11.406,268,186,120,66,82,52,30,14,0.0,0.0
1009,1693,2020-03-19 23:29:00,0,2307.0,1739.0,0.754,11.017,60,30,16,14,30,10,20,0,0.0,0.0
1009,1694,2020-03-19 23:32:00,0,2230.0,1701.0,0.763,10.671,107,48,26,22,59,37,22,0,0.0,0.0
1009,1695,2020-03-19 23:35:00,0,2388.0,1754.0,0.734,11.35,212,111,62,49,101,61,40,27,0.0,0.0
1009,1696,2020-03-19 23:38:00,0,2135.0,1664.0,0.779,10.254,0,0,0,0,0,0,0,0,0.0,0.0
1009,1697,2020-03-19 23:41:00,0,1982.0,1509.0,0.762,9.48,0,0,0,0,0,0,0,0,0.0,0.0
1009,1698,2020-03-19 23:44:00,0,2015.0,1406.0,0.698,9.497,0,0,0,0,0,0,0,0,0.0,0.0
1009,1699,2020-03-19 23:47:00,0,1742.0,1343.0,0.771,8.349,0,0,0,0,0,0,0,0,0.0,0.0
1009,1700,2020-03-19 23:50:00,0,1770.0,1263.0,0.713,8.372,35,21,17,4,14,5,9,0,0.0,0.0
1009,1701,2020-03-19 23:53:00,0,1585.0,1228.0,0.775,7.606,33,2,0,2,31,0,31,0,0.0,0.0
1009,1702,2020-03-19 23:56:00,0,1587.0,1198.0,0.755,7.577,58,2,0,2,56,0,56,0,0.0,0.0
1009,1703,2020-03-19 23:59:00,0,1744.0,1335.0,0.766,8.351,135,35,14,21,100,52,48,6,0.27,0.0
1009,1704,2020-03-20 00:02:00,0,2146.0,1635.0,0.762,10.266,151,100,72,28,51,35,16,30,0.0,0.0
1009,1705,2020-03-20 00:05:00,0,1815.0,1418.0,0.781,8.723,137,90,63,27,47,34,13,64,0.0,0.0
1009,1706,2020-03-20 00:08:00,0,2052.0,1602.0,0.781,9.858,347,179,131,48,168,118,50,75,0.0,0.0
1009,1707,2020-03-20 00:11:00,0,2141.0,1648.0,0.77,10.262,236,91,58,33,145,88,57,3,0.0,0.0
1009,1708,2020-03-20 00:14:00,0,2304.0,1761.0,0.764,11.028,187,111,74,37,76,45,31,0,0.0,0.0
1009,1709,2020-03-20 00:17:00,0,2374.0,1863.0,0.785,11.415,227,134,102,32,93,63,30,27,0.0,0.0
1009,1710,2020-03-20 00:20:00,0,2127.0,1696.0,0.797,10.259,139,80,42,38,59,30,29,0,0.0,0.0
1009,1711,2020-03-20 00:23:00,0,2389.0,1811.0,0.758,11.418,245,151,90,61,94,53,41,4,0.0,0.0
1009,1712,2020-03-20 00:26:00,0,2469.0,1878.0,0.76,11.808,148,104,68,36,44,18,26,7,0.0,0.0
1009,1713,2020-03-20 00:29:00,0,2390.0,1803.0,0.755,11.412,121,77,48,29,44,16,28,39,0.0,0.0
1009,1714,2020-03-20 00:32:00,0,2535.0,1911.0,0.754,12.106,328,199,163,36,129,96,33,318,0.0,0.0
1009,1715,2020-03-20 00:35:00,0,2449.0,1880.0,0.768,11.731,439,261,213,48,178,136,42,397,0.0,0.0
1009,1716,2020-03-20 00:38:00,0,2604.0,2019.0,0.775,12.497,537,304,261,43,233,187,46,409,0.0,0.0
1009,1717,2020-03-20 00:41:00,0,2697.0,2104.0,0.78,12.955,455,261,221,40,194,154,40,424,0.0,0.0
1009,1718,2020-03-20 00:44:00,0,2687.0,2099.0,0.781,12.91,656,418,344,74,238,189,49,383,0.0,0.0
1009,1719,2020-03-20 00:47:00,0,2926.0,2233.0,0.763,14.0,488,283,248,35,205,160,45,386,0.0,0.0
1009,1720,2020-03-20 00:50:00,0,2940.0,2244.0,0.763,14.07,400,228,196,32,172,139,33,394,0.0,0.0
1009,1721,2020-03-20 00:53:00,0,2766.0,2152.0,0.778,13.28,458,285,230,55,173,133,40,267,0.0,0.0
1009,1722,2020-03-20 00:56:00,0,2940.0,2195.0,0.747,14.014,589,349,292,57,240,180,60,289,0.0,0.0
1009,1723,2020-03-20 00:59:00,0,2941.0,2248.0,0.764,14.078,581,348,271,77,233,178,55,73,0.0,0.0
1009,1724,2020-03-20 01:02:00,0,2777.0,2152.0,0.775,13.326,342,185,147,38,157,110,47,98,0.0,0.0
1009,1725,2020-03-20 01:05:00,0,2704.0,2047.0,0.757,12.92,475,282,226,56,193,152,41,252,0.0,0.0
1009,1726,2020-03-20 01:08:00,0,2691.0,2108.0,0.783,12.935,668,460,381,79,208,156,52,270,0.0,0.0
1009,1727,2020-03-20 01:11:00,0,2866.0,2147.0,0.749,13.67,454,324,253,71,130,95,35,40,0.0,0.0
1009,1728,2020-03-20 01:14:00,0,2720.0,1979.0,0.728,12.909,193,140,97,43,53,26,27,82,0.0,0.0
1009,1729,2020-03-20 01:17:00,0,2773.0,2102.0,0.758,13.252,502,256,209,47,246,190,56,299,0.0,0.0
1009,1730,2020-03-20 01:20:00,0,2869.0,2144.0,0.747,13.678,495,293,248,45,202,160,42,409,0.0,0.0
1009,1731,2020-03-20 01:23:00,0,2960.0,2147.0,0.725,14.038,437,259,210,49,178,132,46,152,0.0,0.0
1009,1732,2020-03-20 01:26:00,0,2710.0,2027.0,0.748,12.922,367,213,152,61,154,102,52,62,0.0,0.0
1009,1733,2020-03-20 01:29:00,0,2710.0,2068.0,0.763,12.968,469,297,238,59,172,120,52,183,0.0,0.0
1009,1734,2020-03-20 01:32:00,0,2719.0,2002.0,0.736,12.929,86,59,37,22,27,8,19,26,0.0,0.0
1009,1735,2020-03-20 01:35:00,0,2627.0,2020.0,0.769,12.586,250,133,96,37,117,86,31,159,0.0,0.0
1009,1736,2020-03-20 01:38:00,0,2541.0,1967.0,0.774,12.187,543,342,290,52,201,151,50,336,0.0,0.0
1009,1737,2020-03-20 01:41:00,0,2541.0,1940.0,0.764,12.159,444,249,211,38,195,152,43,255,0.0,0.0
1009,1738,2020-03-20 01:44:00,0,2628.0,1989.0,0.757,12.556,449,264,219,45,185,148,37,333,0.0,0.0
1009,1739,2020-03-20 01:47:00,0,2567.0,1864.0,0.726,12.177,590,303,235,68,287,224,63,123,0.0,0.0
1009,1740,2020-03-20 01:50:00,0,2563.0,1860.0,0.726,12.157,275,146,112,34,129,95,34,89,0.0,0.0
1009,1741,2020-03-20 01:53:00,0,2373.0,1809.0,0.762,11.353,362,211,167,44,151,118,33,140,0.0,0.0
1009,1742,2020-03-20 01:56:00,0,2479.0,1805.0,0.728,11.768,246,123,87,36,123,92,31,47,0.0,0.0
1009,1743,2020-03-20 01:59:00,0,2379.0,1786.0,0.751,11.351,0,0,0,0,0,0,0,0,0.0,0.0
1009,1744,2020-03-20 02:02:00,0,2140.0,1647.0,0.77,10.255,0,0,0,0,0,0,0,0,0.0,0.0
1009,1745,2020-03-20 02:05:00,0,1982.0,1522.0,0.768,9.494,190,89,67,22,101,74,27,20,0.0,0.0
1009,1746,2020-03-20 02:08:00,0,2145.0,1617.0,0.754,10.243,204,131,106,25,73,42,31,82,0.0,0.0
1009,1747,2020-03-20 02:11:00,0,2144.0,1659.0,0.774,10.285,436,251,206,45,185,140,45,338,0.0,0.0
1009,1748,2020-03-20 02:14:00,0,2315.0,1733.0,0.7505,11.0415,449,285,230,55,164,125,39,338,0.0,0.0
1009,1749,2020-03-20 02:17:00,0,2486.0,1807.0,0.727,11.798,230,135,113,22,95,64,31,182,0.0,0.0
1009,1750,2020-03-20 02:20:00,0,2464.0,1835.0,0.745,11.741,300,201,144,57,99,80,19,40,0.0,0.0
1009,1751,2020-03-20 02:23:00,0,2659.0,1884.0,0.709,12.562,276,144,93,51,132,89,43,52,0.0,0.0
1009,1752,2020-03-20 02:26:00,0,2657.0,1858.0,0.699,12.527,131,86,42,44,45,27,18,44,0.0,0.0
1009,1753,2020-03-20 02:29:00,0,2647.0,1909.0,0.721,12.542,198,90,51,39,108,61,47,41,0.0,0.0
1009,1754,2020-03-20 02:32:00,0,2480.0,1791.0,0.722,11.754,456,264,199,65,192,137,55,35,0.0,0.0
1009,1755,2020-03-20 02:35:00,0,2494.0,1759.0,0.705,11.774,368,205,163,42,163,124,39,157,0.0,0.0
1009,1756,2020-03-20 02:38:00,0,2500.0,1747.0,0.699,11.784,159,93,60,33,66,47,19,7,0.0,0.0
1009,1757,2020-03-20 02:41:00,0,2505.0,1733.0,0.692,11.789,99,57,33,24,42,14,28,7,0.01,0.0
1009,1758,2020-03-20 02:44:00,0,2497.0,1731.0,0.693,11.754,188,71,25,46,117,54,63,0,0.0,0.0
1009,1759,2020-03-20 02:47:00,0,2503.0,1704.0,0.681,11.747,37,10,0,10,27,3,24,0,0.0,0.0
1009,1760,2020-03-20 02:50:00,0,2249.0,1591.0,0.707,10.624,10,1,0,1,9,0,9,0,0.0,0.0
1009,1761,2020-03-20 02:53:00,0,2091.0,1467.0,0.702,9.864,7,0,0,0,7,0,7,0,0.0,0.0
1009,1762,2020-03-20 02:56:00,0,1931.0,1364.0,0.706,9.119,7,1,0,1,6,0,6,0,0.0,0.0
1009,1763,2020-03-20 02:59:00,0,1861.0,1284.0,0.69,8.753,3,1,0,1,2,0,2,0,0.0,0.0
1009,1764,2020-03-20 03:02:00,0,1685.0,1198.0,0.711,7.967,1,0,0,0,1,0,1,0,0.0,0.0
1009,1765,2020-03-20 03:05:00,0,1704.0,1129.0,0.663,7.964,5,1,0,1,4,0,4,0,0.0,0.0
1009,1766,2020-03-20 03:08:00,0,1614.0,1084.0,0.672,7.56,0,0,0,0,0,0,0,0,0.0,0.0
1009,1767,2020-03-20 03:11:00,0,1531.0,1037.0,0.677,7.181,38,25,9,16,13,6,7,0,0.0,0.0
1009,1768,2020-03-20 03:14:00,0,1528.0,1081.0,0.707,7.216,103,62,38,24,41,13,28,3,0.0,0.0
1009,1769,2020-03-20 03:17:00,0,2103.0,1446.0,0.687,9.889,289,160,121,39,129,92,37,99,0.0,0.0
1009,1770,2020-03-20 03:20:00,0,2086.0,1491.0,0.715,9.87,396,209,163,46,187,141,46,36,0.0,0.0
1009,1771,2020-03-20 03:23:00,0,2253.0,1592.0,0.707,10.638,395,209,152,57,186,140,46,133,0.0,0.0
1009,1772,2020-03-20 03:26:00,0,2248.0,1577.0,0.701,10.604,281,159,127,32,122,99,23,243,0.01,0.0
1009,1773,2020-03-20 03:29:00,0,2241.0,1638.0,0.731,10.642,381,216,173,43,165,124,41,203,0.0,0.0
1009,1774,2020-03-20 03:32:00,0,2670.0,1847.0,0.692,12.564,105,72,39,33,33,20,13,26,0.0,0.0
1009,1775,2020-03-20 03:35:00,0,2405.0,1714.0,0.713,11.373,268,144,120,24,124,93,31,83,0.0,0.0
1009,1776,2020-03-20 03:38:00,0,2496.0,1748.0,0.7,11.771,148,89,67,22,59,22,37,53,0.0,0.0
1009,1777,2020-03-20 03:41:00,0,2468.0,1810.0,0.733,11.728,93,61,25,36,32,11,21,15,0.0,0.0
1009,1778,2020-03-20 03:44:00,0,2653.0,1845.0,0.696,12.496,330,181,143,38,149,105,44,182,0.01,0.0
1009,1779,2020-03-20 03:47:00,0,2487.0,1805.0,0.726,11.796,62,38,25,13,24,14,10,4,0.0,0.0
1009,1780,2020-03-20 03:50:00,0,2481.0,1727.0,0.696,11.689,1,1,0,1,0,0,0,0,0.01,0.0
1009,1781,2020-03-20 03:53:00,0,2255.0,1597.0,0.708,10.653,2,2,1,1,0,0,0,0,0.0,0.0
1009,1782,2020-03-20 03:56:00,0,2095.0,1473.0,0.703,9.887,0,0,0,0,0,0,0,0,0.0,0.0
1009,1783,2020-03-20 03:59:00,0,1932.0,1357.0,0.703,9.115,0,0,0,0,0,0,0,0,0.0,0.0
1009,1784,2020-03-20 04:02:00,0,1866.0,1255.0,0.673,8.741,72,53,32,21,19,11,8,0,0.0,0.0
1009,1785,2020-03-20 04:05:00,0,1858.0,1290.0,0.695,8.749,171,106,65,41,65,44,21,3,0.06,0.0
1009,1786,2020-03-20 04:08:00,0,1843.0,1309.0,0.71,8.711,171,97,60,37,74,52,22,52,0.0,0.0
1009,1787,2020-03-20 04:11:00,0,1842.0,1341.0,0.728,8.744,364,217,171,46,147,104,43,203,0.0,0.0
1009,1788,2020-03-20 04:14:00,0,1823.0,1394.0,0.765,8.727,250,150,124,26,100,79,21,373,0.0,0.0
1009,1789,2020-03-20 04:17:00,0,2080.0,1492.0,0.717,9.848,229,126,101,25,103,83,20,351,0.0,0.0
1009,1790,2020-03-20 04:20:00,0,2088.0,1488.0,0.713,9.873,309,197,159,38,112,79,33,142,0.0,0.0
1009,1791,2020-03-20 04:23:00,0,2079.0,1518.0,0.73,9.873,129,70,45,25,59,37,22,23,0.0,0.0
1009,1792,2020-03-20 04:26:00,0,2100.0,1425.0,0.678,9.853,232,80,40,40,152,87,65,20,0.07,0.0
1009,1793,2020-03-20 04:29:00,0,2078.0,1507.0,0.725,9.857,407,243,198,45,164,130,34,129,0.0,0.0
1009,1794,2020-03-20 04:32:00,0,2080.0,1504.0,0.723,9.86,38,23,2,21,15,7,8,1,0.0,0.0
1009,1795,2020-03-20 04:35:00,0,2175.0,1556.0,0.716,10.293,117,59,13,46,58,27,31,1,0.0,0.0
1009,1796,2020-03-20 04:38:00,0,2081.0,1497.0,0.719,9.858,33,20,4,16,13,9,4,0,0.0,0.0
1009,1797,2020-03-20 04:41:00,0,2014.0,1376.0,0.683,9.46,17,1,0,1,16,1,15,0,0.0,0.0
1009,1798,2020-03-20 04:44:00,0,1855.0,1259.0,0.679,8.702,38,18,8,10,20,10,10,0,0.0,0.0
1009,1799,2020-03-20 04:47:00,0,1773.0,1203.0,0.679,8.316,15,8,2,6,7,3,4,0,0.0,0.0
1009,1800,2020-03-20 04:50:00,0,1696.0,1157.0,0.682,7.964,1,0,0,0,1,0,1,0,0.0,0.0
1009,1801,2020-03-20 04:53:00,0,1709.0,1098.0,0.643,7.949,9,0,0,0,9,0,9,0,0.0,0.0
1009,1802,2020-03-20 04:56:00,0,1533.0,1056.0,0.689,7.209,3,0,0,0,3,0,3,0,0.0,0.0
1009,1803,2020-03-20 04:59:00,0,1548.0,1009.0,0.652,7.216,6,0,0,0,6,0,6,0,0.0,0.0
1009,1804,2020-03-20 05:02:00,0,1456.0,967.0,0.664,6.807,2,0,0,0,2,0,2,0,0.0,0.0
1009,1805,2020-03-20 05:05:00,0,1276.0,948.0,0.743,6.077,3,0,0,0,3,0,3,0,0.0,0.0
1009,1806,2020-03-20 05:08:00,0,1283.0,909.0,0.709,6.061,0,0,0,0,0,0,0,0,0.0,0.0
1009,1807,2020-03-20 05:11:00,0,1291.0,900.0,0.697,6.082,13,9,1,8,4,1,3,0,0.0,0.0
1009,1808,2020-03-20 05:14:00,0,1248.0,881.0,0.706,5.892,2,2,0,2,0,0,0,0,0.0,0.0
1009,1809,2020-03-20 05:17:00,0,1205.0,862.0,0.715,5.702,4,4,2,2,0,0,0,0,0.0,0.0
1009,1810,2020-03-20 05:20:00,0,1021.0,811.0,0.794,4.919,83,51,31,20,32,16,16,4,0.0,0.0
1009,1811,2020-03-20 05:23:00,0,1259.0,1008.0,0.8,6.076,209,131,95,36,78,48,30,52,0.0,0.0
1009,1812,2020-03-20 05:26:00,0,1666.0,1274.0,0.765,7.976,14,11,2,9,3,3,0,0,0.0,0.0
1009,1813,2020-03-20 05:29:00,0,1585.0,1216.0,0.767,7.593,166,69,41,28,97,59,38,22,0.0,0.0
1009,1814,2020-03-20 05:32:00,0,1745.0,1348.0,0.772,8.368,79,22,9,13,57,28,29,11,0.0,0.0
1009,1815,2020-03-20 05:35:00,0,1997.0,1496.0,0.749,9.526,286,186,153,33,100,78,22,184,0.0,0.0
1009,1816,2020-03-20 05:38:00,0,2165.0,1546.0,0.714,10.243,154,76,48,28,78,57,21,9,0.0,0.0
1009,1817,2020-03-20 05:41:00,0,2165.0,1562.0,0.722,10.259,136,74,51,23,62,38,24,74,0.0,0.0
1009,1818,2020-03-20 05:44:00,0,1991.0,1463.0,0.735,9.463,257,149,121,28,108,88,20,315,0.0,0.0
1009,1819,2020-03-20 05:47:00,0,2069.0,1524.0,0.736,9.841,146,88,77,11,58,50,8,342,0.0,0.0
1009,1820,2020-03-20 05:50:00,0,2078.0,1532.0,0.737,9.885,303,172,143,29,131,106,25,378,0.0,0.0
1009,1821,2020-03-20 05:53:00,0,2151.0,1637.0,0.761,10.285,335,218,174,44,117,89,28,257,0.0,0.0
1009,1822,2020-03-20 05:56:00,0,2152.0,1626.0,0.756,10.278,335,157,121,36,178,138,40,10,0.0,0.0
1009,1823,2020-03-20 05:59:00,0,2141.0,1655.0,0.773,10.267,296,158,121,37,138,105,33,8,0.1,0.0
1009,1824,2020-03-20 06:02:00,1,2155.0,1606.0,0.745,10.268,315,181,138,43,134,96,38,147,0.0,0.0
1009,1825,2020-03-20 06:05:00,1,2562.0,1797.0,0.701,12.086,191,136,82,54,55,27,28,118,0.0,0.0
1009,1826,2020-03-20 06:08:00,1,2544.0,1905.0,0.749,12.133,142,72,42,30,70,30,40,116,0.0,0.0
1009,1827,2020-03-20 06:11:00,1,2539.0,1938.0,0.763,12.151,183,90,40,50,93,29,64,101,0.0,0.0
1009,1828,2020-03-20 06:14:00,1,2689.0,2102.0,0.782,12.922,77,34,15,19,43,14,29,43,0.0,0.32
1009,1829,2020-03-20 06:17:00,1,2552.0,1887.0,0.74,12.145,0,0,0,0,0,0,0,0,0.0,0.0
1009,1830,2020-03-20 06:20:00,1,2541.0,1924.0,0.757,12.142,87,39,26,13,48,32,16,18,0.0,0.0
1009,1831,2020-03-20 06:23:00,1,2510.0,2063.0,0.822,12.172,52,30,13,17,22,11,11,13,0.0,0.08
1009,1832,2020-03-20 06:26:00,1,2491.0,2090.0,0.839,12.13,299,127,95,32,172,122,50,74,0.31,0.0
1009,1833,2020-03-20 06:29:00,1,2586.0,2156.0,0.834,12.578,97,47,28,19,50,14,36,55,0.15,0.05
1009,1834,2020-03-20 06:32:00,1,2511.0,2024.0,0.806,12.135,161,82,56,26,79,59,20,44,0.0,0.07
1009,1835,2020-03-20 06:35:00,1,2431.0,1992.0,0.82,11.784,190,98,71,27,92,39,53,94,0.0,0.0
1009,1836,2020-03-20 06:38:00,1,2645.0,2261.0,0.855,12.923,137,69,42,27,68,15,53,60,0.13,0.0
1009,1837,2020-03-20 06:41:00,1,2632.0,2327.0,0.884,12.948,109,46,13,33,63,3,60,102,0.0,0.0
1009,1838,2020-03-20 06:44:00,1,2477.0,2184.0,0.882,12.177,201,103,55,48,98,58,40,60,0.18,0.02
1009,1839,2020-03-20 06:47:00,1,2482.0,2177.0,0.877,12.188,135,66,32,34,69,18,51,67,0.07,0.0
1009,1840,2020-03-20 06:50:00,1,2626.0,2343.0,0.892,12.94,150,50,24,26,100,39,61,86,0.05,0.02
1009,1841,2020-03-20 06:53:00,1,2467.0,2200.0,0.892,12.154,161,80,42,38,81,24,57,86,0.0,0.08
1009,1842,2020-03-20 06:56:00,1,2442.0,2292.0,0.939,12.16,133,59,29,30,74,12,62,86,0.01,0.0
1009,1843,2020-03-20 06:59:00,1,2673.0,2533.0,0.948,13.337,199,104,64,40,95,27,68,83,0.09,0.0
1009,1844,2020-03-20 07:02:00,1,2593.0,2420.0,0.934,12.894,123,50,23,27,73,7,66,88,0.01,0.0
1009,1845,2020-03-20 07:05:00,1,2841.0,2602.0,0.916,14.072,126,50,21,29,76,7,69,72,0.01,0.02
1009,1846,2020-03-20 07:08:00,1,2624.0,2414.0,0.92,13.01,119,58,30,28,61,12,49,81,0.0,0.05
1009,1847,2020-03-20 07:11:00,1,2426.0,2360.0,0.973,12.172,212,90,45,45,122,57,65,84,0.07,0.01
1009,1848,2020-03-20 07:14:00,1,2223.0,2086.0,0.938,11.068,362,147,113,34,215,137,78,112,0.07,0.0
1009,1849,2020-03-20 07:17:00,1,2752.0,2583.0,0.938,13.703,145,59,27,32,86,2,84,86,0.0,0.03
1009,1850,2020-03-20 07:20:00,1,2522.0,2442.0,0.968,12.642,180,73,38,35,107,37,70,69,0.08,0.18
1009,1851,2020-03-20 07:23:00,1,2597.0,2441.0,0.94,12.935,183,86,46,40,97,25,72,102,0.04,0.0
1009,1852,2020-03-20 07:26:00,1,2576.0,2542.0,0.987,12.964,118,51,15,36,67,3,64,87,0.0,0.0
1009,1853,2020-03-20 07:29:00,1,2583.0,2535.0,0.981,12.985,207,94,60,34,113,67,46,56,0.13,0.0
1009,1854,2020-03-20 07:32:00,1,2033.0,2027.0,0.997,10.253,353,189,155,34,164,128,36,230,0.0,0.0
1009,1855,2020-03-20 07:35:00,1,2032.0,2064.0,1.016,10.293,343,195,163,32,148,109,39,315,0.03,0.0
1009,1856,2020-03-20 07:38:00,1,2295.0,2120.0,0.924,11.387,188,106,82,24,82,63,19,260,0.0,0.0
1009,1857,2020-03-20 07:41:00,1,2025.0,2051.0,1.013,10.249,277,147,119,28,130,96,34,340,0.0,0.0
1009,1858,2020-03-20 07:44:00,1,2266.0,2195.0,0.969,11.358,140,80,60,20,60,43,17,318,0.02,0.0
1009,1859,2020-03-20 07:47:00,1,2653.0,2576.0,0.971,13.306,145,58,19,39,87,3,84,98,0.0,0.0
1009,1860,2020-03-20 07:50:00,1,2828.0,2661.0,0.941,14.088,142,60,18,42,82,10,72,91,0.03,0.0
1009,1861,2020-03-20 07:53:00,1,2792.0,2791.0,0.999,14.092,152,65,44,21,87,20,67,84,0.04,0.08
1009,1862,2020-03-20 07:56:00,1,2564.0,2560.0,0.998,12.936,189,106,67,39,83,37,46,69,0.05,0.0
1009,1863,2020-03-20 07:59:00,1,2580.0,2500.0,0.969,12.933,180,67,32,35,113,35,78,80,0.03,0.0
1009,1864,2020-03-20 08:02:00,1,1908.0,1825.0,0.956,9.538,2,2,1,1,0,0,0,115,0.01,0.0
1009,1865,2020-03-20 08:05:00,1,2034.0,2075.0,1.02,10.312,0,0,0,0,0,0,0,32,0.0,0.0
1009,1866,2020-03-20 08:08:00,1,2290.0,2163.0,0.945,11.417,0,0,0,0,0,0,0,0,0.02,0.01
1009,1867,2020-03-20 08:11:00,1,2035.0,2056.0,1.011,10.295,0,0,0,0,0,0,0,17,0.0,0.0
1009,1868,2020-03-20 08:14:00,1,1986.5,1879.5,0.945,9.9085,0,0,0,0,0,0,0,6,0.0,0.0
1009,1869,2020-03-20 08:17:00,1,1938.0,1703.0,0.879,9.522,0,0,0,0,0,0,0,0,0.0,0.0
1009,1870,2020-03-20 08:20:00,1,1845.0,1683.0,0.912,9.133,0,0,0,0,0,0,0,4,0.0,0.0
1009,1871,2020-03-20 08:23:00,1,1759.0,1655.0,0.941,8.761,0,0,0,0,0,0,0,5,0.0,0.0
1009,1872,2020-03-20 08:26:00,1,1834.0,1737.0,0.947,9.148,0,0,0,0,0,0,0,6,0.0,0.0
1009,1873,2020-03-20 08:29:00,1,1758.0,1618.0,0.921,8.717,0,0,0,0,0,0,0,11,0.0,0.0
1009,1874,2020-03-20 08:32:00,1,1691.0,1555.0,0.919,8.386,0,0,0,0,0,0,0,0,0.0,0.0
1009,1875,2020-03-20 08:35:00,1,1595.0,1546.0,0.969,7.998,0,0,0,0,0,0,0,1,0.0,0.0
1009,1876,2020-03-20 08:38:00,1,1627.0,1440.0,0.885,8.004,0,0,0,0,0,0,0,5,0.0,0.0
1009,1877,2020-03-20 08:41:00,1,1450.0,1372.0,0.946,7.23,0,0,0,0,0,0,0,7,0.0,0.0
1009,1878,2020-03-20 08:44:00,1,1438.0,1378.0,0.958,7.193,168,94,79,15,74,48,26,31,0.0,0.0
1009,1879,2020-03-20 08:47:00,1,1749.0,1694.0,0.968,8.768,120,79,51,28,41,19,22,93,0.0,0.03
1009,1880,2020-03-20 08:50:00,1,1979.0,1930.0,0.975,9.932,95,50,31,19,45,5,40,79,0.0,0.02
1009,1881,2020-03-20 08:53:00,1,1996.0,1785.0,0.895,9.839,0,0,0,0,0,0,0,106,0.0,0.01
1009,1882,2020-03-20 08:56:00,1,2001.0,1814.0,0.907,9.894,47,17,13,4,30,24,6,75,0.0,0.0
1009,1883,2020-03-20 08:59:00,1,2003.0,1832.0,0.914,9.922,0,0,0,0,0,0,0,0,0.0,0.0
1009,1884,2020-03-20 09:02:00,1,1974.0,1887.0,0.956,9.867,0,0,0,0,0,0,0,3,0.0,0.0
1009,1885,2020-03-20 09:05:00,1,1992.0,1860.0,0.933,9.909,0,0,0,0,0,0,0,19,0.0,0.0
1009,1886,2020-03-20 09:08:00,1,1822.0,1751.0,0.961,9.116,0,0,0,0,0,0,0,2,0.0,0.0
1009,1887,2020-03-20 09:11:00,1,1740.0,1710.0,0.983,8.749,0,0,0,0,0,0,0,2,0.01,0.0
1009,1888,2020-03-20 09:14:00,1,1753.0,1648.0,0.94,8.732,0,0,0,0,0,0,0,9,0.0,0.0
1009,1889,2020-03-20 09:17:00,1,1679.0,1574.0,0.937,8.359,0,0,0,0,0,0,0,4,0.0,0.0
1009,1890,2020-03-20 09:20:00,1,1604.0,1515.0,0.945,7.999,0,0,0,0,0,0,0,8,0.0,0.0
1009,1891,2020-03-20 09:23:00,1,1622.0,1448.0,0.893,7.993,0,0,0,0,0,0,0,8,0.0,0.0
1009,1892,2020-03-20 09:26:00,1,1609.0,1492.0,0.928,7.992,0,0,0,0,0,0,0,7,0.0,0.0
1009,1893,2020-03-20 09:29:00,1,1627.0,1445.0,0.888,8.01,0,0,0,0,0,0,0,3,0.0,0.0
1009,1894,2020-03-20 09:32:00,1,1619.0,1479.0,0.914,8.016,0,0,0,0,0,0,0,15,0.0,0.0
1009,1895,2020-03-20 09:35:00,1,1598.0,1548.0,0.968,8.012,181,92,74,18,89,59,30,90,0.0,0.0
1009,1896,2020-03-20 09:38:00,1,1756.0,1660.0,0.945,8.756,107,59,33,26,48,14,34,83,0.0,0.01
1009,1897,2020-03-20 09:41:00,1,1820.0,1764.0,0.969,9.121,142,64,23,41,78,9,69,87,0.0,0.0
1009,1898,2020-03-20 09:44:00,1,2144.0,2007.0,0.936,10.67,158,64,26,38,94,2,92,131,0.0,0.0
1009,1899,2020-03-20 09:47:00,1,2380.0,2196.0,0.923,11.808,152,63,17,46,89,11,78,87,0.0,0.03
1009,1900,2020-03-20 09:50:00,1,2440.0,2324.0,0.952,12.188,123,33,13,20,90,12,78,92,0.0,0.03
1009,1901,2020-03-20 09:53:00,1,2517.0,2414.0,0.959,12.59,147,68,27,41,79,9,70,84,0.0,0.03
1009,1902,2020-03-20 09:56:00,1,2578.0,2519.0,0.977,12.946,168,70,39,31,98,41,57,75,0.08,0.08
1009,1903,2020-03-20 09:59:00,1,2522.0,2332.0,0.924,12.52,153,69,33,36,84,6,78,82,0.01,0.0
1009,1904,2020-03-20 10:02:00,1,2652.0,2663.0,1.004,13.395,156,59,22,37,97,21,76,84,0.0,0.0
1009,1905,2020-03-20 10:05:00,1,2505.0,2470.0,0.986,12.602,224,93,56,37,131,68,63,79,0.15,0.04
1009,1906,2020-03-20 10:08:00,1,2654.0,2552.0,0.961,13.284,146,54,14,40,92,8,84,76,0.0,0.0
1009,1907,2020-03-20 10:11:00,1,2675.0,2559.0,0.957,13.371,180,75,33,42,105,25,80,69,0.06,0.08
1009,1908,2020-03-20 10:14:00,1,2895.0,2768.0,0.956,14.471,155,69,26,43,86,12,74,91,0.0,0.0
1009,1909,2020-03-20 10:17:00,1,2654.0,2587.0,0.975,13.322,173,81,44,37,92,26,66,71,0.04,0.05
1009,1910,2020-03-20 10:20:00,1,2120.0,2109.0,0.995,10.689,44,28,23,5,16,8,8,81,0.02,0.0
1009,1911,2020-03-20 10:23:00,1,2520.0,2334.0,0.926,12.512,176,70,40,30,106,44,62,84,0.02,0.01
1009,1912,2020-03-20 10:26:00,1,2651.0,2578.0,0.973,13.298,151,64,26,38,87,11,76,84,0.0,0.0
1009,1913,2020-03-20 10:29:00,1,2678.0,2537.0,0.947,13.361,120,54,24,30,66,8,58,86,0.01,0.05
1009,1914,2020-03-20 10:32:00,1,2804.0,2678.0,0.955,14.012,128,55,18,37,73,4,69,90,0.0,0.06
1009,1915,2020-03-20 10:35:00,1,2654.0,2566.0,0.967,13.297,113,49,32,17,64,30,34,84,0.11,0.04
1009,1916,2020-03-20 10:38:00,1,2126.0,2047.0,0.963,10.641,470,254,200,54,216,150,66,78,0.09,0.09
1009,1917,2020-03-20 10:41:00,1,2208.0,2134.0,0.967,11.061,197,107,85,22,90,74,16,316,0.0,0.0
1009,1918,2020-03-20 10:44:00,1,2350.0,2292.0,0.975,11.798,339,155,125,30,184,144,40,341,0.0,0.0
1009,1919,2020-03-20 10:47:00,1,2532.0,2364.0,0.933,12.595,290,153,129,24,137,107,30,363,0.07,0.0
1009,1920,2020-03-20 10:50:00,1,2540.0,2345.0,0.924,12.603,168,78,57,21,90,44,46,177,0.0,0.0
1009,1921,2020-03-20 10:53:00,1,2362.0,2248.0,0.952,11.795,59,24,17,7,35,14,21,130,0.0,0.0
1009,1922,2020-03-20 10:56:00,1,2601.0,2478.0,0.953,12.99,112,38,10,28,74,2,72,96,0.0,0.0
1009,1923,2020-03-20 10:59:00,1,2896.0,2753.0,0.95,14.459,105,32,7,25,73,2,71,83,0.0,0.0
1009,1924,2020-03-20 11:02:00,1,2472.0,2517.0,1.018,12.526,257,112,87,25,145,87,58,81,0.06,0.05
1009,1925,2020-03-20 11:05:00,1,1977.0,1924.0,0.973,9.92,47,27,21,6,20,14,6,73,0.0,0.0
1009,1926,2020-03-20 11:08:00,1,2036.0,1973.0,0.969,10.206,415,239,197,42,176,127,49,69,0.01,0.0
1009,1927,2020-03-20 11:11:00,1,2109.0,2119.0,1.005,10.655,52,30,26,4,22,14,8,88,0.0,0.0
1009,1928,2020-03-20 11:14:00,1,2051.0,1983.5,0.9665,10.276,102,57,31,26,45,18,27,16,0.0,0.0
1009,1929,2020-03-20 11:17:00,1,1993.0,1848.0,0.928,9.897,5,4,1,3,1,0,1,0,0.0,0.0
1009,1930,2020-03-20 11:20:00,1,1984.0,1887.0,0.951,9.907,7,5,2,3,2,0,2,0,0.0,0.0
1009,1931,2020-03-20 11:23:00,1,1992.0,1864.0,0.936,9.91,0,0,0,0,0,0,0,0,0.0,0.0
1009,1932,2020-03-20 11:26:00,1,1954.0,1957.0,1.002,9.865,36,17,1,16,19,1,18,0,0.0,0.0
1009,1933,2020-03-20 11:29:00,1,2045.0,2005.0,0.98,10.276,9,5,1,4,4,0,4,0,0.0,0.0
1009,1934,2020-03-20 11:32:00,1,1983.0,1932.0,0.974,9.951,17,5,1,4,12,1,11,0,0.0,0.0
1009,1935,2020-03-20 11:35:00,1,1905.0,1855.0,0.974,9.559,28,1,0,1,27,0,27,0,0.0,0.0
1009,1936,2020-03-20 11:38:00,1,1750.0,1684.0,0.962,8.759,53,30,0,30,23,0,23,0,0.0,0.0
1009,1937,2020-03-20 11:41:00,1,1771.0,1612.0,0.91,8.763,38,19,1,18,19,0,19,0,0.0,0.0
1009,1938,2020-03-20 11:44:00,1,1662.0,1655.0,0.996,8.38,1,1,0,1,0,0,0,0,0.0,0.0
1009,1939,2020-03-20 11:47:00,1,1673.0,1614.0,0.965,8.377,0,0,0,0,0,0,0,0,0.0,0.0
1009,1940,2020-03-20 11:50:00,1,1584.0,1596.0,1.007,8.009,2,0,0,0,2,0,2,0,0.0,0.0
1009,1941,2020-03-20 11:53:00,1,1585.0,1590.0,1.003,8.007,2,0,0,0,2,0,2,0,0.0,0.0
1009,1942,2020-03-20 11:56:00,1,1585.0,1597.0,1.007,8.014,137,63,51,12,74,51,23,23,0.0,0.0
1009,1943,2020-03-20 11:59:00,1,1755.0,1687.0,0.962,8.783,54,9,2,7,45,13,32,0,0.0,0.0
1009,1944,2020-03-20 12:02:00,1,1580.0,1610.0,1.019,8.007,61,0,0,0,61,37,24,0,0.0,0.0
1009,1945,2020-03-20 12:05:00,1,1594.0,1557.0,0.977,8.003,94,6,0,6,88,42,46,0,0.0,0.0
1009,1946,2020-03-20 12:08:00,1,1581.0,1576.0,0.997,7.973,17,0,0,0,17,2,15,0,0.0,0.0
1010,1,2020-03-16 10:53:00,1,3967.0,2735.0,0.69,18.658,39,28,15,13,11,0,11,2,0.0,0.0
1010,2,2020-03-16 10:56:00,1,3597.0,2487.0,0.691,16.927,89,73,43,30,16,0,16,4,0.0,0.0
1010,3,2020-03-16 10:59:00,1,3594.0,2555.0,0.711,16.991,315,207,145,62,108,73,35,12,0.06,0.0
1010,4,2020-03-16 11:02:00,1,4232.0,3021.0,0.714,20.019,258,157,102,55,101,66,35,9,0.0,0.0
1010,5,2020-03-16 11:05:00,1,4085.0,2903.0,0.711,19.308,30,19,3,16,11,0,11,0,0.0,0.0
1010,6,2020-03-16 11:08:00,1,3605.0,2570.0,0.713,17.048,0,0,0,0,0,0,0,0,0.0,0.0
1010,7,2020-03-16 11:11:00,1,3362.0,2419.0,0.72,15.925,8,7,3,4,1,0,1,0,0.0,0.0
1010,8,2020-03-16 11:14:00,1,3216.0,2269.0,0.706,15.185,20,16,10,6,4,0,4,0,0.0,0.0
1010,9,2020-03-16 11:17:00,1,3046.0,2121.0,0.696,14.35,9,2,1,1,7,0,7,0,0.0,0.0
1010,10,2020-03-16 11:20:00,1,2876.0,1973.0,0.686,13.515,34,10,1,9,24,0,24,0,0.01,0.0
1010,11,2020-03-16 11:23:00,1,2868.0,2010.0,0.701,13.527,12,12,1,11,0,0,0,0,0.06,0.0
1010,12,2020-03-16 11:26:00,1,2714.0,1914.0,0.705,12.814,17,17,0,17,0,0,0,0,0.0,0.0
1010,13,2020-03-16 11:29:00,1,2865.0,2007.0,0.701,13.51,58,47,19,28,11,7,4,0,0.0,0.0
1010,14,2020-03-16 11:32:00,1,2865.0,1960.0,0.684,13.46,8,8,1,7,0,0,0,0,0.01,0.0
1010,15,2020-03-16 11:35:00,1,2711.0,1911.0,0.705,12.799,8,7,1,6,1,0,1,0,0.0,0.0
1010,16,2020-03-16 11:38:00,1,2666.0,1861.0,0.698,12.567,7,7,3,4,0,0,0,0,0.0,0.0
1010,17,2020-03-16 11:41:00,1,2657.0,1824.0,0.686,12.487,29,23,11,12,6,0,6,0,0.01,0.0
1010,18,2020-03-16 11:44:00,1,2650.0,1907.0,0.72,12.551,38,23,9,14,15,0,15,0,0.0,0.0
1010,19,2020-03-16 11:47:00,1,2644.0,1861.0,0.704,12.477,21,11,8,3,10,6,4,0,0.04,0.0
1010,20,2020-03-16 11:50:00,1,2666.0,1854.0,0.695,12.559,12,3,1,2,9,0,9,0,0.0,0.0
1010,21,2020-03-16 11:53:00,1,2665.0,1808.0,0.678,12.502,16,6,4,2,10,0,10,0,0.01,0.0
1010,22,2020-03-16 11:56:00,1,2565.0,1792.0,0.699,12.089,41,18,6,12,23,0,23,0,0.0,0.0
1010,23,2020-03-16 11:59:00,1,2657.0,1811.0,0.682,12.473,20,18,10,8,2,0,2,0,0.0,0.0
1010,24,2020-03-16 12:02:00,1,2479.0,1754.0,0.708,11.71,27,27,12,15,0,0,0,0,0.01,0.0
1010,25,2020-03-16 12:05:00,1,3248.0,2274.0,0.7,15.315,27,26,11,15,1,0,1,1,0.0,0.0
1010,26,2020-03-16 12:08:00,1,3590.0,2631.0,0.733,17.059,152,125,72,53,27,8,19,3,0.0,0.0
1010,27,2020-03-16 12:11:00,1,2852.0,2013.0,0.706,13.467,8,8,2,6,0,0,0,0,0.0,0.0
1010,28,2020-03-16 12:14:00,1,2803.0,1936.0,0.691,13.189,292,292,245,47,0,0,0,0,0.0,0.0
1010,29,2020-03-16 12:17:00,1,2648.0,1815.0,0.686,12.444,1,1,0,1,0,0,0,0,0.0,0.0
1010,30,2020-03-16 12:20:00,1,2559.0,1785.0,0.698,12.06,7,7,2,5,0,0,0,0,0.0,0.0
1010,31,2020-03-16 12:23:00,1,2498.0,1742.0,0.698,11.77,11,11,5,6,0,0,0,0,0.01,0.0
1010,32,2020-03-16 12:26:00,1,2425.0,1661.0,0.685,11.393,1,1,0,1,0,0,0,0,0.0,0.0
1010,33,2020-03-16 12:29:00,1,2352.0,1650.0,0.701,11.095,13,13,4,9,0,0,0,0,0.0,0.0
1010,34,2020-03-16 12:32:00,1,2348.0,1641.0,0.699,11.069,4,4,0,4,0,0,0,0,0.0,0.0
1010,35,2020-03-16 12:35:00,1,2493.0,1715.0,0.688,11.723,0,0,0,0,0,0,0,0,0.0,0.0
1010,36,2020-03-16 12:38:00,1,2479.0,1772.0,0.715,11.728,5,5,1,4,0,0,0,0,0.0,0.0
1010,37,2020-03-16 12:41:00,1,2860.0,2037.0,0.712,13.522,2,2,0,2,0,0,0,0,0.0,0.0
1010,38,2020-03-16 12:44:00,1,2485.0,1776.0,0.715,11.758,7,7,1,6,0,0,0,0,0.0,0.0
1010,39,2020-03-16 12:47:00,1,2265.0,1534.0,0.677,10.622,17,17,0,17,0,0,0,0,0.0,0.0
1010,40,2020-03-16 12:50:00,1,2270.0,1546.0,0.681,10.654,0,0,0,0,0,0,0,0,0.01,0.0
1010,41,2020-03-16 12:53:00,1,2277.0,1591.0,0.699,10.732,0,0,0,0,0,0,0,0,0.0,0.0
1010,42,2020-03-16 12:56:00,1,2424.0,1691.0,0.698,11.422,5,4,0,4,1,0,1,0,0.0,0.0
1010,43,2020-03-16 12:59:00,1,2493.0,1777.0,0.713,11.792,6,6,0,6,0,0,0,0,0.0,0.0
1010,44,2020-03-16 13:02:00,1,2509.0,1813.0,0.722,11.893,1,1,1,0,0,0,0,0,0.0,0.0
1010,45,2020-03-16 13:05:00,1,2595.0,1937.0,0.746,12.369,0,0,0,0,0,0,0,0,0.0,0.0
1010,46,2020-03-16 13:08:00,1,2848.0,2092.0,0.734,13.536,2,2,0,2,0,0,0,0,0.0,0.0
1010,47,2020-03-16 13:11:00,1,2643.0,1931.0,0.731,12.554,2,2,1,1,0,0,0,0,0.01,0.0
1010,48,2020-03-16 13:14:00,1,2497.0,1820.0,0.729,11.853,1,1,1,0,0,0,0,0,0.0,0.0
1010,49,2020-03-16 13:17:00,1,2474.0,1791.0,0.724,11.73,4,4,4,0,0,0,0,0,0.0,0.0
1010,50,2020-03-16 13:20:00,1,2616.0,1909.0,0.73,12.42,75,64,43,21,11,2,9,4,0.01,0.0
1010,51,2020-03-16 13:23:00,1,2992.0,2167.0,0.724,14.188,45,45,19,26,0,0,0,0,0.04,0.0
1010,52,2020-03-16 13:26:00,1,3189.0,2321.0,0.728,15.136,89,71,30,41,18,8,10,0,0.0,0.0
1010,53,2020-03-16 13:29:00,1,3265.0,2448.0,0.75,15.574,337,289,217,72,48,32,16,4,0.0,0.0
1010,54,2020-03-16 13:32:00,1,3196.0,2337.0,0.731,15.182,168,154,111,43,14,6,8,3,0.01,0.0
1010,55,2020-03-16 13:35:00,1,2965.0,2240.0,0.755,14.163,50,49,15,34,1,0,1,0,0.0,0.0
1010,56,2020-03-16 13:38:00,1,2780.0,1995.0,0.718,13.164,5,5,2,3,0,0,0,0,0.0,0.0
1010,57,2020-03-16 13:41:00,1,2858.0,2025.0,0.709,13.502,9,9,4,5,0,0,0,0,0.0,0.0
1010,58,2020-03-16 13:44:00,1,2841.0,2017.0,0.71,13.426,1,1,0,1,0,0,0,0,0.0,0.0
1010,59,2020-03-16 13:47:00,1,2764.0,1997.0,0.722,13.103,9,9,5,4,0,0,0,0,0.01,0.0
1010,60,2020-03-16 13:50:00,1,2560.0,1841.0,0.719,12.124,0,0,0,0,0,0,0,0,0.0,0.0
1010,61,2020-03-16 13:53:00,1,2303.0,1567.0,0.681,10.808,3,3,1,2,0,0,0,0,0.0,0.0
1010,62,2020-03-16 13:56:00,1,2286.0,1592.0,0.696,10.768,4,4,0,4,0,0,0,0,0.0,0.0
1010,63,2020-03-16 13:59:00,1,2193.0,1539.0,0.702,10.346,9,9,0,9,0,0,0,0,0.0,0.0
1010,64,2020-03-16 14:02:00,1,2254.0,1671.0,0.741,10.73,27,27,0,27,0,0,0,0,0.0,0.0
1010,65,2020-03-16 14:05:00,1,2560.0,1852.0,0.723,12.139,7,7,0,7,0,0,0,0,0.0,0.0
1010,66,2020-03-16 14:08:00,1,2642.0,1940.0,0.735,12.556,13,13,0,13,0,0,0,0,0.01,0.0
1010,67,2020-03-16 14:11:00,1,2623.0,1911.0,0.729,12.451,14,14,0,14,0,0,0,0,0.01,0.0
1010,68,2020-03-16 14:14:00,1,2631.0,1886.0,0.717,12.456,3,3,0,3,0,0,0,0,0.0,0.0
1010,69,2020-03-16 14:17:00,1,2452.0,1721.5,0.701,11.5675,0,0,0,0,0,0,0,0,0.0,0.0
1010,70,2020-03-16 14:20:00,1,2273.0,1557.0,0.685,10.679,3,3,0,3,0,0,0,0,0.0,0.0
1010,71,2020-03-16 14:23:00,1,2355.0,1658.0,0.704,11.115,1,1,0,1,0,0,0,0,0.0,0.0
1010,72,2020-03-16 14:26:00,1,2506.0,1723.0,0.688,11.78,2,2,0,2,0,0,0,0,0.0,0.0
1010,73,2020-03-16 14:29:00,1,2576.0,1802.0,0.699,12.146,10,10,2,8,0,0,0,0,0.01,0.0
1010,74,2020-03-16 14:32:00,1,2909.0,2058.0,0.707,13.742,148,143,95,48,5,0,5,1,0.0,0.0
1010,75,2020-03-16 14:35:00,1,2907.0,2138.0,0.735,13.822,435,365,276,89,70,51,19,0,0.0,0.0
1010,76,2020-03-16 14:38:00,1,3279.0,2431.0,0.741,15.612,149,130,72,58,19,13,6,2,0.0,0.0
1010,77,2020-03-16 14:41:00,1,2989.0,2143.0,0.717,14.148,95,95,25,70,0,0,0,0,0.0,0.0
1010,78,2020-03-16 14:44:00,1,2946.0,2052.0,0.696,13.881,289,289,197,92,0,0,0,0,0.0,0.0
1010,79,2020-03-16 14:47:00,1,2732.0,1954.0,0.715,12.928,135,135,67,68,0,0,0,0,0.0,0.0
1010,80,2020-03-16 14:50:00,1,2635.0,1854.0,0.704,12.435,48,48,0,48,0,0,0,0,0.0,0.0
1010,81,2020-03-16 14:53:00,1,2660.0,1886.0,0.709,12.569,44,44,0,44,0,0,0,0,0.0,0.0
1010,82,2020-03-16 14:56:00,1,2567.0,1827.0,0.712,12.136,47,47,0,47,0,0,0,0,0.0,0.0
1010,83,2020-03-16 14:59:00,1,2577.0,1777.0,0.69,12.12,41,41,0,41,0,0,0,0,0.01,0.0
1010,84,2020-03-16 15:02:00,1,2498.0,1731.0,0.693,11.76,39,39,0,39,0,0,0,0,0.01,0.0
1010,85,2020-03-16 15:05:00,1,2355.0,1641.0,0.697,11.094,24,24,0,24,0,0,0,0,0.0,0.0
1010,86,2020-03-16 15:08:00,1,2354.0,1606.0,0.682,11.054,41,41,0,41,0,0,0,0,0.0,0.0
1010,87,2020-03-16 15:11:00,1,2340.0,1622.0,0.693,11.014,40,40,0,40,0,0,0,0,0.0,0.0
1010,88,2020-03-16 15:14:00,1,2359.0,1660.0,0.703,11.133,33,33,0,33,0,0,0,0,0.0,0.0
1010,89,2020-03-16 15:17:00,1,2340.0,1684.0,0.72,11.086,24,24,4,20,0,0,0,0,0.0,0.0
1010,90,2020-03-16 15:20:00,1,2359.0,1621.0,0.687,11.09,0,0,0,0,0,0,0,0,0.0,0.0
1010,91,2020-03-16 15:23:00,1,2269.0,1572.0,0.693,10.679,0,0,0,0,0,0,0,0,0.01,0.0
1010,92,2020-03-16 15:26:00,1,2194.0,1574.0,0.718,10.388,4,4,0,4,0,0,0,0,0.0,0.0
1010,93,2020-03-16 15:29:00,1,2289.0,1606.0,0.702,10.797,0,0,0,0,0,0,0,0,0.0,0.0
1010,94,2020-03-16 15:32:00,1,2251.0,1586.0,0.705,10.626,0,0,0,0,0,0,0,0,0.0,0.0
1010,95,2020-03-16 15:35:00,1,2220.0,1536.0,0.692,10.448,0,0,0,0,0,0,0,0,0.0,0.0
1010,96,2020-03-16 15:38:00,1,2275.0,1603.0,0.705,10.736,25,23,10,13,2,0,2,0,0.0,0.0
1010,97,2020-03-16 15:41:00,1,2535.0,1885.0,0.744,12.075,22,21,13,8,1,0,1,0,0.0,0.0
1010,98,2020-03-16 15:44:00,1,2561.0,1843.0,0.719,12.131,2,2,1,1,0,0,0,0,0.0,0.0
1010,99,2020-03-16 15:47:00,1,2562.0,1828.0,0.713,12.118,11,11,2,9,0,0,0,0,0.01,0.0
1010,100,2020-03-16 15:50:00,1,2508.0,1777.0,0.709,11.849,1,1,0,1,0,0,0,0,0.0,0.0
1010,101,2020-03-16 15:53:00,1,2210.0,1576.0,0.713,10.452,2,1,0,1,1,0,1,0,0.0,0.0
1010,102,2020-03-16 15:56:00,1,2202.0,1550.0,0.704,10.392,0,0,0,0,0,0,0,0,0.0,0.0
1010,103,2020-03-16 15:59:00,1,2278.0,1585.0,0.696,10.732,0,0,0,0,0,0,0,0,0.0,0.0
1010,104,2020-03-16 16:02:00,1,2344.0,1606.0,0.685,11.016,2,2,0,2,0,0,0,0,0.0,0.0
1010,105,2020-03-16 16:05:00,1,2567.0,1882.0,0.733,12.199,87,82,54,28,5,1,4,3,0.0,0.0
1010,106,2020-03-16 16:08:00,1,2669.0,2002.0,0.75,12.731,0,0,0,0,0,0,0,0,0.0,0.0
1010,107,2020-03-16 16:11:00,1,2731.0,1935.0,0.708,12.904,0,0,0,0,0,0,0,0,0.0,0.0
1010,108,2020-03-16 16:14:00,1,2560.0,1894.0,0.74,12.182,2,2,1,1,0,0,0,0,0.0,0.0
1010,109,2020-03-16 16:17:00,1,2477.0,1730.0,0.699,11.674,0,0,0,0,0,0,0,0,0.0,0.0
1010,110,2020-03-16 16:20:00,1,2203.0,1539.0,0.698,10.385,8,8,2,6,0,0,0,0,0.0,0.0
1010,111,2020-03-16 16:23:00,1,2189.0,1561.0,0.713,10.352,3,3,0,3,0,0,0,0,0.0,0.0
1010,112,2020-03-16 16:26:00,1,2359.0,1599.0,0.678,11.065,5,5,0,5,0,0,0,0,0.0,0.0
1010,113,2020-03-16 16:29:00,1,2348.0,1627.0,0.693,11.052,4,4,0,4,0,0,0,0,0.01,0.0
1010,114,2020-03-16 16:32:00,1,2312.0,1676.0,0.725,10.965,2,2,0,2,0,0,0,0,0.0,0.0
1010,115,2020-03-16 16:35:00,1,2344.0,1660.0,0.708,11.074,7,7,3,4,0,0,0,0,0.0,0.0
1010,116,2020-03-16 16:38:00,1,2354.0,1713.0,0.727,11.173,4,4,0,4,0,0,0,0,0.0,0.0
1010,117,2020-03-16 16:41:00,1,2337.0,1711.0,0.732,11.103,1,1,0,1,0,0,0,0,0.0,0.0
1010,118,2020-03-16 16:44:00,1,2391.0,1743.0,0.729,11.35,0,0,0,0,0,0,0,0,0.01,0.0
1010,119,2020-03-16 16:47:00,1,2528.0,1889.0,0.747,12.051,105,103,67,36,2,1,1,3,0.0,0.0
1010,120,2020-03-16 16:50:00,1,3027.0,2246.0,0.742,14.414,211,174,131,43,37,27,10,5,0.0,0.0
1010,121,2020-03-16 16:53:00,1,3281.0,2408.0,0.734,15.593,225,178,134,44,47,32,15,5,0.0,0.0
1010,122,2020-03-16 16:56:00,1,3281.0,2451.0,0.747,15.641,123,85,55,30,38,28,10,1,0.0,0.0
1010,123,2020-03-16 16:59:00,1,2856.0,2064.0,0.723,13.537,88,87,56,31,1,0,1,0,0.0,0.0
1010,124,2020-03-16 17:02:00,1,2918.0,2102.0,0.721,13.823,59,58,45,13,1,0,1,3,0.0,0.0
1010,125,2020-03-16 17:05:00,1,2928.0,2149.0,0.734,13.916,0,0,0,0,0,0,0,0,0.0,0.0
1010,126,2020-03-16 17:08:00,1,2766.0,2027.0,0.733,13.144,23,23,9,14,0,0,0,0,0.0,0.0
1010,127,2020-03-16 17:11:00,1,3077.0,2260.0,0.734,14.627,188,186,137,49,2,0,2,6,0.0,0.0
1010,128,2020-03-16 17:14:00,1,3080.0,2226.0,0.723,14.598,25,25,11,14,0,0,0,0,0.0,0.0
1010,129,2020-03-16 17:17:00,1,2887.5,2118.5,0.7345,13.7225,15,15,2,13,0,0,0,0,0.0,0.0
1010,130,2020-03-16 17:20:00,1,2695.0,2011.0,0.746,12.847,0,0,0,0,0,0,0,0,0.01,0.0
1010,131,2020-03-16 17:23:00,1,2567.0,1817.0,0.708,12.125,16,16,7,9,0,0,0,0,0.0,0.0
1010,132,2020-03-16 17:26:00,1,2557.0,1804.0,0.706,12.071,16,16,1,15,0,0,0,0,0.0,0.0
1010,133,2020-03-16 17:29:00,1,2550.0,1837.0,0.72,12.082,6,6,0,6,0,0,0,0,0.0,0.0
1010,134,2020-03-16 17:32:00,1,2351.0,1635.0,0.695,11.073,0,0,0,0,0,0,0,0,0.0,0.0
1010,135,2020-03-16 17:35:00,1,2327.0,1743.0,0.749,11.101,0,0,0,0,0,0,0,0,0.0,0.0
1010,136,2020-03-16 17:38:00,1,2339.0,1703.0,0.728,11.104,0,0,0,0,0,0,0,0,0.0,0.0
1010,137,2020-03-16 17:41:00,1,2340.0,1701.0,0.727,11.104,0,0,0,0,0,0,0,0,0.02,0.0
1010,138,2020-03-16 17:44:00,1,2328.0,1689.0,0.726,11.044,4,4,3,1,0,0,0,0,0.0,0.0
1010,139,2020-03-16 17:47:00,1,2353.0,1701.0,0.723,11.155,14,14,6,8,0,0,0,0,0.0,0.0
1010,140,2020-03-16 17:50:00,1,2562.0,1868.0,0.729,12.162,61,61,32,29,0,0,0,0,0.0,0.0
1010,141,2020-03-16 17:53:00,1,2674.0,1994.0,0.746,12.744,155,153,109,44,2,0,2,0,0.0,0.0
1010,142,2020-03-16 17:56:00,1,2943.0,2156.0,0.732,13.983,158,122,78,44,36,25,11,2,0.0,0.0
1010,143,2020-03-16 17:59:00,1,2907.0,2150.0,0.74,13.834,98,97,63,34,1,0,1,2,0.0,0.0
1010,144,2020-03-16 18:02:00,0,3045.0,2306.0,0.757,14.552,205,182,135,47,23,13,10,4,0.0,0.0
1010,145,2020-03-16 18:05:00,0,3308.0,2387.0,0.722,15.676,344,289,223,66,55,35,20,11,0.0,0.0
1010,146,2020-03-16 18:08:00,0,3482.0,2613.0,0.75,16.612,506,385,314,71,121,78,43,7,0.0,0.0
1010,147,2020-03-16 18:11:00,0,3428.0,2482.0,0.724,16.256,185,94,69,25,91,28,63,4,0.0,0.0
1010,148,2020-03-16 18:14:00,0,2994.0,2155.0,0.72,14.184,141,87,63,24,54,5,49,3,0.0,0.0
1010,149,2020-03-16 18:17:00,0,3088.0,2204.0,0.714,14.607,143,94,67,27,49,2,47,5,0.0,0.0
1010,150,2020-03-16 18:20:00,0,2694.0,2017.0,0.749,12.848,127,91,69,22,36,2,34,9,0.0,0.0
1010,151,2020-03-16 18:23:00,0,2914.0,2186.0,0.75,13.901,107,89,54,35,18,15,3,0,0.0,0.0
1010,152,2020-03-16 18:26:00,0,2859.0,2048.0,0.716,13.533,57,22,18,4,35,0,35,0,0.0,0.0
1010,153,2020-03-16 18:29:00,0,2774.0,2039.0,0.735,13.187,90,26,20,6,64,7,57,0,0.0,0.0
1010,154,2020-03-16 18:32:00,0,2731.0,1991.0,0.729,12.963,125,61,33,28,64,8,56,0,0.0,0.0
1010,155,2020-03-16 18:35:00,0,2990.0,2196.0,0.735,14.211,191,122,74,48,69,6,63,0,0.0,0.0
1010,156,2020-03-16 18:38:00,0,3027.0,2291.0,0.757,14.461,166,111,73,38,55,4,51,0,0.0,0.0
1010,157,2020-03-16 18:41:00,0,3214.0,2349.0,0.731,15.265,72,22,2,20,50,0,50,0,0.0,0.0
1010,158,2020-03-16 18:44:00,0,3022.0,2312.0,0.765,14.467,192,136,80,56,56,10,46,0,0.0,0.0
1010,159,2020-03-16 18:47:00,0,3282.0,2431.0,0.741,15.625,105,67,18,49,38,0,38,0,0.0,0.0
1010,160,2020-03-16 18:50:00,0,3279.0,2429.0,0.741,15.61,92,40,15,25,52,0,52,0,0.0,0.0
1010,161,2020-03-16 18:53:00,0,3265.0,2467.0,0.756,15.596,170,87,45,42,83,29,54,0,0.0,0.0
1010,162,2020-03-16 18:56:00,0,3262.0,2474.0,0.759,15.591,124,54,16,38,70,30,40,0,0.01,0.0
1010,163,2020-03-16 18:59:00,0,3031.0,2309.0,0.762,14.498,50,22,14,8,28,2,26,0,0.0,0.0
1010,164,2020-03-16 19:02:00,0,2899.0,2155.0,0.743,13.809,40,6,1,5,34,0,34,0,0.0,0.0
1010,165,2020-03-16 19:05:00,0,2677.0,2040.0,0.762,12.806,20,3,1,2,17,0,17,0,0.0,0.0
1010,166,2020-03-16 19:08:00,0,2699.0,1984.0,0.735,12.831,21,2,1,1,19,0,19,0,0.0,0.0
1010,167,2020-03-16 19:11:00,0,2561.0,1883.0,0.735,12.176,22,0,0,0,22,0,22,0,0.0,0.0
1010,168,2020-03-16 19:14:00,0,2556.0,1845.0,0.722,12.116,23,2,0,2,21,0,21,0,0.0,0.0
1010,169,2020-03-16 19:17:00,0,2551.0,1888.0,0.74,12.14,26,0,0,0,26,0,26,0,0.0,0.0
1010,170,2020-03-16 19:20:00,0,2555.0,1918.0,0.751,12.191,39,15,0,15,24,0,24,0,0.0,0.0
1010,171,2020-03-16 19:23:00,0,2616.0,1921.0,0.734,12.435,88,61,20,41,27,4,23,0,0.01,0.0
1010,172,2020-03-16 19:26:00,0,2906.0,2190.0,0.754,13.875,269,211,146,65,58,34,24,6,0.0,0.0
1010,173,2020-03-16 19:29:00,0,3305.0,2410.0,0.729,15.691,199,124,78,46,75,33,42,5,0.0,0.0
1010,174,2020-03-16 19:32:00,0,3425.0,2587.0,0.755,16.36,213,99,74,25,114,63,51,11,0.0,0.0
1010,175,2020-03-16 19:35:00,0,3285.0,2399.0,0.73,15.601,68,32,13,19,36,3,33,0,0.0,0.0
1010,176,2020-03-16 19:38:00,0,3278.0,2461.0,0.751,15.643,292,234,178,56,58,22,36,8,0.0,0.0
1010,177,2020-03-16 19:41:00,0,3479.0,2643.0,0.76,16.633,311,233,180,53,78,42,36,19,0.0,0.0
1010,178,2020-03-16 19:44:00,0,3783.0,2769.0,0.732,17.972,811,559,466,93,252,188,64,11,0.0,0.0
1010,179,2020-03-16 19:47:00,0,3687.0,2750.0,0.746,17.572,257,189,134,55,68,47,21,16,0.0,0.0
1010,180,2020-03-16 19:50:00,0,3781.0,2806.0,0.742,18.003,415,285,227,58,130,97,33,18,0.0,0.0
1010,181,2020-03-16 19:53:00,0,3799.0,2789.0,0.734,18.059,330,221,173,48,109,74,35,9,0.0,0.0
1010,182,2020-03-16 19:56:00,0,3816.0,2780.0,0.728,18.115,138,105,52,53,33,6,27,0,0.0,0.0
1010,183,2020-03-16 19:59:00,0,3774.0,2798.0,0.741,17.967,115,107,57,50,8,0,8,0,0.0,0.0
1010,184,2020-03-16 20:02:00,0,3820.0,2798.0,0.733,18.15,404,313,246,67,91,63,28,16,0.0,0.0
1010,185,2020-03-16 20:05:00,0,3911.0,2894.0,0.74,18.613,552,422,336,86,130,100,30,1,0.01,0.0
1010,186,2020-03-16 20:08:00,0,3786.0,2844.0,0.751,18.065,396,289,224,65,107,85,22,22,0.0,0.0
1010,187,2020-03-16 20:11:00,0,3780.0,2825.0,0.747,18.023,270,190,150,40,80,62,18,0,0.0,0.0
1010,188,2020-03-16 20:14:00,0,3641.0,2741.0,0.753,17.38,188,116,85,31,72,50,22,0,0.0,0.0
1010,189,2020-03-16 20:17:00,0,3485.0,2597.0,0.745,16.607,114,71,51,20,43,26,17,2,0.0,0.0
1010,190,2020-03-16 20:20:00,0,3329.0,2453.0,0.737,15.834,182,106,76,30,76,40,36,0,0.0,0.0
1010,191,2020-03-16 20:23:00,0,3115.0,2277.0,0.731,14.794,12,2,1,1,10,5,5,0,0.0,0.0
1010,192,2020-03-16 20:26:00,0,3069.0,2211.0,0.721,14.54,277,182,131,51,95,66,29,14,0.0,0.0
1010,193,2020-03-16 20:29:00,0,3290.0,2366.0,0.719,15.583,416,307,241,66,109,78,31,23,0.0,0.0
1010,194,2020-03-16 20:32:00,0,3403.0,2494.0,0.733,16.17,186,133,98,35,53,38,15,4,0.0,0.0
1010,195,2020-03-16 20:35:00,0,3280.0,2441.0,0.744,15.625,154,103,76,27,51,33,18,4,0.01,0.0
1010,196,2020-03-16 20:38:00,0,3322.0,2365.0,0.712,15.707,58,33,23,10,25,15,10,0,0.0,0.0
1010,197,2020-03-16 20:41:00,0,2934.0,2135.0,0.728,13.924,23,7,6,1,16,6,10,0,0.0,0.0
1010,198,2020-03-16 20:44:00,0,2849.0,2029.0,0.712,13.472,42,15,11,4,27,10,17,0,0.0,0.0
1010,199,2020-03-16 20:47:00,0,2720.0,1898.0,0.698,12.819,11,4,1,3,7,2,5,0,0.0,0.0
1010,200,2020-03-16 20:50:00,0,2577.0,1805.0,0.701,12.151,12,10,6,4,2,0,2,0,0.0,0.0
1010,201,2020-03-16 20:53:00,0,2575.0,1831.0,0.711,12.175,177,111,71,40,66,36,30,2,0.0,0.0
1010,202,2020-03-16 20:56:00,0,2889.0,2153.0,0.745,13.766,277,172,106,66,105,58,47,3,0.0,0.0
1010,203,2020-03-16 20:59:00,0,3286.0,2422.0,0.737,15.631,317,218,160,58,99,56,43,6,0.0,0.0
1010,204,2020-03-16 21:02:00,0,3421.0,2550.0,0.745,16.305,341,214,154,60,127,75,52,15,0.0,0.0
1010,205,2020-03-16 21:05:00,0,3535.0,2594.0,0.734,16.802,495,380,300,80,115,76,39,5,0.0,0.0
1010,206,2020-03-16 21:08:00,0,3600.0,2656.0,0.738,17.125,407,306,233,73,101,68,33,42,0.0,0.0
1010,207,2020-03-16 21:11:00,0,3649.0,2673.0,0.732,17.339,413,258,206,52,155,111,44,27,0.0,0.0
1010,208,2020-03-16 21:14:00,0,3723.0,2711.0,0.728,17.671,316,201,136,65,115,64,51,4,0.0,0.0
1010,209,2020-03-16 21:17:00,0,3630.0,2690.0,0.741,17.281,640,457,376,81,183,125,58,27,0.0,0.0
1010,210,2020-03-16 21:20:00,0,3636.0,2684.0,0.738,17.299,456,334,269,65,122,85,37,17,0.0,0.0
1010,211,2020-03-16 21:23:00,0,3641.0,2663.0,0.731,17.296,263,204,152,52,59,36,23,22,0.0,0.0
1010,212,2020-03-16 21:26:00,0,3582.0,2595.0,0.724,16.988,233,170,119,51,63,42,21,11,0.0,0.0
1010,213,2020-03-16 21:29:00,0,3506.0,2597.0,0.741,16.691,188,118,90,28,70,35,35,4,0.0,0.0
1010,214,2020-03-16 21:32:00,0,3270.0,2396.0,0.733,15.538,36,20,14,6,16,9,7,0,0.0,0.0
1010,215,2020-03-16 21:35:00,0,3051.0,2240.0,0.734,14.5,15,1,0,1,14,2,12,0,0.0,0.0
1010,216,2020-03-16 21:38:00,0,2924.0,2055.0,0.703,13.796,11,3,1,2,8,5,3,0,0.0,0.0
1010,217,2020-03-16 21:41:00,0,2699.0,1932.0,0.716,12.772,18,7,1,6,11,2,9,0,0.01,0.0
1010,218,2020-03-16 21:44:00,0,2568.0,1791.0,0.697,12.103,136,28,16,12,108,76,32,0,0.0,0.0
1010,219,2020-03-16 21:47:00,0,2556.0,1863.0,0.729,12.133,470,332,264,68,138,92,46,24,0.0,0.0
1010,220,2020-03-16 21:50:00,0,2995.0,2200.0,0.735,14.239,374,234,177,57,140,87,53,26,0.0,0.0
1010,221,2020-03-16 21:53:00,0,3303.0,2359.0,0.714,15.625,469,320,245,75,149,109,40,18,0.0,0.0
1010,222,2020-03-16 21:56:00,0,3269.0,2421.0,0.741,15.56,225,135,92,43,90,51,39,0,0.0,0.0
1010,223,2020-03-16 21:59:00,0,3459.0,2474.0,0.715,16.368,286,170,113,57,116,71,45,10,0.0,0.0
1010,224,2020-03-16 22:02:00,0,3341.0,2454.0,0.734,15.881,174,112,76,36,62,38,24,5,0.0,0.0
1010,225,2020-03-16 22:05:00,0,3302.0,2338.0,0.708,15.599,12,8,1,7,4,0,4,0,0.0,0.0
1010,226,2020-03-16 22:08:00,0,2924.0,2123.0,0.726,13.873,16,14,4,10,2,1,1,0,0.0,0.0
1010,227,2020-03-16 22:11:00,0,2724.0,1961.0,0.72,12.906,19,17,5,12,2,0,2,0,0.0,0.0
1010,228,2020-03-16 22:14:00,0,2539.0,1844.0,0.726,12.047,67,50,31,19,17,13,4,0,0.0,0.0
1010,229,2020-03-16 22:17:00,0,2509.0,1765.0,0.703,11.839,3,2,0,2,1,0,1,0,0.0,0.0
1010,230,2020-03-16 22:20:00,0,2337.0,1647.0,0.705,11.031,15,1,1,0,14,1,13,0,0.0,0.0
1010,231,2020-03-16 22:23:00,0,2350.0,1621.0,0.69,11.055,10,0,0,0,10,0,10,0,0.0,0.0
1010,232,2020-03-16 22:26:00,0,2200.0,1589.0,0.722,10.427,54,24,1,23,30,24,6,0,0.0,0.0
1010,233,2020-03-16 22:29:00,0,2137.0,1488.0,0.696,10.066,225,97,43,54,128,81,47,0,0.0,0.0
1010,234,2020-03-16 22:32:00,0,2696.0,1943.0,0.72,12.774,330,246,188,58,84,53,31,8,0.0,0.0
1010,235,2020-03-16 22:35:00,0,2990.0,2210.0,0.739,14.228,437,330,263,67,107,83,24,12,0.0,0.0
1010,236,2020-03-16 22:38:00,0,3265.0,2311.0,0.708,15.423,102,68,47,21,34,14,20,3,0.0,0.0
1010,237,2020-03-16 22:41:00,0,3291.0,2389.0,0.726,15.614,263,160,87,73,103,51,52,18,0.0,0.0
1010,238,2020-03-16 22:44:00,0,3285.0,2474.0,0.753,15.683,252,131,88,43,121,71,50,14,0.0,0.0
1010,239,2020-03-16 22:47:00,0,3436.0,2497.0,0.727,16.305,536,389,306,83,147,99,48,24,0.0,0.0
1010,240,2020-03-16 22:50:00,0,3419.0,2563.0,0.75,16.31,436,278,211,67,158,114,44,38,0.0,0.0
1010,241,2020-03-16 22:53:00,0,3477.0,2561.0,0.737,16.535,182,69,30,39,113,53,60,2,0.0,0.0
1010,242,2020-03-16 22:56:00,0,3571.0,2595.0,0.727,16.943,353,231,174,57,122,85,37,10,0.0,0.0
1010,243,2020-03-16 22:59:00,0,3566.0,2581.0,0.724,16.91,490,319,250,69,171,115,56,48,0.0,0.0
1010,244,2020-03-16 23:02:00,0,3587.0,2612.0,0.728,17.027,465,304,245,59,161,129,32,28,0.0,0.0
1010,245,2020-03-16 23:05:00,0,3573.0,2603.0,0.728,16.961,289,152,105,47,137,81,56,22,0.0,0.0
1010,246,2020-03-16 23:08:00,0,3427.0,2551.0,0.744,16.328,316,186,137,49,130,83,47,21,0.0,0.0
1010,247,2020-03-16 23:11:00,0,3419.0,2567.0,0.751,16.316,235,167,109,58,68,39,29,7,0.0,0.0
1010,248,2020-03-16 23:14:00,0,3502.0,2573.0,0.735,16.648,312,159,106,53,153,85,68,11,0.0,0.0
1010,249,2020-03-16 23:17:00,0,3459.0,2519.0,0.7285,16.4175,561,342,266,76,219,156,63,45,0.0,0.0
1010,250,2020-03-16 23:20:00,0,3416.0,2465.0,0.722,16.187,96,71,43,28,25,19,6,6,0.01,0.0
1010,251,2020-03-16 23:23:00,0,3370.0,2449.0,0.727,15.99,165,102,49,53,63,26,37,2,0.0,0.0
1010,252,2020-03-16 23:26:00,0,3280.0,2383.0,0.727,15.562,19,8,6,2,11,6,5,0,0.0,0.0
1010,253,2020-03-16 23:29:00,0,3086.0,2179.0,0.706,14.571,19,3,2,1,16,2,14,0,0.0,0.0
1010,254,2020-03-16 23:32:00,0,2925.0,2090.0,0.715,13.839,29,17,8,9,12,8,4,0,0.0,0.0
1010,255,2020-03-16 23:35:00,0,2687.0,1965.0,0.731,12.763,12,12,1,11,0,0,0,0,0.0,0.0
1010,256,2020-03-16 23:38:00,0,2557.0,1820.0,0.712,12.09,12,6,2,4,6,3,3,0,0.0,0.0
1010,257,2020-03-16 23:41:00,0,2404.0,1737.0,0.723,11.394,5,4,1,3,1,0,1,0,0.0,0.0
1010,258,2020-03-16 23:44:00,0,2362.0,1651.0,0.699,11.137,0,0,0,0,0,0,0,0,0.0,0.0
1010,259,2020-03-16 23:47:00,0,2192.0,1560.0,0.712,10.366,8,1,1,0,7,5,2,0,0.0,0.0
1010,260,2020-03-16 23:50:00,0,2123.0,1512.0,0.712,10.04,3,2,0,2,1,0,1,0,0.01,0.0
1010,261,2020-03-16 23:53:00,0,1970.0,1456.0,0.739,9.374,15,14,0,14,1,1,0,0,0.0,0.0
1010,262,2020-03-16 23:56:00,0,2000.0,1408.0,0.704,9.437,7,7,2,5,0,0,0,0,0.0,0.0
1010,263,2020-03-16 23:59:00,0,1910.0,1379.0,0.722,9.053,1,1,0,1,0,0,0,0,0.0,0.0
1010,264,2020-03-17 00:02:00,0,1818.0,1345.0,0.74,8.652,36,36,1,35,0,0,0,0,0.0,0.0
1010,265,2020-03-17 00:05:00,0,1993.0,1400.0,0.702,9.403,263,195,130,65,68,41,27,0,0.0,0.0
1010,266,2020-03-17 00:08:00,0,2318.0,1767.0,0.762,11.09,366,285,208,77,81,60,21,19,0.0,0.0
1010,267,2020-03-17 00:11:00,0,2835.0,2088.0,0.736,13.483,373,277,204,73,96,59,37,64,0.0,0.0
1010,268,2020-03-17 00:14:00,0,3128.0,2311.0,0.739,14.884,713,520,425,95,193,139,54,65,0.0,0.0
1010,269,2020-03-17 00:17:00,0,3262.0,2447.0,0.75,15.562,401,304,235,69,97,60,37,72,0.0,0.0
1010,270,2020-03-17 00:20:00,0,3345.0,2461.0,0.736,15.903,388,249,204,45,139,88,51,35,0.0,0.0
1010,271,2020-03-17 00:23:00,0,3324.0,2448.0,0.736,15.806,230,154,103,51,76,52,24,56,0.0,0.0
1010,272,2020-03-17 00:26:00,0,3462.0,2565.0,0.741,16.482,625,413,319,94,212,145,67,41,0.0,0.0
1010,273,2020-03-17 00:29:00,0,3503.0,2571.0,0.734,16.65,749,552,456,96,197,141,56,137,0.0,0.0
1010,274,2020-03-17 00:32:00,0,3789.0,2740.0,0.723,17.961,1027,739,618,121,288,210,78,218,0.0,0.0
1010,275,2020-03-17 00:35:00,0,3813.0,2820.0,0.74,18.145,845,625,522,103,220,160,60,136,0.0,0.0
1010,276,2020-03-17 00:38:00,0,3795.0,2787.0,0.734,18.038,612,412,336,76,200,144,56,103,0.0,0.0
1010,277,2020-03-17 00:41:00,0,3797.0,2794.0,0.736,18.055,593,393,317,76,200,142,58,119,0.0,0.0
1010,278,2020-03-17 00:44:00,0,3801.0,2749.0,0.723,18.019,563,384,302,82,179,120,59,86,0.0,0.0
1010,279,2020-03-17 00:47:00,0,3805.0,2706.0,0.711,17.989,412,281,218,63,131,89,42,63,0.01,0.0
1010,280,2020-03-17 00:50:00,0,3630.0,2629.0,0.724,17.213,494,351,276,75,143,103,40,78,0.0,0.0
1010,281,2020-03-17 00:53:00,0,3652.0,2642.0,0.723,17.314,445,312,234,78,133,81,52,91,0.0,0.0
1010,282,2020-03-17 00:56:00,0,3645.0,2662.0,0.73,17.309,480,384,293,91,96,51,45,77,0.0,0.0
1010,283,2020-03-17 00:59:00,0,3655.0,2641.0,0.723,17.326,301,242,172,70,59,26,33,102,0.0,0.0
1010,284,2020-03-17 01:02:00,0,3756.0,2726.0,0.726,17.816,525,333,251,82,192,120,72,90,0.0,0.0
1010,285,2020-03-17 01:05:00,0,3665.0,2708.0,0.739,17.44,468,372,286,86,96,60,36,69,0.0,0.0
1010,286,2020-03-17 01:08:00,0,3635.0,2687.0,0.739,17.298,608,444,356,88,164,119,45,125,0.0,0.0
1010,287,2020-03-17 01:11:00,0,3377.0,2605.0,0.771,16.189,437,317,246,71,120,90,30,76,0.0,0.0
1010,288,2020-03-17 01:14:00,0,3604.0,2712.0,0.753,17.201,510,377,297,80,133,95,38,74,0.0,0.0
1010,289,2020-03-17 01:17:00,0,3341.0,2598.0,0.778,16.039,447,328,262,66,119,77,42,51,0.0,0.0
1010,290,2020-03-17 01:20:00,0,3313.0,2538.0,0.766,15.864,450,284,222,62,166,116,50,62,0.01,0.0
1010,291,2020-03-17 01:23:00,0,3313.0,2563.0,0.774,15.89,354,272,211,61,82,55,27,73,0.39,0.0
1010,292,2020-03-17 01:26:00,0,3316.0,2575.0,0.777,15.916,218,168,117,51,50,21,29,54,0.0,0.0
1010,293,2020-03-17 01:29:00,0,3437.0,2755.0,0.801,16.594,582,433,319,114,149,96,53,62,0.0,0.0
1010,294,2020-03-17 01:32:00,0,3597.0,2814.0,0.782,17.288,509,355,262,93,154,93,61,54,0.15,0.0
1010,295,2020-03-17 01:35:00,0,3634.0,2851.0,0.784,17.475,330,283,209,74,47,15,32,75,0.0,0.0
1010,296,2020-03-17 01:38:00,0,3377.0,2703.0,0.8,16.298,326,275,182,93,51,17,34,112,0.0,0.0
1010,297,2020-03-17 01:41:00,0,2851.0,2288.0,0.803,13.765,311,242,178,64,69,34,35,71,0.0,0.0
1010,298,2020-03-17 01:44:00,0,3618.0,2920.0,0.807,17.486,304,179,124,55,125,77,48,31,0.11,0.0
1010,299,2020-03-17 01:47:00,0,3023.0,2422.0,0.801,14.592,299,221,156,65,78,40,38,73,0.0,0.0
1010,300,2020-03-17 01:50:00,0,3342.0,2830.0,0.847,16.299,405,315,232,83,90,44,46,86,0.0,0.0
1010,301,2020-03-17 01:53:00,0,3163.0,2556.0,0.808,15.29,363,283,203,80,80,48,32,63,0.0,0.0
1010,302,2020-03-17 01:56:00,0,2995.0,2510.0,0.838,14.582,357,229,184,45,128,95,33,61,0.0,0.0
1010,303,2020-03-17 01:59:00,0,2864.0,2347.0,0.819,13.883,496,298,231,67,198,138,60,38,0.0,0.0
1010,304,2020-03-17 02:02:00,0,2774.0,2276.0,0.82,13.449,345,207,148,59,138,89,49,45,0.0,0.0
1010,305,2020-03-17 02:05:00,0,3354.0,2798.0,0.834,16.311,279,200,135,65,79,53,26,69,0.0,0.0
1010,306,2020-03-17 02:08:00,0,3691.0,3109.0,0.842,17.984,355,283,204,79,72,33,39,75,0.0,0.0
1010,307,2020-03-17 02:11:00,0,3915.0,3242.0,0.828,19.013,322,243,160,83,79,46,33,54,0.0,0.0
1010,308,2020-03-17 02:14:00,0,2971.0,2527.0,0.851,14.501,160,95,46,49,65,22,43,10,0.0,0.0
1010,309,2020-03-17 02:17:00,0,3439.5,2907.5,0.846,16.77,310,227,157,70,83,51,32,55,0.0,0.0
1010,310,2020-03-17 02:20:00,0,3908.0,3288.0,0.841,19.039,393,317,239,78,76,18,58,122,0.0,0.02
1010,311,2020-03-17 02:23:00,0,3836.0,3207.0,0.836,18.664,410,305,224,81,105,50,55,88,0.36,0.0
1010,312,2020-03-17 02:26:00,0,3946.0,3285.0,0.833,19.184,288,240,164,76,48,8,40,89,0.0,0.0
1010,313,2020-03-17 02:29:00,0,3169.0,2604.0,0.822,15.367,309,190,145,45,119,82,37,53,0.0,0.0
1010,314,2020-03-17 02:32:00,0,3228.0,2703.0,0.837,15.71,289,184,136,48,105,67,38,77,0.0,0.0
1010,315,2020-03-17 02:35:00,0,3133.0,2620.0,0.836,15.244,261,158,114,44,103,69,34,59,0.0,0.0
1010,316,2020-03-17 02:38:00,0,3709.0,3122.0,0.842,18.068,519,314,243,71,205,157,48,38,0.0,0.03
1010,317,2020-03-17 02:41:00,0,3293.0,2717.0,0.825,15.983,438,295,233,62,143,101,42,75,0.0,0.0
1010,318,2020-03-17 02:44:00,0,3241.0,2606.0,0.804,15.656,310,176,125,51,134,86,48,33,0.0,0.0
1010,319,2020-03-17 02:47:00,0,2736.0,2189.0,0.8,13.204,124,74,35,39,50,15,35,6,0.0,0.0
1010,320,2020-03-17 02:50:00,0,3476.0,2860.0,0.823,16.862,262,176,126,50,86,56,30,22,0.0,0.0
1010,321,2020-03-17 02:53:00,0,3580.0,2901.0,0.81,17.316,300,244,169,75,56,35,21,97,0.0,0.0
1010,322,2020-03-17 02:56:00,0,3715.0,3080.0,0.829,18.049,396,324,240,84,72,27,45,102,0.0,0.0
1010,323,2020-03-17 02:59:00,0,3640.0,2988.0,0.821,17.651,288,176,121,55,112,68,44,44,0.0,0.0
1010,324,2020-03-17 03:02:00,0,2803.0,2259.0,0.806,13.543,414,323,249,74,91,51,40,120,0.0,0.0
1010,325,2020-03-17 03:05:00,0,3791.0,3106.0,0.819,18.377,365,309,232,77,56,14,42,93,0.0,0.0
1010,326,2020-03-17 03:08:00,0,2940.0,2352.0,0.8,14.188,113,93,72,21,20,2,18,16,0.0,0.0
1010,327,2020-03-17 03:11:00,0,2290.0,1859.0,0.812,11.082,8,5,0,5,3,1,2,0,0.0,0.01
1010,328,2020-03-17 03:14:00,0,2525.0,1973.0,0.781,12.132,18,8,4,4,10,3,7,0,0.0,0.0
1010,329,2020-03-17 03:17:00,0,2835.0,2188.0,0.772,13.592,44,22,14,8,22,15,7,0,0.0,0.0
1010,330,2020-03-17 03:20:00,0,2669.0,2090.0,0.783,12.83,1,1,0,1,0,0,0,0,0.0,0.0
1010,331,2020-03-17 03:23:00,0,2676.0,2067.0,0.772,12.833,7,3,0,3,4,2,2,0,0.0,0.0
1010,332,2020-03-17 03:26:00,0,2666.0,2039.0,0.765,12.762,28,26,14,12,2,1,1,0,0.0,0.0
1010,333,2020-03-17 03:29:00,0,2598.0,2044.0,0.787,12.498,24,12,10,2,12,4,8,2,0.0,0.0
1010,334,2020-03-17 03:32:00,0,2512.0,1935.0,0.77,12.039,12,12,1,11,0,0,0,0,0.0,0.0
1010,335,2020-03-17 03:35:00,0,2289.0,1841.0,0.804,11.057,14,14,1,13,0,0,0,0,0.0,0.0
1010,336,2020-03-17 03:38:00,0,2217.0,1753.0,0.791,10.678,7,5,2,3,2,1,1,0,0.0,0.0
1010,337,2020-03-17 03:41:00,0,2162.0,1666.0,0.771,10.364,0,0,0,0,0,0,0,0,0.0,0.01
1010,338,2020-03-17 03:44:00,0,1937.0,1560.0,0.805,9.36,6,3,1,2,3,0,3,0,0.0,0.0
1010,339,2020-03-17 03:47:00,0,1940.0,1541.0,0.794,9.349,1,1,0,1,0,0,0,0,0.0,0.0
1010,340,2020-03-17 03:50:00,0,1949.0,1488.0,0.764,9.329,0,0,0,0,0,0,0,0,0.0,0.0
1010,341,2020-03-17 03:53:00,0,1953.0,1528.0,0.782,9.386,269,208,143,65,61,23,38,11,0.0,0.0
1010,342,2020-03-17 03:56:00,0,2452.0,1894.0,0.772,11.76,408,264,201,63,144,98,46,71,0.0,0.0
1010,343,2020-03-17 03:59:00,0,2888.0,2231.0,0.773,13.848,568,386,309,77,182,125,57,109,0.0,0.0
1010,344,2020-03-17 04:02:00,0,3170.0,2418.0,0.763,15.167,695,528,422,106,167,118,49,158,0.0,0.0
1010,345,2020-03-17 04:05:00,0,3240.0,2519.0,0.778,15.554,579,372,289,83,207,144,63,107,0.0,0.0
1010,346,2020-03-17 04:08:00,0,3410.0,2583.0,0.758,16.296,427,281,210,71,146,99,47,89,0.0,0.0
1010,347,2020-03-17 04:11:00,0,3329.0,2517.0,0.756,15.904,236,163,106,57,73,34,39,41,0.0,0.0
1010,348,2020-03-17 04:14:00,0,3472.0,2669.0,0.769,16.637,361,270,190,80,91,57,34,51,0.0,0.0
1010,349,2020-03-17 04:17:00,0,3409.0,2594.0,0.761,16.304,500,307,240,67,193,139,54,53,0.0,0.0
1010,350,2020-03-17 04:20:00,0,3406.0,2603.0,0.764,16.303,415,271,194,77,144,102,42,59,0.0,0.01
1010,351,2020-03-17 04:23:00,0,3352.0,2512.0,0.749,15.988,350,263,188,75,87,47,40,74,0.0,0.0
1010,352,2020-03-17 04:26:00,0,3414.0,2636.0,0.772,16.369,252,214,148,66,38,2,36,77,0.0,0.0
1010,353,2020-03-17 04:29:00,0,3465.0,2672.0,0.771,16.611,342,277,195,82,65,17,48,101,0.0,0.0
1010,354,2020-03-17 04:32:00,0,3394.0,2615.0,0.77,16.267,379,325,234,91,54,6,48,80,0.0,0.0
1010,355,2020-03-17 04:35:00,0,3399.0,2599.0,0.765,16.27,359,304,212,92,55,3,52,93,0.0,0.0
1010,356,2020-03-17 04:38:00,0,3322.0,2518.0,0.758,15.879,330,294,212,82,36,5,31,76,0.0,0.0
1010,357,2020-03-17 04:41:00,0,3407.0,2520.0,0.74,16.213,267,222,147,75,45,0,45,78,0.0,0.0
1010,358,2020-03-17 04:44:00,0,3237.0,2514.0,0.776,15.539,266,219,161,58,47,6,41,55,0.0,0.02
1010,359,2020-03-17 04:47:00,0,3248.0,2523.0,0.777,15.589,271,228,156,72,43,13,30,63,0.0,0.01
1010,360,2020-03-17 04:50:00,0,3256.0,2485.0,0.763,15.581,260,225,163,62,35,8,27,45,0.0,0.0
1010,361,2020-03-17 04:53:00,0,2596.0,2014.0,0.775,12.46,353,206,156,50,147,100,47,36,0.16,0.0
1010,362,2020-03-17 04:56:00,0,2471.0,1855.0,0.751,11.791,158,97,74,23,61,37,24,20,0.0,0.0
1010,363,2020-03-17 04:59:00,0,3010.0,2390.0,0.794,14.507,347,297,226,71,50,25,25,57,0.0,0.0
1010,364,2020-03-17 05:02:00,0,3377.0,2664.0,0.789,16.253,231,206,138,68,25,0,25,43,0.0,0.0
1010,365,2020-03-17 05:05:00,0,3365.0,2691.0,0.8,16.237,329,284,208,76,45,8,37,82,0.0,0.0
1010,366,2020-03-17 05:08:00,0,3205.0,2530.0,0.789,15.427,405,267,204,63,138,89,49,59,0.0,0.06
1010,367,2020-03-17 05:11:00,0,2291.0,1794.0,0.783,11.012,276,161,120,41,115,76,39,11,0.0,0.0
1010,368,2020-03-17 05:14:00,0,2304.0,1827.0,0.793,11.1,451,277,212,65,174,116,58,9,0.0,0.0
1010,369,2020-03-17 05:17:00,0,2449.5,1933.5,0.7895,11.792,135,86,45,41,49,17,32,0,0.0,0.0
1010,370,2020-03-17 05:20:00,0,2595.0,2040.0,0.786,12.484,267,164,128,36,103,70,33,9,0.0,0.0
1010,371,2020-03-17 05:23:00,0,3095.0,2487.0,0.804,14.947,407,281,233,48,126,87,39,11,0.2,0.0
1010,372,2020-03-17 05:26:00,0,3341.0,2754.0,0.824,16.214,689,492,399,93,197,142,55,5,0.0,0.0
1010,373,2020-03-17 05:29:00,0,2899.0,2272.0,0.784,13.937,94,60,38,22,34,16,18,1,0.0,0.0
1010,374,2020-03-17 05:32:00,0,3018.0,2417.0,0.801,14.569,119,72,51,21,47,17,30,3,0.0,0.0
1010,375,2020-03-17 05:35:00,0,3216.0,2668.0,0.83,15.624,167,95,66,29,72,52,20,5,0.0,0.0
1010,376,2020-03-17 05:38:00,0,3156.0,2527.0,0.801,15.234,58,43,28,15,15,10,5,0,0.0,0.0
1010,377,2020-03-17 05:41:00,0,3026.0,2377.0,0.786,14.554,833,628,531,97,205,134,71,2,0.0,0.0
1010,378,2020-03-17 05:44:00,0,2927.0,2337.0,0.798,14.121,200,118,82,36,82,51,31,11,0.0,0.0
1010,379,2020-03-17 05:47:00,0,2906.0,2279.0,0.784,13.972,32,27,3,24,5,3,2,8,0.0,0.0
1010,380,2020-03-17 05:50:00,0,2903.0,2268.0,0.781,13.95,203,145,92,53,58,28,30,2,0.0,0.0
1010,381,2020-03-17 05:53:00,0,2805.0,2209.0,0.787,13.496,164,102,64,38,62,21,41,4,0.0,0.0
1010,382,2020-03-17 05:56:00,0,2818.0,2178.0,0.773,13.513,69,18,1,17,51,0,51,0,0.0,0.0
1010,383,2020-03-17 05:59:00,0,2685.0,2093.0,0.779,12.897,0,0,0,0,0,0,0,0,0.0,0.0
1010,384,2020-03-17 06:02:00,1,2539.0,1901.0,0.749,12.111,233,156,111,45,77,50,27,26,0.0,0.0
1010,385,2020-03-17 06:05:00,1,2532.0,1943.0,0.768,12.127,129,75,54,21,54,34,20,6,0.0,0.0
1010,386,2020-03-17 06:08:00,1,2560.0,1907.0,0.745,12.198,8,2,1,1,6,2,4,0,0.0,0.0
1010,387,2020-03-17 06:11:00,1,2306.0,1771.0,0.768,11.046,13,10,0,10,3,1,2,0,0.0,0.0
1010,388,2020-03-17 06:14:00,1,2180.0,1665.0,0.764,10.435,0,0,0,0,0,0,0,0,0.0,0.0
1010,389,2020-03-17 06:17:00,1,2023.0,1536.0,0.759,9.671,4,2,0,2,2,0,2,0,0.0,0.0
1010,390,2020-03-17 06:20:00,1,1966.0,1448.0,0.736,9.351,15,3,0,3,12,0,12,0,0.0,0.0
1010,391,2020-03-17 06:23:00,1,1820.0,1385.0,0.761,8.703,22,7,0,7,15,0,15,0,0.0,0.0
1010,392,2020-03-17 06:26:00,1,1839.0,1318.0,0.717,8.705,6,0,0,0,6,0,6,0,0.0,0.0
1010,393,2020-03-17 06:29:00,1,1667.0,1246.0,0.748,7.949,7,0,0,0,7,0,7,0,0.0,0.0
1010,394,2020-03-17 06:32:00,1,1588.0,1189.0,0.749,7.575,70,38,18,20,32,6,26,0,0.0,0.0
1010,395,2020-03-17 06:35:00,1,1740.0,1295.0,0.744,8.292,37,25,13,12,12,2,10,0,0.0,0.0
1010,396,2020-03-17 06:38:00,1,1743.0,1305.0,0.748,8.314,0,0,0,0,0,0,0,0,0.0,0.0
1010,397,2020-03-17 06:41:00,1,1658.0,1265.0,0.763,7.933,26,13,1,12,13,0,13,0,0.0,0.0
1010,398,2020-03-17 06:44:00,1,1665.0,1257.0,0.755,7.954,22,3,0,3,19,0,19,0,0.0,0.0
1010,399,2020-03-17 06:47:00,1,1587.0,1252.0,0.789,7.638,92,70,49,21,22,8,14,0,0.0,0.0
1010,400,2020-03-17 06:50:00,1,1680.0,1274.0,0.758,8.03,0,0,0,0,0,0,0,0,0.0,0.0
1010,401,2020-03-17 06:53:00,1,1599.0,1218.0,0.762,7.651,0,0,0,0,0,0,0,0,0.0,0.0
1010,402,2020-03-17 06:56:00,1,1602.0,1178.0,0.736,7.615,11,4,0,4,7,0,7,0,0.0,0.0
1010,403,2020-03-17 06:59:00,1,1612.0,1150.0,0.714,7.623,20,4,0,4,16,0,16,0,0.0,0.0
1010,404,2020-03-17 07:02:00,1,1602.0,1185.0,0.74,7.624,72,28,4,24,44,2,42,0,0.0,0.0
1010,405,2020-03-17 07:05:00,1,1818.0,1370.0,0.754,8.678,42,12,4,8,30,0,30,0,0.0,0.0
1010,406,2020-03-17 07:08:00,1,1933.0,1506.0,0.779,9.282,67,32,7,25,35,2,33,2,0.0,0.0
1010,407,2020-03-17 07:11:00,1,2168.0,1668.0,0.769,10.388,90,49,29,20,41,17,24,4,0.0,0.0
1010,408,2020-03-17 07:14:00,1,2547.0,1866.0,0.733,12.101,132,59,27,32,73,37,36,12,0.0,0.0
1010,409,2020-03-17 07:17:00,1,2686.0,2058.0,0.766,12.86,324,223,172,51,101,65,36,54,0.0,0.0
1010,410,2020-03-17 07:20:00,1,2906.0,2159.0,0.743,13.841,366,226,166,60,140,89,51,11,0.0,0.0
1010,411,2020-03-17 07:23:00,1,2902.0,2141.0,0.737,13.806,608,421,333,88,187,134,53,18,0.0,0.0
1010,412,2020-03-17 07:26:00,1,2933.0,2152.0,0.734,13.94,142,89,59,30,53,29,24,42,0.0,0.0
1010,413,2020-03-17 07:29:00,1,2662.0,1975.0,0.742,12.678,49,33,15,18,16,2,14,0,0.0,0.0
1010,414,2020-03-17 07:32:00,1,2749.0,1955.0,0.711,12.998,63,18,0,18,45,0,45,0,0.0,0.0
1010,415,2020-03-17 07:35:00,1,2720.0,1962.0,0.721,12.889,22,12,0,12,10,0,10,0,0.0,0.0
1010,416,2020-03-17 07:38:00,1,2563.0,1834.0,0.716,12.128,2,1,0,1,1,0,1,0,0.0,0.0
1010,417,2020-03-17 07:41:00,1,2335.0,1684.0,0.721,11.064,9,9,3,6,0,0,0,0,0.0,0.0
1010,418,2020-03-17 07:44:00,1,2178.0,1542.0,0.708,10.291,0,0,0,0,0,0,0,0,0.0,0.0
1010,419,2020-03-17 07:47:00,1,1971.0,1450.0,0.736,9.37,0,0,0,0,0,0,0,0,0.0,0.0
1010,420,2020-03-17 07:50:00,1,1807.0,1371.0,0.759,8.636,0,0,0,0,0,0,0,0,0.0,0.0
1010,421,2020-03-17 07:53:00,1,1821.0,1302.0,0.715,8.617,3,3,1,2,0,0,0,0,0.0,0.0
1010,422,2020-03-17 07:56:00,1,1770.0,1259.0,0.711,8.367,0,0,0,0,0,0,0,0,0.0,0.0
1010,423,2020-03-17 07:59:00,1,1604.0,1172.0,0.731,7.615,22,18,5,13,4,2,2,1,0.0,0.0
1010,424,2020-03-17 08:02:00,1,1823.0,1343.0,0.736,8.671,28,14,5,9,14,2,12,1,0.0,0.0
1010,425,2020-03-17 08:05:00,1,1819.0,1387.0,0.763,8.701,0,0,0,0,0,0,0,0,0.0,0.0
1010,426,2020-03-17 08:08:00,1,1835.0,1318.0,0.718,8.69,0,0,0,0,0,0,0,0,0.0,0.0
1010,427,2020-03-17 08:11:00,1,1845.0,1283.0,0.695,8.688,6,3,1,2,3,2,1,0,0.0,0.0
1010,428,2020-03-17 08:14:00,1,1840.0,1272.0,0.691,8.658,1,1,1,0,0,0,0,0,0.0,0.0
1010,429,2020-03-17 08:17:00,1,1878.0,1281.0,0.682,8.8175,3,3,2,1,0,0,0,0,0.0,0.0
1010,430,2020-03-17 08:20:00,1,1916.0,1290.0,0.673,8.977,0,0,0,0,0,0,0,0,0.0,0.0
1010,431,2020-03-17 08:23:00,1,1924.0,1274.0,0.662,8.993,1,1,0,1,0,0,0,0,0.0,0.0
1010,432,2020-03-17 08:26:00,1,1914.0,1310.0,0.684,8.992,38,32,10,22,6,1,5,1,0.0,0.0
1010,433,2020-03-17 08:29:00,1,2046.0,1514.0,0.74,9.737,12,4,4,0,8,1,7,0,0.0,0.0
1010,434,2020-03-17 08:32:00,1,2274.0,1594.0,0.701,10.725,30,19,9,10,11,1,10,0,0.0,0.0
1010,435,2020-03-17 08:35:00,1,2340.0,1663.0,0.711,11.059,136,88,66,22,48,30,18,16,0.0,0.0
1010,436,2020-03-17 08:38:00,1,2631.0,1914.0,0.728,12.488,101,69,46,23,32,12,20,8,0.0,0.0
1010,437,2020-03-17 08:41:00,1,2789.0,1958.0,0.702,13.158,267,128,97,31,139,108,31,10,0.0,0.0
1010,438,2020-03-17 08:44:00,1,2762.0,2034.0,0.737,13.133,684,463,362,101,221,156,65,20,0.0,0.0
1010,439,2020-03-17 08:47:00,1,2754.0,1998.0,0.726,13.064,960,681,557,124,279,205,74,15,0.0,0.0
1010,440,2020-03-17 08:50:00,1,2791.0,2007.0,0.719,13.221,626,421,332,89,205,135,70,3,0.0,0.0
1010,441,2020-03-17 08:53:00,1,2782.0,1963.0,0.706,13.136,950,670,568,102,280,198,82,5,0.0,0.0
1010,442,2020-03-17 08:56:00,1,2725.0,1917.0,0.703,12.86,139,89,59,30,50,37,13,11,0.0,0.0
1010,443,2020-03-17 08:59:00,1,2654.0,1872.0,0.705,12.53,43,35,6,29,8,1,7,2,0.0,0.0
1010,444,2020-03-17 09:02:00,1,2633.0,1853.0,0.704,12.427,8,5,0,5,3,0,3,0,0.0,0.0
1010,445,2020-03-17 09:05:00,1,2421.0,1722.0,0.711,11.447,0,0,0,0,0,0,0,0,0.0,0.0
1010,446,2020-03-17 09:08:00,1,2279.0,1584.0,0.695,10.734,0,0,0,0,0,0,0,0,0.0,0.0
1010,447,2020-03-17 09:11:00,1,2052.0,1462.0,0.712,9.703,6,2,0,2,4,1,3,0,0.0,0.0
1010,448,2020-03-17 09:14:00,1,2059.0,1382.0,0.671,9.644,0,0,0,0,0,0,0,0,0.0,0.0
1010,449,2020-03-17 09:17:00,1,1920.0,1319.0,0.687,9.025,19,6,3,3,13,3,10,0,0.0,0.0
1010,450,2020-03-17 09:20:00,1,1904.0,1309.0,0.687,8.954,4,0,0,0,4,0,4,0,0.0,0.0
1010,451,2020-03-17 09:23:00,1,1918.0,1324.0,0.69,9.025,1,0,0,0,1,0,1,0,0.0,0.0
1010,452,2020-03-17 09:26:00,1,1849.0,1258.0,0.68,8.677,0,0,0,0,0,0,0,0,0.0,0.0
1010,453,2020-03-17 09:29:00,1,1694.0,1204.0,0.711,8.009,4,0,0,0,4,0,4,0,0.0,0.0
1010,454,2020-03-17 09:32:00,1,1690.0,1173.0,0.694,7.958,57,44,30,14,13,9,4,25,0.0,0.0
1010,455,2020-03-17 09:35:00,1,1802.0,1322.0,0.733,8.564,79,55,18,37,24,5,19,2,0.0,0.0
1010,456,2020-03-17 09:38:00,1,2399.0,1781.0,0.742,11.426,224,150,100,50,74,35,39,16,0.0,0.0
1010,457,2020-03-17 09:41:00,1,2648.0,1915.0,0.723,12.555,109,54,30,24,55,20,35,11,0.0,0.0
1010,458,2020-03-17 09:44:00,1,2625.0,1925.0,0.733,12.474,96,85,38,47,11,1,10,1,0.0,0.0
1010,459,2020-03-17 09:47:00,1,2635.0,1903.0,0.722,12.487,46,41,12,29,5,1,4,0,0.0,0.0
1010,460,2020-03-17 09:50:00,1,2665.0,1898.0,0.712,12.602,85,49,35,14,36,20,16,0,0.0,0.0
1010,461,2020-03-17 09:53:00,1,2555.0,1798.0,0.704,12.055,2,0,0,0,2,0,2,0,0.0,0.0
1010,462,2020-03-17 09:56:00,1,2435.0,1682.0,0.691,11.458,0,0,0,0,0,0,0,0,0.0,0.0
1010,463,2020-03-17 09:59:00,1,2297.0,1581.0,0.688,10.801,0,0,0,0,0,0,0,0,0.0,0.0
1010,464,2020-03-17 10:02:00,1,2051.0,1453.0,0.708,9.691,4,4,1,3,0,0,0,0,0.0,0.0
1010,465,2020-03-17 10:05:00,1,1983.0,1390.0,0.701,9.355,3,3,0,3,0,0,0,0,0.0,0.0
1010,466,2020-03-17 10:08:00,1,1903.0,1324.0,0.696,8.965,0,0,0,0,0,0,0,0,0.0,0.0
1010,467,2020-03-17 10:11:00,1,1833.0,1247.0,0.68,8.602,8,8,1,7,0,0,0,0,0.0,0.0
1010,468,2020-03-17 10:14:00,1,1834.0,1251.0,0.682,8.613,0,0,0,0,0,0,0,0,0.0,0.0
1010,469,2020-03-17 10:17:00,1,1779.0,1254.0,0.705,8.399,0,0,0,0,0,0,0,0,0.0,0.0
1010,470,2020-03-17 10:20:00,1,1773.0,1237.0,0.698,8.356,17,10,4,6,7,0,7,0,0.0,0.0
1010,471,2020-03-17 10:23:00,1,1914.0,1273.0,0.665,8.953,38,31,0,31,7,0,7,0,0.0,0.0
1010,472,2020-03-17 10:26:00,1,1842.0,1257.0,0.682,8.65,9,7,0,7,2,0,2,0,0.0,0.0
1010,473,2020-03-17 10:29:00,1,1842.0,1246.0,0.676,8.638,23,8,2,6,15,6,9,0,0.0,0.0
1010,474,2020-03-17 10:32:00,1,1894.0,1350.0,0.713,8.957,91,52,31,21,39,4,35,0,0.0,0.0
1010,475,2020-03-17 10:35:00,1,2041.0,1492.0,0.731,9.695,7,6,1,5,1,0,1,0,0.0,0.0
1010,476,2020-03-17 10:38:00,1,2045.0,1474.0,0.721,9.691,0,0,0,0,0,0,0,0,0.0,0.0
1010,477,2020-03-17 10:41:00,1,2076.0,1408.0,0.678,9.74,1,1,0,1,0,0,0,0,0.0,0.0
1010,478,2020-03-17 10:44:00,1,1915.0,1317.0,0.687,9.004,21,18,6,12,3,1,2,0,0.0,0.0
1010,479,2020-03-17 10:47:00,1,2075.0,1415.0,0.682,9.744,18,2,2,0,16,4,12,0,0.0,0.0
1010,480,2020-03-17 10:50:00,1,2065.0,1413.0,0.684,9.703,16,6,0,6,10,4,6,0,0.0,0.0
1010,481,2020-03-17 10:53:00,1,2052.0,1415.0,0.69,9.652,2,0,0,0,2,0,2,0,0.0,0.0
1010,482,2020-03-17 10:56:00,1,1981.0,1378.0,0.696,9.331,7,3,0,3,4,0,4,0,0.0,0.0
1010,483,2020-03-17 10:59:00,1,1987.0,1385.0,0.697,9.363,0,0,0,0,0,0,0,0,0.0,0.0
1010,484,2020-03-17 11:02:00,1,1915.0,1311.0,0.684,8.998,10,4,0,4,6,3,3,0,0.0,0.0
1010,485,2020-03-17 11:05:00,1,1988.0,1375.0,0.691,9.356,5,1,0,1,4,1,3,0,0.0,0.0
1010,486,2020-03-17 11:08:00,1,1989.0,1374.0,0.691,9.357,4,3,1,2,1,0,1,0,0.0,0.0
1010,487,2020-03-17 11:11:00,1,1995.0,1377.0,0.69,9.385,2,0,0,0,2,0,2,0,0.0,0.0
1010,488,2020-03-17 11:14:00,1,1903.0,1362.0,0.716,9.004,54,32,18,14,22,18,4,0,0.0,0.0
1010,489,2020-03-17 11:17:00,1,1940.0,1378.5,0.7105,9.1695,0,0,0,0,0,0,0,0,0.0,0.0
1010,490,2020-03-17 11:20:00,1,1977.0,1395.0,0.705,9.335,2,2,1,1,0,0,0,0,0.0,0.0
1010,491,2020-03-17 11:23:00,1,1827.0,1307.0,0.716,8.645,0,0,0,0,0,0,0,0,0.0,0.0
1010,492,2020-03-17 11:26:00,1,1847.0,1247.0,0.675,8.659,0,0,0,0,0,0,0,0,0.0,0.0
1010,493,2020-03-17 11:29:00,1,1829.0,1349.0,0.737,8.701,3,1,1,0,2,1,1,0,0.0,0.0
1010,494,2020-03-17 11:32:00,1,1818.0,1352.0,0.744,8.662,0,0,0,0,0,0,0,0,0.0,0.0
1010,495,2020-03-17 11:35:00,1,1897.0,1355.0,0.715,8.974,1,1,1,0,0,0,0,0,0.0,0.0
1010,496,2020-03-17 11:38:00,1,1812.0,1332.0,0.735,8.614,2,2,1,1,0,0,0,0,0.0,0.0
1010,497,2020-03-17 11:41:00,1,1828.0,1340.0,0.733,8.688,0,0,0,0,0,0,0,0,0.0,0.0
1010,498,2020-03-17 11:44:00,1,1828.0,1333.0,0.729,8.678,0,0,0,0,0,0,0,0,0.0,0.0
1010,499,2020-03-17 11:47:00,1,1843.0,1280.0,0.694,8.681,18,0,0,0,18,0,18,0,0.0,0.0
1010,500,2020-03-17 11:50:00,1,1824.0,1310.0,0.718,8.638,4,0,0,0,4,0,4,0,0.0,0.0
1010,501,2020-03-17 11:53:00,1,1830.0,1324.0,0.724,8.677,2,0,0,0,2,0,2,0,0.0,0.0
1010,502,2020-03-17 11:56:00,1,1836.0,1327.0,0.723,8.705,0,0,0,0,0,0,0,0,0.0,0.0
1010,503,2020-03-17 11:59:00,1,1820.0,1321.0,0.726,8.634,41,9,1,8,32,0,32,0,0.0,0.0
1010,504,2020-03-17 12:02:00,1,1968.0,1460.0,0.742,9.372,118,87,71,16,31,25,6,0,0.0,0.0
1010,505,2020-03-17 12:05:00,1,2198.0,1645.0,0.748,10.482,59,25,4,21,34,3,31,0,0.0,0.0
1010,506,2020-03-17 12:08:00,1,2324.0,1695.0,0.729,11.035,266,153,104,49,113,62,51,6,0.0,0.0
1010,507,2020-03-17 12:11:00,1,2473.0,1798.0,0.727,11.736,609,408,334,74,201,148,53,28,0.0,0.0
1010,508,2020-03-17 12:14:00,1,2568.0,1817.0,0.707,12.131,710,540,439,101,170,114,56,17,0.0,0.0
1010,509,2020-03-17 12:17:00,1,2546.0,1871.0,0.735,12.102,540,346,265,81,194,125,69,14,0.0,0.0
1010,510,2020-03-17 12:20:00,1,2566.0,1868.0,0.728,12.178,643,459,373,86,184,127,57,4,0.0,0.0
1010,511,2020-03-17 12:23:00,1,2565.0,1861.0,0.726,12.168,22,20,1,19,2,0,2,0,0.0,0.0
1010,512,2020-03-17 12:26:00,1,2554.0,1834.0,0.718,12.095,44,18,12,6,26,1,25,0,0.0,0.0
1010,513,2020-03-17 12:29:00,1,2345.0,1750.0,0.746,11.175,17,17,1,16,0,0,0,0,0.0,0.0
1010,514,2020-03-17 12:32:00,1,2195.0,1573.0,0.716,10.391,11,5,2,3,6,1,5,0,0.0,0.0
1010,515,2020-03-17 12:35:00,1,2131.0,1501.0,0.704,10.059,5,0,0,0,5,0,5,0,0.0,0.0
1010,516,2020-03-17 12:38:00,1,1984.0,1391.0,0.701,9.356,17,1,0,1,16,0,16,0,0.0,0.0
1010,517,2020-03-17 12:41:00,1,1824.0,1356.0,0.744,8.688,22,1,0,1,21,0,21,0,0.0,0.0
1010,518,2020-03-17 12:44:00,1,1822.0,1309.0,0.718,8.63,13,3,0,3,10,0,10,0,0.0,0.0
1010,519,2020-03-17 12:47:00,1,1834.0,1332.0,0.726,8.702,0,0,0,0,0,0,0,0,0.0,0.0
1010,520,2020-03-17 12:50:00,1,1836.0,1312.0,0.715,8.688,15,7,0,7,8,0,8,0,0.0,0.0
1010,521,2020-03-17 12:53:00,1,1824.0,1300.0,0.713,8.626,15,0,0,0,15,0,15,0,0.0,0.0
1010,522,2020-03-17 12:56:00,1,1844.0,1275.0,0.691,8.679,0,0,0,0,0,0,0,0,0.0,0.0
1010,523,2020-03-17 12:59:00,1,1845.0,1252.0,0.679,8.655,0,0,0,0,0,0,0,0,0.0,0.0
1010,524,2020-03-17 13:02:00,1,1771.0,1223.0,0.691,8.332,13,7,0,7,6,0,6,0,0.0,0.0
1010,525,2020-03-17 13:05:00,1,1844.0,1258.0,0.682,8.66,2,0,0,0,2,0,2,0,0.0,0.0
1010,526,2020-03-17 13:08:00,1,1839.0,1274.0,0.693,8.656,17,7,1,6,10,2,8,0,0.0,0.0
1010,527,2020-03-17 13:11:00,1,1976.0,1391.0,0.704,9.325,1,1,0,1,0,0,0,0,0.0,0.0
1010,528,2020-03-17 13:14:00,1,1977.0,1394.0,0.705,9.333,9,4,1,3,5,0,5,0,0.0,0.0
1010,529,2020-03-17 13:17:00,1,1967.0,1387.0,0.705,9.286,3,3,1,2,0,0,0,0,0.0,0.0
1010,530,2020-03-17 13:20:00,1,1982.0,1372.0,0.692,9.328,0,0,0,0,0,0,0,0,0.0,0.0
1010,531,2020-03-17 13:23:00,1,1905.0,1369.0,0.719,9.021,3,3,0,3,0,0,0,0,0.0,0.0
1010,532,2020-03-17 13:26:00,1,1975.0,1409.0,0.713,9.342,0,0,0,0,0,0,0,0,0.0,0.0
1010,533,2020-03-17 13:29:00,1,1907.0,1359.0,0.713,9.018,6,6,0,6,0,0,0,0,0.0,0.0
1010,534,2020-03-17 13:32:00,1,1912.0,1339.0,0.701,9.017,0,0,0,0,0,0,0,0,0.0,0.0
1010,535,2020-03-17 13:35:00,1,1835.0,1316.0,0.717,8.689,0,0,0,0,0,0,0,0,0.0,0.0
1010,536,2020-03-17 13:38:00,1,1836.0,1299.0,0.708,8.671,12,11,3,8,1,1,0,0,0.0,0.0
1010,537,2020-03-17 13:41:00,1,1977.0,1350.0,0.683,9.285,0,0,0,0,0,0,0,0,0.0,0.0
1010,538,2020-03-17 13:44:00,1,1987.0,1378.0,0.693,9.355,12,6,2,4,6,3,3,0,0.0,0.0
1010,539,2020-03-17 13:47:00,1,1973.0,1421.0,0.72,9.349,1,1,1,0,0,0,0,0,0.0,0.0
1010,540,2020-03-17 13:50:00,1,1971.0,1386.0,0.703,9.3,0,0,0,0,0,0,0,0,0.0,0.0
1010,541,2020-03-17 13:53:00,1,1987.0,1373.0,0.691,9.351,10,8,1,7,2,1,1,0,0.0,0.0
1010,542,2020-03-17 13:56:00,1,1975.0,1422.0,0.72,9.356,123,86,62,24,37,22,15,4,0.0,0.0
1010,543,2020-03-17 13:59:00,1,2204.0,1576.0,0.715,10.429,2,2,0,2,0,0,0,0,0.01,0.0
1010,544,2020-03-17 14:02:00,1,2227.0,1521.0,0.683,10.458,8,8,0,8,0,0,0,0,0.0,0.0
1010,545,2020-03-17 14:05:00,1,2143.0,1467.0,0.685,10.069,24,24,0,24,0,0,0,0,0.0,0.0
1010,546,2020-03-17 14:08:00,1,2222.0,1512.0,0.681,10.428,20,20,3,17,0,0,0,0,0.0,0.0
1010,547,2020-03-17 14:11:00,1,2354.0,1596.0,0.678,11.04,66,41,12,29,25,2,23,0,0.0,0.0
1010,548,2020-03-17 14:14:00,1,2326.0,1690.0,0.727,11.036,53,34,11,23,19,2,17,0,0.0,0.0
1010,549,2020-03-17 14:17:00,1,2446.5,1752.5,0.717,11.581,415,282,221,61,133,93,40,10,0.06,0.0
1010,550,2020-03-17 14:20:00,1,2567.0,1815.0,0.707,12.126,752,516,425,91,236,166,70,11,0.0,0.0
1010,551,2020-03-17 14:23:00,1,2566.0,1834.0,0.715,12.143,601,449,357,92,152,112,40,42,0.02,0.0
1010,552,2020-03-17 14:26:00,1,2551.0,1836.0,0.72,12.085,190,132,97,35,58,35,23,5,0.0,0.0
1010,553,2020-03-17 14:29:00,1,2568.0,1835.0,0.714,12.15,355,255,190,65,100,70,30,5,0.07,0.0
1010,554,2020-03-17 14:32:00,1,2659.0,1855.0,0.697,12.533,55,31,4,27,24,0,24,0,0.0,0.0
1010,555,2020-03-17 14:35:00,1,2590.0,1766.0,0.682,12.161,7,4,0,4,3,0,3,0,0.0,0.0
1010,556,2020-03-17 14:38:00,1,2375.0,1655.0,0.697,11.191,24,12,4,8,12,1,11,0,0.0,0.0
1010,557,2020-03-17 14:41:00,1,2377.0,1569.0,0.66,11.104,9,0,0,0,9,0,9,0,0.0,0.0
1010,558,2020-03-17 14:44:00,1,2209.0,1469.0,0.665,10.329,12,4,1,3,8,0,8,0,0.0,0.0
1010,559,2020-03-17 14:47:00,1,2237.0,1452.0,0.649,10.421,6,0,0,0,6,0,6,0,0.0,0.0
1010,560,2020-03-17 14:50:00,1,2135.0,1422.0,0.666,9.986,2,0,0,0,2,0,2,0,0.0,0.0
1010,561,2020-03-17 14:53:00,1,2074.0,1409.0,0.679,9.733,4,1,1,0,3,0,3,0,0.0,0.0
1010,562,2020-03-17 14:56:00,1,1985.0,1399.0,0.705,9.37,3,2,1,1,1,0,1,0,0.0,0.0
1010,563,2020-03-17 14:59:00,1,2003.0,1344.0,0.671,9.381,7,0,0,0,7,0,7,0,0.0,0.0
1010,564,2020-03-17 15:02:00,1,2060.0,1391.0,0.675,9.655,0,0,0,0,0,0,0,0,0.0,0.0
1010,565,2020-03-17 15:05:00,1,2060.0,1400.0,0.679,9.667,2,2,1,1,0,0,0,0,0.0,0.0
1010,566,2020-03-17 15:08:00,1,2081.0,1398.0,0.672,9.748,1,1,0,1,0,0,0,0,0.0,0.0
1010,567,2020-03-17 15:11:00,1,2070.0,1406.0,0.679,9.711,6,3,0,3,3,1,2,0,0.0,0.0
1010,568,2020-03-17 15:14:00,1,2238.0,1446.0,0.646,10.42,0,0,0,0,0,0,0,0,0.0,0.0
1010,569,2020-03-17 15:17:00,1,2161.0,1427.0,0.66,10.095,7,6,0,6,1,0,1,0,0.0,0.0
1010,570,2020-03-17 15:20:00,1,2216.0,1459.0,0.659,10.346,7,5,0,5,2,0,2,0,0.0,0.0
1010,571,2020-03-17 15:23:00,1,2155.0,1425.0,0.662,10.067,0,0,0,0,0,0,0,0,0.0,0.0
1010,572,2020-03-17 15:26:00,1,2073.0,1400.0,0.675,9.719,4,3,0,3,1,0,1,0,0.0,0.0
1010,573,2020-03-17 15:29:00,1,2203.0,1462.0,0.664,10.298,5,4,0,4,1,0,1,0,0.0,0.0
1010,574,2020-03-17 15:32:00,1,2236.0,1473.0,0.659,10.44,1,1,0,1,0,0,0,0,0.0,0.0
1010,575,2020-03-17 15:35:00,1,2055.0,1412.0,0.687,9.661,10,8,0,8,2,0,2,0,0.0,0.0
1010,576,2020-03-17 15:38:00,1,2213.0,1436.0,0.649,10.31,11,7,0,7,4,0,4,0,0.0,0.0
1010,577,2020-03-17 15:41:00,1,2140.0,1424.0,0.665,10.007,97,80,41,39,17,4,13,1,0.0,0.0
1010,578,2020-03-17 15:44:00,1,2367.0,1581.0,0.668,11.075,140,105,49,56,35,1,34,4,0.0,0.0
1010,579,2020-03-17 15:47:00,1,2352.0,1674.0,0.712,11.119,15,15,1,14,0,0,0,0,0.0,0.0
1010,580,2020-03-17 15:50:00,1,2367.0,1605.0,0.678,11.104,5,1,0,1,4,0,4,0,0.0,0.0
1010,581,2020-03-17 15:53:00,1,2217.0,1490.0,0.672,10.387,0,0,0,0,0,0,0,0,0.0,0.0
1010,582,2020-03-17 15:56:00,1,1977.0,1376.0,0.696,9.312,17,15,2,13,2,1,1,0,0.0,0.0
1010,583,2020-03-17 15:59:00,1,2150.0,1458.0,0.678,10.085,23,22,0,22,1,0,1,0,0.0,0.0
1010,584,2020-03-17 16:02:00,1,2132.0,1419.0,0.665,9.974,23,22,2,20,1,0,1,0,0.0,0.0
1010,585,2020-03-17 16:05:00,1,2061.0,1395.0,0.677,9.667,25,25,0,25,0,0,0,0,0.0,0.0
1010,586,2020-03-17 16:08:00,1,1992.0,1380.0,0.693,9.378,4,4,0,4,0,0,0,0,0.0,0.0
1010,587,2020-03-17 16:11:00,1,1981.0,1356.0,0.685,9.305,12,6,0,6,6,1,5,0,0.0,0.0
1010,588,2020-03-17 16:14:00,1,1992.0,1327.0,0.666,9.319,83,77,58,19,6,2,4,0,0.0,0.0
1010,589,2020-03-17 16:17:00,1,2133.0,1441.0,0.675,10.002,70,53,34,19,17,0,17,0,0.0,0.0
1010,590,2020-03-17 16:20:00,1,2235.0,1464.0,0.655,10.427,6,3,0,3,3,0,3,0,0.0,0.0
1010,591,2020-03-17 16:23:00,1,2161.0,1423.0,0.658,10.092,152,109,65,44,43,17,26,2,0.0,0.0
1010,592,2020-03-17 16:26:00,1,2358.0,1602.0,0.679,11.066,49,35,30,5,14,8,6,14,0.0,0.0
1010,593,2020-03-17 16:29:00,1,2382.0,1584.0,0.665,11.138,14,5,4,1,9,1,8,0,0.0,0.0
1010,594,2020-03-17 16:32:00,1,2204.0,1479.0,0.671,10.321,7,3,1,2,4,0,4,0,0.0,0.0
1010,595,2020-03-17 16:35:00,1,2239.0,1438.0,0.642,10.413,9,7,3,4,2,0,2,0,0.0,0.0
1010,596,2020-03-17 16:38:00,1,2155.0,1430.0,0.663,10.072,3,1,0,1,2,0,2,0,0.0,0.0
1010,597,2020-03-17 16:41:00,1,2005.0,1386.0,0.692,9.434,15,8,3,5,7,0,7,0,0.0,0.0
1010,598,2020-03-17 16:44:00,1,1971.0,1362.0,0.691,9.276,9,9,0,9,0,0,0,0,0.0,0.0
1010,599,2020-03-17 16:47:00,1,1999.0,1391.0,0.696,9.418,5,5,0,5,0,0,0,0,0.0,0.0
1010,600,2020-03-17 16:50:00,1,1979.0,1371.0,0.693,9.317,8,8,0,8,0,0,0,0,0.0,0.0
1010,601,2020-03-17 16:53:00,1,1985.0,1379.0,0.695,9.347,12,7,0,7,5,0,5,0,0.0,0.0
1010,602,2020-03-17 16:56:00,1,1968.0,1407.0,0.715,9.314,9,3,0,3,6,0,6,0,0.0,0.0
1010,603,2020-03-17 16:59:00,1,2078.0,1430.0,0.688,9.772,6,1,0,1,5,0,5,0,0.0,0.0
1010,604,2020-03-17 17:02:00,1,2156.0,1463.0,0.679,10.114,15,10,6,4,5,1,4,0,0.0,0.0
1010,605,2020-03-17 17:05:00,1,2213.0,1503.0,0.679,10.383,10,10,1,9,0,0,0,0,0.0,0.0
1010,606,2020-03-17 17:08:00,1,2215.0,1484.0,0.67,10.371,107,83,41,42,24,10,14,1,0.0,0.0
1010,607,2020-03-17 17:11:00,1,2430.0,1691.0,0.696,11.449,74,47,20,27,27,4,23,0,0.0,0.0
1010,608,2020-03-17 17:14:00,1,2596.0,1781.0,0.686,12.199,73,48,5,43,25,1,24,1,0.0,0.0
1010,609,2020-03-17 17:17:00,1,2653.5,1851.0,0.6975,12.5035,75,53,10,43,22,1,21,0,0.0,0.0
1010,610,2020-03-17 17:20:00,1,2711.0,1921.0,0.709,12.808,205,150,96,54,55,29,26,15,0.0,0.0
1010,611,2020-03-17 17:23:00,1,2774.0,1996.0,0.72,13.138,269,171,142,29,98,66,32,50,0.0,0.0
1010,612,2020-03-17 17:26:00,1,2693.0,1972.0,0.732,12.795,8,8,3,5,0,0,0,0,0.0,0.0
1010,613,2020-03-17 17:29:00,1,2650.0,1836.0,0.693,12.475,0,0,0,0,0,0,0,0,0.0,0.0
1010,614,2020-03-17 17:32:00,1,2424.0,1680.0,0.693,11.409,0,0,0,0,0,0,0,0,0.0,0.0
1010,615,2020-03-17 17:35:00,1,2286.0,1556.0,0.681,10.732,16,13,4,9,3,1,2,0,0.0,0.0
1010,616,2020-03-17 17:38:00,1,2222.0,1521.0,0.684,10.439,9,8,0,8,1,0,1,0,0.0,0.0
1010,617,2020-03-17 17:41:00,1,2127.0,1440.0,0.677,9.974,0,0,0,0,0,0,0,0,0.0,0.0
1010,618,2020-03-17 17:44:00,1,1970.0,1416.0,0.718,9.331,1,0,0,0,1,0,1,0,0.0,0.0
1010,619,2020-03-17 17:47:00,1,1972.0,1426.0,0.723,9.348,0,0,0,0,0,0,0,0,0.0,0.0
1010,620,2020-03-17 17:50:00,1,2064.0,1434.0,0.695,9.72,0,0,0,0,0,0,0,0,0.0,0.0
1010,621,2020-03-17 17:53:00,1,2151.0,1449.0,0.673,10.08,2,2,0,2,0,0,0,0,0.0,0.0
1010,622,2020-03-17 17:56:00,1,2223.0,1479.0,0.665,10.397,40,33,17,16,7,2,5,0,0.0,0.0
1010,623,2020-03-17 17:59:00,1,2366.0,1590.0,0.672,11.084,121,83,40,43,38,7,31,0,0.0,0.0
1010,624,2020-03-17 18:02:00,0,2588.0,1790.0,0.692,12.177,206,171,133,38,35,19,16,54,0.0,0.0
1010,625,2020-03-17 18:05:00,0,3235.0,2297.0,0.71,15.292,325,230,163,67,95,67,28,96,0.15,0.0
1010,626,2020-03-17 18:08:00,0,2956.0,2022.0,0.684,13.885,149,105,55,50,44,26,18,87,0.0,0.0
1010,627,2020-03-17 18:11:00,0,2702.0,1964.0,0.727,12.82,213,163,105,58,50,24,26,63,0.0,0.0
1010,628,2020-03-17 18:14:00,0,2949.0,1985.0,0.673,13.818,121,113,72,41,8,4,4,69,0.0,0.0
1010,629,2020-03-17 18:17:00,0,2928.0,2079.0,0.71,13.84,177,132,78,54,45,24,21,76,0.0,0.0
1010,630,2020-03-17 18:20:00,0,3063.0,2220.0,0.725,14.529,169,133,79,54,36,12,24,94,0.0,0.0
1010,631,2020-03-17 18:23:00,0,3155.0,2273.0,0.721,14.946,168,128,76,52,40,11,29,92,0.0,0.0
1010,632,2020-03-17 18:26:00,0,3231.0,2302.0,0.712,15.277,213,191,122,69,22,5,17,82,0.0,0.0
1010,633,2020-03-17 18:29:00,0,3087.0,2201.0,0.713,14.599,215,156,101,55,59,34,25,76,0.0,0.0
1010,634,2020-03-17 18:32:00,0,2278.0,1600.0,0.702,10.748,257,167,117,50,90,50,40,23,0.0,0.0
1010,635,2020-03-17 18:35:00,0,3283.0,2364.0,0.72,15.551,189,153,99,54,36,18,18,81,0.0,0.0
1010,636,2020-03-17 18:38:00,0,3333.0,2461.0,0.738,15.859,167,109,67,42,58,25,33,87,0.0,0.0
1010,637,2020-03-17 18:41:00,0,2927.0,2143.0,0.732,13.905,210,136,90,46,74,36,38,22,0.0,0.0
1010,638,2020-03-17 18:44:00,0,2335.0,1631.0,0.698,11.006,56,41,22,19,15,3,12,0,0.0,0.0
1010,639,2020-03-17 18:47:00,0,2191.0,1592.0,0.726,10.396,0,0,0,0,0,0,0,0,0.0,0.0
1010,640,2020-03-17 18:50:00,0,2185.0,1573.0,0.72,10.352,0,0,0,0,0,0,0,0,0.0,0.0
1010,641,2020-03-17 18:53:00,0,2196.0,1532.0,0.698,10.35,126,87,68,19,39,26,13,12,0.0,0.0
1010,642,2020-03-17 18:56:00,0,3270.0,2474.0,0.757,15.622,189,151,93,58,38,15,23,84,0.0,0.0
1010,643,2020-03-17 18:59:00,0,3604.0,2805.0,0.778,17.306,177,154,98,56,23,5,18,76,0.0,0.0
1010,644,2020-03-17 19:02:00,0,3377.0,2680.0,0.794,16.272,161,134,89,45,27,8,19,79,0.0,0.0
1010,645,2020-03-17 19:05:00,0,3630.0,2788.0,0.768,17.388,172,148,103,45,24,3,21,93,0.0,0.0
1010,646,2020-03-17 19:08:00,0,3444.0,2754.0,0.8,16.62,227,178,109,69,49,23,26,72,0.0,0.01
1010,647,2020-03-17 19:11:00,0,3381.0,2733.0,0.808,16.349,226,198,129,69,28,8,20,78,0.0,0.07
1010,648,2020-03-17 19:14:00,0,3378.0,2760.0,0.817,16.366,233,216,153,63,17,4,13,66,0.0,0.09
1010,649,2020-03-17 19:17:00,0,3297.0,2669.0,0.81,15.944,410,254,199,55,156,110,46,58,0.24,0.02
1010,650,2020-03-17 19:20:00,0,3286.0,2664.0,0.811,15.896,342,260,181,79,82,42,40,64,0.0,0.0
1010,651,2020-03-17 19:23:00,0,3936.0,3231.0,0.821,19.084,205,173,118,55,32,2,30,82,0.0,0.04
1010,652,2020-03-17 19:26:00,0,3694.0,3167.0,0.857,18.06,286,169,118,51,117,96,21,62,0.0,0.03
1010,653,2020-03-17 19:29:00,0,3672.0,3079.0,0.839,17.876,306,194,148,46,112,70,42,42,0.27,0.0
1010,654,2020-03-17 19:32:00,0,3705.0,3077.0,0.831,18.006,103,98,53,45,5,1,4,61,0.0,0.03
1010,655,2020-03-17 19:35:00,0,3946.0,3370.0,0.854,19.277,140,120,70,50,20,5,15,83,0.0,0.07
1010,656,2020-03-17 19:38:00,0,3708.0,3212.0,0.866,18.165,191,148,102,46,43,26,17,55,0.0,0.02
1010,657,2020-03-17 19:41:00,0,2858.0,2417.0,0.846,13.935,112,75,46,29,37,17,20,6,0.15,0.0
1010,658,2020-03-17 19:44:00,0,2982.0,2524.0,0.846,14.543,87,47,36,11,40,25,15,6,0.0,0.0
1010,659,2020-03-17 19:47:00,0,2641.0,2220.0,0.841,12.862,11,3,0,3,8,0,8,0,0.0,0.0
1010,660,2020-03-17 19:50:00,0,2665.0,2116.0,0.794,12.843,16,4,0,4,12,0,12,0,0.0,0.01
1010,661,2020-03-17 19:53:00,0,2937.0,2397.0,0.816,14.226,199,125,85,40,74,34,40,11,0.11,0.0
1010,662,2020-03-17 19:56:00,0,2499.0,2020.0,0.808,12.083,41,24,7,17,17,0,17,1,0.0,0.0
1010,663,2020-03-17 19:59:00,0,2665.0,2132.0,0.8,12.861,25,21,0,21,4,2,2,0,0.0,0.0
1010,664,2020-03-17 20:02:00,0,2840.0,2368.0,0.834,13.812,94,61,54,7,33,20,13,0,0.0,0.0
1010,665,2020-03-17 20:05:00,0,2645.0,2169.0,0.82,12.821,0,0,0,0,0,0,0,0,0.0,0.0
1010,666,2020-03-17 20:08:00,0,2644.0,2190.0,0.828,12.843,4,3,3,0,1,1,0,0,0.0,0.0
1010,667,2020-03-17 20:11:00,0,2517.0,2040.0,0.81,12.177,1,0,0,0,1,1,0,0,0.0,0.01
1010,668,2020-03-17 20:14:00,0,2785.0,2341.0,0.841,13.564,261,183,154,29,78,56,22,26,0.2,0.0
1010,669,2020-03-17 20:17:00,0,2603.5,2162.0,0.83,12.6515,0,0,0,0,0,0,0,0,0.0,0.0
1010,670,2020-03-17 20:20:00,0,2422.0,1983.0,0.819,11.739,0,0,0,0,0,0,0,0,0.0,0.0
1010,671,2020-03-17 20:23:00,0,2538.0,2026.0,0.798,12.243,74,61,45,16,13,9,4,18,0.0,0.0
1010,672,2020-03-17 20:26:00,0,3522.0,3126.0,0.888,17.338,171,122,65,57,49,34,15,74,0.0,0.0
1010,673,2020-03-17 20:29:00,0,3723.0,3396.0,0.912,18.429,147,126,78,48,21,4,17,90,0.0,0.04
1010,674,2020-03-17 20:32:00,0,3616.0,3350.0,0.926,17.954,125,110,56,54,15,2,13,73,0.0,0.03
1010,675,2020-03-17 20:35:00,0,3647.0,3313.0,0.909,18.036,91,87,38,49,4,0,4,46,0.0,0.05
1010,676,2020-03-17 20:38:00,0,3282.0,3031.0,0.924,16.285,97,90,44,46,7,2,5,48,0.0,0.05
1010,677,2020-03-17 20:41:00,0,3146.0,2785.0,0.885,15.48,157,96,71,25,61,35,26,28,0.0,0.08
1010,678,2020-03-17 20:44:00,0,4200.0,3939.0,0.938,20.91,404,265,208,57,139,103,36,50,0.0,0.0
1010,679,2020-03-17 20:47:00,0,3354.0,3101.0,0.925,16.647,356,230,174,56,126,93,33,73,0.19,0.01
1010,680,2020-03-17 20:50:00,0,3741.0,3472.0,0.928,18.585,120,118,73,45,2,0,2,58,0.0,0.04
1010,681,2020-03-17 20:53:00,0,3611.0,3346.0,0.927,17.93,126,121,74,47,5,2,3,48,0.0,0.11
1010,682,2020-03-17 20:56:00,0,3500.0,3250.0,0.929,17.39,81,78,41,37,3,0,3,35,0.0,0.09
1010,683,2020-03-17 20:59:00,0,3642.0,3391.0,0.931,18.104,61,60,31,29,1,1,0,17,0.0,0.33
1010,684,2020-03-17 21:02:00,0,3151.0,2856.0,0.906,15.577,168,99,79,20,69,42,27,0,0.12,0.0
1010,685,2020-03-17 21:05:00,0,3265.0,3084.0,0.944,16.28,584,406,327,79,178,123,55,27,0.39,0.03
1010,686,2020-03-17 21:08:00,0,3763.0,3443.0,0.915,18.64,727,471,368,103,256,196,60,22,0.0,0.0
1010,687,2020-03-17 21:11:00,0,2611.0,2237.0,0.857,12.763,552,358,284,74,194,146,48,30,0.13,0.0
1010,688,2020-03-17 21:14:00,0,3455.0,3150.0,0.912,17.1,521,338,284,54,183,132,51,6,0.02,0.0
1010,689,2020-03-17 21:17:00,0,2525.0,2218.0,0.879,12.402,55,26,12,14,29,13,16,0,0.0,0.0
1010,690,2020-03-17 21:20:00,0,3381.0,3003.0,0.888,16.648,499,356,286,70,143,97,46,19,0.06,0.0
1010,691,2020-03-17 21:23:00,0,4181.0,3889.0,0.93,20.778,740,478,372,106,262,182,80,6,0.0,0.04
1010,692,2020-03-17 21:26:00,0,3973.0,3820.0,0.962,19.88,523,326,269,57,197,143,54,21,0.24,0.0
1010,693,2020-03-17 21:29:00,0,3850.0,3655.0,0.949,19.217,488,289,213,76,199,142,57,7,0.0,0.0
1010,694,2020-03-17 21:32:00,0,3975.0,3711.0,0.934,19.769,524,372,298,74,152,100,52,11,0.0,0.0
1010,695,2020-03-17 21:35:00,0,3836.0,3665.0,0.956,19.17,309,188,138,50,121,81,40,35,0.0,0.0
1010,696,2020-03-17 21:38:00,0,3491.0,3197.0,0.916,17.294,153,120,81,39,33,22,11,1,0.0,0.0
1010,697,2020-03-17 21:41:00,0,3166.0,2803.0,0.885,15.576,145,99,50,49,46,10,36,0,0.0,0.0
1010,698,2020-03-17 21:44:00,0,3602.0,3371.0,0.936,17.925,123,91,34,57,32,2,30,0,0.0,0.0
1010,699,2020-03-17 21:47:00,0,3861.0,3563.0,0.923,19.159,306,200,151,49,106,72,34,5,0.02,0.0
1010,700,2020-03-17 21:50:00,0,3859.0,3590.0,0.93,19.181,390,243,183,60,147,99,48,6,0.0,0.0
1010,701,2020-03-17 21:53:00,0,3893.0,3579.0,0.919,19.299,209,137,85,52,72,36,36,23,0.0,0.0
1010,702,2020-03-17 21:56:00,0,3705.0,3507.0,0.946,18.481,70,43,11,32,27,5,22,1,0.0,0.0
1010,703,2020-03-17 21:59:00,0,3635.0,3370.0,0.927,18.054,9,9,1,8,0,0,0,0,0.0,0.0
1010,704,2020-03-17 22:02:00,0,3262.0,3112.0,0.954,16.297,14,12,3,9,2,1,1,0,0.0,0.0
1010,705,2020-03-17 22:05:00,0,3120.0,2904.0,0.931,15.509,2,1,0,1,1,0,1,0,0.0,0.0
1010,706,2020-03-17 22:08:00,0,3007.0,2769.0,0.921,14.914,5,2,0,2,3,1,2,0,0.0,0.0
1010,707,2020-03-17 22:11:00,0,2878.0,2622.0,0.911,14.243,0,0,0,0,0,0,0,0,0.0,0.0
1010,708,2020-03-17 22:14:00,0,2754.0,2444.0,0.887,13.558,22,11,1,10,11,1,10,0,0.0,0.0
1010,709,2020-03-17 22:17:00,0,2608.0,2416.0,0.926,12.952,3,3,0,3,0,0,0,0,0.0,0.0
1010,710,2020-03-17 22:20:00,0,2603.0,2321.0,0.892,12.826,1,1,0,1,0,0,0,0,0.0,0.0
1010,711,2020-03-17 22:23:00,0,2446.0,2225.0,0.909,12.101,34,23,16,7,11,6,5,2,0.0,0.0
1010,712,2020-03-17 22:26:00,0,2457.0,2226.0,0.906,12.144,6,6,0,6,0,0,0,0,0.0,0.0
1010,713,2020-03-17 22:29:00,0,2472.0,2135.0,0.864,12.101,82,64,41,23,18,7,11,30,0.0,0.0
1010,714,2020-03-17 22:32:00,0,2585.0,2391.0,0.925,12.832,187,117,65,52,70,52,18,61,0.16,0.0
1010,715,2020-03-17 22:35:00,0,2742.0,2482.0,0.905,13.551,200,144,75,69,56,9,47,18,0.0,0.0
1010,716,2020-03-17 22:38:00,0,2929.0,2675.0,0.913,14.502,123,102,63,39,21,12,9,16,0.0,0.0
1010,717,2020-03-17 22:41:00,0,2863.0,2686.0,0.938,14.253,10,10,0,10,0,0,0,0,0.0,0.0
1010,718,2020-03-17 22:44:00,0,2810.0,2604.0,0.927,13.954,15,13,0,13,2,0,2,0,0.0,0.0
1010,719,2020-03-17 22:47:00,0,2828.0,2502.0,0.885,13.914,14,3,0,3,11,0,11,0,0.0,0.0
1010,720,2020-03-17 22:50:00,0,2597.0,2448.0,0.943,12.942,28,21,4,17,7,0,7,0,0.0,0.0
1010,721,2020-03-17 22:53:00,0,2608.0,2347.0,0.9,12.872,6,6,0,6,0,0,0,0,0.0,0.0
1010,722,2020-03-17 22:56:00,0,2630.0,2327.0,0.885,12.939,39,23,5,18,16,3,13,0,0.0,0.0
1010,723,2020-03-17 22:59:00,0,2449.0,2268.0,0.926,12.161,7,7,0,7,0,0,0,0,0.0,0.0
1010,724,2020-03-17 23:02:00,0,2485.0,2170.0,0.873,12.192,149,105,71,34,44,30,14,9,0.0,0.0
1010,725,2020-03-17 23:05:00,0,2600.0,2343.0,0.901,12.839,221,157,87,70,64,42,22,98,0.0,0.0
1010,726,2020-03-17 23:08:00,0,2794.0,2598.0,0.93,13.883,151,132,87,45,19,7,12,97,0.0,0.0
1010,727,2020-03-17 23:11:00,0,2920.0,2707.0,0.927,14.503,49,42,19,23,7,1,6,32,0.0,0.0
1010,728,2020-03-17 23:14:00,0,2930.0,2731.0,0.932,14.566,168,142,100,42,26,10,16,91,0.0,0.0
1010,729,2020-03-17 23:17:00,0,2955.5,2841.0,0.961,14.7885,152,122,69,53,30,19,11,73,0.0,0.0
1010,730,2020-03-17 23:20:00,0,2981.0,2951.0,0.99,15.011,223,130,93,37,93,65,28,62,0.0,0.0
1010,731,2020-03-17 23:23:00,0,1959.0,1804.0,0.92,9.717,65,29,16,13,36,21,15,6,0.0,0.0
1010,732,2020-03-17 23:26:00,0,2121.0,1857.0,0.876,10.414,68,33,10,23,35,5,30,2,0.0,0.0
1010,733,2020-03-17 23:29:00,0,2464.0,2225.0,0.903,12.172,54,35,9,26,19,2,17,0,0.0,0.01
1010,734,2020-03-17 23:32:00,0,3543.0,3445.0,0.972,17.773,189,168,110,58,21,8,13,72,0.0,0.0
1010,735,2020-03-17 23:35:00,0,2327.0,2052.0,0.882,11.439,18,10,6,4,8,5,3,0,0.0,0.0
1010,736,2020-03-17 23:38:00,0,2296.0,2119.0,0.923,11.393,7,7,3,4,0,0,0,0,0.0,0.0
1010,737,2020-03-17 23:41:00,0,2455.0,2188.0,0.891,12.094,8,8,0,8,0,0,0,0,0.0,0.0
1010,738,2020-03-17 23:44:00,0,2475.0,2210.0,0.893,12.199,11,11,1,10,0,0,0,0,0.0,0.0
1010,739,2020-03-17 23:47:00,0,2450.0,2226.0,0.909,12.117,30,23,11,12,7,4,3,0,0.0,0.0
1010,740,2020-03-17 23:50:00,0,2453.0,2238.0,0.912,12.144,15,3,0,3,12,0,12,0,0.0,0.0
1010,741,2020-03-17 23:53:00,0,2669.0,2453.0,0.919,13.23,1,0,0,0,1,0,1,0,0.0,0.0
1010,742,2020-03-17 23:56:00,0,2995.0,2867.0,0.957,14.974,259,190,145,45,69,56,13,20,0.0,0.0
1010,743,2020-03-17 23:59:00,0,3325.0,3225.0,0.97,16.67,215,178,120,58,37,15,22,92,0.0,0.01
1010,744,2020-03-18 00:02:00,0,3473.0,3410.0,0.982,17.459,121,102,63,39,19,5,14,68,0.0,0.07
1010,745,2020-03-18 00:05:00,0,3624.0,3477.0,0.96,18.126,135,113,73,40,22,13,9,105,0.0,0.01
1010,746,2020-03-18 00:08:00,0,3527.0,3431.0,0.973,17.694,203,163,108,55,40,10,30,105,0.0,0.0
1010,747,2020-03-18 00:11:00,0,3606.0,3450.0,0.957,18.028,147,113,65,48,34,6,28,97,0.0,0.05
1010,748,2020-03-18 00:14:00,0,3785.0,3654.0,0.965,18.959,89,80,30,50,9,0,9,55,0.0,0.0
1010,749,2020-03-18 00:17:00,0,3782.0,3747.0,0.991,19.05,76,59,26,33,17,10,7,35,0.31,0.07
1010,750,2020-03-18 00:20:00,0,2985.0,2791.0,0.935,14.852,149,111,64,47,38,21,17,4,0.0,0.0
1010,751,2020-03-18 00:23:00,0,2463.0,2219.0,0.901,12.161,80,38,5,33,42,5,37,1,0.0,0.0
1010,752,2020-03-18 00:26:00,0,2500.0,2311.0,0.924,12.411,55,46,18,28,9,0,9,0,0.0,0.0
1010,753,2020-03-18 00:29:00,0,3573.0,3519.0,0.985,17.973,290,228,166,62,62,37,25,59,0.0,0.0
1010,754,2020-03-18 00:32:00,0,4155.0,4082.0,0.982,20.888,297,196,144,52,101,63,38,67,0.08,0.0
1010,755,2020-03-18 00:35:00,0,2791.0,2636.0,0.944,13.914,154,129,88,41,25,4,21,53,0.0,0.0
1010,756,2020-03-18 00:38:00,0,4164.0,4094.0,0.983,20.938,145,108,72,36,37,10,27,84,0.0,0.07
1010,757,2020-03-18 00:41:00,0,4340.0,4399.0,1.013,21.97,414,290,225,65,124,95,29,84,0.0,0.0
1010,758,2020-03-18 00:44:00,0,4156.0,4061.0,0.977,20.871,279,187,143,44,92,55,37,69,0.0,0.0
1010,759,2020-03-18 00:47:00,0,4237.0,4140.0,0.977,21.276,154,133,84,49,21,0,21,88,0.0,0.0
1010,760,2020-03-18 00:50:00,0,3823.0,3627.0,0.949,19.076,254,191,145,46,63,39,24,54,0.18,0.0
1010,761,2020-03-18 00:53:00,0,2966.0,2867.0,0.966,14.86,267,170,118,52,97,62,35,39,0.0,0.0
1010,762,2020-03-18 00:56:00,0,2940.0,2721.0,0.925,14.597,381,268,212,56,113,82,31,51,0.0,0.0
1010,763,2020-03-18 00:59:00,0,3064.0,3004.0,0.981,15.396,298,190,130,60,108,73,35,14,0.0,0.03
1010,764,2020-03-18 01:02:00,0,3689.0,3493.0,0.947,18.402,218,182,118,64,36,14,22,91,0.0,0.0
1010,765,2020-03-18 01:05:00,0,4050.0,3855.0,0.952,20.224,191,154,95,59,37,2,35,79,0.0,0.02
1010,766,2020-03-18 01:08:00,0,3803.0,3669.0,0.965,19.043,113,98,60,38,15,2,13,67,0.0,0.0
1010,767,2020-03-18 01:11:00,0,4028.0,3910.0,0.971,20.197,113,102,65,37,11,0,11,45,0.0,0.01
1010,768,2020-03-18 01:14:00,0,3780.0,3711.0,0.982,19.003,174,143,98,45,31,2,29,66,0.0,0.0
1010,769,2020-03-18 01:17:00,0,2656.0,2481.0,0.934,13.211,48,19,5,14,29,2,27,0,0.0,0.0
1010,770,2020-03-18 01:20:00,0,2310.0,2095.0,0.907,11.42,20,9,1,8,11,0,11,0,0.0,0.01
1010,771,2020-03-18 01:23:00,0,2299.0,2111.0,0.918,11.394,1,1,0,1,0,0,0,0,0.0,0.0
1010,772,2020-03-18 01:26:00,0,2336.0,2056.0,0.88,11.48,3,3,1,2,0,0,0,0,0.0,0.0
1010,773,2020-03-18 01:29:00,0,2334.0,2077.0,0.89,11.497,17,16,7,9,1,1,0,0,0.0,0.0
1010,774,2020-03-18 01:32:00,0,2407.0,2136.0,0.887,11.848,11,9,2,7,2,1,1,0,0.0,0.0
1010,775,2020-03-18 01:35:00,0,2469.0,2207.0,0.894,12.172,0,0,0,0,0,0,0,0,0.0,0.0
1010,776,2020-03-18 01:38:00,0,2720.0,2500.0,0.919,13.483,177,114,82,32,63,46,17,12,0.0,0.0
1010,777,2020-03-18 01:41:00,0,3246.0,3121.0,0.962,16.244,264,196,140,56,68,39,29,62,0.0,0.0
1010,778,2020-03-18 01:44:00,0,3443.0,3405.0,0.989,17.334,115,102,61,41,13,0,13,69,0.0,0.02
1010,779,2020-03-18 01:47:00,0,3383.0,3320.0,0.981,17.004,361,206,154,52,155,106,49,43,0.0,0.05
1010,780,2020-03-18 01:50:00,0,2658.0,2474.0,0.931,13.21,215,152,107,45,63,17,46,12,0.16,0.0
1010,781,2020-03-18 01:53:00,0,2391.0,2158.0,0.903,11.812,166,136,84,52,30,6,24,33,0.0,0.0
1010,782,2020-03-18 01:56:00,0,3813.0,3681.0,0.966,19.098,195,151,87,64,44,4,40,98,0.0,0.0
1010,783,2020-03-18 01:59:00,0,3812.0,3679.0,0.965,19.092,153,136,81,55,17,0,17,85,0.0,0.0
1010,784,2020-03-18 02:02:00,0,3813.0,3606.0,0.946,19.016,126,101,65,36,25,2,23,99,0.0,0.0
1010,785,2020-03-18 02:05:00,0,3684.0,3487.0,0.946,18.374,168,128,81,47,40,9,31,89,0.0,0.0
1010,786,2020-03-18 02:08:00,0,3748.0,3530.0,0.942,18.675,90,70,36,34,20,2,18,74,0.0,0.0
1010,787,2020-03-18 02:11:00,0,3636.0,3429.0,0.943,18.122,104,77,30,47,27,6,21,84,0.0,0.0
1010,788,2020-03-18 02:14:00,0,3702.0,3404.0,0.92,18.353,42,35,15,20,7,3,4,84,0.0,0.0
1010,789,2020-03-18 02:17:00,0,3259.5,2992.5,0.918,16.1535,115,79,41,38,36,16,20,57,0.0,0.02
1010,790,2020-03-18 02:20:00,0,2817.0,2581.0,0.916,13.954,164,109,81,28,55,30,25,6,0.1,0.0
1010,791,2020-03-18 02:23:00,0,3754.0,3398.0,0.905,18.553,191,118,80,38,73,38,35,71,0.0,0.02
1010,792,2020-03-18 02:26:00,0,3709.0,3521.0,0.949,18.512,215,159,102,57,56,19,37,88,0.0,0.0
1010,793,2020-03-18 02:29:00,0,2417.0,2247.0,0.93,12.012,105,68,40,28,37,18,19,0,0.03,0.0
1010,794,2020-03-18 02:32:00,0,3680.0,3467.0,0.942,18.339,213,160,87,73,53,22,31,103,0.0,0.0
1010,795,2020-03-18 02:35:00,0,3128.0,2924.0,0.935,15.563,191,114,71,43,77,42,35,28,0.0,0.0
1010,796,2020-03-18 02:38:00,0,2457.0,2209.0,0.899,12.124,153,94,57,37,59,27,32,11,0.0,0.0
1010,797,2020-03-18 02:41:00,0,3707.0,3422.0,0.923,18.396,279,161,123,38,118,84,34,44,0.0,0.0
1010,798,2020-03-18 02:44:00,0,2969.0,2663.0,0.897,14.646,352,232,179,53,120,73,47,38,0.01,0.0
1010,799,2020-03-18 02:47:00,0,2882.0,2630.0,0.913,14.266,666,461,371,90,205,145,60,9,0.0,0.0
1010,800,2020-03-18 02:50:00,0,3594.0,3374.0,0.939,17.894,708,493,416,77,215,162,53,15,0.0,0.01
1010,801,2020-03-18 02:53:00,0,3356.0,3138.0,0.935,16.696,214,136,106,30,78,40,38,5,0.0,0.0
1010,802,2020-03-18 02:56:00,0,3518.0,3186.0,0.905,17.388,18,12,0,12,6,3,3,0,0.0,0.0
1010,803,2020-03-18 02:59:00,0,3297.0,2996.0,0.909,16.307,12,7,5,2,5,1,4,0,0.0,0.0
1010,804,2020-03-18 03:02:00,0,3164.0,2838.0,0.897,15.608,2,2,0,2,0,0,0,0,0.0,0.0
1010,805,2020-03-18 03:05:00,0,2889.0,2623.0,0.908,14.287,6,4,0,4,2,0,2,0,0.0,0.0
1010,806,2020-03-18 03:08:00,0,2684.0,2449.0,0.913,13.286,9,6,0,6,3,2,1,0,0.0,0.0
1010,807,2020-03-18 03:11:00,0,2528.0,2272.0,0.899,12.475,3,3,1,2,0,0,0,0,0.0,0.0
1010,808,2020-03-18 03:14:00,0,2327.0,2092.0,0.899,11.486,2,2,0,2,0,0,0,0,0.0,0.0
1010,809,2020-03-18 03:17:00,0,2268.0,1964.0,0.866,11.109,19,11,1,10,8,2,6,0,0.0,0.0
1010,810,2020-03-18 03:20:00,0,2111.0,1863.0,0.883,10.38,8,4,0,4,4,0,4,0,0.0,0.0
1010,811,2020-03-18 03:23:00,0,1981.0,1780.0,0.899,9.774,22,9,5,4,13,5,8,0,0.0,0.0
1010,812,2020-03-18 03:26:00,0,1973.0,1734.0,0.879,9.695,12,10,1,9,2,0,2,0,0.0,0.0
1010,813,2020-03-18 03:29:00,0,1911.0,1644.0,0.86,9.35,1,1,0,1,0,0,0,0,0.0,0.0
1010,814,2020-03-18 03:32:00,0,1745.0,1587.0,0.91,8.632,16,15,0,15,1,0,1,0,0.0,0.0
1010,815,2020-03-18 03:35:00,0,1765.0,1570.0,0.889,8.691,10,10,0,10,0,0,0,0,0.0,0.0
1010,816,2020-03-18 03:38:00,0,1776.0,1531.0,0.862,8.694,7,4,0,4,3,0,3,0,0.0,0.0
1010,817,2020-03-18 03:41:00,0,1679.0,1493.0,0.89,8.267,5,0,0,0,5,0,5,0,0.0,0.0
1010,818,2020-03-18 03:44:00,0,1777.0,1530.0,0.861,8.693,9,5,1,4,4,0,4,0,0.0,0.0
1010,819,2020-03-18 03:47:00,0,1781.0,1524.0,0.856,8.703,5,1,0,1,4,0,4,0,0.0,0.0
1010,820,2020-03-18 03:50:00,0,1789.0,1467.0,0.82,8.673,16,6,3,3,10,0,10,0,0.0,0.0
1010,821,2020-03-18 03:53:00,0,1783.0,1482.0,0.831,8.666,12,6,0,6,6,0,6,0,0.0,0.0
1010,822,2020-03-18 03:56:00,0,1777.0,1472.0,0.829,8.631,12,4,0,4,8,0,8,0,0.0,0.0
1010,823,2020-03-18 03:59:00,0,1769.0,1551.0,0.877,8.686,12,1,0,1,11,0,11,0,0.0,0.0
1010,824,2020-03-18 04:02:00,0,1772.0,1529.0,0.863,8.674,14,3,1,2,11,0,11,0,0.0,0.0
1010,825,2020-03-18 04:05:00,0,1930.0,1554.0,0.805,9.326,280,179,132,47,101,68,33,25,0.0,0.0
1010,826,2020-03-18 04:08:00,0,2366.0,1937.0,0.819,11.465,280,192,148,44,88,63,25,51,0.0,0.0
1010,827,2020-03-18 04:11:00,0,2353.0,1894.0,0.805,11.366,126,82,37,45,44,11,33,11,0.0,0.0
1010,828,2020-03-18 04:14:00,0,2649.0,2157.0,0.814,12.826,279,199,146,53,80,29,51,7,0.0,0.0
1010,829,2020-03-18 04:17:00,0,2703.0,2264.0,0.838,13.156,11,4,1,3,7,0,7,0,0.0,0.0
1010,830,2020-03-18 04:20:00,0,2574.0,2130.0,0.828,12.5,12,2,0,2,10,0,10,0,0.0,0.0
1010,831,2020-03-18 04:23:00,0,2440.0,1961.0,0.804,11.784,7,0,0,0,7,0,7,0,0.0,0.0
1010,832,2020-03-18 04:26:00,0,2306.0,1821.0,0.79,11.104,9,5,2,3,4,0,4,0,0.0,0.0
1010,833,2020-03-18 04:29:00,0,2146.0,1728.0,0.806,10.368,8,3,0,3,5,0,5,0,0.0,0.0
1010,834,2020-03-18 04:32:00,0,2021.0,1618.0,0.801,9.755,21,15,1,14,6,0,6,0,0.0,0.0
1010,835,2020-03-18 04:35:00,0,1999.0,1625.0,0.813,9.676,4,4,1,3,0,0,0,0,0.0,0.0
1010,836,2020-03-18 04:38:00,0,1999.0,1623.0,0.812,9.673,27,14,9,5,13,1,12,0,0.0,0.0
1010,837,2020-03-18 04:41:00,0,1993.0,1638.0,0.822,9.666,82,48,12,36,34,1,33,0,0.0,0.0
1010,838,2020-03-18 04:44:00,0,2289.0,1854.0,0.81,11.069,234,162,116,46,72,34,38,41,0.0,0.0
1010,839,2020-03-18 04:47:00,0,2500.0,1981.0,0.792,12.043,196,147,95,52,49,34,15,14,0.0,0.0
1010,840,2020-03-18 04:50:00,0,2477.0,2060.0,0.832,12.041,159,115,81,34,44,22,22,25,0.0,0.0
1010,841,2020-03-18 04:53:00,0,2736.0,2156.0,0.788,13.165,220,127,110,17,93,66,27,15,0.0,0.0
1010,842,2020-03-18 04:56:00,0,2659.0,2158.0,0.811,12.867,511,338,275,63,173,125,48,45,0.0,0.0
1010,843,2020-03-18 04:59:00,0,2505.0,2094.0,0.836,12.187,369,217,171,46,152,107,45,20,0.0,0.0
1010,844,2020-03-18 05:02:00,0,2716.0,2152.0,0.792,13.085,158,107,61,46,51,29,22,75,0.0,0.0
1010,845,2020-03-18 05:05:00,0,2876.0,2289.0,0.796,13.866,208,160,92,68,48,7,41,93,0.0,0.0
1010,846,2020-03-18 05:08:00,0,3103.0,2460.0,0.793,14.949,203,150,86,64,53,7,46,104,0.0,0.0
1010,847,2020-03-18 05:11:00,0,3080.0,2522.0,0.819,14.929,202,133,71,62,69,15,54,99,0.0,0.0
1010,848,2020-03-18 05:14:00,0,3230.0,2641.0,0.818,15.649,143,102,60,42,41,11,30,60,0.0,0.0
1010,849,2020-03-18 05:17:00,0,3214.5,2675.0,0.8325,15.627,134,104,55,49,30,8,22,51,0.0,0.0
1010,850,2020-03-18 05:20:00,0,3199.0,2709.0,0.847,15.605,184,135,72,63,49,8,41,75,0.0,0.0
1010,851,2020-03-18 05:23:00,0,3265.0,2808.0,0.86,15.973,125,101,62,39,24,8,16,50,0.0,0.02
1010,852,2020-03-18 05:26:00,0,3217.0,2675.0,0.831,15.638,195,130,69,61,65,30,35,65,0.0,0.0
1010,853,2020-03-18 05:29:00,0,3158.0,2808.0,0.889,15.551,162,114,72,42,48,6,42,63,0.0,0.02
1010,854,2020-03-18 05:32:00,0,3044.0,2667.0,0.876,14.947,216,163,94,69,53,5,48,80,0.0,0.0
1010,855,2020-03-18 05:35:00,0,3039.0,2675.0,0.88,14.935,90,58,28,30,32,1,31,70,0.0,0.0
1010,856,2020-03-18 05:38:00,0,3396.0,2914.0,0.858,16.607,130,75,27,48,55,21,34,79,0.0,0.03
1010,857,2020-03-18 05:41:00,0,3402.0,2896.0,0.851,16.61,141,115,56,59,26,8,18,64,0.0,0.01
1010,858,2020-03-18 05:44:00,0,2709.0,2264.0,0.836,13.179,241,138,105,33,103,63,40,13,0.31,0.02
1010,859,2020-03-18 05:47:00,0,3680.0,3252.0,0.884,18.1,452,301,246,55,151,105,46,23,0.0,0.01
1010,860,2020-03-18 05:50:00,0,3418.0,2925.0,0.856,16.707,151,107,53,54,44,14,30,70,0.0,0.0
1010,861,2020-03-18 05:53:00,0,3510.0,3180.0,0.906,17.351,188,141,82,59,47,19,28,79,0.0,0.0
1010,862,2020-03-18 05:56:00,0,3517.0,3127.0,0.889,17.32,183,116,60,56,67,16,51,73,0.0,0.03
1010,863,2020-03-18 05:59:00,0,3499.0,3151.0,0.901,17.276,193,134,71,63,59,25,34,70,0.0,0.01
1010,864,2020-03-18 06:02:00,1,2692.0,2377.0,0.883,13.237,196,125,94,31,71,43,28,17,0.0,0.02
1010,865,2020-03-18 06:05:00,1,3397.0,3044.0,0.896,16.754,242,162,108,54,80,50,30,44,0.0,0.0
1010,866,2020-03-18 06:08:00,1,3536.0,3126.0,0.884,17.393,180,131,78,53,49,5,44,73,0.0,0.0
1010,867,2020-03-18 06:11:00,1,3321.0,2965.0,0.893,16.368,307,202,140,62,105,57,48,58,0.1,0.02
1010,868,2020-03-18 06:14:00,1,2766.0,2385.0,0.862,13.538,760,574,467,107,186,126,60,12,0.0,0.01
1010,869,2020-03-18 06:17:00,1,2695.0,2339.0,0.868,13.207,762,504,409,95,258,174,84,2,0.0,0.0
1010,870,2020-03-18 06:20:00,1,2696.0,2321.0,0.861,13.192,646,499,385,114,147,89,58,7,0.0,0.0
1010,871,2020-03-18 06:23:00,1,2622.0,2237.0,0.853,12.805,126,110,62,48,16,7,9,0,0.0,0.0
1010,872,2020-03-18 06:26:00,1,2811.0,2394.0,0.852,13.725,23,14,1,13,9,0,9,0,0.0,0.0
1010,873,2020-03-18 06:29:00,1,2919.0,2561.0,0.877,14.336,11,11,1,10,0,0,0,0,0.0,0.0
1010,874,2020-03-18 06:32:00,1,2811.0,2491.0,0.886,13.833,0,0,0,0,0,0,0,0,0.0,0.0
1010,875,2020-03-18 06:35:00,1,2817.0,2460.0,0.873,13.825,0,0,0,0,0,0,0,0,0.0,0.01
1010,876,2020-03-18 06:38:00,1,2847.0,2405.0,0.845,13.881,17,12,3,9,5,2,3,0,0.0,0.0
1010,877,2020-03-18 06:41:00,1,2707.0,2328.0,0.86,13.244,0,0,0,0,0,0,0,0,0.0,0.01
1010,878,2020-03-18 06:44:00,1,2475.0,2085.0,0.843,12.06,1,0,0,0,1,0,1,0,0.0,0.0
1010,879,2020-03-18 06:47:00,1,2353.0,1953.0,0.83,11.433,0,0,0,0,0,0,0,0,0.0,0.0
1010,880,2020-03-18 06:50:00,1,2136.0,1827.0,0.855,10.439,21,7,1,6,14,0,14,0,0.0,0.0
1010,881,2020-03-18 06:53:00,1,2132.0,1813.0,0.85,10.407,5,2,0,2,3,0,3,0,0.0,0.0
1010,882,2020-03-18 06:56:00,1,2161.0,1718.0,0.795,10.417,9,3,0,3,6,0,6,0,0.0,0.0
1010,883,2020-03-18 06:59:00,1,2011.0,1623.0,0.807,9.72,17,10,0,10,7,0,7,0,0.0,0.0
1010,884,2020-03-18 07:02:00,1,2006.0,1565.0,0.78,9.635,23,10,2,8,13,0,13,0,0.0,0.0
1010,885,2020-03-18 07:05:00,1,2008.0,1565.0,0.779,9.644,5,0,0,0,5,0,5,0,0.0,0.0
1010,886,2020-03-18 07:08:00,1,1956.0,1537.0,0.786,9.409,17,0,0,0,17,0,17,0,0.0,0.0
1010,887,2020-03-18 07:11:00,1,1790.0,1458.0,0.814,8.667,95,71,53,18,24,8,16,4,0.0,0.0
1010,888,2020-03-18 07:14:00,1,1946.0,1498.0,0.77,9.324,29,22,8,14,7,2,5,0,0.0,0.0
1010,889,2020-03-18 07:17:00,1,2017.0,1548.0,0.767,9.659,1,0,0,0,1,0,1,0,0.0,0.0
1010,890,2020-03-18 07:20:00,1,1970.0,1489.0,0.756,9.411,0,0,0,0,0,0,0,0,0.0,0.0
1010,891,2020-03-18 07:23:00,1,1888.0,1432.0,0.759,9.023,0,0,0,0,0,0,0,0,0.0,0.0
1010,892,2020-03-18 07:26:00,1,1887.0,1395.0,0.739,8.978,22,9,0,9,13,0,13,0,0.0,0.0
1010,893,2020-03-18 07:29:00,1,1960.0,1392.0,0.71,9.263,1,0,0,0,1,0,1,0,0.0,0.0
1010,894,2020-03-18 07:32:00,1,1967.0,1395.0,0.709,9.294,0,0,0,0,0,0,0,0,0.0,0.0
1010,895,2020-03-18 07:35:00,1,1977.0,1411.0,0.714,9.351,393,291,216,75,102,63,39,23,0.0,0.0
1010,896,2020-03-18 07:38:00,1,2197.0,1576.0,0.717,10.403,53,24,11,13,29,5,24,0,0.0,0.0
1010,897,2020-03-18 07:41:00,1,2471.0,1785.0,0.722,11.711,148,103,74,29,45,25,20,17,0.0,0.0
1010,898,2020-03-18 07:44:00,1,2414.0,1807.0,0.748,11.512,3,1,1,0,2,0,2,0,0.0,0.0
1010,899,2020-03-18 07:47:00,1,2445.0,1707.0,0.698,11.525,0,0,0,0,0,0,0,0,0.0,0.0
1010,900,2020-03-18 07:50:00,1,2211.0,1595.0,0.721,10.479,0,0,0,0,0,0,0,0,0.0,0.0
1010,901,2020-03-18 07:53:00,1,2041.0,1483.0,0.726,9.684,2,2,1,1,0,0,0,0,0.0,0.0
1010,902,2020-03-18 07:56:00,1,2072.0,1402.0,0.677,9.716,0,0,0,0,0,0,0,0,0.0,0.0
1010,903,2020-03-18 07:59:00,1,1820.0,1324.0,0.727,8.635,0,0,0,0,0,0,0,0,0.0,0.0
1010,904,2020-03-18 08:02:00,1,1823.0,1350.0,0.74,8.678,6,4,3,1,2,1,1,0,0.0,0.0
1010,905,2020-03-18 08:05:00,1,1831.0,1352.0,0.738,8.711,0,0,0,0,0,0,0,0,0.0,0.0
1010,906,2020-03-18 08:08:00,1,1829.0,1282.0,0.701,8.627,0,0,0,0,0,0,0,0,0.0,0.0
1010,907,2020-03-18 08:11:00,1,1825.0,1311.0,0.718,8.643,0,0,0,0,0,0,0,0,0.0,0.0
1010,908,2020-03-18 08:14:00,1,1837.0,1284.0,0.699,8.66,0,0,0,0,0,0,0,0,0.0,0.0
1010,909,2020-03-18 08:17:00,1,1840.0,1271.5,0.691,8.658,0,0,0,0,0,0,0,0,0.0,0.0
1010,910,2020-03-18 08:20:00,1,1843.0,1259.0,0.683,8.656,0,0,0,0,0,0,0,0,0.0,0.0
1010,911,2020-03-18 08:23:00,1,1835.0,1276.0,0.695,8.643,14,13,6,7,1,0,1,0,0.0,0.0
1010,912,2020-03-18 08:26:00,1,1832.0,1283.0,0.7,8.639,19,5,1,4,14,1,13,1,0.0,0.0
1010,913,2020-03-18 08:29:00,1,2182.0,1607.0,0.736,10.378,138,96,62,34,42,28,14,21,0.0,0.05
1010,914,2020-03-18 08:32:00,1,2548.0,1887.0,0.741,12.13,122,92,51,41,30,10,20,44,0.0,0.0
1010,915,2020-03-18 08:35:00,1,2537.0,1920.0,0.757,12.121,219,118,80,38,101,51,50,6,0.0,0.0
1010,916,2020-03-18 08:38:00,1,2776.0,1997.0,0.719,13.15,15,9,4,5,6,0,6,0,0.0,0.0
1010,917,2020-03-18 08:41:00,1,2767.0,1987.0,0.718,13.104,53,47,8,39,6,0,6,1,0.0,0.0
1010,918,2020-03-18 08:44:00,1,2627.0,1941.0,0.739,12.497,0,0,0,0,0,0,0,0,0.0,0.0
1010,919,2020-03-18 08:47:00,1,2483.0,1771.0,0.713,11.743,20,11,2,9,9,0,9,0,0.0,0.0
1010,920,2020-03-18 08:50:00,1,2420.0,1707.0,0.706,11.424,2,2,1,1,0,0,0,0,0.0,0.0
1010,921,2020-03-18 08:53:00,1,2208.0,1629.0,0.738,10.505,1,1,0,1,0,0,0,0,0.0,0.0
1010,922,2020-03-18 08:56:00,1,2197.0,1530.0,0.697,10.349,1,1,0,1,0,0,0,0,0.0,0.0
1010,923,2020-03-18 08:59:00,1,2034.0,1456.0,0.716,9.624,3,3,0,3,0,0,0,0,0.0,0.0
1010,924,2020-03-18 09:02:00,1,2053.0,1438.0,0.7,9.681,0,0,0,0,0,0,0,0,0.0,0.0
1010,925,2020-03-18 09:05:00,1,1980.0,1373.0,0.693,9.323,4,4,1,3,0,0,0,0,0.0,0.0
1010,926,2020-03-18 09:08:00,1,2043.0,1457.0,0.713,9.664,80,59,41,18,21,10,11,0,0.0,0.0
1010,927,2020-03-18 09:11:00,1,2402.0,1672.0,0.696,11.316,134,83,44,39,51,19,32,92,0.0,0.0
1010,928,2020-03-18 09:14:00,1,2794.0,1965.0,0.703,13.184,125,96,36,60,29,2,27,78,0.0,0.0
1010,929,2020-03-18 09:17:00,1,3065.0,2187.0,0.713,14.499,196,137,92,45,59,26,33,62,0.0,0.0
1010,930,2020-03-18 09:20:00,1,2434.0,1730.0,0.711,11.505,36,28,16,12,8,3,5,0,0.0,0.0
1010,931,2020-03-18 09:23:00,1,2738.0,1927.0,0.704,12.922,514,384,301,83,130,74,56,51,0.0,0.0
1010,932,2020-03-18 09:26:00,1,2904.0,2091.0,0.72,13.757,141,107,55,52,34,12,22,55,0.0,0.0
1010,933,2020-03-18 09:29:00,1,3094.0,2208.0,0.714,14.633,433,292,219,73,141,97,44,55,0.0,0.0
1010,934,2020-03-18 09:32:00,1,2784.0,1996.0,0.717,13.178,768,584,484,100,184,116,68,25,0.0,0.0
1010,935,2020-03-18 09:35:00,1,2757.0,1993.0,0.723,13.07,820,578,464,114,242,160,82,24,0.0,0.0
1010,936,2020-03-18 09:38:00,1,2787.0,1986.0,0.713,13.178,941,713,579,134,228,162,66,10,0.0,0.0
1010,937,2020-03-18 09:41:00,1,2907.0,2138.0,0.735,13.819,501,373,292,81,128,86,42,9,0.0,0.0
1010,938,2020-03-18 09:44:00,1,2913.0,2138.0,0.734,13.843,47,43,10,33,4,1,3,0,0.0,0.0
1010,939,2020-03-18 09:47:00,1,2752.0,2022.0,0.735,13.083,3,3,0,3,0,0,0,0,0.0,0.0
1010,940,2020-03-18 09:50:00,1,2612.0,1933.0,0.74,12.431,0,0,0,0,0,0,0,0,0.0,0.0
1010,941,2020-03-18 09:53:00,1,2484.0,1793.0,0.722,11.772,92,49,36,13,43,31,12,2,0.0,0.0
1010,942,2020-03-18 09:56:00,1,2390.0,1795.0,0.751,11.404,16,8,1,7,8,3,5,0,0.0,0.0
1010,943,2020-03-18 09:59:00,1,2422.0,1730.0,0.714,11.458,4,1,0,1,3,0,3,0,0.0,0.0
1010,944,2020-03-18 10:02:00,1,2161.0,1596.0,0.739,10.281,0,0,0,0,0,0,0,0,0.0,0.0
1010,945,2020-03-18 10:05:00,1,2211.0,1512.0,0.684,10.384,3,0,0,0,3,0,3,0,0.0,0.0
1010,946,2020-03-18 10:08:00,1,2061.0,1455.0,0.706,9.731,7,3,2,1,4,0,4,0,0.0,0.0
1010,947,2020-03-18 10:11:00,1,2067.0,1411.0,0.683,9.706,7,4,4,0,3,0,3,0,0.0,0.0
1010,948,2020-03-18 10:14:00,1,2067.0,1438.0,0.696,9.735,0,0,0,0,0,0,0,0,0.0,0.0
1010,949,2020-03-18 10:17:00,1,2072.0,1400.0,0.676,9.715,4,2,0,2,2,1,1,0,0.0,0.0
1010,950,2020-03-18 10:20:00,1,2059.0,1426.0,0.692,9.693,3,3,0,3,0,0,0,0,0.0,0.0
1010,951,2020-03-18 10:23:00,1,2066.0,1391.0,0.673,9.681,2,2,1,1,0,0,0,0,0.0,0.0
1010,952,2020-03-18 10:26:00,1,1903.0,1330.0,0.699,8.969,16,15,5,10,1,0,1,0,0.0,0.0
1010,953,2020-03-18 10:29:00,1,1978.0,1369.0,0.692,9.308,12,12,0,12,0,0,0,0,0.0,0.0
1010,954,2020-03-18 10:32:00,1,2063.0,1389.0,0.673,9.666,23,16,8,8,7,5,2,0,0.0,0.0
1010,955,2020-03-18 10:35:00,1,2065.0,1391.0,0.674,9.677,17,13,8,5,4,2,2,0,0.0,0.0
1010,956,2020-03-18 10:38:00,1,2074.0,1418.0,0.684,9.741,2,2,0,2,0,0,0,0,0.0,0.0
1010,957,2020-03-18 10:41:00,1,2077.0,1373.0,0.661,9.703,1,1,0,1,0,0,0,0,0.0,0.0
1010,958,2020-03-18 10:44:00,1,1990.0,1346.0,0.677,9.333,2,2,0,2,0,0,0,0,0.0,0.0
1010,959,2020-03-18 10:47:00,1,1908.0,1328.0,0.696,8.988,19,19,4,15,0,0,0,0,0.0,0.0
1010,960,2020-03-18 10:50:00,1,2083.0,1412.0,0.678,9.771,103,96,33,63,7,0,7,0,0.0,0.0
1010,961,2020-03-18 10:53:00,1,2342.0,1611.0,0.688,11.009,36,32,12,20,4,0,4,0,0.0,0.0
1010,962,2020-03-18 10:56:00,1,2403.0,1731.0,0.72,11.384,102,66,38,28,36,27,9,0,0.0,0.0
1010,963,2020-03-18 10:59:00,1,2599.0,1788.0,0.688,12.219,25,18,8,10,7,4,3,0,0.0,0.0
1010,964,2020-03-18 11:02:00,1,2420.0,1689.0,0.698,11.406,0,0,0,0,0,0,0,0,0.0,0.0
1010,965,2020-03-18 11:05:00,1,2282.0,1592.0,0.697,10.754,4,4,0,4,0,0,0,0,0.0,0.0
1010,966,2020-03-18 11:08:00,1,2217.0,1469.0,0.663,10.36,0,0,0,0,0,0,0,0,0.0,0.0
1010,967,2020-03-18 11:11:00,1,2077.0,1361.0,0.656,9.689,0,0,0,0,0,0,0,0,0.0,0.0
1010,968,2020-03-18 11:14:00,1,1831.0,1273.0,0.695,8.625,1,1,0,1,0,0,0,0,0.0,0.0
1010,969,2020-03-18 11:17:00,1,1922.0,1298.0,0.676,9.0115,0,0,0,0,0,0,0,0,0.0,0.0
1010,970,2020-03-18 11:20:00,1,2013.0,1323.0,0.657,9.398,0,0,0,0,0,0,0,0,0.0,0.0
1010,971,2020-03-18 11:23:00,1,1921.0,1304.0,0.679,9.012,0,0,0,0,0,0,0,0,0.0,0.0
1010,972,2020-03-18 11:26:00,1,1829.0,1310.0,0.717,8.656,0,0,0,0,0,0,0,0,0.0,0.0
1010,973,2020-03-18 11:29:00,1,1839.0,1315.0,0.715,8.704,24,14,9,5,10,1,9,0,0.0,0.0
1010,974,2020-03-18 11:32:00,1,2062.0,1403.0,0.68,9.68,3,0,0,0,3,0,3,0,0.0,0.0
1010,975,2020-03-18 11:35:00,1,2059.0,1375.0,0.668,9.637,13,10,0,10,3,0,3,0,0.0,0.0
1010,976,2020-03-18 11:38:00,1,2071.0,1363.0,0.658,9.671,7,1,0,1,6,0,6,0,0.0,0.0
1010,977,2020-03-18 11:41:00,1,2079.0,1371.0,0.66,9.708,0,0,0,0,0,0,0,0,0.0,0.0
1010,978,2020-03-18 11:44:00,1,2066.0,1339.0,0.648,9.621,11,6,0,6,5,0,5,0,0.0,0.0
1010,979,2020-03-18 11:47:00,1,2063.0,1398.0,0.678,9.675,0,0,0,0,0,0,0,0,0.0,0.0
1010,980,2020-03-18 11:50:00,1,2073.0,1394.0,0.672,9.71,148,110,80,30,38,31,7,10,0.0,0.0
1010,981,2020-03-18 11:53:00,1,2227.0,1530.0,0.687,10.469,3,3,0,3,0,0,0,0,0.0,0.0
1010,982,2020-03-18 11:56:00,1,2210.0,1466.0,0.663,10.329,0,0,0,0,0,0,0,0,0.0,0.0
1010,983,2020-03-18 11:59:00,1,2213.0,1443.0,0.652,10.317,4,0,0,0,4,0,4,0,0.0,0.0
1010,984,2020-03-18 12:02:00,1,2050.0,1420.0,0.692,9.651,0,0,0,0,0,0,0,0,0.0,0.0
1010,985,2020-03-18 12:05:00,1,2074.0,1343.0,0.647,9.658,23,23,0,23,0,0,0,0,0.0,0.0
1010,986,2020-03-18 12:08:00,1,2092.0,1331.0,0.636,9.717,15,15,0,15,0,0,0,0,0.0,0.0
1010,987,2020-03-18 12:11:00,1,2089.0,1371.0,0.656,9.748,1,1,0,1,0,0,0,0,0.0,0.0
1010,988,2020-03-18 12:14:00,1,2071.0,1363.0,0.658,9.671,6,6,3,3,0,0,0,0,0.0,0.0
1010,989,2020-03-18 12:17:00,1,2086.0,1365.0,0.654,9.731,5,5,1,4,0,0,0,0,0.0,0.0
1010,990,2020-03-18 12:20:00,1,2096.0,1370.0,0.654,9.774,8,8,4,4,0,0,0,0,0.0,0.0
1010,991,2020-03-18 12:23:00,1,2071.0,1307.0,0.631,9.609,7,7,5,2,0,0,0,0,0.0,0.0
1010,992,2020-03-18 12:26:00,1,2083.0,1313.0,0.63,9.661,26,26,17,9,0,0,0,0,0.0,0.0
1010,993,2020-03-18 12:29:00,1,2096.0,1324.0,0.632,9.724,7,7,2,5,0,0,0,0,0.0,0.0
1010,994,2020-03-18 12:32:00,1,2080.0,1363.0,0.655,9.703,175,166,86,80,9,4,5,0,0.0,0.0
1010,995,2020-03-18 12:35:00,1,2289.0,1572.0,0.687,10.76,128,98,41,57,30,5,25,0,0.0,0.0
1010,996,2020-03-18 12:38:00,1,2610.0,1755.0,0.672,12.229,148,132,78,54,16,1,15,0,0.0,0.0
1010,997,2020-03-18 12:41:00,1,2565.0,1822.0,0.71,12.125,139,121,65,56,18,8,10,25,0.0,0.0
1010,998,2020-03-18 12:44:00,1,2740.0,1901.0,0.694,12.899,134,118,69,49,16,3,13,77,0.0,0.0
1010,999,2020-03-18 12:47:00,1,2806.0,1958.0,0.698,13.224,179,146,77,69,33,10,23,91,0.0,0.0
1010,1000,2020-03-18 12:50:00,1,2654.0,1886.0,0.711,12.544,350,257,195,62,93,55,38,26,0.0,0.0
1010,1001,2020-03-18 12:53:00,1,2795.0,1897.0,0.678,13.114,314,236,167,69,78,49,29,73,0.0,0.0
1010,1002,2020-03-18 12:56:00,1,2874.0,1994.0,0.694,13.53,143,102,49,53,41,15,26,79,0.0,0.0
1010,1003,2020-03-18 12:59:00,1,3012.0,2118.0,0.703,14.212,179,138,77,61,41,19,22,96,0.0,0.0
1010,1004,2020-03-18 13:02:00,1,3090.0,2148.0,0.695,14.553,120,88,45,43,32,12,20,43,0.0,0.0
1010,1005,2020-03-18 13:05:00,1,2850.0,2043.0,0.717,13.493,166,114,77,37,52,33,19,22,0.0,0.0
1010,1006,2020-03-18 13:08:00,1,2362.0,1630.0,0.69,11.112,50,46,10,36,4,0,4,0,0.0,0.0
1010,1007,2020-03-18 13:11:00,1,2437.0,1690.0,0.693,11.475,21,21,1,20,0,0,0,0,0.0,0.0
1010,1008,2020-03-18 13:14:00,1,2431.0,1678.0,0.69,11.437,23,23,1,22,0,0,0,0,0.0,0.0
1010,1009,2020-03-18 13:17:00,1,2422.0,1714.0,0.708,11.442,10,10,6,4,0,0,0,0,0.0,0.0
1010,1010,2020-03-18 13:20:00,1,2424.0,1729.0,0.713,11.465,27,15,7,8,12,0,12,0,0.0,0.0
1010,1011,2020-03-18 13:23:00,1,2417.0,1739.0,0.72,11.449,46,36,15,21,10,0,10,0,0.0,0.0
1010,1012,2020-03-18 13:26:00,1,2325.0,1719.0,0.739,11.064,47,45,28,17,2,0,2,0,0.0,0.0
1010,1013,2020-03-18 13:29:00,1,2253.0,1703.0,0.756,10.761,12,3,1,2,9,0,9,0,0.0,0.0
1010,1014,2020-03-18 13:32:00,1,2246.0,1710.0,0.761,10.744,3,2,1,1,1,0,1,0,0.0,0.0
1010,1015,2020-03-18 13:35:00,1,2176.0,1649.0,0.758,10.399,14,10,6,4,4,0,4,0,0.0,0.0
1010,1016,2020-03-18 13:38:00,1,2168.0,1700.0,0.784,10.424,3,2,1,1,1,0,1,0,0.0,0.0
1010,1017,2020-03-18 13:41:00,1,2172.0,1662.0,0.765,10.396,2,2,0,2,0,0,0,0,0.0,0.0
1010,1018,2020-03-18 13:44:00,1,2193.0,1619.0,0.738,10.432,0,0,0,0,0,0,0,0,0.0,0.0
1010,1019,2020-03-18 13:47:00,1,2193.0,1585.0,0.722,10.396,2,1,0,1,1,0,1,0,0.0,0.0
1010,1020,2020-03-18 13:50:00,1,2117.0,1545.0,0.73,10.051,2,0,0,0,2,0,2,0,0.0,0.01
1010,1021,2020-03-18 13:53:00,1,2117.0,1531.0,0.723,10.035,0,0,0,0,0,0,0,0,0.0,0.0
1010,1022,2020-03-18 13:56:00,1,2111.0,1527.0,0.723,10.008,3,3,2,1,0,0,0,0,0.0,0.0
1010,1023,2020-03-18 13:59:00,1,2206.0,1519.0,0.689,10.374,6,5,2,3,1,1,0,0,0.0,0.0
1010,1024,2020-03-18 14:02:00,1,2135.0,1505.0,0.705,10.08,1,1,0,1,0,0,0,0,0.0,0.0
1010,1025,2020-03-18 14:05:00,1,2142.0,1502.0,0.701,10.102,0,0,0,0,0,0,0,0,0.0,0.0
1010,1026,2020-03-18 14:08:00,1,2057.0,1410.0,0.685,9.666,8,7,0,7,1,0,1,0,0.0,0.0
1010,1027,2020-03-18 14:11:00,1,2052.0,1488.0,0.725,9.73,0,0,0,0,0,0,0,0,0.0,0.0
1010,1028,2020-03-18 14:14:00,1,2057.0,1453.0,0.706,9.715,20,14,9,5,6,2,4,0,0.0,0.0
1010,1029,2020-03-18 14:17:00,1,2053.0,1454.0,0.708,9.7,0,0,0,0,0,0,0,0,0.0,0.0
1010,1030,2020-03-18 14:20:00,1,2049.0,1455.0,0.71,9.685,2,2,0,2,0,0,0,0,0.0,0.0
1010,1031,2020-03-18 14:23:00,1,2058.0,1440.0,0.7,9.704,2,0,0,0,2,1,1,0,0.0,0.0
1010,1032,2020-03-18 14:26:00,1,2070.0,1404.0,0.678,9.712,0,0,0,0,0,0,0,0,0.0,0.0
1010,1033,2020-03-18 14:29:00,1,2072.0,1376.0,0.664,9.688,3,3,0,3,0,0,0,0,0.0,0.0
1010,1034,2020-03-18 14:32:00,1,2074.0,1402.0,0.676,9.724,14,14,0,14,0,0,0,0,0.0,0.0
1010,1035,2020-03-18 14:35:00,1,2063.0,1405.0,0.681,9.686,3,3,0,3,0,0,0,0,0.0,0.0
1010,1036,2020-03-18 14:38:00,1,2084.0,1391.0,0.667,9.753,18,10,0,10,8,0,8,0,0.0,0.0
1010,1037,2020-03-18 14:41:00,1,2069.0,1369.0,0.662,9.667,3,1,0,1,2,0,2,0,0.0,0.0
1010,1038,2020-03-18 14:44:00,1,2059.0,1358.0,0.66,9.615,71,54,16,38,17,1,16,0,0.0,0.0
1010,1039,2020-03-18 14:47:00,1,2415.0,1690.0,0.7,11.385,156,101,59,42,55,32,23,38,0.0,0.0
1010,1040,2020-03-18 14:50:00,1,2535.0,1795.0,0.708,11.974,131,102,53,49,29,4,25,92,0.0,0.0
1010,1041,2020-03-18 14:53:00,1,2868.0,2015.0,0.703,13.533,97,82,42,40,15,0,15,60,0.0,0.0
1010,1042,2020-03-18 14:56:00,1,2924.0,2095.0,0.716,13.842,125,106,53,53,19,0,19,77,0.0,0.0
1010,1043,2020-03-18 14:59:00,1,2999.0,2174.0,0.725,14.223,92,74,40,34,18,0,18,46,0.0,0.02
1010,1044,2020-03-18 15:02:00,1,3145.0,2281.0,0.725,14.916,110,90,48,42,20,2,18,55,0.0,0.03
1010,1045,2020-03-18 15:05:00,1,3119.0,2370.0,0.76,14.912,152,134,76,58,18,0,18,81,0.0,0.05
1010,1046,2020-03-18 15:08:00,1,3109.0,2415.0,0.777,14.923,296,216,157,59,80,48,32,68,0.0,0.02
1010,1047,2020-03-18 15:11:00,1,2891.0,2271.0,0.786,13.903,738,502,405,97,236,174,62,32,0.08,0.03
1010,1048,2020-03-18 15:14:00,1,3163.0,2494.0,0.788,15.226,150,106,64,42,44,13,31,77,0.0,0.0
1010,1049,2020-03-18 15:17:00,1,3235.0,2535.0,0.784,15.553,195,143,84,59,52,23,29,97,0.0,0.0
1010,1050,2020-03-18 15:20:00,1,3183.0,2603.0,0.818,15.425,145,97,42,55,48,13,35,51,0.0,0.0
1010,1051,2020-03-18 15:23:00,1,3228.0,2637.0,0.817,15.64,256,181,122,59,75,48,27,35,0.0,0.01
1010,1052,2020-03-18 15:26:00,1,2716.0,2217.0,0.816,13.155,1023,725,583,142,298,213,85,7,0.0,0.02
1010,1053,2020-03-18 15:29:00,1,2381.0,1887.0,0.793,11.471,355,247,190,57,108,77,31,3,0.0,0.0
1010,1054,2020-03-18 15:32:00,1,2379.0,1892.0,0.795,11.466,31,16,4,12,15,1,14,0,0.0,0.0
1010,1055,2020-03-18 15:35:00,1,2733.0,2130.0,0.78,13.125,43,36,7,29,7,2,5,0,0.0,0.0
1010,1056,2020-03-18 15:38:00,1,2749.0,2186.0,0.795,13.25,14,7,0,7,7,0,7,0,0.0,0.0
1010,1057,2020-03-18 15:41:00,1,2721.0,2168.0,0.797,13.123,23,5,0,5,18,0,18,0,0.0,0.0
1010,1058,2020-03-18 15:44:00,1,2751.0,2153.0,0.783,13.223,8,4,0,4,4,0,4,0,0.0,0.0
1010,1059,2020-03-18 15:47:00,1,2755.0,2162.0,0.785,13.248,15,11,0,11,4,0,4,0,0.0,0.0
1010,1060,2020-03-18 15:50:00,1,2758.0,2228.0,0.808,13.333,0,0,0,0,0,0,0,0,0.0,0.0
1010,1061,2020-03-18 15:53:00,1,2725.0,2177.0,0.799,13.146,12,3,0,3,9,0,9,0,0.0,0.0
1010,1062,2020-03-18 15:56:00,1,2498.0,2091.0,0.837,12.159,22,2,0,2,20,0,20,0,0.0,0.0
1010,1063,2020-03-18 15:59:00,1,2415.0,1983.0,0.821,11.709,66,31,5,26,35,0,35,0,0.0,0.0
1010,1064,2020-03-18 16:02:00,1,2432.0,1982.0,0.815,11.775,2,2,0,2,0,0,0,0,0.0,0.0
1010,1065,2020-03-18 16:05:00,1,2379.0,1875.0,0.788,11.45,1,1,0,1,0,0,0,0,0.0,0.0
1010,1066,2020-03-18 16:08:00,1,2221.0,1797.0,0.809,10.74,5,5,0,5,0,0,0,0,0.0,0.0
1010,1067,2020-03-18 16:11:00,1,2148.0,1714.0,0.798,10.362,8,8,0,8,0,0,0,0,0.0,0.0
1010,1068,2020-03-18 16:14:00,1,2176.0,1720.0,0.79,10.479,22,12,3,9,10,0,10,0,0.0,0.0
1010,1069,2020-03-18 16:17:00,1,2155.0,1709.0,0.793,10.383,4,0,0,0,4,0,4,0,0.0,0.0
1010,1070,2020-03-18 16:20:00,1,2185.0,1655.0,0.757,10.441,10,10,3,7,0,0,0,0,0.0,0.0
1010,1071,2020-03-18 16:23:00,1,2177.0,1628.0,0.748,10.379,60,40,18,22,20,1,19,0,0.0,0.0
1010,1072,2020-03-18 16:26:00,1,2231.0,1725.0,0.773,10.699,61,52,24,28,9,3,6,0,0.0,0.0
1010,1073,2020-03-18 16:29:00,1,2370.0,1881.0,0.794,11.421,137,115,61,54,22,2,20,0,0.0,0.01
1010,1074,2020-03-18 16:32:00,1,2523.0,2032.0,0.805,12.191,100,72,31,41,28,2,26,0,0.0,0.0
1010,1075,2020-03-18 16:35:00,1,2505.0,2010.0,0.802,12.094,4,0,0,0,4,0,4,0,0.0,0.0
1010,1076,2020-03-18 16:38:00,1,2379.0,1900.0,0.799,11.479,0,0,0,0,0,0,0,0,0.0,0.0
1010,1077,2020-03-18 16:41:00,1,2319.0,1751.0,0.755,11.078,108,74,58,16,34,22,12,4,0.0,0.0
1010,1078,2020-03-18 16:44:00,1,2319.0,1745.0,0.752,11.071,11,11,1,10,0,0,0,0,0.0,0.0
1010,1079,2020-03-18 16:47:00,1,2184.0,1660.0,0.76,10.443,19,19,7,12,0,0,0,0,0.0,0.0
1010,1080,2020-03-18 16:50:00,1,2162.0,1574.0,0.728,10.262,16,16,4,12,0,0,0,0,0.0,0.0
1010,1081,2020-03-18 16:53:00,1,2021.0,1561.0,0.772,9.692,8,8,5,3,0,0,0,0,0.0,0.0
1010,1082,2020-03-18 16:56:00,1,2031.0,1526.0,0.751,9.694,19,19,12,7,0,0,0,0,0.0,0.0
1010,1083,2020-03-18 16:59:00,1,2025.0,1536.0,0.758,9.68,9,7,5,2,2,0,2,0,0.0,0.0
1010,1084,2020-03-18 17:02:00,1,2188.0,1570.0,0.718,10.359,0,0,0,0,0,0,0,0,0.0,0.0
1010,1085,2020-03-18 17:05:00,1,2192.0,1562.0,0.713,10.367,0,0,0,0,0,0,0,0,0.0,0.0
1010,1086,2020-03-18 17:08:00,1,2174.0,1591.0,0.732,10.326,64,62,26,36,2,0,2,0,0.0,0.0
1010,1087,2020-03-18 17:11:00,1,2541.0,1870.0,0.736,12.082,277,177,102,75,100,92,8,92,0.0,0.0
1010,1088,2020-03-18 17:14:00,1,2770.0,2045.0,0.738,13.179,201,103,56,47,98,79,19,52,0.0,0.0
1010,1089,2020-03-18 17:17:00,1,2823.5,2147.5,0.76,13.5025,226,109,56,53,117,92,25,62,0.0,0.0
1010,1090,2020-03-18 17:20:00,1,2877.0,2250.0,0.782,13.826,224,125,77,48,99,73,26,68,0.0,0.01
1010,1091,2020-03-18 17:23:00,1,3101.0,2423.0,0.781,14.901,276,137,77,60,139,87,52,53,0.0,0.0
1010,1092,2020-03-18 17:26:00,1,3096.0,2496.0,0.806,14.961,237,119,74,45,118,60,58,45,0.0,0.0
1010,1093,2020-03-18 17:29:00,1,3246.0,2571.0,0.792,15.635,182,91,46,45,91,29,62,37,0.0,0.04
1010,1094,2020-03-18 17:32:00,1,3215.0,2603.0,0.81,15.549,135,61,32,29,74,24,50,29,0.0,0.05
1010,1095,2020-03-18 17:35:00,1,3228.0,2625.0,0.813,15.624,121,58,25,33,63,33,30,14,0.0,0.03
1010,1096,2020-03-18 17:38:00,1,3071.0,2524.0,0.822,14.892,163,78,40,38,85,38,47,33,0.0,0.0
1010,1097,2020-03-18 17:41:00,1,3345.0,2806.0,0.839,16.285,152,88,48,40,64,16,48,34,0.0,0.05
1010,1098,2020-03-18 17:44:00,1,3320.0,2828.0,0.852,16.214,133,70,33,37,63,15,48,35,0.0,0.06
1010,1099,2020-03-18 17:47:00,1,3473.0,2983.0,0.859,16.986,150,69,40,29,81,37,44,20,0.33,0.04
1010,1100,2020-03-18 17:50:00,1,3188.0,2798.0,0.878,15.658,157,71,40,31,86,38,48,23,0.13,0.01
1010,1101,2020-03-18 17:53:00,1,3032.0,2608.0,0.86,14.834,226,156,125,31,70,38,32,17,0.0,0.01
1010,1102,2020-03-18 17:56:00,1,2706.0,2307.0,0.853,13.215,69,53,25,28,16,1,15,0,0.0,0.0
1010,1103,2020-03-18 17:59:00,1,2440.0,2010.0,0.824,11.84,8,7,3,4,1,0,1,0,0.0,0.0
1010,1104,2020-03-18 18:02:00,0,2136.0,1817.0,0.85,10.428,10,10,0,10,0,0,0,0,0.0,0.0
1010,1105,2020-03-18 18:05:00,0,2156.0,1756.0,0.815,10.441,20,8,2,6,12,1,11,0,0.0,0.0
1010,1106,2020-03-18 18:08:00,0,2129.0,1790.0,0.841,10.369,23,6,4,2,17,0,17,0,0.0,0.0
1010,1107,2020-03-18 18:11:00,0,2402.0,1894.0,0.789,11.56,2,2,1,1,0,0,0,0,0.0,0.0
1010,1108,2020-03-18 18:14:00,0,2509.0,2040.0,0.813,12.145,7,5,1,4,2,0,2,0,0.0,0.01
1010,1109,2020-03-18 18:17:00,0,2723.0,2297.0,0.844,13.273,69,50,24,26,19,2,17,0,0.0,0.01
1010,1110,2020-03-18 18:20:00,0,3299.0,2949.0,0.894,16.262,320,220,158,62,100,67,33,42,0.08,0.0
1010,1111,2020-03-18 18:23:00,0,3348.0,3169.0,0.946,16.699,104,77,40,37,27,15,12,9,0.07,0.0
1010,1112,2020-03-18 18:26:00,0,3177.0,2853.0,0.898,15.675,10,10,0,10,0,0,0,0,0.0,0.0
1010,1113,2020-03-18 18:29:00,0,3169.0,2868.0,0.905,15.661,3,3,2,1,0,0,0,0,0.0,0.0
1010,1114,2020-03-18 18:32:00,0,3125.0,2956.0,0.946,15.586,65,65,27,38,0,0,0,1,0.0,0.0
1010,1115,2020-03-18 18:35:00,0,3342.0,3111.0,0.931,16.613,184,140,73,67,44,32,12,27,0.0,0.0
1010,1116,2020-03-18 18:38:00,0,3476.0,3179.0,0.915,17.215,158,158,94,64,0,0,0,61,0.0,0.0
1010,1117,2020-03-18 18:41:00,0,3494.0,3269.0,0.936,17.386,80,75,37,38,5,1,4,37,0.0,0.0
1010,1118,2020-03-18 18:44:00,0,3504.0,3247.0,0.927,17.4,39,39,21,18,0,0,0,19,0.0,0.0
1010,1119,2020-03-18 18:47:00,0,3341.0,3096.0,0.927,16.59,41,40,14,26,1,0,1,23,0.0,0.05
1010,1120,2020-03-18 18:50:00,0,3524.0,3210.0,0.911,17.438,89,86,44,42,3,0,3,43,0.0,0.0
1010,1121,2020-03-18 18:53:00,0,3507.0,3225.0,0.92,17.385,76,64,27,37,12,3,9,17,0.29,0.15
1010,1122,2020-03-18 18:56:00,0,3738.0,3364.0,0.9,18.451,120,104,50,54,16,5,11,29,0.0,0.0
1010,1123,2020-03-18 18:59:00,0,3738.0,3363.0,0.9,18.452,83,72,36,36,11,2,9,25,0.02,0.09
1010,1124,2020-03-18 19:02:00,0,3709.0,3357.0,0.905,18.33,133,95,58,37,38,25,13,33,0.11,0.02
1010,1125,2020-03-18 19:05:00,0,2536.0,2254.0,0.889,12.488,60,59,21,38,1,0,1,0,0.0,0.0
1010,1126,2020-03-18 19:08:00,0,2720.0,2318.0,0.852,13.284,8,3,0,3,5,1,4,0,0.0,0.0
1010,1127,2020-03-18 19:11:00,0,2689.0,2288.0,0.851,13.129,11,11,2,9,0,0,0,0,0.0,0.0
1010,1128,2020-03-18 19:14:00,0,2815.0,2445.0,0.869,13.799,335,235,182,53,100,60,40,25,0.0,0.05
1010,1129,2020-03-18 19:17:00,0,4087.0,3788.0,0.927,20.296,185,117,66,51,68,37,31,45,0.0,0.0
1010,1130,2020-03-18 19:20:00,0,4141.0,3861.0,0.932,20.59,345,161,103,58,184,116,68,55,0.0,0.07
1010,1131,2020-03-18 19:23:00,0,4060.0,3670.0,0.904,20.061,292,199,125,74,93,50,43,74,0.0,0.0
1010,1132,2020-03-18 19:26:00,0,4048.0,3783.0,0.935,20.137,203,111,55,56,92,43,49,57,0.0,0.02
1010,1133,2020-03-18 19:29:00,0,4155.0,3842.0,0.925,20.622,217,119,70,49,98,46,52,45,0.23,0.07
1010,1134,2020-03-18 19:32:00,0,3852.0,3506.0,0.91,19.059,220,131,85,46,89,54,35,34,0.09,0.27
1010,1135,2020-03-18 19:35:00,0,3023.0,2731.0,0.903,14.934,37,15,1,14,22,0,22,0,0.0,0.01
1010,1136,2020-03-18 19:38:00,0,2661.0,2398.0,0.901,13.141,47,32,2,30,15,0,15,0,0.0,0.0
1010,1137,2020-03-18 19:41:00,0,3447.0,3119.0,0.905,17.034,392,254,202,52,138,103,35,34,0.02,0.0
1010,1138,2020-03-18 19:44:00,0,4302.0,3971.0,0.923,21.345,296,186,135,51,110,72,38,44,0.0,0.01
1010,1139,2020-03-18 19:47:00,0,2884.0,2591.0,0.898,14.233,89,65,23,42,24,4,20,0,0.0,0.0
1010,1140,2020-03-18 19:50:00,0,3021.0,2706.0,0.896,14.897,9,3,2,1,6,4,2,0,0.0,0.0
1010,1141,2020-03-18 19:53:00,0,3298.0,2938.0,0.891,16.246,18,8,5,3,10,2,8,0,0.0,0.0
1010,1142,2020-03-18 19:56:00,0,3183.0,2800.0,0.88,15.641,0,0,0,0,0,0,0,0,0.0,0.0
1010,1143,2020-03-18 19:59:00,0,3175.0,2806.0,0.884,15.617,8,2,0,2,6,0,6,0,0.0,0.0
1010,1144,2020-03-18 20:02:00,0,3179.0,2810.0,0.884,15.636,8,3,2,1,5,0,5,0,0.0,0.0
1010,1145,2020-03-18 20:05:00,0,3421.0,3124.0,0.913,16.939,1,1,0,1,0,0,0,0,0.0,0.0
1010,1146,2020-03-18 20:08:00,0,3518.0,3169.0,0.901,17.371,67,50,27,23,17,3,14,2,0.0,0.0
1010,1147,2020-03-18 20:11:00,0,3322.0,3122.0,0.94,16.545,18,6,2,4,12,0,12,0,0.0,0.0
1010,1148,2020-03-18 20:14:00,0,3363.0,3044.0,0.905,16.621,11,7,0,7,4,0,4,0,0.0,0.0
1010,1149,2020-03-18 20:17:00,0,3054.5,2902.5,0.955,15.248,10,9,0,9,1,0,1,0,0.0,0.01
1010,1150,2020-03-18 20:20:00,0,2746.0,2761.0,1.005,13.875,4,4,0,4,0,0,0,0,0.0,0.0
1010,1151,2020-03-18 20:23:00,0,2692.0,2671.0,0.992,13.566,110,91,49,42,19,0,19,1,0.0,0.0
1010,1152,2020-03-18 20:26:00,0,2753.0,2780.0,1.01,13.923,48,31,13,18,17,2,15,0,0.0,0.0
1010,1153,2020-03-18 20:29:00,0,2736.0,2722.0,0.995,13.792,29,21,13,8,8,5,3,1,0.0,0.0
1010,1154,2020-03-18 20:32:00,0,2690.0,2652.0,0.986,13.535,9,8,0,8,1,0,1,0,0.0,0.0
1010,1155,2020-03-18 20:35:00,0,2537.0,2565.0,1.011,12.836,21,16,6,10,5,1,4,0,0.0,0.0
1010,1156,2020-03-18 20:38:00,0,2569.0,2531.0,0.985,12.923,175,140,100,40,35,13,22,27,0.46,0.0
1010,1157,2020-03-18 20:41:00,0,2617.0,2639.0,1.008,13.232,84,65,28,37,19,3,16,0,0.0,0.0
1010,1158,2020-03-18 20:44:00,0,2877.0,2902.0,1.009,14.546,81,68,30,38,13,1,12,2,0.0,0.0
1010,1159,2020-03-18 20:47:00,0,2952.0,3007.0,1.019,14.96,217,144,90,54,73,44,29,46,0.0,0.01
1010,1160,2020-03-18 20:50:00,0,3238.0,3220.0,0.994,16.32,150,99,43,56,51,10,41,95,0.0,0.0
1010,1161,2020-03-18 20:53:00,0,3214.0,3296.0,1.025,16.311,185,131,68,63,54,25,29,81,0.0,0.01
1010,1162,2020-03-18 20:56:00,0,3094.0,3106.0,1.004,15.627,162,109,72,37,53,38,15,34,0.0,0.01
1010,1163,2020-03-18 20:59:00,0,2557.0,2502.0,0.978,12.845,9,8,0,8,1,0,1,0,0.0,0.0
1010,1164,2020-03-18 21:02:00,0,2440.0,2306.0,0.945,12.168,12,9,3,6,3,1,2,0,0.0,0.0
1010,1165,2020-03-18 21:05:00,0,2555.0,2427.0,0.95,12.755,9,1,0,1,8,1,7,0,0.0,0.01
1010,1166,2020-03-18 21:08:00,0,2761.0,2732.0,0.989,13.901,4,4,0,4,0,0,0,0,0.0,0.0
1010,1167,2020-03-18 21:11:00,0,2756.0,2720.0,0.987,13.871,63,56,27,29,7,1,6,0,0.0,0.0
1010,1168,2020-03-18 21:14:00,0,3120.0,3035.0,0.973,15.654,335,242,156,86,93,69,24,67,0.0,0.0
1010,1169,2020-03-18 21:17:00,0,2761.0,2720.0,0.985,13.889,223,164,101,63,59,24,35,65,0.0,0.0
1010,1170,2020-03-18 21:20:00,0,3247.0,3142.0,0.967,16.271,193,142,88,54,51,18,33,94,0.0,0.01
1010,1171,2020-03-18 21:23:00,0,3220.0,3304.0,1.026,16.343,140,101,53,48,39,20,19,64,0.0,0.0
1010,1172,2020-03-18 21:26:00,0,3474.0,3356.0,0.966,17.404,165,122,64,58,43,20,23,76,0.0,0.07
1010,1173,2020-03-18 21:29:00,0,3307.0,3296.0,0.997,16.678,176,116,70,46,60,23,37,90,0.0,0.0
1010,1174,2020-03-18 21:32:00,0,3476.0,3330.0,0.958,17.382,172,130,64,66,42,23,19,65,0.0,0.03
1010,1175,2020-03-18 21:35:00,0,2855.0,2769.0,0.97,14.314,326,184,139,45,142,85,57,35,0.12,0.03
1010,1176,2020-03-18 21:38:00,0,3309.0,3306.0,0.999,16.696,477,287,222,65,190,141,49,78,0.0,0.02
1010,1177,2020-03-18 21:41:00,0,2561.0,2536.0,0.991,12.896,340,244,187,57,96,57,39,27,0.0,0.02
1010,1178,2020-03-18 21:44:00,0,3574.0,3610.0,1.01,18.079,259,190,120,70,69,28,41,89,0.0,0.0
1010,1179,2020-03-18 21:47:00,0,3804.0,3746.0,0.985,19.135,204,151,82,69,53,24,29,95,0.0,0.0
1010,1180,2020-03-18 21:50:00,0,3508.0,3534.0,1.007,17.735,373,252,182,70,121,80,41,132,0.0,0.01
1010,1181,2020-03-18 21:53:00,0,3664.0,3664.0,1.0,18.493,722,454,340,114,268,198,70,133,0.0,0.0
1010,1182,2020-03-18 21:56:00,0,3811.0,3753.0,0.985,19.172,187,115,51,64,72,35,37,52,0.0,0.06
1010,1183,2020-03-18 21:59:00,0,3768.0,3795.0,1.007,19.048,177,85,40,45,92,49,43,41,0.0,0.0
1010,1184,2020-03-18 22:02:00,0,3768.0,3799.0,1.008,19.05,200,78,32,46,122,71,51,29,0.0,0.09
1010,1185,2020-03-18 22:05:00,0,3735.0,3667.0,0.982,18.774,131,68,21,47,63,12,51,50,0.0,0.08
1010,1186,2020-03-18 22:08:00,0,3737.0,3666.0,0.981,18.781,237,119,80,39,118,83,35,24,0.56,0.03
1010,1187,2020-03-18 22:11:00,0,2919.0,2836.0,0.971,14.639,197,131,79,52,66,31,35,19,0.0,0.01
1010,1188,2020-03-18 22:14:00,0,2549.0,2471.0,0.969,12.776,119,82,35,47,37,9,28,1,0.0,0.0
1010,1189,2020-03-18 22:17:00,0,2586.0,2473.0,0.956,12.927,28,8,1,7,20,10,10,0,0.0,0.0
1010,1190,2020-03-18 22:20:00,0,2564.0,2485.0,0.969,12.854,19,19,2,17,0,0,0,0,0.0,0.01
1010,1191,2020-03-18 22:23:00,0,3573.0,3524.0,0.986,17.98,257,186,117,69,71,37,34,68,0.0,0.0
1010,1192,2020-03-18 22:26:00,0,4199.0,4186.0,0.997,21.177,184,132,80,52,52,16,36,57,0.0,0.0
1010,1193,2020-03-18 22:29:00,0,4056.0,4003.0,0.987,20.412,164,131,69,62,33,19,14,69,0.0,0.0
1010,1194,2020-03-18 22:32:00,0,4157.0,4067.0,0.978,20.879,217,166,102,64,51,26,25,65,0.0,0.0
1010,1195,2020-03-18 22:35:00,0,4073.0,3983.0,0.978,20.455,173,103,49,54,70,35,35,39,0.0,0.18
1010,1196,2020-03-18 22:38:00,0,3703.0,3659.0,0.988,18.639,208,158,100,58,50,33,17,76,0.0,0.09
1010,1197,2020-03-18 22:41:00,0,3569.0,3564.0,0.999,18.009,328,233,158,75,95,71,24,70,0.0,0.05
1010,1198,2020-03-18 22:44:00,0,4116.0,4030.0,0.979,20.677,377,218,164,54,159,117,42,52,0.16,0.04
1010,1199,2020-03-18 22:47:00,0,3970.0,3974.0,1.001,20.043,293,228,159,69,65,39,26,90,0.17,0.07
1010,1200,2020-03-18 22:50:00,0,4131.0,4130.0,1.0,20.848,583,333,257,76,250,182,68,73,0.05,0.0
1010,1201,2020-03-18 22:53:00,0,2875.0,2886.0,1.004,14.523,581,358,278,80,223,165,58,46,0.0,0.0
1010,1202,2020-03-18 22:56:00,0,4099.0,4154.0,1.014,20.749,458,271,185,86,187,118,69,93,0.0,0.0
1010,1203,2020-03-18 22:59:00,0,4289.0,4123.0,0.961,21.463,125,21,2,19,104,24,80,7,0.0,0.0
1010,1204,2020-03-18 23:02:00,0,4161.0,4120.0,0.99,20.956,245,127,90,37,118,56,62,30,0.0,0.11
1010,1205,2020-03-18 23:05:00,0,3940.0,3822.0,0.97,19.754,601,419,318,101,182,136,46,72,0.08,0.02
1010,1206,2020-03-18 23:08:00,0,3104.0,3025.0,0.974,15.578,732,528,424,104,204,149,55,28,0.0,0.0
1010,1207,2020-03-18 23:11:00,0,4117.0,4125.0,1.002,20.787,144,57,24,33,87,22,65,18,0.0,0.05
1010,1208,2020-03-18 23:14:00,0,4138.0,4094.0,0.989,20.838,235,82,31,51,153,85,68,27,0.0,0.0
1010,1209,2020-03-18 23:17:00,0,4135.5,4071.5,0.9845,20.8015,318,197,129,68,121,68,53,39,0.26,0.03
1010,1210,2020-03-18 23:20:00,0,4133.0,4049.0,0.98,20.765,107,26,5,21,81,8,73,9,0.0,0.0
1010,1211,2020-03-18 23:23:00,0,4289.0,4124.0,0.961,21.464,324,186,134,52,138,87,51,13,0.25,0.11
1010,1212,2020-03-18 23:26:00,0,3131.0,2974.0,0.95,15.629,1125,756,595,161,369,259,110,0,0.0,0.01
1010,1213,2020-03-18 23:29:00,0,2778.0,2613.0,0.941,13.838,1286,952,780,172,334,249,85,1,0.0,0.01
1010,1214,2020-03-18 23:32:00,0,4023.0,3958.0,0.984,20.234,764,509,411,98,255,194,61,24,0.0,0.02
1010,1215,2020-03-18 23:35:00,0,2970.0,2880.0,0.97,14.889,1012,695,542,153,317,216,101,5,0.0,0.0
1010,1216,2020-03-18 23:38:00,0,3569.0,3518.0,0.986,17.957,814,521,412,109,293,211,82,10,0.0,0.0
1010,1217,2020-03-18 23:41:00,0,2945.0,2739.0,0.93,14.635,266,152,90,62,114,55,59,6,0.0,0.0
1010,1218,2020-03-18 23:44:00,0,2922.0,2662.0,0.911,14.459,172,82,33,49,90,42,48,0,0.0,0.0
1010,1219,2020-03-18 23:47:00,0,3469.0,3282.0,0.946,17.3,25,21,8,13,4,1,3,0,0.0,0.0
1010,1220,2020-03-18 23:50:00,0,3239.0,3176.0,0.98,16.277,2,1,0,1,1,1,0,0,0.0,0.0
1010,1221,2020-03-18 23:53:00,0,3097.0,3028.0,0.978,15.555,11,7,1,6,4,1,3,0,0.0,0.0
1010,1222,2020-03-18 23:56:00,0,3156.0,2970.0,0.941,15.723,6,4,1,3,2,0,2,0,0.0,0.0
1010,1223,2020-03-18 23:59:00,0,3164.0,2932.0,0.927,15.711,271,180,132,48,91,66,25,21,0.0,0.0
1010,1224,2020-03-19 00:02:00,0,3817.0,3744.0,0.981,19.182,496,320,245,75,176,116,60,39,0.0,0.02
1010,1225,2020-03-19 00:05:00,0,3265.0,3185.0,0.976,16.391,42,26,9,17,16,0,16,0,0.0,0.0
1010,1226,2020-03-19 00:08:00,0,3096.0,3054.0,0.986,15.581,101,82,43,39,19,2,17,0,0.0,0.0
1010,1227,2020-03-19 00:11:00,0,3462.0,3374.0,0.975,17.375,28,28,13,15,0,0,0,0,0.0,0.0
1010,1228,2020-03-19 00:14:00,0,3789.0,3806.0,1.004,19.142,84,55,21,34,29,3,26,2,0.0,0.02
1010,1229,2020-03-19 00:17:00,0,3586.0,3549.0,0.99,18.057,15,1,1,0,14,0,14,0,0.0,0.0
1010,1230,2020-03-19 00:20:00,0,3357.0,3292.0,0.981,16.872,97,55,38,17,42,10,32,0,0.0,0.0
1010,1231,2020-03-19 00:23:00,0,3316.0,3326.0,1.003,16.746,262,166,129,37,96,66,30,12,0.0,0.0
1010,1232,2020-03-19 00:26:00,0,3232.0,3205.0,0.992,16.282,9,7,2,5,2,1,1,0,0.0,0.0
1010,1233,2020-03-19 00:29:00,0,3129.0,3058.0,0.977,15.714,2,0,0,0,2,0,2,0,0.0,0.0
1010,1234,2020-03-19 00:32:00,0,2904.0,2862.0,0.986,14.609,18,3,0,3,15,0,15,0,0.0,0.0
1010,1235,2020-03-19 00:35:00,0,2747.0,2752.0,1.002,13.871,217,152,111,41,65,41,24,47,0.12,0.0
1010,1236,2020-03-19 00:38:00,0,3138.0,2979.0,0.949,15.663,178,150,81,69,28,7,21,53,0.0,0.01
1010,1237,2020-03-19 00:41:00,0,3177.0,3135.0,0.987,15.99,70,55,16,39,15,4,11,60,0.0,0.03
1010,1238,2020-03-19 00:44:00,0,3302.0,3278.0,0.993,16.64,274,201,144,57,73,51,22,45,0.0,0.07
1010,1239,2020-03-19 00:47:00,0,3476.0,3315.0,0.954,17.367,243,186,107,79,57,18,39,82,0.0,0.0
1010,1240,2020-03-19 00:50:00,0,3423.0,3439.0,1.005,17.295,570,392,307,85,178,138,40,33,0.0,0.08
1010,1241,2020-03-19 00:53:00,0,2580.0,2489.0,0.965,12.922,551,398,322,76,153,103,50,16,0.08,0.01
1010,1242,2020-03-19 00:56:00,0,3256.0,3130.0,0.961,16.291,776,513,405,108,263,182,81,9,0.0,0.0
1010,1243,2020-03-19 00:59:00,0,2963.0,2915.0,0.984,14.903,1377,821,638,183,556,401,155,21,0.0,0.0
1010,1244,2020-03-19 01:02:00,0,3296.0,3091.0,0.938,16.408,1111,784,607,177,327,217,110,33,0.0,0.0
1010,1245,2020-03-19 01:05:00,0,3474.0,3286.0,0.946,17.325,565,377,287,90,188,134,54,0,0.09,0.0
1010,1246,2020-03-19 01:08:00,0,3613.0,3491.0,0.966,18.101,642,435,338,97,207,139,68,16,0.0,0.02
1010,1247,2020-03-19 01:11:00,0,3790.0,3796.0,1.002,19.136,235,192,128,64,43,7,36,56,0.0,0.0
1010,1248,2020-03-19 01:14:00,0,3750.0,3796.0,1.012,18.978,349,259,182,77,90,54,36,67,0.0,0.03
1010,1249,2020-03-19 01:17:00,0,3771.0,3755.0,0.996,19.015,257,143,88,55,114,64,50,56,0.0,0.04
1010,1250,2020-03-19 01:20:00,0,3795.0,3762.0,0.992,19.116,297,186,127,59,111,64,47,72,0.0,0.01
1010,1251,2020-03-19 01:23:00,0,3114.0,2961.0,0.951,15.546,226,166,131,35,60,40,20,11,0.0,0.02
1010,1252,2020-03-19 01:26:00,0,2577.0,2409.0,0.935,12.818,72,51,12,39,21,2,19,0,0.0,0.0
1010,1253,2020-03-19 01:29:00,0,2433.0,2247.0,0.924,12.072,6,4,2,2,2,0,2,0,0.0,0.01
1010,1254,2020-03-19 01:32:00,0,3086.0,3052.0,0.989,15.537,2,1,0,1,1,0,1,0,0.0,0.0
1010,1255,2020-03-19 01:35:00,0,2899.0,2846.0,0.982,14.573,4,4,1,3,0,0,0,0,0.0,0.0
1010,1256,2020-03-19 01:38:00,0,2916.0,2744.0,0.941,14.528,6,2,0,2,4,0,4,0,0.0,0.0
1010,1257,2020-03-19 01:41:00,0,2780.0,2670.0,0.96,13.91,15,11,4,7,4,1,3,0,0.0,0.0
1010,1258,2020-03-19 01:44:00,0,2768.0,2734.0,0.988,13.934,5,1,0,1,4,0,4,0,0.0,0.0
1010,1259,2020-03-19 01:47:00,0,2876.0,2923.0,1.016,14.567,164,120,94,26,44,20,24,2,0.0,0.0
1010,1260,2020-03-19 01:50:00,0,3154.0,3184.0,1.01,15.952,785,551,444,107,234,177,57,7,0.16,0.0
1010,1261,2020-03-19 01:53:00,0,3215.0,3289.0,1.023,16.308,90,51,19,32,39,20,19,4,0.0,0.0
1010,1262,2020-03-19 01:56:00,0,3369.0,3382.0,1.004,17.016,34,22,4,18,12,2,10,0,0.0,0.0
1010,1263,2020-03-19 01:59:00,0,3225.0,3267.0,1.013,16.322,1,1,0,1,0,0,0,0,0.0,0.0
1010,1264,2020-03-19 02:02:00,0,3110.0,3063.0,0.985,15.645,13,4,1,3,9,0,9,0,0.0,0.0
1010,1265,2020-03-19 02:05:00,0,2885.0,2846.0,0.986,14.519,0,0,0,0,0,0,0,0,0.0,0.0
1010,1266,2020-03-19 02:08:00,0,2764.0,2669.0,0.966,13.844,0,0,0,0,0,0,0,0,0.0,0.0
1010,1267,2020-03-19 02:11:00,0,2556.0,2540.0,0.994,12.882,40,25,13,12,15,7,8,0,0.0,0.0
1010,1268,2020-03-19 02:14:00,0,2551.0,2544.0,0.997,12.868,8,8,4,4,0,0,0,0,0.0,0.0
1010,1269,2020-03-19 02:17:00,0,2489.0,2461.0,0.9885,12.5315,4,4,0,4,0,0,0,0,0.0,0.01
1010,1270,2020-03-19 02:20:00,0,2427.0,2378.0,0.98,12.195,5,5,0,5,0,0,0,0,0.0,0.0
1010,1271,2020-03-19 02:23:00,0,2274.0,2279.0,1.002,11.484,8,8,2,6,0,0,0,0,0.0,0.0
1010,1272,2020-03-19 02:26:00,0,2204.0,2212.0,1.003,11.134,12,8,5,3,4,0,4,0,0.0,0.0
1010,1273,2020-03-19 02:29:00,0,2192.0,2247.0,1.025,11.122,13,8,2,6,5,0,5,0,0.0,0.0
1010,1274,2020-03-19 02:32:00,0,2275.0,2299.0,1.011,11.507,275,193,132,61,82,46,36,67,0.0,0.0
1010,1275,2020-03-19 02:35:00,0,2751.0,2706.0,0.983,13.835,177,119,82,37,58,35,23,58,0.0,0.0
1010,1276,2020-03-19 02:38:00,0,2560.0,2477.0,0.967,12.829,87,76,45,31,11,0,11,0,0.0,0.01
1010,1277,2020-03-19 02:41:00,0,2623.0,2605.0,0.993,13.217,77,68,43,25,9,0,9,0,0.0,0.0
1010,1278,2020-03-19 02:44:00,0,2701.0,2639.0,0.977,13.564,7,7,2,5,0,0,0,0,0.0,0.0
1010,1279,2020-03-19 02:47:00,0,2684.0,2631.0,0.98,13.487,3,3,0,3,0,0,0,0,0.0,0.0
1010,1280,2020-03-19 02:50:00,0,2530.0,2591.0,1.024,12.838,276,178,116,62,98,63,35,61,0.0,0.0
1010,1281,2020-03-19 02:53:00,0,2770.0,2752.0,0.994,13.959,118,89,66,23,29,21,8,14,0.0,0.0
1010,1282,2020-03-19 02:56:00,0,2745.0,2704.0,0.985,13.809,115,75,51,24,40,31,9,29,0.0,0.0
1010,1283,2020-03-19 02:59:00,0,2898.0,2888.0,0.997,14.613,153,106,57,49,47,20,27,86,0.0,0.0
1010,1284,2020-03-19 03:02:00,0,3250.0,3191.0,0.982,16.336,146,93,46,47,53,16,37,42,0.0,0.05
1010,1285,2020-03-19 03:05:00,0,3216.0,3242.0,1.008,16.258,221,172,105,67,49,27,22,89,0.0,0.06
1010,1286,2020-03-19 03:08:00,0,3207.0,3242.0,1.011,16.226,83,73,37,36,10,1,9,22,0.0,0.29
1010,1287,2020-03-19 03:11:00,0,3237.0,3278.0,1.013,16.382,40,26,7,19,14,0,14,0,0.0,0.01
1010,1288,2020-03-19 03:14:00,0,3538.0,3532.0,0.998,17.849,608,395,323,72,213,160,53,28,0.15,0.0
1010,1289,2020-03-19 03:17:00,0,3558.0,3706.0,1.042,18.121,887,569,461,108,318,241,77,39,0.09,0.0
1010,1290,2020-03-19 03:20:00,0,3436.0,3445.0,1.002,17.353,743,479,381,98,264,200,64,42,0.0,0.0
1010,1291,2020-03-19 03:23:00,0,3293.0,3140.0,0.954,16.451,664,459,369,90,205,143,62,21,0.0,0.01
1010,1292,2020-03-19 03:26:00,0,3452.0,3356.0,0.972,17.316,434,309,237,72,125,86,39,90,0.0,0.11
1010,1293,2020-03-19 03:29:00,0,3831.0,3735.0,0.975,19.228,143,111,58,53,32,12,20,52,0.0,0.0
1010,1294,2020-03-19 03:32:00,0,3777.0,3732.0,0.988,19.012,294,154,101,53,140,91,49,24,0.23,0.0
1010,1295,2020-03-19 03:35:00,0,3283.0,3164.0,0.964,16.439,941,643,514,129,298,215,83,26,0.0,0.0
1010,1296,2020-03-19 03:38:00,0,2764.0,2688.0,0.972,13.867,444,335,270,65,109,43,66,7,0.0,0.0
1010,1297,2020-03-19 03:41:00,0,2905.0,2731.0,0.94,14.468,84,53,24,29,31,4,27,0,0.0,0.0
1010,1298,2020-03-19 03:44:00,0,3565.0,3426.0,0.961,17.839,90,43,16,27,47,7,40,0,0.0,0.01
1010,1299,2020-03-19 03:47:00,0,3532.0,3431.0,0.971,17.715,61,35,19,16,26,3,23,0,0.0,0.0
1010,1300,2020-03-19 03:50:00,0,3248.0,3197.0,0.984,16.336,1,0,0,0,1,0,1,0,0.0,0.0
1010,1301,2020-03-19 03:53:00,0,3255.0,3164.0,0.972,16.328,4,2,1,1,2,0,2,0,0.0,0.0
1010,1302,2020-03-19 03:56:00,0,3273.0,3160.0,0.965,16.396,2,1,1,0,1,0,1,0,0.0,0.0
1010,1303,2020-03-19 03:59:00,0,3111.0,3008.0,0.967,15.588,35,20,10,10,15,2,13,0,0.0,0.0
1010,1304,2020-03-19 04:02:00,0,2891.0,2893.0,1.0,14.595,7,3,0,3,4,0,4,0,0.0,0.0
1010,1305,2020-03-19 04:05:00,0,2749.0,2763.0,1.005,13.888,8,7,0,7,1,0,1,0,0.0,0.0
1010,1306,2020-03-19 04:08:00,0,2762.0,2702.0,0.979,13.872,793,509,417,92,284,199,85,11,0.0,0.0
1010,1307,2020-03-19 04:11:00,0,2895.0,2847.0,0.983,14.56,506,381,288,93,125,86,39,3,0.0,0.0
1010,1308,2020-03-19 04:14:00,0,3055.0,2996.0,0.981,15.353,217,126,71,55,91,52,39,3,0.0,0.0
1010,1309,2020-03-19 04:17:00,0,2967.0,2953.0,0.996,14.957,9,2,1,1,7,1,6,0,0.0,0.0
1010,1310,2020-03-19 04:20:00,0,2919.0,2801.0,0.96,14.601,1,0,0,0,1,0,1,0,0.0,0.0
1010,1311,2020-03-19 04:23:00,0,2812.0,2638.0,0.938,13.998,0,0,0,0,0,0,0,0,0.0,0.0
1010,1312,2020-03-19 04:26:00,0,2552.0,2484.0,0.973,12.804,35,23,15,8,12,4,8,0,0.0,0.0
1010,1313,2020-03-19 04:29:00,0,2433.0,2360.0,0.97,12.199,6,0,0,0,6,0,6,0,0.0,0.0
1010,1314,2020-03-19 04:32:00,0,2436.0,2261.0,0.928,12.102,4,0,0,0,4,0,4,0,0.0,0.0
1010,1315,2020-03-19 04:35:00,0,2297.0,2211.0,0.963,11.497,5,0,0,0,5,0,5,0,0.0,0.0
1010,1316,2020-03-19 04:38:00,0,2239.0,2154.0,0.962,11.207,0,0,0,0,0,0,0,0,0.0,0.0
1010,1317,2020-03-19 04:41:00,0,2250.0,2062.0,0.916,11.149,13,5,2,3,8,0,8,0,0.0,0.0
1010,1318,2020-03-19 04:44:00,0,2219.0,2079.0,0.937,11.045,0,0,0,0,0,0,0,0,0.0,0.0
1010,1319,2020-03-19 04:47:00,0,2168.0,2080.0,0.96,10.844,89,58,33,25,31,0,31,0,0.0,0.0
1010,1320,2020-03-19 04:50:00,0,2431.0,2292.0,0.943,12.116,51,36,10,26,15,5,10,0,0.0,0.0
1010,1321,2020-03-19 04:53:00,0,2423.0,2282.0,0.942,12.073,5,5,0,5,0,0,0,0,0.0,0.0
1010,1322,2020-03-19 04:56:00,0,2294.0,2237.0,0.975,11.514,7,7,0,7,0,0,0,0,0.0,0.0
1010,1323,2020-03-19 04:59:00,0,2235.0,2158.0,0.966,11.193,15,10,0,10,5,0,5,0,0.0,0.0
1010,1324,2020-03-19 05:02:00,0,2193.0,2208.0,1.007,11.084,0,0,0,0,0,0,0,0,0.0,0.0
1010,1325,2020-03-19 05:05:00,0,2203.0,2185.0,0.992,11.098,0,0,0,0,0,0,0,0,0.0,0.0
1010,1326,2020-03-19 05:08:00,0,2205.0,2155.0,0.978,11.074,16,13,6,7,3,0,3,0,0.0,0.0
1010,1327,2020-03-19 05:11:00,0,2261.0,2241.0,0.991,11.387,223,173,121,52,50,36,14,46,0.0,0.0
1010,1328,2020-03-19 05:14:00,0,2496.0,2423.0,0.97,12.518,25,25,0,25,0,0,0,0,0.0,0.0
1010,1329,2020-03-19 05:17:00,0,2629.0,2567.0,0.9755,13.2005,114,86,40,46,28,2,26,1,0.0,0.0
1010,1330,2020-03-19 05:20:00,0,2762.0,2711.0,0.981,13.883,250,173,108,65,77,46,31,11,0.0,0.0
1010,1331,2020-03-19 05:23:00,0,2917.0,2876.0,0.986,14.678,160,97,57,40,63,13,50,81,0.0,0.0
1010,1332,2020-03-19 05:26:00,0,3189.0,3071.0,0.963,15.966,183,140,82,58,43,21,22,87,0.0,0.0
1010,1333,2020-03-19 05:29:00,0,3270.0,3124.0,0.955,16.344,236,175,118,57,61,27,34,108,0.0,0.04
1010,1334,2020-03-19 05:32:00,0,3266.0,3177.0,0.973,16.386,526,369,283,86,157,113,44,108,0.0,0.0
1010,1335,2020-03-19 05:35:00,0,3291.0,3233.0,0.982,16.547,321,255,180,75,66,32,34,115,0.0,0.0
1010,1336,2020-03-19 05:38:00,0,3597.0,3530.0,0.981,18.081,106,66,28,38,40,4,36,73,0.0,0.0
1010,1337,2020-03-19 05:41:00,0,3129.0,3011.0,0.962,15.66,651,384,304,80,267,190,77,34,0.0,0.06
1010,1338,2020-03-19 05:44:00,0,3236.0,3123.0,0.965,16.206,644,373,310,63,271,199,72,49,0.0,0.0
1010,1339,2020-03-19 05:47:00,0,2778.0,2654.0,0.955,13.884,939,666,542,124,273,201,72,0,0.0,0.0
1010,1340,2020-03-19 05:50:00,0,3475.0,3291.0,0.947,17.336,1087,712,594,118,375,283,92,6,0.12,0.0
1010,1341,2020-03-19 05:53:00,0,3052.0,2933.0,0.961,15.272,569,412,318,94,157,96,61,9,0.0,0.02
1010,1342,2020-03-19 05:56:00,0,3341.0,3157.0,0.945,16.66,680,456,357,99,224,158,66,4,0.0,0.0
1010,1343,2020-03-19 05:59:00,0,3476.0,3404.0,0.979,17.465,841,567,457,110,274,200,74,25,0.0,0.0
1010,1344,2020-03-19 06:02:00,1,3466.0,3326.0,0.96,17.339,419,283,214,69,136,93,43,25,0.0,0.0
1010,1345,2020-03-19 06:05:00,1,3328.0,3248.0,0.976,16.707,119,85,64,21,34,16,18,0,0.0,0.0
1010,1346,2020-03-19 06:08:00,1,3259.0,3168.0,0.972,16.346,18,11,4,7,7,1,6,0,0.0,0.0
1010,1347,2020-03-19 06:11:00,1,3145.0,3018.0,0.96,15.731,2,2,0,2,0,0,0,0,0.0,0.0
1010,1348,2020-03-19 06:14:00,1,2918.0,2795.0,0.958,14.592,19,15,4,11,4,2,2,0,0.0,0.0
1010,1349,2020-03-19 06:17:00,1,2809.0,2695.0,0.959,14.052,529,324,245,79,205,136,69,13,0.0,0.02
1010,1350,2020-03-19 06:20:00,1,2769.0,2668.0,0.963,13.863,38,25,7,18,13,0,13,0,0.0,0.0
1010,1351,2020-03-19 06:23:00,1,2778.0,2650.0,0.954,13.88,2,2,1,1,0,0,0,0,0.0,0.0
1010,1352,2020-03-19 06:26:00,1,2578.0,2526.0,0.98,12.953,2,2,0,2,0,0,0,0,0.0,0.0
1010,1353,2020-03-19 06:29:00,1,2507.0,2363.0,0.942,12.493,0,0,0,0,0,0,0,0,0.0,0.0
1010,1354,2020-03-19 06:32:00,1,2380.0,2199.0,0.924,11.812,0,0,0,0,0,0,0,0,0.0,0.0
1010,1355,2020-03-19 06:35:00,1,2240.0,2069.0,0.923,11.117,0,0,0,0,0,0,0,0,0.0,0.0
1010,1356,2020-03-19 06:38:00,1,2173.0,1984.0,0.913,10.758,0,0,0,0,0,0,0,0,0.0,0.0
1010,1357,2020-03-19 06:41:00,1,2105.0,1877.0,0.892,10.374,1,1,0,1,0,0,0,0,0.0,0.0
1010,1358,2020-03-19 06:44:00,1,1956.0,1806.0,0.924,9.705,7,7,2,5,0,0,0,0,0.0,0.0
1010,1359,2020-03-19 06:47:00,1,2047.0,1843.0,0.9,10.104,12,8,5,3,4,1,3,0,0.0,0.0
1010,1360,2020-03-19 06:50:00,1,1947.0,1792.0,0.921,9.656,1,1,0,1,0,0,0,0,0.0,0.0
1010,1361,2020-03-19 06:53:00,1,1877.0,1784.0,0.95,9.37,0,0,0,0,0,0,0,0,0.0,0.0
1010,1362,2020-03-19 06:56:00,1,1881.0,1780.0,0.946,9.38,4,2,1,1,2,1,1,0,0.0,0.0
1010,1363,2020-03-19 06:59:00,1,2026.0,1840.0,0.908,10.02,6,6,1,5,0,0,0,0,0.0,0.0
1010,1364,2020-03-19 07:02:00,1,2132.0,1874.0,0.879,10.477,0,0,0,0,0,0,0,0,0.0,0.0
1010,1365,2020-03-19 07:05:00,1,2028.0,1807.0,0.891,9.991,13,6,0,6,7,0,7,0,0.0,0.0
1010,1366,2020-03-19 07:08:00,1,2055.0,1842.0,0.896,10.136,8,8,0,8,0,0,0,0,0.0,0.0
1010,1367,2020-03-19 07:11:00,1,2059.0,1799.0,0.874,10.105,3,3,0,3,0,0,0,0,0.0,0.0
1010,1368,2020-03-19 07:14:00,1,1907.0,1718.0,0.901,9.417,0,0,0,0,0,0,0,0,0.0,0.0
1010,1369,2020-03-19 07:17:00,1,2047.0,1753.0,0.856,10.005,0,0,0,0,0,0,0,0,0.0,0.0
1010,1370,2020-03-19 07:20:00,1,1977.0,1739.0,0.88,9.713,1,1,0,1,0,0,0,0,0.0,0.0
1010,1371,2020-03-19 07:23:00,1,1983.0,1739.0,0.877,9.737,1,0,0,0,1,0,1,0,0.0,0.0
1010,1372,2020-03-19 07:26:00,1,1896.0,1744.0,0.92,9.402,17,6,3,3,11,3,8,0,0.0,0.0
1010,1373,2020-03-19 07:29:00,1,2124.0,1861.0,0.876,10.43,52,33,21,12,19,1,18,0,0.0,0.0
1010,1374,2020-03-19 07:32:00,1,2344.0,2038.0,0.869,11.492,82,71,43,28,11,4,7,1,0.0,0.0
1010,1375,2020-03-19 07:35:00,1,2623.0,2292.0,0.874,12.874,183,109,78,31,74,46,28,24,0.0,0.0
1010,1376,2020-03-19 07:38:00,1,2591.0,2307.0,0.89,12.763,137,88,68,20,49,17,32,4,0.0,0.0
1010,1377,2020-03-19 07:41:00,1,2771.0,2397.0,0.865,13.571,630,411,333,78,219,152,67,18,0.0,0.0
1010,1378,2020-03-19 07:44:00,1,2826.0,2448.0,0.866,13.844,900,681,556,125,219,150,69,11,0.0,0.0
1010,1379,2020-03-19 07:47:00,1,2821.0,2491.0,0.883,13.872,807,539,452,87,268,184,84,20,0.0,0.0
1010,1380,2020-03-19 07:50:00,1,2767.0,2396.0,0.866,13.555,197,93,72,21,104,56,48,2,0.0,0.0
1010,1381,2020-03-19 07:53:00,1,2752.0,2383.0,0.866,13.483,428,309,236,73,119,75,44,6,0.0,0.0
1010,1382,2020-03-19 07:56:00,1,2835.0,2400.0,0.847,13.827,3,3,0,3,0,0,0,0,0.0,0.0
1010,1383,2020-03-19 07:59:00,1,2845.0,2432.0,0.855,13.902,23,19,9,10,4,2,2,0,0.0,0.0
1010,1384,2020-03-19 08:02:00,1,2608.0,2313.0,0.887,12.836,8,6,0,6,2,0,2,0,0.0,0.0
1010,1385,2020-03-19 08:05:00,1,2469.0,2174.0,0.88,12.135,5,2,0,2,3,0,3,0,0.0,0.0
1010,1386,2020-03-19 08:08:00,1,2267.0,1967.0,0.868,11.112,2,2,0,2,0,0,0,0,0.0,0.0
1010,1387,2020-03-19 08:11:00,1,2106.0,1820.0,0.864,10.314,9,7,1,6,2,0,2,0,0.0,0.0
1010,1388,2020-03-19 08:14:00,1,2140.0,1816.0,0.849,10.441,13,0,0,0,13,0,13,0,0.0,0.0
1010,1389,2020-03-19 08:17:00,1,2148.0,1771.5,0.825,10.4245,3,0,0,0,3,0,3,0,0.0,0.0
1010,1390,2020-03-19 08:20:00,1,2156.0,1727.0,0.801,10.408,28,5,1,4,23,0,23,0,0.0,0.0
1010,1391,2020-03-19 08:23:00,1,2074.0,1708.0,0.824,10.064,19,13,0,13,6,0,6,0,0.0,0.0
1010,1392,2020-03-19 08:26:00,1,2129.0,1821.0,0.855,10.405,16,11,3,8,5,0,5,0,0.0,0.0
1010,1393,2020-03-19 08:29:00,1,2133.0,1831.0,0.858,10.432,5,5,0,5,0,0,0,0,0.0,0.0
1010,1394,2020-03-19 08:32:00,1,2155.0,1727.0,0.801,10.403,6,3,0,3,3,0,3,0,0.0,0.0
1010,1395,2020-03-19 08:35:00,1,2070.0,1695.0,0.819,10.033,0,0,0,0,0,0,0,0,0.0,0.0
1010,1396,2020-03-19 08:38:00,1,1935.0,1650.0,0.853,9.448,10,8,2,6,2,0,2,0,0.0,0.0
1010,1397,2020-03-19 08:41:00,1,1988.0,1656.0,0.833,9.668,13,6,2,4,7,0,7,0,0.0,0.0
1010,1398,2020-03-19 08:44:00,1,2160.0,1739.0,0.805,10.437,3,3,2,1,0,0,0,0,0.0,0.0
1010,1399,2020-03-19 08:47:00,1,2078.0,1670.0,0.804,10.038,10,7,2,5,3,0,3,0,0.0,0.0
1010,1400,2020-03-19 08:50:00,1,1930.0,1634.0,0.847,9.415,51,22,7,15,29,11,18,0,0.0,0.0
1010,1401,2020-03-19 08:53:00,1,2157.0,1729.0,0.801,10.413,15,14,7,7,1,0,1,0,0.0,0.0
1010,1402,2020-03-19 08:56:00,1,2226.0,1794.0,0.806,10.757,167,98,60,38,69,44,25,2,0.0,0.0
1010,1403,2020-03-19 08:59:00,1,2504.0,2054.0,0.82,12.139,162,59,45,14,103,51,52,17,0.0,0.03
1010,1404,2020-03-19 09:02:00,1,2664.0,2097.0,0.787,12.82,88,56,29,27,32,4,28,1,0.0,0.0
1010,1405,2020-03-19 09:05:00,1,2501.0,2047.0,0.819,12.122,23,14,4,10,9,5,4,0,0.0,0.0
1010,1406,2020-03-19 09:08:00,1,2463.0,1945.0,0.79,11.857,0,0,0,0,0,0,0,0,0.0,0.0
1010,1407,2020-03-19 09:11:00,1,2334.0,1798.0,0.771,11.185,5,2,0,2,3,0,3,0,0.0,0.0
1010,1408,2020-03-19 09:14:00,1,2157.0,1697.0,0.787,10.379,6,5,0,5,1,0,1,0,0.0,0.0
1010,1409,2020-03-19 09:17:00,1,2180.0,1661.0,0.762,10.428,4,3,0,3,1,0,1,0,0.0,0.0
1010,1410,2020-03-19 09:20:00,1,2006.0,1588.0,0.792,9.664,19,5,0,5,14,5,9,0,0.0,0.0
1010,1411,2020-03-19 09:23:00,1,2104.0,1613.0,0.767,10.076,14,0,0,0,14,0,14,0,0.0,0.0
1010,1412,2020-03-19 09:26:00,1,2114.0,1599.0,0.756,10.102,16,0,0,0,16,6,10,0,0.0,0.0
1010,1413,2020-03-19 09:29:00,1,2167.0,1645.0,0.759,10.358,49,13,4,9,36,19,17,0,0.0,0.0
1010,1414,2020-03-19 09:32:00,1,2086.0,1600.0,0.767,9.99,20,9,0,9,11,1,10,0,0.0,0.0
1010,1415,2020-03-19 09:35:00,1,1946.0,1552.0,0.797,9.387,14,10,2,8,4,3,1,0,0.0,0.0
1010,1416,2020-03-19 09:38:00,1,1937.0,1532.0,0.791,9.326,0,0,0,0,0,0,0,0,0.0,0.0
1010,1417,2020-03-19 09:41:00,1,1954.0,1529.0,0.782,9.389,1,1,0,1,0,0,0,0,0.0,0.0
1010,1418,2020-03-19 09:44:00,1,1959.0,1492.0,0.761,9.371,48,30,9,21,18,4,14,0,0.0,0.0
1010,1419,2020-03-19 09:47:00,1,2032.0,1579.0,0.777,9.753,110,102,49,53,8,1,7,0,0.0,0.0
1010,1420,2020-03-19 09:50:00,1,2261.0,1731.0,0.765,10.827,64,52,21,31,12,3,9,0,0.0,0.0
1010,1421,2020-03-19 09:53:00,1,2463.0,1891.0,0.768,11.796,184,102,74,28,82,51,31,6,0.0,0.0
1010,1422,2020-03-19 09:56:00,1,2652.0,2178.0,0.821,12.86,551,354,284,70,197,136,61,33,0.0,0.0
1010,1423,2020-03-19 09:59:00,1,2908.0,2253.0,0.775,13.954,572,403,325,78,169,116,53,32,0.0,0.0
1010,1424,2020-03-19 10:02:00,1,2895.0,2287.0,0.79,13.937,604,404,328,76,200,145,55,13,0.0,0.0
1010,1425,2020-03-19 10:05:00,1,2876.0,2265.0,0.788,13.84,681,456,354,102,225,154,71,2,0.0,0.0
1010,1426,2020-03-19 10:08:00,1,2897.0,2269.0,0.783,13.925,118,76,56,20,42,21,21,0,0.0,0.0
1010,1427,2020-03-19 10:11:00,1,2895.0,2232.0,0.771,13.878,137,117,54,63,20,1,19,0,0.0,0.0
1010,1428,2020-03-19 10:14:00,1,2650.0,2160.0,0.815,12.831,154,149,79,70,5,0,5,1,0.0,0.0
1010,1429,2020-03-19 10:17:00,1,2653.0,2080.0,0.784,12.754,47,46,31,15,1,0,1,0,0.0,0.0
1010,1430,2020-03-19 10:20:00,1,2605.0,2066.0,0.793,12.553,0,0,0,0,0,0,0,0,0.0,0.0
1010,1431,2020-03-19 10:23:00,1,2449.0,1904.0,0.777,11.757,17,11,4,7,6,0,6,0,0.0,0.0
1010,1432,2020-03-19 10:26:00,1,2290.0,1867.0,0.815,11.089,18,5,0,5,13,0,13,0,0.0,0.0
1010,1433,2020-03-19 10:29:00,1,2307.0,1829.0,0.793,11.113,6,3,0,3,3,0,3,0,0.0,0.0
1010,1434,2020-03-19 10:32:00,1,2151.0,1726.0,0.803,10.385,0,0,0,0,0,0,0,0,0.0,0.0
1010,1435,2020-03-19 10:35:00,1,2168.0,1606.0,0.741,10.319,30,12,0,12,18,0,18,0,0.0,0.0
1010,1436,2020-03-19 10:38:00,1,2096.0,1615.0,0.771,10.046,17,10,8,2,7,2,5,0,0.0,0.0
1010,1437,2020-03-19 10:41:00,1,2166.0,1648.0,0.761,10.359,0,0,0,0,0,0,0,0,0.0,0.0
1010,1438,2020-03-19 10:44:00,1,2187.0,1624.0,0.743,10.415,2,2,1,1,0,0,0,0,0.0,0.0
1010,1439,2020-03-19 10:47:00,1,2032.0,1572.0,0.774,9.746,14,14,2,12,0,0,0,0,0.0,0.0
1010,1440,2020-03-19 10:50:00,1,2177.0,1666.0,0.765,10.42,12,12,2,10,0,0,0,0,0.0,0.0
1010,1441,2020-03-19 10:53:00,1,2168.0,1656.0,0.764,10.376,9,9,4,5,0,0,0,0,0.0,0.0
1010,1442,2020-03-19 10:56:00,1,2191.0,1597.0,0.729,10.403,21,21,0,21,0,0,0,0,0.0,0.0
1010,1443,2020-03-19 10:59:00,1,2018.0,1524.0,0.755,9.637,27,17,4,13,10,2,8,0,0.0,0.0
1010,1444,2020-03-19 11:02:00,1,2170.0,1662.0,0.766,10.389,10,4,4,0,6,1,5,0,0.0,0.0
1010,1445,2020-03-19 11:05:00,1,2330.0,1716.0,0.736,11.081,4,1,0,1,3,0,3,0,0.0,0.0
1010,1446,2020-03-19 11:08:00,1,2167.0,1630.0,0.752,10.344,0,0,0,0,0,0,0,0,0.0,0.0
1010,1447,2020-03-19 11:11:00,1,2186.0,1619.0,0.741,10.404,60,48,35,13,12,3,9,0,0.0,0.0
1010,1448,2020-03-19 11:14:00,1,2162.0,1663.0,0.769,10.359,1,1,0,1,0,0,0,0,0.0,0.0
1010,1449,2020-03-19 11:17:00,1,2088.0,1603.5,0.768,10.003,2,2,0,2,0,0,0,0,0.0,0.0
1010,1450,2020-03-19 11:20:00,1,2014.0,1544.0,0.767,9.647,8,8,0,8,0,0,0,0,0.0,0.0
1010,1451,2020-03-19 11:23:00,1,2109.0,1548.0,0.734,10.023,11,1,0,1,10,1,9,0,0.0,0.0
1010,1452,2020-03-19 11:26:00,1,2196.0,1577.0,0.718,10.4,6,2,1,1,4,0,4,0,0.0,0.0
1010,1453,2020-03-19 11:29:00,1,2190.0,1566.0,0.715,10.361,4,1,0,1,3,0,3,0,0.0,0.0
1010,1454,2020-03-19 11:32:00,1,2024.0,1529.0,0.755,9.667,0,0,0,0,0,0,0,0,0.0,0.0
1010,1455,2020-03-19 11:35:00,1,2105.0,1522.0,0.723,9.981,0,0,0,0,0,0,0,0,0.0,0.0
1010,1456,2020-03-19 11:38:00,1,1963.0,1515.0,0.772,9.413,59,11,2,9,48,0,48,0,0.0,0.0
1010,1457,2020-03-19 11:41:00,1,2323.0,1747.0,0.752,11.085,88,50,22,28,38,4,34,0,0.0,0.0
1010,1458,2020-03-19 11:44:00,1,2527.0,1912.0,0.757,12.073,75,58,26,32,17,0,17,0,0.0,0.0
1010,1459,2020-03-19 11:47:00,1,2649.0,2037.0,0.769,12.694,179,135,88,47,44,30,14,21,0.0,0.0
1010,1460,2020-03-19 11:50:00,1,2891.0,2231.0,0.771,13.862,200,153,101,52,47,29,18,63,0.0,0.0
1010,1461,2020-03-19 11:53:00,1,2890.0,2249.0,0.778,13.876,146,83,60,23,63,22,41,27,0.0,0.0
1010,1462,2020-03-19 11:56:00,1,3115.0,2471.0,0.793,15.009,119,84,46,38,35,13,22,39,0.0,0.0
1010,1463,2020-03-19 11:59:00,1,3238.0,2553.0,0.788,15.582,66,52,26,26,14,5,9,50,0.0,0.0
1010,1464,2020-03-19 12:02:00,1,3406.0,2711.0,0.796,16.421,84,58,20,38,26,3,23,45,0.0,0.0
1010,1465,2020-03-19 12:05:00,1,3282.0,2722.0,0.83,15.944,325,199,151,48,126,77,49,38,0.17,0.15
1010,1466,2020-03-19 12:08:00,1,3313.0,2869.0,0.866,16.231,517,299,221,78,218,155,63,34,0.0,0.0
1010,1467,2020-03-19 12:11:00,1,2577.0,2153.0,0.836,12.535,758,518,421,97,240,155,85,1,0.02,0.0
1010,1468,2020-03-19 12:14:00,1,2617.0,2222.0,0.849,12.772,226,190,127,63,36,15,21,0,0.0,0.0
1010,1469,2020-03-19 12:17:00,1,2645.0,2165.0,0.818,12.818,97,85,35,50,12,3,9,0,0.0,0.0
1010,1470,2020-03-19 12:20:00,1,2973.0,2609.0,0.878,14.604,72,54,14,40,18,5,13,0,0.0,0.0
1010,1471,2020-03-19 12:23:00,1,3100.0,2719.0,0.877,15.226,11,4,3,1,7,3,4,0,0.0,0.0
1010,1472,2020-03-19 12:26:00,1,3183.0,2814.0,0.884,15.658,0,0,0,0,0,0,0,0,0.0,0.0
1010,1473,2020-03-19 12:29:00,1,2961.0,2704.0,0.913,14.661,3,3,1,2,0,0,0,0,0.0,0.0
1010,1474,2020-03-19 12:32:00,1,2853.0,2489.0,0.872,13.999,0,0,0,0,0,0,0,0,0.0,0.0
1010,1475,2020-03-19 12:35:00,1,2613.0,2319.0,0.888,12.861,14,14,0,14,0,0,0,0,0.0,0.0
1010,1476,2020-03-19 12:38:00,1,2447.0,2200.0,0.899,12.076,24,17,13,4,7,2,5,0,0.0,0.0
1010,1477,2020-03-19 12:41:00,1,2478.0,2144.0,0.865,12.137,20,19,3,16,1,0,1,0,0.0,0.0
1010,1478,2020-03-19 12:44:00,1,2254.0,1998.0,0.887,11.093,10,10,0,10,0,0,0,0,0.0,0.0
1010,1479,2020-03-19 12:47:00,1,2183.0,1946.0,0.891,10.757,0,0,0,0,0,0,0,0,0.0,0.0
1010,1480,2020-03-19 12:50:00,1,2112.0,1889.0,0.895,10.411,27,20,11,9,7,1,6,0,0.0,0.0
1010,1481,2020-03-19 12:53:00,1,2088.0,1933.0,0.926,10.367,31,13,2,11,18,8,10,0,0.0,0.0
1010,1482,2020-03-19 12:56:00,1,2119.0,1873.0,0.884,10.423,9,9,0,9,0,0,0,0,0.0,0.0
1010,1483,2020-03-19 12:59:00,1,2138.0,1788.0,0.836,10.404,8,8,0,8,0,0,0,0,0.0,0.0
1010,1484,2020-03-19 13:02:00,1,2051.0,1725.0,0.841,9.992,7,7,2,5,0,0,0,0,0.0,0.0
1010,1485,2020-03-19 13:05:00,1,2051.0,1741.0,0.848,10.01,0,0,0,0,0,0,0,0,0.0,0.0
1010,1486,2020-03-19 13:08:00,1,2145.0,1786.0,0.833,10.429,0,0,0,0,0,0,0,0,0.0,0.0
1010,1487,2020-03-19 13:11:00,1,2134.0,1798.0,0.843,10.4,6,6,0,6,0,0,0,0,0.0,0.0
1010,1488,2020-03-19 13:14:00,1,2145.0,1789.0,0.834,10.431,4,4,4,0,0,0,0,0,0.0,0.0
1010,1489,2020-03-19 13:17:00,1,2136.0,1743.0,0.816,10.347,10,7,2,5,3,0,3,0,0.0,0.0
1010,1490,2020-03-19 13:20:00,1,2136.0,1825.0,0.854,10.438,82,60,26,34,22,0,22,0,0.0,0.0
1010,1491,2020-03-19 13:23:00,1,2406.0,2036.0,0.846,11.732,74,59,19,40,15,0,15,0,0.0,0.0
1010,1492,2020-03-19 13:26:00,1,2474.0,2177.0,0.88,12.156,79,51,16,35,28,2,26,0,0.0,0.0
1010,1493,2020-03-19 13:29:00,1,2457.0,2188.0,0.89,12.102,135,94,69,25,41,26,15,7,0.0,0.0
1010,1494,2020-03-19 13:32:00,1,2491.0,2165.0,0.869,12.21,108,59,22,37,49,25,24,28,0.0,0.0
1010,1495,2020-03-19 13:35:00,1,2908.0,2501.0,0.86,14.226,110,73,40,33,37,9,28,50,0.0,0.0
1010,1496,2020-03-19 13:38:00,1,2971.0,2596.0,0.874,14.579,85,55,26,29,30,3,27,38,0.0,0.02
1010,1497,2020-03-19 13:41:00,1,3102.0,2698.0,0.87,15.207,82,69,28,41,13,4,9,55,0.0,0.0
1010,1498,2020-03-19 13:44:00,1,3152.0,2796.0,0.887,15.514,301,171,118,53,130,90,40,40,0.24,0.18
1010,1499,2020-03-19 13:47:00,1,2927.0,2703.0,0.924,14.524,811,474,386,88,337,254,83,9,0.03,0.06
1010,1500,2020-03-19 13:50:00,1,3170.0,2826.0,0.891,15.619,604,428,346,82,176,126,50,14,0.0,0.02
1010,1501,2020-03-19 13:53:00,1,2793.0,2458.0,0.88,13.726,456,334,275,59,122,78,44,6,0.0,0.0
1010,1502,2020-03-19 13:56:00,1,2606.0,2332.0,0.895,12.848,52,46,15,31,6,1,5,0,0.0,0.0
1010,1503,2020-03-19 13:59:00,1,2944.0,2652.0,0.901,14.537,64,48,27,21,16,0,16,0,0.0,0.0
1010,1504,2020-03-19 14:02:00,1,2946.0,2694.0,0.915,14.59,66,28,18,10,38,6,32,1,0.0,0.0
1010,1505,2020-03-19 14:05:00,1,2935.0,2761.0,0.941,14.62,0,0,0,0,0,0,0,0,0.0,0.0
1010,1506,2020-03-19 14:08:00,1,2850.0,2685.0,0.942,14.201,11,9,1,8,2,1,1,0,0.0,0.0
1010,1507,2020-03-19 14:11:00,1,2791.0,2635.0,0.944,13.913,9,9,3,6,0,0,0,0,0.0,0.0
1010,1508,2020-03-19 14:14:00,1,2546.0,2472.0,0.971,12.768,3,3,0,3,0,0,0,0,0.0,0.0
1010,1509,2020-03-19 14:17:00,1,2378.0,2313.5,0.973,11.93,6,6,0,6,0,0,0,0,0.0,0.0
1010,1510,2020-03-19 14:20:00,1,2210.0,2155.0,0.975,11.092,5,3,0,3,2,1,1,0,0.0,0.0
1010,1511,2020-03-19 14:23:00,1,2415.0,2314.0,0.958,12.078,29,22,9,13,7,4,3,7,0.0,0.0
1010,1512,2020-03-19 14:26:00,1,2563.0,2458.0,0.959,12.819,16,14,4,10,2,1,1,0,0.0,0.0
1010,1513,2020-03-19 14:29:00,1,2601.0,2391.0,0.919,12.893,5,5,0,5,0,0,0,0,0.0,0.0
1010,1514,2020-03-19 14:32:00,1,2453.0,2239.0,0.913,12.144,2,1,0,1,1,0,1,0,0.0,0.0
1010,1515,2020-03-19 14:35:00,1,2311.0,2183.0,0.945,11.522,10,8,0,8,2,0,2,0,0.0,0.0
1010,1516,2020-03-19 14:38:00,1,2382.0,2158.0,0.906,11.772,18,8,6,2,10,5,5,0,0.0,0.0
1010,1517,2020-03-19 14:41:00,1,2256.0,2049.0,0.908,11.158,5,4,0,4,1,0,1,0,0.0,0.0
1010,1518,2020-03-19 14:44:00,1,2244.0,1997.0,0.89,11.052,11,10,2,8,1,0,1,0,0.0,0.0
1010,1519,2020-03-19 14:47:00,1,2178.0,1979.0,0.908,10.774,0,0,0,0,0,0,0,0,0.0,0.0
1010,1520,2020-03-19 14:50:00,1,2110.0,1924.0,0.912,10.442,1,0,0,0,1,0,1,0,0.0,0.0
1010,1521,2020-03-19 14:53:00,1,2109.0,1911.0,0.906,10.426,15,9,3,6,6,2,4,0,0.0,0.0
1010,1522,2020-03-19 14:56:00,1,2259.0,1955.0,0.866,11.065,12,6,3,3,6,4,2,0,0.0,0.0
1010,1523,2020-03-19 14:59:00,1,2268.0,1988.0,0.876,11.138,13,8,3,5,5,2,3,0,0.0,0.0
1010,1524,2020-03-19 15:02:00,1,2251.0,1927.0,0.856,11.003,3,0,0,0,3,0,3,0,0.0,0.0
1010,1525,2020-03-19 15:05:00,1,2273.0,1904.0,0.838,11.062,0,0,0,0,0,0,0,0,0.0,0.0
1010,1526,2020-03-19 15:08:00,1,2124.0,1837.0,0.865,10.404,68,45,2,43,23,5,18,0,0.0,0.0
1010,1527,2020-03-19 15:11:00,1,2483.0,2121.0,0.854,12.133,119,84,42,42,35,6,29,2,0.0,0.0
1010,1528,2020-03-19 15:14:00,1,2614.0,2282.0,0.873,12.825,65,37,5,32,28,9,19,0,0.0,0.0
1010,1529,2020-03-19 15:17:00,1,2607.0,2323.0,0.891,12.843,161,126,87,39,35,18,17,41,0.0,0.0
1010,1530,2020-03-19 15:20:00,1,3006.0,2554.0,0.85,14.67,91,88,28,60,3,2,1,49,0.0,0.0
1010,1531,2020-03-19 15:23:00,1,2943.0,2655.0,0.902,14.534,93,81,27,54,12,7,5,39,0.0,0.06
1010,1532,2020-03-19 15:26:00,1,3197.0,2797.0,0.875,15.693,126,90,48,42,36,15,21,64,0.14,0.05
1010,1533,2020-03-19 15:29:00,1,3231.0,2908.0,0.9,15.949,73,47,19,28,26,13,13,35,0.0,0.07
1010,1534,2020-03-19 15:32:00,1,2922.0,2761.0,0.945,14.571,512,347,268,79,165,117,48,27,0.14,0.01
1010,1535,2020-03-19 15:35:00,1,2432.0,2286.0,0.94,12.112,27,20,5,15,7,2,5,0,0.0,0.0
1010,1536,2020-03-19 15:38:00,1,2235.0,2065.0,0.924,11.093,44,44,19,25,0,0,0,0,0.0,0.01
1010,1537,2020-03-19 15:41:00,1,2608.0,2341.0,0.898,12.866,7,5,2,3,2,1,1,0,0.0,0.0
1010,1538,2020-03-19 15:44:00,1,2586.0,2397.0,0.927,12.844,14,13,4,9,1,0,1,0,0.0,0.0
1010,1539,2020-03-19 15:47:00,1,2826.0,2516.0,0.89,13.918,21,14,7,7,7,3,4,0,0.0,0.0
1010,1540,2020-03-19 15:50:00,1,2809.0,2581.0,0.919,13.925,6,6,2,4,0,0,0,0,0.0,0.0
1010,1541,2020-03-19 15:53:00,1,2777.0,2597.0,0.935,13.816,28,25,6,19,3,1,2,0,0.0,0.0
1010,1542,2020-03-19 15:56:00,1,2615.0,2575.0,0.985,13.155,6,5,0,5,1,0,1,0,0.0,0.0
1010,1543,2020-03-19 15:59:00,1,2595.0,2441.0,0.941,12.926,2,1,0,1,1,0,1,0,0.0,0.0
1010,1544,2020-03-19 16:02:00,1,2436.0,2352.0,0.965,12.202,23,17,4,13,6,1,5,0,0.0,0.0
1010,1545,2020-03-19 16:05:00,1,2545.0,2489.0,0.978,12.783,129,65,31,34,64,24,40,0,0.0,0.0
1010,1546,2020-03-19 16:08:00,1,2649.0,2567.0,0.969,13.281,12,11,2,9,1,0,1,0,0.0,0.0
1010,1547,2020-03-19 16:11:00,1,2431.0,2428.0,0.999,12.265,0,0,0,0,0,0,0,0,0.0,0.0
1010,1548,2020-03-19 16:14:00,1,2358.0,2290.0,0.971,11.827,1,1,0,1,0,0,0,0,0.0,0.0
1010,1549,2020-03-19 16:17:00,1,2213.0,2177.0,0.984,11.128,0,0,0,0,0,0,0,0,0.0,0.0
1010,1550,2020-03-19 16:20:00,1,2222.0,2099.0,0.945,11.079,12,3,1,2,9,3,6,0,0.0,0.0
1010,1551,2020-03-19 16:23:00,1,2226.0,2155.0,0.968,11.155,214,142,110,32,72,50,22,3,0.0,0.01
1010,1552,2020-03-19 16:26:00,1,2478.0,2245.0,0.906,12.25,104,80,27,53,24,3,21,0,0.0,0.0
1010,1553,2020-03-19 16:29:00,1,2433.0,2276.0,0.936,12.107,13,10,3,7,3,2,1,0,0.0,0.0
1010,1554,2020-03-19 16:32:00,1,2263.0,2180.0,0.963,11.33,11,5,3,2,6,4,2,0,0.0,0.0
1010,1555,2020-03-19 16:35:00,1,2208.0,2090.0,0.946,11.015,1,1,0,1,0,0,0,0,0.0,0.0
1010,1556,2020-03-19 16:38:00,1,2241.0,2030.0,0.906,11.079,34,23,12,11,11,1,10,0,0.0,0.0
1010,1557,2020-03-19 16:41:00,1,2235.0,2094.0,0.937,11.125,4,2,0,2,2,1,1,0,0.0,0.0
1010,1558,2020-03-19 16:44:00,1,2251.0,2096.0,0.931,11.188,8,2,0,2,6,1,5,0,0.0,0.0
1010,1559,2020-03-19 16:47:00,1,2170.0,2053.0,0.946,10.822,154,54,23,31,100,45,55,0,0.0,0.0
1010,1560,2020-03-19 16:50:00,1,2423.0,2319.0,0.957,12.113,120,76,33,43,44,12,32,0,0.0,0.0
1010,1561,2020-03-19 16:53:00,1,2594.0,2409.0,0.929,12.886,16,7,1,6,9,1,8,0,0.0,0.0
1010,1562,2020-03-19 16:56:00,1,2576.0,2382.0,0.925,12.786,167,116,77,39,51,27,24,62,0.0,0.0
1010,1563,2020-03-19 16:59:00,1,2948.0,2742.0,0.93,14.652,124,104,58,46,20,3,17,70,0.0,0.08
1010,1564,2020-03-19 17:02:00,1,3147.0,2955.0,0.939,15.669,90,57,19,38,33,4,29,66,0.0,0.37
1010,1565,2020-03-19 17:05:00,1,3206.0,3013.0,0.94,15.965,4,3,0,3,1,0,1,0,0.0,0.0
1010,1566,2020-03-19 17:08:00,1,3263.0,3127.0,0.958,16.318,22,18,2,16,4,2,2,0,0.0,0.0
1010,1567,2020-03-19 17:11:00,1,3205.0,3026.0,0.944,15.978,135,62,41,21,73,42,31,2,0.17,0.01
1010,1568,2020-03-19 17:14:00,1,2499.0,2371.0,0.949,12.47,55,19,2,17,36,21,15,0,0.0,0.0
1010,1569,2020-03-19 17:17:00,1,2810.0,2648.0,0.943,14.0015,16,2,1,1,14,0,14,0,0.0,0.0
1010,1570,2020-03-19 17:20:00,1,3121.0,2925.0,0.937,15.533,0,0,0,0,0,0,0,0,0.0,0.0
1010,1571,2020-03-19 17:23:00,1,2988.0,2850.0,0.954,14.926,15,9,0,9,6,0,6,0,0.0,0.01
1010,1572,2020-03-19 17:26:00,1,2909.0,2718.0,0.935,14.469,2,0,0,0,2,0,2,0,0.0,0.0
1010,1573,2020-03-19 17:29:00,1,2847.0,2708.0,0.951,14.216,215,123,72,51,92,52,40,0,0.23,0.0
1010,1574,2020-03-19 17:32:00,1,2927.0,2751.0,0.94,14.577,19,18,7,11,1,0,1,0,0.0,0.0
1010,1575,2020-03-19 17:35:00,1,2805.0,2611.0,0.931,13.942,16,13,5,8,3,0,3,0,0.0,0.0
1010,1576,2020-03-19 17:38:00,1,2628.0,2536.0,0.965,13.162,24,15,5,10,9,0,9,0,0.0,0.0
1010,1577,2020-03-19 17:41:00,1,2540.0,2492.0,0.981,12.766,9,9,3,6,0,0,0,0,0.0,0.0
1010,1578,2020-03-19 17:44:00,1,2546.0,2481.0,0.974,12.777,9,8,0,8,1,0,1,0,0.0,0.0
1010,1579,2020-03-19 17:47:00,1,2470.0,2415.0,0.978,12.406,10,7,0,7,3,2,1,0,0.0,0.0
1010,1580,2020-03-19 17:50:00,1,2493.0,2424.0,0.973,12.505,107,71,52,19,36,30,6,0,0.0,0.0
1010,1581,2020-03-19 17:53:00,1,2393.0,2385.0,0.996,12.07,41,33,10,23,8,2,6,0,0.0,0.0
1010,1582,2020-03-19 17:56:00,1,2417.0,2397.0,0.992,12.175,14,14,7,7,0,0,0,0,0.0,0.0
1010,1583,2020-03-19 17:59:00,1,2438.0,2378.0,0.975,12.239,15,13,8,5,2,1,1,0,0.0,0.0
1010,1584,2020-03-19 18:02:00,0,2412.0,2398.0,0.994,12.158,127,85,61,24,42,26,16,4,0.0,0.0
1010,1585,2020-03-19 18:05:00,0,2774.0,2752.0,0.992,13.977,361,221,167,54,140,89,51,9,0.0,0.02
1010,1586,2020-03-19 18:08:00,0,2753.0,2827.0,1.027,13.976,315,176,113,63,139,77,62,22,0.0,0.0
1010,1587,2020-03-19 18:11:00,0,2882.0,2895.0,1.005,14.559,82,51,14,37,31,9,22,2,0.0,0.0
1010,1588,2020-03-19 18:14:00,0,3121.0,3057.0,0.979,15.681,118,71,29,42,47,12,35,2,0.0,0.0
1010,1589,2020-03-19 18:17:00,0,3279.0,3179.0,0.969,16.437,149,89,53,36,60,30,30,7,0.0,0.0
1010,1590,2020-03-19 18:20:00,0,3097.0,3101.0,1.001,15.636,48,29,22,7,19,12,7,0,0.0,0.0
1010,1591,2020-03-19 18:23:00,0,3031.0,3043.0,1.004,15.31,16,7,3,4,9,3,6,0,0.0,0.0
1010,1592,2020-03-19 18:26:00,0,2890.0,2949.0,1.021,14.652,164,89,38,51,75,39,36,0,0.0,0.0
1010,1593,2020-03-19 18:29:00,0,3073.0,3068.0,0.998,15.506,252,155,110,45,97,47,50,11,0.0,0.02
1010,1594,2020-03-19 18:32:00,0,3110.0,3106.0,0.999,15.692,357,248,198,50,109,69,40,19,0.0,0.0
1010,1595,2020-03-19 18:35:00,0,3073.0,3184.0,1.036,15.63,621,431,354,77,190,136,54,77,0.0,0.0
1010,1596,2020-03-19 18:38:00,0,3206.0,3308.0,1.032,16.294,450,314,241,73,136,89,47,48,0.0,0.0
1010,1597,2020-03-19 18:41:00,0,3100.0,3158.0,1.018,15.711,587,419,316,103,168,137,31,47,0.0,0.06
1010,1598,2020-03-19 18:44:00,0,3230.0,3200.0,0.991,16.269,653,463,360,103,190,150,40,20,0.0,0.0
1010,1599,2020-03-19 18:47:00,0,3090.0,3188.0,1.032,15.704,373,282,208,74,91,58,33,46,0.0,0.0
1010,1600,2020-03-19 18:50:00,0,3157.0,3183.0,1.008,15.961,254,150,102,48,104,62,42,5,0.0,0.0
1010,1601,2020-03-19 18:53:00,0,3011.0,3053.0,1.014,15.244,148,91,53,38,57,32,25,16,0.0,0.0
1010,1602,2020-03-19 18:56:00,0,3080.0,3083.0,1.001,15.548,50,27,9,18,23,13,10,3,0.0,0.0
1010,1603,2020-03-19 18:59:00,0,3105.0,3101.0,0.999,15.666,108,57,20,37,51,19,32,0,0.0,0.0
1010,1604,2020-03-19 19:02:00,0,3086.0,3124.0,1.012,15.618,486,368,277,91,118,85,33,64,0.0,0.0
1010,1605,2020-03-19 19:05:00,0,3084.0,3086.0,1.001,15.567,417,279,225,54,138,96,42,28,0.0,0.0
1010,1606,2020-03-19 19:08:00,0,3106.0,3031.0,0.976,15.591,271,172,117,55,99,57,42,5,0.0,0.0
1010,1607,2020-03-19 19:11:00,0,2866.0,2893.0,1.01,14.494,220,176,112,64,44,16,28,46,0.0,0.0
1010,1608,2020-03-19 19:14:00,0,3137.0,3046.0,0.971,15.731,629,488,372,116,141,113,28,47,0.0,0.0
1010,1609,2020-03-19 19:17:00,0,3333.0,3257.0,0.977,16.736,552,385,292,93,167,121,46,32,0.0,0.0
1010,1610,2020-03-19 19:20:00,0,3251.0,3100.0,0.954,16.24,436,317,222,95,119,74,45,15,0.0,0.0
1010,1611,2020-03-19 19:23:00,0,2956.0,2651.0,0.897,14.583,355,228,165,63,127,79,48,30,0.0,0.0
1010,1612,2020-03-19 19:26:00,0,3319.0,2941.0,0.886,16.334,318,231,148,83,87,43,44,5,0.0,0.0
1010,1613,2020-03-19 19:29:00,0,3173.0,2762.0,0.87,15.56,265,143,86,57,122,82,40,7,0.0,0.0
1010,1614,2020-03-19 19:32:00,0,2623.0,2310.0,0.881,12.891,466,270,205,65,196,140,56,48,0.0,0.0
1010,1615,2020-03-19 19:35:00,0,3333.0,2865.0,0.86,16.303,419,263,205,58,156,102,54,61,0.0,0.0
1010,1616,2020-03-19 19:38:00,0,3628.0,3118.0,0.859,17.747,311,202,144,58,109,80,29,20,0.0,0.0
1010,1617,2020-03-19 19:41:00,0,3095.0,2669.0,0.862,15.151,631,479,366,113,152,112,40,42,0.0,0.01
1010,1618,2020-03-19 19:44:00,0,3587.0,2990.0,0.834,17.443,763,580,447,133,183,135,48,11,0.0,0.0
1010,1619,2020-03-19 19:47:00,0,3566.0,2958.0,0.83,17.324,526,483,362,121,43,21,22,2,0.0,0.0
1010,1620,2020-03-19 19:50:00,0,3733.0,3103.0,0.831,18.145,363,212,161,51,151,110,41,25,0.0,0.0
1010,1621,2020-03-19 19:53:00,0,3587.0,2917.0,0.813,17.362,565,415,311,104,150,111,39,26,0.0,0.0
1010,1622,2020-03-19 19:56:00,0,3341.0,2719.0,0.814,16.172,326,195,148,47,131,85,46,23,0.0,0.0
1010,1623,2020-03-19 19:59:00,0,3149.0,2555.0,0.811,15.236,186,102,52,50,84,39,45,5,0.0,0.0
1010,1624,2020-03-19 20:02:00,0,3498.0,2819.0,0.806,16.903,436,309,235,74,127,89,38,55,0.0,0.0
1010,1625,2020-03-19 20:05:00,0,3216.0,2621.0,0.815,15.575,200,134,62,72,66,23,43,16,0.0,0.0
1010,1626,2020-03-19 20:08:00,0,3222.0,2629.0,0.816,15.606,415,251,183,68,164,107,57,48,0.0,0.0
1010,1627,2020-03-19 20:11:00,0,3400.0,2694.0,0.792,16.378,523,338,256,82,185,127,58,54,0.0,0.0
1010,1628,2020-03-19 20:14:00,0,3539.0,2773.0,0.784,17.016,372,231,163,68,141,99,42,2,0.0,0.0
1010,1629,2020-03-19 20:17:00,0,3392.0,2663.0,0.7855,16.3145,243,137,73,64,106,57,49,3,0.0,0.0
1010,1630,2020-03-19 20:20:00,0,3245.0,2553.0,0.787,15.613,437,227,154,73,210,136,74,23,0.0,0.0
1010,1631,2020-03-19 20:23:00,0,3240.0,2486.0,0.767,15.518,525,364,278,86,161,114,47,62,0.0,0.0
1010,1632,2020-03-19 20:26:00,0,3373.0,2646.0,0.784,16.221,551,434,328,106,117,79,38,29,0.0,0.0
1010,1633,2020-03-19 20:29:00,0,3231.0,2509.0,0.777,15.508,129,104,55,49,25,8,17,7,0.0,0.0
1010,1634,2020-03-19 20:32:00,0,3363.0,2730.0,0.812,16.271,379,207,158,49,172,125,47,85,0.09,0.0
1010,1635,2020-03-19 20:35:00,0,3383.0,2697.0,0.797,16.315,283,198,137,61,85,50,35,44,0.0,0.0
1010,1636,2020-03-19 20:38:00,0,3231.0,2540.0,0.786,15.543,526,352,267,85,174,131,43,115,0.0,0.0
1010,1637,2020-03-19 20:41:00,0,3252.0,2459.0,0.756,15.537,263,138,86,52,125,78,47,36,0.0,0.0
1010,1638,2020-03-19 20:44:00,0,3231.0,2521.0,0.78,15.523,510,341,267,74,169,133,36,87,0.0,0.0
1010,1639,2020-03-19 20:47:00,0,3160.0,2465.0,0.78,15.18,353,220,152,68,133,81,52,5,0.0,0.0
1010,1640,2020-03-19 20:50:00,0,3036.0,2367.0,0.779,14.584,360,218,165,53,142,85,57,122,0.0,0.0
1010,1641,2020-03-19 20:53:00,0,3248.0,2554.0,0.786,15.624,794,612,482,130,182,128,54,21,0.0,0.0
1010,1642,2020-03-19 20:56:00,0,3260.0,2546.0,0.781,15.662,237,136,95,41,101,51,50,33,0.0,0.0
1010,1643,2020-03-19 20:59:00,0,3268.0,2572.0,0.787,15.723,642,493,386,107,149,94,55,41,0.0,0.0
1010,1644,2020-03-19 21:02:00,0,2889.0,2247.0,0.778,13.871,78,75,46,29,3,0,3,3,0.0,0.0
1010,1645,2020-03-19 21:05:00,0,3251.0,2549.0,0.784,15.633,405,306,219,87,99,61,38,38,0.0,0.0
1010,1646,2020-03-19 21:08:00,0,3395.0,2633.0,0.776,16.291,448,297,224,73,151,111,40,65,0.0,0.0
1010,1647,2020-03-19 21:11:00,0,3028.0,2392.0,0.79,14.579,243,160,113,47,83,44,39,0,0.0,0.0
1010,1648,2020-03-19 21:14:00,0,3263.0,2490.0,0.763,15.612,658,420,327,93,238,172,66,20,0.0,0.0
1010,1649,2020-03-19 21:17:00,0,3023.0,2354.0,0.779,14.516,278,191,151,40,87,60,27,32,0.0,0.0
1010,1650,2020-03-19 21:20:00,0,3239.0,2517.0,0.777,15.551,552,353,256,97,199,148,51,52,0.0,0.0
1010,1651,2020-03-19 21:23:00,0,3288.0,2478.0,0.754,15.697,112,64,41,23,48,18,30,30,0.0,0.0
1010,1652,2020-03-19 21:26:00,0,2915.0,2204.0,0.756,13.925,125,68,34,34,57,12,45,2,0.0,0.0
1010,1653,2020-03-19 21:29:00,0,3253.0,2458.0,0.755,15.54,263,161,110,51,102,62,40,18,0.0,0.0
1010,1654,2020-03-19 21:32:00,0,3032.0,2362.0,0.779,14.562,415,271,205,66,144,95,49,42,0.0,0.0
1010,1655,2020-03-19 21:35:00,0,2962.0,2224.0,0.751,14.132,88,61,30,31,27,13,14,0,0.0,0.0
1010,1656,2020-03-19 21:38:00,0,2894.0,2258.0,0.78,13.903,304,231,169,62,73,46,27,35,0.0,0.0
1010,1657,2020-03-19 21:41:00,0,2981.0,2281.0,0.765,14.271,460,277,208,69,183,133,50,70,0.0,0.0
1010,1658,2020-03-19 21:44:00,0,2896.0,2249.0,0.777,13.901,457,255,193,62,202,145,57,42,0.0,0.0
1010,1659,2020-03-19 21:47:00,0,2912.0,2191.0,0.753,13.898,463,281,229,52,182,129,53,163,0.0,0.0
1010,1660,2020-03-19 21:50:00,0,3023.0,2279.0,0.754,14.432,710,438,371,67,272,220,52,228,0.0,0.0
1010,1661,2020-03-19 21:53:00,0,3399.0,2590.0,0.762,16.259,846,522,428,94,324,248,76,242,0.0,0.0
1010,1662,2020-03-19 21:56:00,0,3397.0,2636.0,0.776,16.302,1122,701,586,115,421,327,94,215,0.0,0.0
1010,1663,2020-03-19 21:59:00,0,3448.0,2579.0,0.748,16.442,1138,637,525,112,501,397,104,198,0.0,0.0
1010,1664,2020-03-19 22:02:00,0,3552.0,2647.0,0.745,16.927,1133,659,545,114,474,379,95,196,0.0,0.0
1010,1665,2020-03-19 22:05:00,0,3394.0,2563.0,0.755,16.212,1056,691,576,115,365,280,85,250,0.0,0.0
1010,1666,2020-03-19 22:08:00,0,3404.0,2560.0,0.752,16.245,924,537,445,92,387,306,81,250,0.0,0.0
1010,1667,2020-03-19 22:11:00,0,3405.0,2588.0,0.76,16.28,792,473,378,95,319,254,65,200,0.0,0.0
1010,1668,2020-03-19 22:14:00,0,3426.0,2608.0,0.761,16.386,1126,693,554,139,433,349,84,227,0.0,0.0
1010,1669,2020-03-19 22:17:00,0,3404.0,2630.0,0.773,16.322,663,412,324,88,251,193,58,164,0.0,0.0
1010,1670,2020-03-19 22:20:00,0,4274.0,2469.0,0.578,19.575,598,319,260,59,279,202,77,111,0.0,0.0
1010,1671,2020-03-19 22:23:00,0,4590.0,2452.0,0.534,20.8,560,373,288,85,187,142,45,98,0.0,0.0
1010,1672,2020-03-19 22:26:00,0,4732.0,2501.0,0.529,21.415,760,497,395,102,263,207,56,242,0.0,0.0
1010,1673,2020-03-19 22:29:00,0,4749.0,2542.0,0.535,21.527,714,506,427,79,208,162,46,170,0.0,0.0
1010,1674,2020-03-19 22:32:00,0,4757.0,2511.0,0.528,21.526,565,379,297,82,186,141,45,72,0.0,0.0
1010,1675,2020-03-19 22:35:00,0,4701.0,2504.0,0.533,21.294,400,266,195,71,134,98,36,66,0.0,0.0
1010,1676,2020-03-19 22:38:00,0,4641.0,2488.0,0.536,21.042,566,372,303,69,194,157,37,199,0.0,0.0
1010,1677,2020-03-19 22:41:00,0,4644.0,2525.0,0.544,21.095,889,598,506,92,291,229,62,239,0.0,0.0
1010,1678,2020-03-19 22:44:00,0,4540.0,2543.0,0.56,20.704,794,480,403,77,314,248,66,211,0.0,0.0
1010,1679,2020-03-19 22:47:00,0,4560.0,2507.0,0.55,20.745,711,442,365,77,269,203,66,154,0.0,0.0
1010,1680,2020-03-19 22:50:00,0,4292.0,2436.0,0.568,19.609,550,355,296,59,195,144,51,152,0.0,0.0
1010,1681,2020-03-19 22:53:00,0,4566.0,2510.0,0.55,20.77,649,406,331,75,243,200,43,190,0.0,0.0
1010,1682,2020-03-19 22:56:00,0,4312.0,2457.0,0.57,19.71,552,317,253,64,235,186,49,118,0.0,0.0
1010,1683,2020-03-19 22:59:00,0,4310.0,2471.0,0.573,19.72,689,429,351,78,260,205,55,195,0.0,0.0
1010,1684,2020-03-19 23:02:00,0,4365.0,2532.0,0.58,20.001,675,407,314,93,268,202,66,183,0.0,0.0
1010,1685,2020-03-19 23:05:00,0,4272.0,2476.0,0.58,19.574,658,385,319,66,273,212,61,147,0.0,0.0
1010,1686,2020-03-19 23:08:00,0,4294.0,2488.0,0.58,19.675,624,413,347,66,211,173,38,161,0.0,0.0
1010,1687,2020-03-19 23:11:00,0,4295.0,2590.0,0.603,19.793,425,278,230,48,147,103,44,172,0.03,0.0
1010,1688,2020-03-19 23:14:00,0,4509.0,2650.0,0.588,20.699,776,482,392,90,294,229,65,138,0.0,0.0
1010,1689,2020-03-19 23:17:00,0,4006.0,2624.5,0.665,18.6885,738,463,386,77,275,225,50,198,0.0,0.0
1010,1690,2020-03-19 23:20:00,0,3503.0,2599.0,0.742,16.678,478,239,184,55,239,169,70,136,0.0,0.0
1010,1691,2020-03-19 23:23:00,0,3495.0,2522.0,0.722,16.564,450,258,207,51,192,151,41,136,0.0,0.0
1010,1692,2020-03-19 23:26:00,0,3511.0,2567.0,0.731,16.677,456,274,221,53,182,137,45,161,0.0,0.0
1010,1693,2020-03-19 23:29:00,0,3324.0,2518.0,0.757,15.885,398,226,160,66,172,123,49,116,0.0,0.0
1010,1694,2020-03-19 23:32:00,0,3340.0,2553.0,0.764,15.986,485,299,251,48,186,150,36,151,0.0,0.0
1010,1695,2020-03-19 23:35:00,0,3502.0,2585.0,0.738,16.659,502,328,261,67,174,123,51,126,0.0,0.0
1010,1696,2020-03-19 23:38:00,0,3651.0,2714.0,0.743,17.392,351,224,165,59,127,94,33,71,0.0,0.0
1010,1697,2020-03-19 23:41:00,0,3307.0,2471.0,0.747,15.766,332,215,152,63,117,73,44,56,0.0,0.0
1010,1698,2020-03-19 23:44:00,0,3257.0,2428.0,0.746,15.519,308,184,129,55,124,77,47,68,0.0,0.0
1010,1699,2020-03-19 23:47:00,0,3379.0,2550.0,0.755,16.137,617,402,328,74,215,164,51,179,0.0,0.0
1010,1700,2020-03-19 23:50:00,0,3328.0,2505.0,0.753,15.887,366,205,151,54,161,111,50,124,0.0,0.0
1010,1701,2020-03-19 23:53:00,0,3334.0,2523.0,0.757,15.93,606,383,308,75,223,161,62,117,0.0,0.0
1010,1702,2020-03-19 23:56:00,0,3196.0,2474.0,0.774,15.334,554,361,285,76,193,146,47,118,0.0,0.0
1010,1703,2020-03-19 23:59:00,0,3103.0,2442.0,0.787,14.93,575,372,304,68,203,156,47,180,0.0,0.0
1010,1704,2020-03-20 00:02:00,0,3170.0,2446.0,0.772,15.199,206,148,88,60,58,26,32,63,0.0,0.0
1010,1705,2020-03-20 00:05:00,0,3176.0,2495.0,0.786,15.276,386,226,172,54,160,118,42,140,0.0,0.0
1010,1706,2020-03-20 00:08:00,0,3078.0,2526.0,0.821,14.925,333,217,158,59,116,67,49,23,0.0,0.0
1010,1707,2020-03-20 00:11:00,0,2862.0,2312.0,0.808,13.837,545,359,288,71,186,142,44,81,0.0,0.0
1010,1708,2020-03-20 00:14:00,0,2841.0,2347.0,0.826,13.792,291,175,126,49,116,71,45,75,0.0,0.0
1010,1709,2020-03-20 00:17:00,0,2881.0,2349.0,0.816,13.951,659,473,388,85,186,138,48,125,0.0,0.0
1010,1710,2020-03-20 00:20:00,0,2928.0,2331.0,0.796,14.116,312,207,164,43,105,56,49,50,0.0,0.0
1010,1711,2020-03-20 00:23:00,0,2877.0,2328.0,0.809,13.915,193,106,64,42,87,40,47,33,0.0,0.0
1010,1712,2020-03-20 00:26:00,0,2997.0,2457.0,0.82,14.528,632,403,321,82,229,174,55,119,0.0,0.0
1010,1713,2020-03-20 00:29:00,0,2720.0,2260.0,0.831,13.22,325,203,133,70,122,66,56,45,0.0,0.0
1010,1714,2020-03-20 00:32:00,0,2879.0,2341.0,0.813,13.934,515,360,281,79,155,106,49,95,0.0,0.0
1010,1715,2020-03-20 00:35:00,0,2772.0,2320.0,0.837,13.489,384,266,221,45,118,94,24,129,0.0,0.0
1010,1716,2020-03-20 00:38:00,0,2710.0,2324.0,0.857,13.251,381,226,165,61,155,98,57,19,0.0,0.02
1010,1717,2020-03-20 00:41:00,0,2677.0,2305.0,0.861,13.099,406,258,200,58,148,105,43,178,0.0,0.0
1010,1718,2020-03-20 00:44:00,0,2676.0,2307.0,0.862,13.097,507,316,262,54,191,143,48,122,0.0,0.0
1010,1719,2020-03-20 00:47:00,0,2519.0,2280.0,0.905,12.448,449,279,224,55,170,122,48,123,0.0,0.0
1010,1720,2020-03-20 00:50:00,0,2513.0,2308.0,0.918,12.457,322,224,174,50,98,78,20,72,0.0,0.0
1010,1721,2020-03-20 00:53:00,0,2612.0,2338.0,0.895,12.882,540,368,289,79,172,132,40,81,0.0,0.0
1010,1722,2020-03-20 00:56:00,0,2559.0,2268.0,0.887,12.592,275,200,157,43,75,41,34,80,0.0,0.0
1010,1723,2020-03-20 00:59:00,0,2281.0,2216.0,0.972,11.441,137,84,42,42,53,27,26,22,0.0,0.0
1010,1724,2020-03-20 01:02:00,0,2529.0,2317.0,0.916,12.528,458,327,264,63,131,91,40,121,0.0,0.0
1010,1725,2020-03-20 01:05:00,0,2274.0,2198.0,0.966,11.393,67,53,15,38,14,3,11,2,0.0,0.0
1010,1726,2020-03-20 01:08:00,0,2289.0,2204.0,0.963,11.457,203,115,67,48,88,46,42,34,0.0,0.0
1010,1727,2020-03-20 01:11:00,0,2145.0,2116.0,0.987,10.794,348,207,158,49,141,93,48,66,0.0,0.0
1010,1728,2020-03-20 01:14:00,0,2524.0,2323.0,0.921,12.516,442,282,218,64,160,122,38,74,0.0,0.0
1010,1729,2020-03-20 01:17:00,0,2143.0,2083.0,0.972,10.747,589,397,338,59,192,156,36,197,0.0,0.0
1010,1730,2020-03-20 01:20:00,0,2449.0,2290.0,0.935,12.186,333,183,144,39,150,103,47,47,0.38,0.0
1010,1731,2020-03-20 01:23:00,0,2523.0,2306.0,0.914,12.493,473,303,251,52,170,126,44,100,0.0,0.0
1010,1732,2020-03-20 01:26:00,0,2526.0,2266.0,0.897,12.462,364,240,184,56,124,83,41,80,0.0,0.0
1010,1733,2020-03-20 01:29:00,0,2524.0,2308.0,0.914,12.5,336,210,161,49,126,92,34,86,0.0,0.0
1010,1734,2020-03-20 01:32:00,0,2644.0,2382.0,0.901,13.054,600,387,304,83,213,167,46,118,0.0,0.0
1010,1735,2020-03-20 01:35:00,0,2586.0,2387.0,0.923,12.833,527,326,270,56,201,149,52,124,0.04,0.0
1010,1736,2020-03-20 01:38:00,0,2672.0,2391.0,0.895,13.176,666,400,316,84,266,214,52,195,0.0,0.0
1010,1737,2020-03-20 01:41:00,0,2606.0,2388.0,0.917,12.912,203,119,71,48,84,34,50,50,0.0,0.0
1010,1738,2020-03-20 01:44:00,0,2523.0,2378.0,0.942,12.572,412,266,199,67,146,108,38,78,0.0,0.0
1010,1739,2020-03-20 01:47:00,0,2497.0,2384.0,0.955,12.478,416,276,226,50,140,103,37,86,0.0,0.0
1010,1740,2020-03-20 01:50:00,0,2281.0,2252.0,0.987,11.479,279,182,138,44,97,64,33,18,0.0,0.0
1010,1741,2020-03-20 01:53:00,0,2269.0,2272.0,1.001,11.454,581,352,285,67,229,178,51,112,0.0,0.0
1010,1742,2020-03-20 01:56:00,0,2291.0,2207.0,0.963,11.469,440,275,216,59,165,125,40,16,0.0,0.0
1010,1743,2020-03-20 01:59:00,0,2315.0,2178.0,0.941,11.531,273,194,150,44,79,47,32,14,0.0,0.0
1010,1744,2020-03-20 02:02:00,0,2443.0,2283.0,0.935,12.152,145,73,36,37,72,23,49,67,0.0,0.0
1010,1745,2020-03-20 02:05:00,0,2462.0,2284.0,0.928,12.229,470,287,232,55,183,130,53,32,0.0,0.0
1010,1746,2020-03-20 02:08:00,0,2493.0,2351.0,0.943,12.427,358,219,163,56,139,98,41,19,0.0,0.0
1010,1747,2020-03-20 02:11:00,0,2136.0,2109.0,0.987,10.751,591,352,279,73,239,180,59,91,0.0,0.01
1010,1748,2020-03-20 02:14:00,0,2289.0,2192.0,0.958,11.446,587,368,298,70,219,168,51,70,0.0,0.0
1010,1749,2020-03-20 02:17:00,0,2680.0,2190.0,0.835,12.985,271,172,125,47,99,70,29,84,0.0,0.0
1010,1750,2020-03-20 02:20:00,0,3071.0,2188.0,0.712,14.524,454,267,213,54,187,143,44,123,0.0,0.0
1010,1751,2020-03-20 02:23:00,0,3060.0,2224.0,0.727,14.52,557,337,269,68,220,181,39,196,0.0,0.0
1010,1752,2020-03-20 02:26:00,0,3277.0,2351.0,0.717,15.514,406,259,212,47,147,110,37,88,0.18,0.0
1010,1753,2020-03-20 02:29:00,0,3071.0,2235.0,0.728,14.575,361,231,175,56,130,97,33,44,0.0,0.0
1010,1754,2020-03-20 02:32:00,0,2859.0,2040.0,0.713,13.524,196,149,98,51,47,21,26,36,0.0,0.0
1010,1755,2020-03-20 02:35:00,0,3052.0,2291.0,0.751,14.561,122,63,35,28,59,33,26,19,0.0,0.0
1010,1756,2020-03-20 02:38:00,0,2867.0,2016.0,0.703,13.528,0,0,0,0,0,0,0,0,0.0,0.0
1010,1757,2020-03-20 02:41:00,0,2705.0,1895.0,0.701,12.754,0,0,0,0,0,0,0,0,0.0,0.0
1010,1758,2020-03-20 02:44:00,0,2561.0,1833.0,0.716,12.121,0,0,0,0,0,0,0,0,0.0,0.0
1010,1759,2020-03-20 02:47:00,0,2491.0,1777.0,0.713,11.782,252,146,107,39,106,70,36,23,0.0,0.0
1010,1760,2020-03-20 02:50:00,0,2050.0,1465.0,0.715,9.701,236,175,114,61,61,40,21,77,0.0,0.0
1010,1761,2020-03-20 02:53:00,0,2558.0,1891.0,0.739,12.174,248,168,124,44,80,59,21,37,0.0,0.0
1010,1762,2020-03-20 02:56:00,0,2571.0,1813.0,0.705,12.138,371,226,166,60,145,99,46,39,0.0,0.0
1010,1763,2020-03-20 02:59:00,0,2674.0,1911.0,0.715,12.654,162,107,55,52,55,32,23,4,0.0,0.0
1010,1764,2020-03-20 03:02:00,0,2717.0,1949.0,0.717,12.865,514,327,271,56,187,144,43,182,0.0,0.0
1010,1765,2020-03-20 03:05:00,0,2730.0,1956.0,0.716,12.924,198,100,67,33,98,53,45,18,0.0,0.0
1010,1766,2020-03-20 03:08:00,0,2715.0,1975.0,0.727,12.884,133,71,39,32,62,41,21,1,0.0,0.0
1010,1767,2020-03-20 03:11:00,0,2708.0,2031.0,0.75,12.917,134,76,59,17,58,39,19,1,0.0,0.0
1010,1768,2020-03-20 03:14:00,0,2697.0,1927.0,0.715,12.759,378,255,193,62,123,83,40,10,0.12,0.0
1010,1769,2020-03-20 03:17:00,0,2539.0,1845.0,0.727,12.046,256,165,121,44,91,61,30,28,0.0,0.0
1010,1770,2020-03-20 03:20:00,0,2636.0,1922.0,0.729,12.516,45,29,20,9,16,9,7,10,0.0,0.0
1010,1771,2020-03-20 03:23:00,0,2487.0,1770.0,0.712,11.758,0,0,0,0,0,0,0,0,0.0,0.0
1010,1772,2020-03-20 03:26:00,0,2365.0,1657.0,0.701,11.152,203,136,102,34,67,47,20,3,0.0,0.0
1010,1773,2020-03-20 03:29:00,0,2339.0,1664.0,0.711,11.059,355,244,200,44,111,76,35,136,0.0,0.0
1010,1774,2020-03-20 03:32:00,0,2487.0,1775.0,0.714,11.765,259,127,73,54,132,90,42,10,0.1,0.0
1010,1775,2020-03-20 03:35:00,0,2338.0,1657.0,0.709,11.044,84,41,19,22,43,20,23,18,0.0,0.0
1010,1776,2020-03-20 03:38:00,0,2938.0,2012.0,0.685,13.803,130,89,59,30,41,25,16,26,0.0,0.0
1010,1777,2020-03-20 03:41:00,0,2348.0,1612.0,0.687,11.036,423,250,185,65,173,124,49,51,0.0,0.0
1010,1778,2020-03-20 03:44:00,0,2349.0,1672.0,0.712,11.106,70,47,20,27,23,9,14,0,0.0,0.0
1010,1779,2020-03-20 03:47:00,0,2562.0,1773.0,0.692,12.06,0,0,0,0,0,0,0,0,0.0,0.0
1010,1780,2020-03-20 03:50:00,0,2334.0,1622.0,0.695,10.991,0,0,0,0,0,0,0,0,0.0,0.0
1010,1781,2020-03-20 03:53:00,0,2217.0,1556.0,0.702,10.458,0,0,0,0,0,0,0,0,0.0,0.0
1010,1782,2020-03-20 03:56:00,0,1967.0,1463.0,0.744,9.368,0,0,0,0,0,0,0,0,0.0,0.0
1010,1783,2020-03-20 03:59:00,0,2001.0,1403.0,0.701,9.436,0,0,0,0,0,0,0,0,0.0,0.0
1010,1784,2020-03-20 04:02:00,0,1908.0,1318.0,0.691,8.976,5,2,1,1,3,1,2,0,0.0,0.0
1010,1785,2020-03-20 04:05:00,0,1835.0,1331.0,0.726,8.703,2,1,0,1,1,0,1,0,0.0,0.0
1010,1786,2020-03-20 04:08:00,0,1986.0,1375.0,0.693,9.347,0,0,0,0,0,0,0,0,0.0,0.0
1010,1787,2020-03-20 04:11:00,0,2000.0,1374.0,0.687,9.4,0,0,0,0,0,0,0,0,0.0,0.0
1010,1788,2020-03-20 04:14:00,0,1815.0,1328.0,0.732,8.624,0,0,0,0,0,0,0,0,0.0,0.0
1010,1789,2020-03-20 04:17:00,0,1824.0,1302.0,0.714,8.629,0,0,0,0,0,0,0,0,0.0,0.0
1010,1790,2020-03-20 04:20:00,0,1836.0,1261.0,0.687,8.631,0,0,0,0,0,0,0,0,0.0,0.0
1010,1791,2020-03-20 04:23:00,0,1841.0,1303.0,0.708,8.695,467,280,217,63,187,146,41,23,0.0,0.0
1010,1792,2020-03-20 04:26:00,0,1897.0,1396.0,0.736,9.02,684,391,320,71,293,224,69,164,0.0,0.0
1010,1793,2020-03-20 04:29:00,0,2181.0,1586.0,0.727,10.35,671,424,354,70,247,195,52,201,0.0,0.0
1010,1794,2020-03-20 04:32:00,0,2541.0,1890.0,0.744,12.103,616,378,314,64,238,180,58,147,0.0,0.0
1010,1795,2020-03-20 04:35:00,0,2682.0,2006.0,0.748,12.787,482,287,214,73,195,142,53,89,0.0,0.0
1010,1796,2020-03-20 04:38:00,0,2914.0,2100.0,0.721,13.807,348,223,164,59,125,86,39,104,0.0,0.0
1010,1797,2020-03-20 04:41:00,0,3044.0,2271.0,0.746,14.508,256,163,116,47,93,63,30,55,0.0,0.0
1010,1798,2020-03-20 04:44:00,0,2942.0,2074.0,0.705,13.888,317,175,131,44,142,94,48,42,0.0,0.0
1010,1799,2020-03-20 04:47:00,0,2930.0,2149.0,0.733,13.925,367,213,156,57,154,113,41,75,0.0,0.0
1010,1800,2020-03-20 04:50:00,0,2853.0,2069.0,0.725,13.53,138,89,50,39,49,24,25,6,0.0,0.0
1010,1801,2020-03-20 04:53:00,0,2936.0,2106.0,0.717,13.899,413,265,204,61,148,112,36,103,0.0,0.0
1010,1802,2020-03-20 04:56:00,0,2908.0,2122.0,0.73,13.806,157,97,61,36,60,31,29,1,0.0,0.0
1010,1803,2020-03-20 04:59:00,0,2928.0,2114.0,0.722,13.876,365,209,166,43,156,111,45,38,0.08,0.0
1010,1804,2020-03-20 05:02:00,0,2899.0,2136.0,0.737,13.786,259,160,123,37,99,71,28,28,0.07,0.0
1010,1805,2020-03-20 05:05:00,0,2858.0,2074.0,0.726,13.558,121,81,39,42,40,17,23,3,0.02,0.0
1010,1806,2020-03-20 05:08:00,0,2562.0,1848.0,0.721,12.143,57,40,15,25,17,6,11,3,0.0,0.0
1010,1807,2020-03-20 05:11:00,0,2918.0,2126.0,0.729,13.851,418,235,175,60,183,129,54,9,0.01,0.0
1010,1808,2020-03-20 05:14:00,0,2689.0,1961.0,0.729,12.766,202,105,75,30,97,60,37,0,0.0,0.0
1010,1809,2020-03-20 05:17:00,0,2695.0,1957.5,0.726,12.7855,291,186,148,38,105,75,30,99,0.02,0.0
1010,1810,2020-03-20 05:20:00,0,2701.0,1954.0,0.723,12.805,349,197,136,61,152,95,57,16,0.0,0.0
1010,1811,2020-03-20 05:23:00,0,2529.0,1875.0,0.741,12.042,233,167,128,39,66,45,21,2,0.0,0.0
1010,1812,2020-03-20 05:26:00,0,2473.0,1810.0,0.732,11.75,103,74,27,47,29,5,24,2,0.0,0.0
1010,1813,2020-03-20 05:29:00,0,2391.0,1772.0,0.741,11.384,321,217,145,72,104,58,46,10,0.0,0.0
1010,1814,2020-03-20 05:32:00,0,2392.0,1800.0,0.753,11.418,746,519,417,102,227,167,60,0,0.16,0.0
1010,1815,2020-03-20 05:35:00,0,2315.0,1778.0,0.768,11.089,15,13,1,12,2,1,1,1,0.0,0.0
1010,1816,2020-03-20 05:38:00,0,2174.0,1677.0,0.771,10.423,1,0,0,0,1,0,1,0,0.0,0.0
1010,1817,2020-03-20 05:41:00,0,2114.0,1539.0,0.728,10.034,3,2,1,1,1,0,1,0,0.0,0.0
1010,1818,2020-03-20 05:44:00,0,1976.0,1435.0,0.726,9.374,1,0,0,0,1,0,1,0,0.0,0.0
1010,1819,2020-03-20 05:47:00,0,1826.0,1345.0,0.736,8.682,21,0,0,0,21,0,21,0,0.0,0.0
1010,1820,2020-03-20 05:50:00,0,1745.0,1293.0,0.741,8.306,3,0,0,0,3,0,3,0,0.0,0.0
1010,1821,2020-03-20 05:53:00,0,1600.0,1237.0,0.773,7.673,5,0,0,0,5,0,5,0,0.0,0.0
1010,1822,2020-03-20 05:56:00,0,1613.0,1167.0,0.723,7.648,50,0,0,0,50,0,50,0,0.0,0.0
1010,1823,2020-03-20 05:59:00,0,1450.0,1116.0,0.77,6.947,7,0,0,0,7,0,7,0,0.0,0.0
1010,1824,2020-03-20 06:02:00,1,1452.0,1098.0,0.756,6.938,1,0,0,0,1,0,1,0,0.0,0.0
1010,1825,2020-03-20 06:05:00,1,1469.0,1062.0,0.723,6.964,0,0,0,0,0,0,0,0,0.0,0.0
1010,1826,2020-03-20 06:08:00,1,1308.0,1010.0,0.773,6.27,5,5,0,5,0,0,0,0,0.0,0.0
1010,1827,2020-03-20 06:11:00,1,1231.0,945.0,0.768,5.899,17,17,3,14,0,0,0,0,0.0,0.0
1010,1828,2020-03-20 06:14:00,1,1232.0,971.0,0.788,5.93,0,0,0,0,0,0,0,0,0.0,0.0
1010,1829,2020-03-20 06:17:00,1,1312.0,986.0,0.751,6.261,439,273,211,62,166,133,33,58,0.0,0.0
1010,1830,2020-03-20 06:20:00,1,2188.0,1581.0,0.723,10.37,297,209,145,64,88,57,31,40,0.0,0.0
1010,1831,2020-03-20 06:23:00,1,2563.0,1895.0,0.74,12.196,89,76,28,48,13,5,8,72,0.0,0.0
1010,1832,2020-03-20 06:26:00,1,2898.0,2210.0,0.763,13.866,160,133,61,72,27,8,19,85,0.0,0.0
1010,1833,2020-03-20 06:29:00,1,3249.0,2523.0,0.777,15.596,317,221,162,59,96,65,31,81,0.05,0.06
1010,1834,2020-03-20 06:32:00,1,3241.0,2544.0,0.785,15.584,334,206,138,68,128,92,36,56,0.0,0.08
1010,1835,2020-03-20 06:35:00,1,3408.0,2661.0,0.781,16.375,519,389,297,92,130,97,33,35,0.19,0.01
1010,1836,2020-03-20 06:38:00,1,3387.0,2754.0,0.813,16.394,418,310,229,81,108,77,31,111,0.14,0.08
1010,1837,2020-03-20 06:41:00,1,3359.0,2734.0,0.814,16.263,208,174,115,59,34,12,22,73,0.0,0.05
1010,1838,2020-03-20 06:44:00,1,3378.0,2794.0,0.827,16.403,150,87,54,33,63,30,33,69,0.16,0.06
1010,1839,2020-03-20 06:47:00,1,3439.0,2851.0,0.829,16.707,284,170,107,63,114,67,47,79,0.01,0.11
1010,1840,2020-03-20 06:50:00,1,3575.0,2949.0,0.825,17.351,162,121,60,61,41,5,36,100,0.0,0.0
1010,1841,2020-03-20 06:53:00,1,3394.0,2939.0,0.866,16.627,537,372,290,82,165,114,51,74,0.29,0.05
1010,1842,2020-03-20 06:56:00,1,3528.0,3081.0,0.873,17.311,237,158,103,55,79,26,53,61,0.0,0.0
1010,1843,2020-03-20 06:59:00,1,3571.0,3067.0,0.859,17.468,128,86,46,40,42,19,23,64,0.18,0.0
1010,1844,2020-03-20 07:02:00,1,3654.0,3199.0,0.876,17.938,129,73,30,43,56,13,43,53,0.0,0.08
1010,1845,2020-03-20 07:05:00,1,3320.0,2959.0,0.891,16.355,371,212,162,50,159,118,41,66,0.09,0.04
1010,1846,2020-03-20 07:08:00,1,3552.0,3114.0,0.877,17.444,226,163,108,55,63,38,25,50,0.06,0.06
1010,1847,2020-03-20 07:11:00,1,3523.0,3175.0,0.901,17.395,432,330,257,73,102,69,33,71,0.11,0.01
1010,1848,2020-03-20 07:14:00,1,3517.0,3156.0,0.897,17.351,440,304,227,77,136,106,30,83,0.04,0.07
1010,1849,2020-03-20 07:17:00,1,3483.0,3186.0,0.915,17.249,234,176,106,70,58,30,28,93,0.0,0.0
1010,1850,2020-03-20 07:20:00,1,3523.0,3277.0,0.93,17.509,238,180,112,68,58,13,45,81,0.0,0.0
1010,1851,2020-03-20 07:23:00,1,3269.0,3164.0,0.968,16.381,358,284,198,86,74,52,22,73,0.12,0.08
1010,1852,2020-03-20 07:26:00,1,3549.0,3372.0,0.95,17.715,406,298,219,79,108,82,26,47,0.0,0.14
1010,1853,2020-03-20 07:29:00,1,3477.0,3303.0,0.95,17.358,200,158,90,68,42,9,33,81,0.0,0.0
1010,1854,2020-03-20 07:32:00,1,3641.0,3442.0,0.945,18.156,222,90,41,49,132,80,52,19,0.0,0.0
1010,1855,2020-03-20 07:35:00,1,3622.0,3500.0,0.966,18.145,145,55,27,28,90,40,50,20,0.34,0.02
1010,1856,2020-03-20 07:38:00,1,3725.0,3560.0,0.956,18.619,758,512,423,89,246,187,59,44,0.0,0.01
1010,1857,2020-03-20 07:41:00,1,2905.0,2873.0,0.989,14.626,737,457,367,90,280,213,67,49,0.0,0.04
1010,1858,2020-03-20 07:44:00,1,3448.0,3357.0,0.974,17.302,100,59,24,35,41,19,22,20,0.0,0.04
1010,1859,2020-03-20 07:47:00,1,3588.0,3474.0,0.968,17.982,127,72,34,38,55,28,27,27,0.0,0.07
1010,1860,2020-03-20 07:50:00,1,3623.0,3512.0,0.969,18.163,85,42,25,17,43,18,25,21,0.16,0.06
1010,1861,2020-03-20 07:53:00,1,3268.0,3224.0,0.987,16.444,366,240,188,52,126,88,38,3,0.0,0.0
1010,1862,2020-03-20 07:56:00,1,3235.0,3194.0,0.987,16.282,755,486,391,95,269,215,54,0,0.11,0.0
1010,1863,2020-03-20 07:59:00,1,2902.0,2824.0,0.973,14.561,79,37,19,18,42,17,25,0,0.0,0.0
1010,1864,2020-03-20 08:02:00,1,2911.0,2812.0,0.966,14.582,2,1,1,0,1,0,1,0,0.0,0.0
1010,1865,2020-03-20 08:05:00,1,3086.0,2872.0,0.93,15.339,14,8,2,6,6,1,5,0,0.0,0.0
1010,1866,2020-03-20 08:08:00,1,3003.0,2858.0,0.951,14.997,2,2,0,2,0,0,0,0,0.0,0.01
1010,1867,2020-03-20 08:11:00,1,2919.0,2826.0,0.968,14.631,0,0,0,0,0,0,0,0,0.0,0.0
1010,1868,2020-03-20 08:14:00,1,2932.0,2719.0,0.927,14.563,0,0,0,0,0,0,0,0,0.0,0.0
1010,1869,2020-03-20 08:17:00,1,2863.5,2653.5,0.9265,14.2195,13,7,0,7,6,3,3,0,0.0,0.0
1010,1870,2020-03-20 08:20:00,1,2795.0,2588.0,0.926,13.876,3,3,0,3,0,0,0,0,0.0,0.0
1010,1871,2020-03-20 08:23:00,1,2730.0,2554.0,0.936,13.584,9,7,2,5,2,1,1,0,0.0,0.0
1010,1872,2020-03-20 08:26:00,1,2778.0,2588.0,0.932,13.81,263,162,107,55,101,65,36,16,0.18,0.0
1010,1873,2020-03-20 08:29:00,1,2783.0,2676.0,0.961,13.929,4,1,0,1,3,0,3,0,0.0,0.0
1010,1874,2020-03-20 08:32:00,1,2718.0,2581.0,0.95,13.565,3,0,0,0,3,0,3,0,0.0,0.01
1010,1875,2020-03-20 08:35:00,1,2567.0,2500.0,0.974,12.882,57,33,10,23,24,12,12,0,0.0,0.0
1010,1876,2020-03-20 08:38:00,1,2639.0,2580.0,0.978,13.254,213,149,89,60,64,28,36,19,0.0,0.0
1010,1877,2020-03-20 08:41:00,1,2886.0,2850.0,0.988,14.526,123,109,51,58,14,4,10,78,0.0,0.03
1010,1878,2020-03-20 08:44:00,1,3106.0,3048.0,0.981,15.61,104,52,15,37,52,29,23,44,0.0,0.09
1010,1879,2020-03-20 08:47:00,1,3244.0,3185.0,0.982,16.308,94,59,15,44,35,12,23,42,0.0,0.04
1010,1880,2020-03-20 08:50:00,1,3390.0,3258.0,0.961,16.963,146,80,37,43,66,39,27,67,0.11,0.06
1010,1881,2020-03-20 08:53:00,1,3382.0,3253.0,0.962,16.928,1165,751,623,128,414,309,105,20,0.03,0.04
1010,1882,2020-03-20 08:56:00,1,3467.0,3317.0,0.957,17.333,220,156,86,70,64,22,42,71,0.0,0.0
1010,1883,2020-03-20 08:59:00,1,3375.0,3261.0,0.966,16.906,96,74,44,30,22,12,10,56,0.06,0.05
1010,1884,2020-03-20 09:02:00,1,3217.0,3173.0,0.986,16.189,62,31,25,6,31,23,8,2,0.06,0.01
1010,1885,2020-03-20 09:05:00,1,2783.0,2645.0,0.951,13.892,4,0,0,0,4,2,2,0,0.0,0.0
1010,1886,2020-03-20 09:08:00,1,2898.0,2853.0,0.984,14.577,1,0,0,0,1,0,1,0,0.0,0.0
1010,1887,2020-03-20 09:11:00,1,2912.0,2834.0,0.973,14.61,146,89,57,32,57,36,21,18,0.0,0.0
1010,1888,2020-03-20 09:14:00,1,2887.0,2894.0,1.002,14.577,139,81,50,31,58,33,25,11,0.11,0.0
1010,1889,2020-03-20 09:17:00,1,2747.0,2750.0,1.001,13.867,26,25,0,25,1,0,1,0,0.0,0.0
1010,1890,2020-03-20 09:20:00,1,2755.0,2724.0,0.989,13.873,0,0,0,0,0,0,0,0,0.0,0.0
1010,1891,2020-03-20 09:23:00,1,2764.0,2663.0,0.963,13.838,21,17,10,7,4,2,2,0,0.0,0.0
1010,1892,2020-03-20 09:26:00,1,2674.0,2674.0,1.0,13.496,5,4,0,4,1,1,0,0,0.0,0.0
1010,1893,2020-03-20 09:29:00,1,2550.0,2608.0,1.023,12.934,9,2,0,2,7,0,7,0,0.0,0.0
1010,1894,2020-03-20 09:32:00,1,2526.0,2538.0,1.005,12.761,149,82,63,19,67,46,21,1,0.0,0.01
1010,1895,2020-03-20 09:35:00,1,2544.0,2592.0,1.019,12.893,0,0,0,0,0,0,0,0,0.0,0.0
1010,1896,2020-03-20 09:38:00,1,2466.0,2545.0,1.032,12.533,25,7,3,4,18,7,11,0,0.0,0.0
1010,1897,2020-03-20 09:41:00,1,2414.0,2455.0,1.017,12.229,63,63,41,22,0,0,0,0,0.0,0.0
1010,1898,2020-03-20 09:44:00,1,2400.0,2411.0,1.005,12.125,17,10,3,7,7,3,4,0,0.0,0.0
1010,1899,2020-03-20 09:47:00,1,2162.0,2392.0,1.106,11.166,21,9,3,6,12,3,9,0,0.0,0.0
1010,1900,2020-03-20 09:50:00,1,2161.0,2351.0,1.088,11.117,39,31,16,15,8,3,5,0,0.0,0.0
1010,1901,2020-03-20 09:53:00,1,2168.0,2405.0,1.109,11.204,276,198,127,71,78,36,42,35,0.0,0.0
1010,1902,2020-03-20 09:56:00,1,2676.0,2721.0,1.017,13.554,206,132,74,58,74,34,40,79,0.0,0.0
1010,1903,2020-03-20 09:59:00,1,2873.0,2980.0,1.037,14.616,273,181,113,68,92,57,35,109,0.0,0.01
1010,1904,2020-03-20 10:02:00,1,2845.0,3093.0,1.087,14.631,79,60,35,25,19,7,12,44,0.0,0.02
1010,1905,2020-03-20 10:05:00,1,3207.0,3307.0,1.031,16.296,217,175,110,65,42,24,18,56,0.0,0.05
1010,1906,2020-03-20 10:08:00,1,3213.0,3304.0,1.028,16.315,121,67,27,40,54,17,37,44,0.0,0.0
1010,1907,2020-03-20 10:11:00,1,3411.0,3510.0,1.029,17.326,93,64,19,45,29,0,29,32,0.0,0.1
1010,1908,2020-03-20 10:14:00,1,3423.0,3463.0,1.011,17.321,185,112,84,28,73,52,21,19,0.37,0.1
1010,1909,2020-03-20 10:17:00,1,3027.0,3110.0,1.027,15.368,969,638,518,120,331,248,83,61,0.02,0.05
1010,1910,2020-03-20 10:20:00,1,3434.0,3450.0,1.005,17.348,175,131,76,55,44,20,24,69,0.0,0.01
1010,1911,2020-03-20 10:23:00,1,3421.0,3532.0,1.032,17.39,82,54,22,32,28,5,23,32,0.0,0.06
1010,1912,2020-03-20 10:26:00,1,3392.0,3543.0,1.044,17.287,438,292,226,66,146,104,42,31,0.35,0.06
1010,1913,2020-03-20 10:29:00,1,3078.0,3169.0,1.029,15.635,1116,723,597,126,393,296,97,2,0.0,0.03
1010,1914,2020-03-20 10:32:00,1,3440.0,3423.0,0.995,17.343,604,387,305,82,217,163,54,10,0.0,0.0
1010,1915,2020-03-20 10:35:00,1,2961.0,2959.0,0.999,14.942,185,117,61,56,68,47,21,0,0.0,0.0
1010,1916,2020-03-20 10:38:00,1,3237.0,3197.0,0.988,16.291,12,10,6,4,2,0,2,0,0.0,0.0
1010,1917,2020-03-20 10:41:00,1,3267.0,3211.0,0.983,16.427,0,0,0,0,0,0,0,0,0.0,0.0
1010,1918,2020-03-20 10:44:00,1,3177.0,3138.0,0.988,15.99,6,5,0,5,1,0,1,0,0.0,0.0
1010,1919,2020-03-20 10:47:00,1,2895.0,2958.0,1.022,14.679,0,0,0,0,0,0,0,0,0.0,0.0
1010,1920,2020-03-20 10:50:00,1,2747.0,2759.0,1.004,13.877,10,4,3,1,6,2,4,0,0.0,0.0
1010,1921,2020-03-20 10:53:00,1,2792.0,2682.0,0.96,13.971,1,1,0,1,0,0,0,0,0.0,0.0
1010,1922,2020-03-20 10:56:00,1,2693.0,2612.0,0.97,13.501,3,3,0,3,0,0,0,0,0.0,0.0
1010,1923,2020-03-20 10:59:00,1,2564.0,2503.0,0.976,12.875,4,4,0,4,0,0,0,0,0.0,0.0
1010,1924,2020-03-20 11:02:00,1,2401.0,2379.0,0.991,12.092,1,1,0,1,0,0,0,0,0.0,0.0
1010,1925,2020-03-20 11:05:00,1,2434.0,2350.0,0.965,12.193,1,1,0,1,0,0,0,0,0.0,0.0
1010,1926,2020-03-20 11:08:00,1,2335.0,2275.0,0.974,11.718,6,6,0,6,0,0,0,0,0.0,0.0
1010,1927,2020-03-20 11:11:00,1,2276.0,2297.0,1.009,11.51,2,2,0,2,0,0,0,0,0.0,0.0
1010,1928,2020-03-20 11:14:00,1,2268.0,2289.0,1.009,11.472,0,0,0,0,0,0,0,0,0.0,0.0
1010,1929,2020-03-20 11:17:00,1,2259.5,2304.5,1.02,11.454,34,24,12,12,10,3,7,0,0.0,0.0
1010,1930,2020-03-20 11:20:00,1,2251.0,2320.0,1.031,11.436,8,5,1,4,3,0,3,0,0.0,0.0
1010,1931,2020-03-20 11:23:00,1,2187.0,2231.0,1.02,11.085,24,16,8,8,8,2,6,0,0.0,0.0
1010,1932,2020-03-20 11:26:00,1,2174.0,2269.0,1.044,11.076,7,7,0,7,0,0,0,0,0.0,0.0
1010,1933,2020-03-20 11:29:00,1,2279.0,2316.0,1.016,11.544,10,10,0,10,0,0,0,0,0.0,0.0
1010,1934,2020-03-20 11:32:00,1,2202.0,2275.0,1.033,11.194,23,22,7,15,1,0,1,0,0.0,0.0
1010,1935,2020-03-20 11:35:00,1,2171.0,2281.0,1.05,11.08,7,7,2,5,0,0,0,0,0.0,0.0
1010,1936,2020-03-20 11:38:00,1,2170.0,2332.0,1.075,11.131,156,97,60,37,59,42,17,5,0.0,0.0
1010,1937,2020-03-20 11:41:00,1,2239.0,2375.0,1.061,11.451,26,15,6,9,11,8,3,0,0.0,0.0
1010,1938,2020-03-20 11:44:00,1,2180.0,2286.0,1.049,11.117,1,1,0,1,0,0,0,0,0.0,0.0
1010,1939,2020-03-20 11:47:00,1,2184.0,2252.0,1.031,11.096,4,4,0,4,0,0,0,0,0.0,0.0
1010,1940,2020-03-20 11:50:00,1,2117.0,2179.0,1.029,10.753,56,40,14,26,16,0,16,0,0.0,0.0
1010,1941,2020-03-20 11:53:00,1,2226.0,2398.0,1.077,11.426,117,101,43,58,16,1,15,0,0.0,0.0
1010,1942,2020-03-20 11:56:00,1,2499.0,2716.0,1.087,12.854,109,92,38,54,17,2,15,0,0.0,0.0
1010,1943,2020-03-20 11:59:00,1,2529.0,2719.0,1.075,12.975,190,136,77,59,54,28,26,74,0.0,0.0
1010,1944,2020-03-20 12:02:00,1,2698.0,2947.0,1.092,13.891,145,113,61,52,32,15,17,92,0.0,0.0
1010,1945,2020-03-20 12:05:00,1,2987.0,3155.0,1.056,15.261,93,62,34,28,31,2,29,43,0.0,0.1
1010,1946,2020-03-20 12:08:00,1,3038.0,3299.0,1.086,15.624,176,154,94,60,22,1,21,60,0.0,0.06
1011,1,2020-03-16 10:53:00,1,3768.0,3014.0,0.8,18.182,689,399,314,85,290,217,73,28,0.01,0.02
1011,2,2020-03-16 10:56:00,1,3183.0,2389.0,0.751,15.186,186,147,95,52,39,8,31,51,0.0,0.0
1011,3,2020-03-16 10:59:00,1,3558.0,2783.0,0.782,17.1,647,454,372,82,193,141,52,63,0.0,0.01
1011,4,2020-03-16 11:02:00,1,2644.0,1977.0,0.748,12.608,162,140,78,62,22,9,13,14,0.0,0.0
1011,5,2020-03-16 11:05:00,1,2730.0,2014.0,0.738,12.988,148,111,58,53,37,2,35,13,0.0,0.0
1011,6,2020-03-16 11:08:00,1,2795.0,2117.0,0.757,13.357,58,43,6,37,15,0,15,6,0.05,0.0
1011,7,2020-03-16 11:11:00,1,2554.0,1976.0,0.774,12.25,165,124,70,54,41,14,27,9,0.0,0.01
1011,8,2020-03-16 11:14:00,1,3642.0,2857.0,0.785,17.511,387,316,250,66,71,48,23,31,0.01,0.01
1011,9,2020-03-16 11:17:00,1,2725.0,2012.0,0.738,12.966,120,86,67,19,34,21,13,10,0.0,0.0
1011,10,2020-03-16 11:20:00,1,2650.5,1952.5,0.7365,12.6065,46,42,27,15,4,0,4,5,0.0,0.0
1011,11,2020-03-16 11:23:00,1,2576.0,1893.0,0.735,12.247,326,257,200,57,69,43,26,10,0.0,0.0
1011,12,2020-03-16 11:26:00,1,3487.0,2664.0,0.764,16.689,387,340,261,79,47,29,18,40,0.0,0.0
1011,13,2020-03-16 11:29:00,1,4026.0,3160.0,0.785,19.362,428,291,224,67,137,96,41,38,0.05,0.0
1011,14,2020-03-16 11:32:00,1,3788.0,2945.0,0.778,18.184,449,335,271,64,114,71,43,39,0.01,0.01
1011,15,2020-03-16 11:35:00,1,3639.0,2789.0,0.766,17.426,442,310,239,71,132,89,43,46,0.0,0.02
1011,16,2020-03-16 11:38:00,1,3616.0,2807.0,0.776,17.356,473,274,219,55,199,152,47,23,0.01,0.0
1011,17,2020-03-16 11:41:00,1,3386.0,2680.0,0.792,16.308,378,289,222,67,89,55,34,9,0.0,0.0
1011,18,2020-03-16 11:44:00,1,3185.0,2458.0,0.772,15.271,375,193,147,46,182,144,38,8,0.0,0.0
1011,19,2020-03-16 11:47:00,1,3321.0,2563.0,0.772,15.921,148,101,82,19,47,37,10,3,0.0,0.0
1011,20,2020-03-16 11:50:00,1,3112.0,2398.0,0.771,14.917,166,123,84,39,43,25,18,3,0.0,0.0
1011,21,2020-03-16 11:53:00,1,3098.0,2358.0,0.761,14.817,10,7,3,4,3,3,0,0,0.0,0.0
1011,22,2020-03-16 11:56:00,1,3091.0,2374.0,0.768,14.807,26,21,8,13,5,4,1,1,0.07,0.0
1011,23,2020-03-16 11:59:00,1,2880.0,2123.0,0.737,13.7,0,0,0,0,0,0,0,0,0.0,0.0
1011,24,2020-03-16 12:02:00,1,2647.0,1976.0,0.746,12.618,3,3,1,2,0,0,0,0,0.0,0.0
1011,25,2020-03-16 12:05:00,1,2950.0,2259.0,0.766,14.123,77,46,16,30,31,19,12,0,0.0,0.0
1011,26,2020-03-16 12:08:00,1,2869.0,2191.0,0.764,13.728,466,353,282,71,113,85,28,29,0.0,0.0
1011,27,2020-03-16 12:11:00,1,3105.0,2328.0,0.75,14.811,199,143,95,48,56,40,16,1,0.0,0.0
1011,28,2020-03-16 12:14:00,1,2790.0,2121.0,0.76,13.343,227,168,124,44,59,39,20,0,0.0,0.0
1011,29,2020-03-16 12:17:00,1,2348.0,1709.0,0.728,11.143,29,25,8,17,4,1,3,0,0.0,0.0
1011,30,2020-03-16 12:20:00,1,2484.0,1885.0,0.759,11.875,54,42,14,28,12,1,11,2,0.01,0.0
1011,31,2020-03-16 12:23:00,1,2492.0,1879.0,0.754,11.897,55,45,21,24,10,4,6,0,0.0,0.0
1011,32,2020-03-16 12:26:00,1,2497.0,1855.0,0.743,11.891,173,156,112,44,17,6,11,2,0.0,0.0
1011,33,2020-03-16 12:29:00,1,2348.0,1730.0,0.737,11.168,13,13,10,3,0,0,0,0,0.0,0.0
1011,34,2020-03-16 12:32:00,1,2097.0,1546.0,0.737,9.972,0,0,0,0,0,0,0,0,0.0,0.0
1011,35,2020-03-16 12:35:00,1,1943.0,1476.0,0.76,9.292,0,0,0,0,0,0,0,0,0.01,0.0
1011,36,2020-03-16 12:38:00,1,2094.0,1596.0,0.762,10.018,15,13,8,5,2,1,1,0,0.05,0.0
1011,37,2020-03-16 12:41:00,1,2101.0,1575.0,0.749,10.021,12,10,7,3,2,0,2,0,0.01,0.0
1011,38,2020-03-16 12:44:00,1,1943.0,1445.0,0.744,9.255,2,2,2,0,0,0,0,0,0.0,0.0
1011,39,2020-03-16 12:47:00,1,2018.0,1529.0,0.758,9.643,0,0,0,0,0,0,0,0,0.0,0.0
1011,40,2020-03-16 12:50:00,1,1960.0,1419.0,0.724,9.293,26,26,8,18,0,0,0,4,0.0,0.0
1011,41,2020-03-16 12:53:00,1,2400.0,1853.0,0.772,11.506,250,205,148,57,45,26,19,23,0.0,0.0
1011,42,2020-03-16 12:56:00,1,2470.0,1940.0,0.785,11.879,287,238,178,60,49,26,23,33,0.0,0.0
1011,43,2020-03-16 12:59:00,1,2478.0,1907.0,0.77,11.875,89,52,20,32,37,9,28,3,0.0,0.0
1011,44,2020-03-16 13:02:00,1,2485.0,1931.0,0.777,11.928,121,110,63,47,11,6,5,12,0.01,0.0
1011,45,2020-03-16 13:05:00,1,2478.0,1901.0,0.767,11.869,0,0,0,0,0,0,0,0,0.0,0.0
1011,46,2020-03-16 13:08:00,1,2327.0,1783.0,0.766,11.143,2,0,0,0,2,0,2,0,0.0,0.0
1011,47,2020-03-16 13:11:00,1,1955.0,1430.0,0.731,9.288,3,0,0,0,3,0,3,0,0.0,0.0
1011,48,2020-03-16 13:14:00,1,1793.0,1320.0,0.736,8.527,0,0,0,0,0,0,0,0,0.0,0.0
1011,49,2020-03-16 13:17:00,1,1715.0,1245.0,0.726,8.137,12,2,1,1,10,0,10,0,0.01,0.0
1011,50,2020-03-16 13:20:00,1,1808.0,1267.0,0.701,8.525,6,0,0,0,6,0,6,0,0.0,0.0
1011,51,2020-03-16 13:23:00,1,1955.0,1424.0,0.728,9.278,18,12,5,7,6,0,6,0,0.01,0.0
1011,52,2020-03-16 13:26:00,1,2027.0,1536.0,0.757,9.688,13,13,6,7,0,0,0,0,0.0,0.0
1011,53,2020-03-16 13:29:00,1,1940.0,1470.0,0.758,9.272,27,26,2,24,1,0,1,0,0.0,0.02
1011,54,2020-03-16 13:32:00,1,1949.0,1442.0,0.74,9.275,7,7,2,5,0,0,0,0,0.0,0.04
1011,55,2020-03-16 13:35:00,1,1549.0,1179.0,0.761,7.41,0,0,0,0,0,0,0,0,0.01,0.0
1011,56,2020-03-16 13:38:00,1,1867.0,1398.0,0.749,8.903,7,6,1,5,1,0,1,0,0.0,0.0
1011,57,2020-03-16 13:41:00,1,2018.0,1526.0,0.757,9.64,0,0,0,0,0,0,0,0,0.0,0.0
1011,58,2020-03-16 13:44:00,1,1929.0,1514.0,0.785,9.276,0,0,0,0,0,0,0,0,0.0,0.0
1011,59,2020-03-16 13:47:00,1,1957.0,1423.0,0.727,9.286,5,2,0,2,3,1,2,0,0.01,0.0
1011,60,2020-03-16 13:50:00,1,1783.0,1371.0,0.769,8.543,2,2,0,2,0,0,0,0,0.0,0.0
1011,61,2020-03-16 13:53:00,1,1797.0,1330.0,0.74,8.554,11,9,7,2,2,1,1,0,0.0,0.0
1011,62,2020-03-16 13:56:00,1,1778.0,1384.0,0.778,8.539,0,0,0,0,0,0,0,0,0.0,0.0
1011,63,2020-03-16 13:59:00,1,1791.0,1352.0,0.755,8.554,0,0,0,0,0,0,0,0,0.01,0.0
1011,64,2020-03-16 14:02:00,1,1787.0,1340.0,0.75,8.523,3,3,1,2,0,0,0,0,0.0,0.0
1011,65,2020-03-16 14:05:00,1,1784.0,1365.0,0.765,8.542,0,0,0,0,0,0,0,0,0.0,0.0
1011,66,2020-03-16 14:08:00,1,1783.0,1390.0,0.78,8.563,0,0,0,0,0,0,0,0,0.01,0.0
1011,67,2020-03-16 14:11:00,1,1951.0,1435.0,0.735,9.276,2,2,0,2,0,0,0,0,0.0,0.0
1011,68,2020-03-16 14:14:00,1,1934.0,1492.0,0.771,9.273,106,96,65,31,10,7,3,3,0.0,0.0
1011,69,2020-03-16 14:17:00,1,2395.0,1880.0,0.785,11.518,190,153,112,41,37,13,24,18,0.0,0.0
1011,70,2020-03-16 14:20:00,1,2368.0,1810.0,0.764,11.3355,92,63,24,39,29,6,23,3,0.0,0.0
1011,71,2020-03-16 14:23:00,1,2341.0,1740.0,0.743,11.153,100,79,34,45,21,0,21,0,0.01,0.0
1011,72,2020-03-16 14:26:00,1,2479.0,1898.0,0.766,11.868,92,74,50,24,18,7,11,20,0.0,0.0
1011,73,2020-03-16 14:29:00,1,2422.0,1787.0,0.738,11.521,408,334,253,81,74,43,31,15,0.01,0.0
1011,74,2020-03-16 14:32:00,1,2098.0,1611.0,0.768,10.052,103,66,51,15,37,19,18,0,0.0,0.0
1011,75,2020-03-16 14:35:00,1,2398.0,1862.0,0.777,11.509,299,187,140,47,112,70,42,16,0.0,0.0
1011,76,2020-03-16 14:38:00,1,2399.0,1827.0,0.761,11.477,194,172,118,54,22,10,12,5,0.0,0.0
1011,77,2020-03-16 14:41:00,1,2495.0,1849.0,0.741,11.879,434,223,154,69,211,152,59,10,0.01,0.0
1011,78,2020-03-16 14:44:00,1,2569.0,1934.0,0.753,12.263,211,159,121,38,52,31,21,6,0.0,0.0
1011,79,2020-03-16 14:47:00,1,2576.0,1885.0,0.732,12.235,96,94,49,45,2,0,2,12,0.0,0.0
1011,80,2020-03-16 14:50:00,1,2540.0,2017.0,0.794,12.243,103,98,48,50,5,1,4,11,0.01,0.0
1011,81,2020-03-16 14:53:00,1,2398.0,1862.0,0.776,11.511,0,0,0,0,0,0,0,0,0.0,0.0
1011,82,2020-03-16 14:56:00,1,2165.0,1683.0,0.778,10.392,3,3,2,1,0,0,0,0,0.0,0.0
1011,83,2020-03-16 14:59:00,1,2020.0,1514.0,0.75,9.634,9,7,3,4,2,0,2,0,0.0,0.0
1011,84,2020-03-16 15:02:00,1,1946.0,1442.0,0.741,9.263,9,9,0,9,0,0,0,0,0.0,0.0
1011,85,2020-03-16 15:05:00,1,1878.0,1355.0,0.721,8.901,43,43,4,39,0,0,0,0,0.0,0.0
1011,86,2020-03-16 15:08:00,1,1888.0,1320.0,0.699,8.902,4,4,0,4,0,0,0,0,0.01,0.0
1011,87,2020-03-16 15:11:00,1,1712.0,1290.0,0.754,8.173,11,11,4,7,0,0,0,0,0.0,0.0
1011,88,2020-03-16 15:14:00,1,1794.0,1303.0,0.727,8.51,20,18,0,18,2,0,2,0,0.0,0.0
1011,89,2020-03-16 15:17:00,1,1886.0,1340.0,0.711,8.916,48,45,0,45,3,0,3,0,0.02,0.0
1011,90,2020-03-16 15:20:00,1,1797.0,1311.0,0.73,8.533,25,20,0,20,5,0,5,0,0.0,0.0
1011,91,2020-03-16 15:23:00,1,1798.0,1328.0,0.739,8.556,4,2,0,2,2,0,2,0,0.0,0.0
1011,92,2020-03-16 15:26:00,1,1789.0,1320.0,0.738,8.511,5,0,0,0,5,0,5,0,0.0,0.0
1011,93,2020-03-16 15:29:00,1,1626.0,1247.0,0.767,7.787,5,4,2,2,1,0,1,0,0.0,0.0
1011,94,2020-03-16 15:32:00,1,1619.0,1304.0,0.806,7.822,21,20,9,11,1,0,1,0,0.0,0.0
1011,95,2020-03-16 15:35:00,1,1856.0,1464.0,0.789,8.932,99,97,47,50,2,1,1,30,0.0,0.0
1011,96,2020-03-16 15:38:00,1,2022.0,1522.0,0.753,9.652,9,9,5,4,0,0,0,3,0.01,0.0
1011,97,2020-03-16 15:41:00,1,1857.0,1459.0,0.786,8.932,4,4,2,2,0,0,0,0,0.0,0.0
1011,98,2020-03-16 15:44:00,1,1873.0,1388.0,0.741,8.916,0,0,0,0,0,0,0,0,0.0,0.0
1011,99,2020-03-16 15:47:00,1,1878.0,1371.0,0.73,8.915,8,3,2,1,5,1,4,0,0.01,0.0
1011,100,2020-03-16 15:50:00,1,1879.0,1396.0,0.743,8.948,0,0,0,0,0,0,0,0,0.0,0.0
1011,101,2020-03-16 15:53:00,1,1620.0,1272.0,0.785,7.79,3,3,2,1,0,0,0,1,0.0,0.0
1011,102,2020-03-16 15:56:00,1,1627.0,1243.0,0.764,7.785,0,0,0,0,0,0,0,0,0.01,0.0
1011,103,2020-03-16 15:59:00,1,1647.0,1200.0,0.728,7.818,3,3,2,1,0,0,0,1,0.0,0.0
1011,104,2020-03-16 16:02:00,1,1622.0,1258.0,0.776,7.783,1,1,0,1,0,0,0,0,0.0,0.0
1011,105,2020-03-16 16:05:00,1,1631.0,1263.0,0.774,7.824,0,0,0,0,0,0,0,0,0.0,0.0
1011,106,2020-03-16 16:08:00,1,1708.0,1303.0,0.763,8.174,0,0,0,0,0,0,0,0,0.01,0.0
1011,107,2020-03-16 16:11:00,1,1627.0,1242.0,0.763,7.787,37,35,23,12,2,1,1,4,0.0,0.0
1011,108,2020-03-16 16:14:00,1,1878.0,1361.0,0.725,8.908,5,0,0,0,5,1,4,0,0.01,0.0
1011,109,2020-03-16 16:17:00,1,2030.0,1479.0,0.729,9.634,8,8,1,7,0,0,0,0,0.0,0.0
1011,110,2020-03-16 16:20:00,1,2031.0,1486.0,0.731,9.647,18,18,1,17,0,0,0,0,0.0,0.0
1011,111,2020-03-16 16:23:00,1,1950.0,1451.0,0.744,9.288,34,34,27,7,0,0,0,0,0.0,0.0
1011,112,2020-03-16 16:26:00,1,2030.0,1495.0,0.737,9.652,15,15,2,13,0,0,0,0,0.0,0.0
1011,113,2020-03-16 16:29:00,1,1862.0,1443.0,0.775,8.934,13,11,7,4,2,0,2,0,0.0,0.0
1011,114,2020-03-16 16:32:00,1,1862.0,1412.0,0.758,8.9,23,21,6,15,2,0,2,0,0.01,0.0
1011,115,2020-03-16 16:35:00,1,1874.0,1355.0,0.723,8.883,2,2,1,1,0,0,0,0,0.0,0.0
1011,116,2020-03-16 16:38:00,1,1866.0,1417.0,0.76,8.92,1,1,0,1,0,0,0,0,0.0,0.0
1011,117,2020-03-16 16:41:00,1,1874.0,1394.0,0.744,8.926,16,13,4,9,3,1,2,0,0.0,0.0
1011,118,2020-03-16 16:44:00,1,2018.0,1527.0,0.757,9.643,177,149,100,49,28,7,21,24,0.01,0.0
1011,119,2020-03-16 16:47:00,1,2158.0,1710.0,0.793,10.395,218,148,99,49,70,33,37,25,0.0,0.0
1011,120,2020-03-16 16:50:00,1,2232.0,1743.0,0.781,10.723,23,21,8,13,2,0,2,1,0.0,0.0
1011,121,2020-03-16 16:53:00,1,2169.0,1680.0,0.775,10.407,43,41,9,32,2,0,2,15,0.0,0.0
1011,122,2020-03-16 16:56:00,1,2156.0,1710.0,0.793,10.388,21,17,11,6,4,0,4,11,0.0,0.0
1011,123,2020-03-16 16:59:00,1,2150.0,1746.0,0.812,10.406,65,65,37,28,0,0,0,12,0.01,0.0
1011,124,2020-03-16 17:02:00,1,2148.0,1744.0,0.812,10.392,12,12,3,9,0,0,0,0,0.0,0.0
1011,125,2020-03-16 17:05:00,1,1991.0,1620.0,0.814,9.638,3,3,0,3,0,0,0,0,0.01,0.0
1011,126,2020-03-16 17:08:00,1,1933.0,1499.0,0.775,9.277,14,14,0,14,0,0,0,0,0.0,0.0
1011,127,2020-03-16 17:11:00,1,1866.0,1401.0,0.75,8.904,24,24,0,24,0,0,0,0,0.0,0.0
1011,128,2020-03-16 17:14:00,1,1626.0,1259.0,0.774,7.798,4,4,0,4,0,0,0,0,0.0,0.0
1011,129,2020-03-16 17:17:00,1,1642.0,1227.0,0.747,7.829,0,0,0,0,0,0,0,0,0.0,0.0
1011,130,2020-03-16 17:20:00,1,1751.0,1337.0,0.7625,8.3795,23,16,3,13,7,1,6,0,0.01,0.0
1011,131,2020-03-16 17:23:00,1,1860.0,1447.0,0.778,8.93,1,1,1,0,0,0,0,0,0.0,0.0
1011,132,2020-03-16 17:26:00,1,1860.0,1458.0,0.784,8.943,0,0,0,0,0,0,0,0,0.0,0.0
1011,133,2020-03-16 17:29:00,1,1854.0,1454.0,0.784,8.917,5,5,1,4,0,0,0,0,0.0,0.0
1011,134,2020-03-16 17:32:00,1,1865.0,1418.0,0.76,8.919,0,0,0,0,0,0,0,0,0.0,0.0
1011,135,2020-03-16 17:35:00,1,1790.0,1362.0,0.761,8.559,13,8,3,5,5,1,4,0,0.0,0.0
1011,136,2020-03-16 17:38:00,1,1868.0,1407.0,0.753,8.918,1,0,0,0,1,0,1,0,0.01,0.0
1011,137,2020-03-16 17:41:00,1,1852.0,1447.0,0.781,8.898,2,2,0,2,0,0,0,0,0.0,0.0
1011,138,2020-03-16 17:44:00,1,1851.0,1459.0,0.788,8.909,7,3,1,2,4,0,4,0,0.0,0.0
1011,139,2020-03-16 17:47:00,1,1844.0,1458.0,0.791,8.881,17,15,6,9,2,0,2,0,0.0,0.0
1011,140,2020-03-16 17:50:00,1,1846.0,1462.0,0.792,8.893,9,4,2,2,5,0,5,0,0.0,0.0
1011,141,2020-03-16 17:53:00,1,1865.0,1406.0,0.754,8.904,0,0,0,0,0,0,0,0,0.01,0.0
1011,142,2020-03-16 17:56:00,1,1701.0,1340.0,0.787,8.187,10,3,0,3,7,0,7,0,0.0,0.0
1011,143,2020-03-16 17:59:00,1,1781.0,1366.0,0.767,8.531,6,1,0,1,5,0,5,0,0.0,0.0
1011,144,2020-03-16 18:02:00,0,1859.0,1414.0,0.761,8.892,27,15,3,12,12,0,12,0,0.01,0.0
1011,145,2020-03-16 18:05:00,0,1840.0,1490.0,0.81,8.898,190,146,96,50,44,12,32,48,0.0,0.0
1011,146,2020-03-16 18:08:00,0,2167.0,1713.0,0.79,10.432,287,241,174,67,46,29,17,59,0.0,0.0
1011,147,2020-03-16 18:11:00,0,2412.0,1841.0,0.763,11.543,371,271,204,67,100,64,36,48,0.0,0.0
1011,148,2020-03-16 18:14:00,0,2567.0,1944.0,0.757,12.266,125,112,59,53,13,1,12,44,0.0,0.0
1011,149,2020-03-16 18:17:00,0,2565.0,1963.0,0.765,12.279,47,35,10,25,12,0,12,28,0.0,0.0
1011,150,2020-03-16 18:20:00,0,2559.0,1991.0,0.778,12.288,58,55,19,36,3,0,3,9,0.0,0.0
1011,151,2020-03-16 18:23:00,0,2554.0,1976.0,0.774,12.25,20,19,6,13,1,0,1,3,0.0,0.0
1011,152,2020-03-16 18:26:00,0,2543.0,1985.0,0.781,12.216,58,31,10,21,27,3,24,9,0.02,0.0
1011,153,2020-03-16 18:29:00,0,2544.0,2000.0,0.786,12.24,32,30,13,17,2,0,2,1,0.0,0.0
1011,154,2020-03-16 18:32:00,0,2548.0,2010.0,0.789,12.265,58,20,4,16,38,0,38,11,0.0,0.0
1011,155,2020-03-16 18:35:00,0,2531.0,2061.0,0.814,12.256,147,107,54,53,40,0,40,6,0.0,0.0
1011,156,2020-03-16 18:38:00,0,2532.0,2086.0,0.824,12.285,68,55,36,19,13,4,9,5,0.0,0.0
1011,157,2020-03-16 18:41:00,0,2471.0,1933.0,0.782,11.877,24,24,0,24,0,0,0,0,0.0,0.0
1011,158,2020-03-16 18:44:00,0,2237.0,1756.0,0.785,10.758,13,13,3,10,0,0,0,0,0.0,0.0
1011,159,2020-03-16 18:47:00,0,2095.0,1634.0,0.78,10.062,27,27,6,21,0,0,0,0,0.0,0.0
1011,160,2020-03-16 18:50:00,0,2149.0,1724.0,0.802,10.374,175,152,109,43,23,14,9,33,0.0,0.0
1011,161,2020-03-16 18:53:00,0,2406.0,1847.0,0.768,11.525,11,10,1,9,1,0,1,0,0.0,0.0
1011,162,2020-03-16 18:56:00,0,2334.0,1756.0,0.752,11.141,3,3,0,3,0,0,0,0,0.01,0.0
1011,163,2020-03-16 18:59:00,0,2167.0,1659.0,0.766,10.375,25,21,13,8,4,2,2,0,0.0,0.0
1011,164,2020-03-16 19:02:00,0,2414.0,1798.0,0.745,11.503,296,216,149,67,80,52,28,53,0.0,0.0
1011,165,2020-03-16 19:05:00,0,2560.0,1945.0,0.76,12.24,260,191,136,55,69,43,26,82,0.0,0.0
1011,166,2020-03-16 19:08:00,0,2545.0,1971.0,0.774,12.211,97,90,46,44,7,2,5,5,0.0,0.0
1011,167,2020-03-16 19:11:00,0,2546.0,2002.0,0.786,12.248,150,142,89,53,8,0,8,31,0.0,0.0
1011,168,2020-03-16 19:14:00,0,2625.0,2052.0,0.782,12.616,91,85,47,38,6,0,6,10,0.0,0.0
1011,169,2020-03-16 19:17:00,0,2548.0,1988.0,0.78,12.241,1,0,0,0,1,0,1,0,0.0,0.0
1011,170,2020-03-16 19:20:00,0,2414.0,1816.0,0.752,11.521,3,0,0,0,3,0,3,0,0.01,0.0
1011,171,2020-03-16 19:23:00,0,2167.0,1690.0,0.78,10.41,5,3,3,0,2,0,2,0,0.0,0.0
1011,172,2020-03-16 19:26:00,0,2093.0,1614.0,0.771,10.035,1,0,0,0,1,0,1,0,0.0,0.0
1011,173,2020-03-16 19:29:00,0,2007.0,1557.0,0.776,9.63,4,4,2,2,0,0,0,0,0.0,0.0
1011,174,2020-03-16 19:32:00,0,2018.0,1558.0,0.772,9.678,6,6,2,4,0,0,0,0,0.0,0.0
1011,175,2020-03-16 19:35:00,0,2021.0,1542.0,0.763,9.67,259,211,155,56,48,25,23,45,0.0,0.0
1011,176,2020-03-16 19:38:00,0,2328.0,1792.0,0.77,11.155,405,330,249,81,75,45,30,60,0.0,0.0
1011,177,2020-03-16 19:41:00,0,2486.0,1889.0,0.76,11.887,360,284,217,67,76,30,46,66,0.0,0.0
1011,178,2020-03-16 19:44:00,0,2548.0,1998.0,0.784,12.252,135,94,54,40,41,4,37,27,0.01,0.0
1011,179,2020-03-16 19:47:00,0,2793.0,2108.0,0.755,13.341,278,170,115,55,108,68,40,41,0.0,0.0
1011,180,2020-03-16 19:50:00,0,2715.0,2069.0,0.762,12.989,552,369,304,65,183,135,48,154,0.0,0.0
1011,181,2020-03-16 19:53:00,0,2799.0,2121.0,0.758,13.377,275,177,123,54,98,69,29,30,0.0,0.0
1011,182,2020-03-16 19:56:00,0,2801.0,2110.0,0.753,13.373,337,281,217,64,56,29,27,42,0.0,0.0
1011,183,2020-03-16 19:59:00,0,2547.0,2018.0,0.792,12.268,629,331,261,70,298,229,69,165,0.0,0.0
1011,184,2020-03-16 20:02:00,0,2812.0,2099.0,0.746,13.404,421,257,193,64,164,123,41,45,0.0,0.0
1011,185,2020-03-16 20:05:00,0,2644.0,2010.0,0.76,12.644,276,225,183,42,51,32,19,31,0.01,0.0
1011,186,2020-03-16 20:08:00,0,2718.0,2053.0,0.755,12.981,243,136,90,46,107,60,47,31,0.0,0.0
1011,187,2020-03-16 20:11:00,0,2800.0,2088.0,0.746,13.345,101,91,46,45,10,0,10,11,0.0,0.0
1011,188,2020-03-16 20:14:00,0,2785.0,2121.0,0.762,13.323,73,62,26,36,11,2,9,5,0.0,0.0
1011,189,2020-03-16 20:17:00,0,2783.0,2135.0,0.767,13.329,487,303,246,57,184,135,49,56,0.0,0.0
1011,190,2020-03-16 20:20:00,0,2682.0,2011.0,0.749,12.7945,226,193,140,53,33,20,13,72,0.0,0.0
1011,191,2020-03-16 20:23:00,0,2581.0,1887.0,0.731,12.26,1,1,1,0,0,0,0,0,0.0,0.0
1011,192,2020-03-16 20:26:00,0,2429.0,1770.0,0.729,11.531,6,6,3,3,0,0,0,0,0.0,0.0
1011,193,2020-03-16 20:29:00,0,2172.0,1645.0,0.757,10.378,4,4,2,2,0,0,0,0,0.0,0.0
1011,194,2020-03-16 20:32:00,0,2011.0,1558.0,0.774,9.649,39,36,19,17,3,1,2,0,0.0,0.0
1011,195,2020-03-16 20:35:00,0,2024.0,1529.0,0.756,9.668,28,20,0,20,8,1,7,0,0.01,0.0
1011,196,2020-03-16 20:38:00,0,1938.0,1489.0,0.768,9.282,28,24,12,12,4,1,3,0,0.0,0.0
1011,197,2020-03-16 20:41:00,0,1947.0,1479.0,0.76,9.311,6,4,1,3,2,0,2,0,0.0,0.0
1011,198,2020-03-16 20:44:00,0,1943.0,1474.0,0.758,9.289,10,9,6,3,1,0,1,0,0.0,0.0
1011,199,2020-03-16 20:47:00,0,2026.0,1514.0,0.747,9.657,285,229,164,65,56,34,22,68,0.0,0.0
1011,200,2020-03-16 20:50:00,0,2426.0,1810.0,0.746,11.564,421,312,239,73,109,71,38,116,0.0,0.0
1011,201,2020-03-16 20:53:00,0,2408.0,1808.0,0.751,11.488,521,297,222,75,224,170,54,103,0.0,0.0
1011,202,2020-03-16 20:56:00,0,2396.0,1870.0,0.78,11.512,598,387,304,83,211,149,62,94,0.01,0.0
1011,203,2020-03-16 20:59:00,0,2563.0,1952.0,0.762,12.257,472,396,306,90,76,48,28,161,0.0,0.0
1011,204,2020-03-16 21:02:00,0,2565.0,1941.0,0.757,12.254,329,270,201,69,59,37,22,43,0.0,0.0
1011,205,2020-03-16 21:05:00,0,2643.0,2010.0,0.761,12.639,460,279,209,70,181,121,60,93,0.0,0.0
1011,206,2020-03-16 21:08:00,0,2814.0,2072.0,0.736,13.38,380,253,194,59,127,94,33,79,0.0,0.0
1011,207,2020-03-16 21:11:00,0,2801.0,2074.0,0.74,13.331,433,316,234,82,117,79,38,143,0.0,0.0
1011,208,2020-03-16 21:14:00,0,2564.0,1920.0,0.749,12.227,351,256,195,61,95,60,35,49,0.0,0.0
1011,209,2020-03-16 21:17:00,0,2582.0,1905.0,0.738,12.282,172,139,96,43,33,12,21,43,0.0,0.0
1011,210,2020-03-16 21:20:00,0,2413.0,1819.0,0.754,11.521,133,87,32,55,46,3,43,25,0.0,0.0
1011,211,2020-03-16 21:23:00,0,2633.0,2024.0,0.769,12.616,126,106,61,45,20,8,12,19,0.0,0.0
1011,212,2020-03-16 21:26:00,0,2398.0,1860.0,0.776,11.509,4,1,0,1,3,1,2,0,0.01,0.0
1011,213,2020-03-16 21:29:00,0,2169.0,1675.0,0.772,10.4,2,2,0,2,0,0,0,0,0.0,0.0
1011,214,2020-03-16 21:32:00,0,2182.0,1620.0,0.742,10.391,40,25,11,14,15,9,6,0,0.0,0.0
1011,215,2020-03-16 21:35:00,0,2015.0,1566.0,0.777,9.674,4,4,0,4,0,0,0,0,0.0,0.0
1011,216,2020-03-16 21:38:00,0,2025.0,1516.0,0.749,9.655,4,4,0,4,0,0,0,0,0.0,0.0
1011,217,2020-03-16 21:41:00,0,1843.0,1476.0,0.801,8.894,5,0,0,0,5,1,4,0,0.0,0.0
1011,218,2020-03-16 21:44:00,0,1787.0,1345.0,0.753,8.532,73,59,43,16,14,3,11,16,0.0,0.0
1011,219,2020-03-16 21:47:00,0,2170.0,1688.0,0.778,10.417,295,203,136,67,92,47,45,107,0.0,0.0
1011,220,2020-03-16 21:50:00,0,2471.0,1952.0,0.79,11.896,362,250,188,62,112,64,48,70,0.0,0.0
1011,221,2020-03-16 21:53:00,0,2401.0,1916.0,0.798,11.58,402,271,210,61,131,86,45,55,0.0,0.0
1011,222,2020-03-16 21:56:00,0,2478.0,1898.0,0.766,11.864,333,184,129,55,149,106,43,63,0.01,0.0
1011,223,2020-03-16 21:59:00,0,2557.0,1967.0,0.769,12.255,300,200,146,54,100,83,17,127,0.0,0.0
1011,224,2020-03-16 22:02:00,0,2559.0,1982.0,0.775,12.278,258,171,121,50,87,55,32,58,0.0,0.0
1011,225,2020-03-16 22:05:00,0,2542.0,2021.0,0.795,12.251,377,271,202,69,106,76,30,105,0.0,0.0
1011,226,2020-03-16 22:08:00,0,2551.0,1994.0,0.782,12.258,767,431,335,96,336,268,68,47,0.0,0.0
1011,227,2020-03-16 22:11:00,0,2563.0,1974.0,0.77,12.286,167,129,88,41,38,19,19,14,0.0,0.0
1011,228,2020-03-16 22:14:00,0,2820.0,2090.0,0.741,13.424,547,342,258,84,205,153,52,44,0.01,0.0
1011,229,2020-03-16 22:17:00,0,2568.0,1906.0,0.742,12.227,384,268,181,87,116,68,48,79,0.0,0.0
1011,230,2020-03-16 22:20:00,0,2816.0,2108.0,0.748,13.43,306,202,127,75,104,58,46,80,0.0,0.0
1011,231,2020-03-16 22:23:00,0,2625.0,2070.0,0.789,12.633,410,236,179,57,174,104,70,50,0.0,0.0
1011,232,2020-03-16 22:26:00,0,2546.0,1996.0,0.784,12.24,500,278,212,66,222,161,61,64,0.0,0.0
1011,233,2020-03-16 22:29:00,0,2161.0,1661.0,0.769,10.352,314,171,123,48,143,100,43,42,0.0,0.0
1011,234,2020-03-16 22:32:00,0,2013.0,1550.0,0.77,9.647,130,114,66,48,16,0,16,14,0.0,0.0
1011,235,2020-03-16 22:35:00,0,2570.0,1914.0,0.745,12.247,222,165,118,47,57,27,30,20,0.0,0.0
1011,236,2020-03-16 22:38:00,0,2239.0,1760.0,0.786,10.771,12,11,5,6,1,0,1,3,0.0,0.0
1011,237,2020-03-16 22:41:00,0,2010.0,1555.0,0.773,9.64,1,1,1,0,0,0,0,0,0.0,0.0
1011,238,2020-03-16 22:44:00,0,2020.0,1525.0,0.755,9.647,3,3,0,3,0,0,0,0,0.0,0.0
1011,239,2020-03-16 22:47:00,0,2011.0,1572.0,0.782,9.663,210,170,131,39,40,24,16,64,0.01,0.0
1011,240,2020-03-16 22:50:00,0,2229.0,1814.0,0.814,10.79,321,210,153,57,111,63,48,80,0.0,0.0
1011,241,2020-03-16 22:53:00,0,2531.0,2061.0,0.814,12.255,307,189,126,63,118,65,53,93,0.0,0.0
1011,242,2020-03-16 22:56:00,0,2710.0,2114.0,0.78,13.02,292,163,110,53,129,79,50,69,0.0,0.0
1011,243,2020-03-16 22:59:00,0,2619.0,2096.0,0.8,12.641,588,357,271,86,231,173,58,60,0.0,0.0
1011,244,2020-03-16 23:02:00,0,2082.0,1639.0,0.787,10.017,200,170,122,48,30,11,19,46,0.0,0.0
1011,245,2020-03-16 23:05:00,0,2768.0,2211.0,0.799,13.355,538,343,267,76,195,131,64,104,0.0,0.0
1011,246,2020-03-16 23:08:00,0,2549.0,2002.0,0.786,12.26,529,302,250,52,227,164,63,65,0.0,0.0
1011,247,2020-03-16 23:11:00,0,2558.0,1956.0,0.765,12.244,367,252,195,57,115,79,36,95,0.01,0.0
1011,248,2020-03-16 23:14:00,0,2536.0,2027.0,0.799,12.237,585,306,236,70,279,206,73,37,0.0,0.0
1011,249,2020-03-16 23:17:00,0,2765.0,2202.0,0.796,13.332,363,205,124,81,158,105,53,87,0.0,0.0
1011,250,2020-03-16 23:20:00,0,2656.5,2100.5,0.79,12.7915,331,180,117,63,151,99,52,62,0.0,0.0
1011,251,2020-03-16 23:23:00,0,2548.0,1999.0,0.784,12.251,257,210,147,63,47,20,27,66,0.0,0.0
1011,252,2020-03-16 23:26:00,0,2385.0,1901.0,0.797,11.5,397,263,188,75,134,88,46,69,0.0,0.07
1011,253,2020-03-16 23:29:00,0,2169.0,1699.0,0.783,10.429,292,179,126,53,113,73,40,72,0.0,0.03
1011,254,2020-03-16 23:32:00,0,2086.0,1638.0,0.786,10.032,202,170,116,54,32,21,11,34,0.01,0.0
1011,255,2020-03-16 23:35:00,0,2406.0,1852.0,0.77,11.531,473,371,284,87,102,69,33,94,0.0,0.0
1011,256,2020-03-16 23:38:00,0,2319.0,1789.0,0.772,11.116,262,187,120,67,75,55,20,26,0.0,0.0
1011,257,2020-03-16 23:41:00,0,2389.0,1908.0,0.799,11.527,75,72,35,37,3,3,0,4,0.0,0.0
1011,258,2020-03-16 23:44:00,0,2549.0,1977.0,0.775,12.233,28,27,11,16,1,0,1,2,0.0,0.0
1011,259,2020-03-16 23:47:00,0,2408.0,1821.0,0.756,11.505,23,22,7,15,1,0,1,0,0.0,0.0
1011,260,2020-03-16 23:50:00,0,2169.0,1667.0,0.768,10.392,7,5,0,5,2,1,1,0,0.0,0.0
1011,261,2020-03-16 23:53:00,0,1843.0,1512.0,0.821,8.934,2,1,1,0,1,1,0,0,0.0,0.0
1011,262,2020-03-16 23:56:00,0,1687.0,1372.0,0.814,8.165,0,0,0,0,0,0,0,0,0.0,0.0
1011,263,2020-03-16 23:59:00,0,1617.0,1289.0,0.797,7.798,197,168,121,47,29,12,17,59,0.0,0.0
1011,264,2020-03-17 00:02:00,0,1995.0,1611.0,0.807,9.645,590,346,251,95,244,179,65,130,0.03,0.0
1011,265,2020-03-17 00:05:00,0,2152.0,1748.0,0.812,10.414,323,251,160,91,72,34,38,112,0.0,0.0
1011,266,2020-03-17 00:08:00,0,2320.0,1784.0,0.769,11.115,253,179,106,73,74,41,33,87,0.0,0.0
1011,267,2020-03-17 00:11:00,0,2415.0,1790.0,0.741,11.499,273,168,104,64,105,54,51,109,0.0,0.0
1011,268,2020-03-17 00:14:00,0,2544.0,2003.0,0.787,12.24,395,273,176,97,122,71,51,97,0.0,0.0
1011,269,2020-03-17 00:17:00,0,2723.0,2040.0,0.749,12.988,319,131,77,54,188,132,56,106,0.0,0.0
1011,270,2020-03-17 00:20:00,0,2406.0,1872.0,0.778,11.553,395,234,179,55,161,104,57,65,0.0,0.0
1011,271,2020-03-17 00:23:00,0,2477.0,1895.0,0.765,11.857,251,115,71,44,136,78,58,40,0.0,0.0
1011,272,2020-03-17 00:26:00,0,2795.0,2145.0,0.767,13.388,266,93,53,40,173,116,57,40,0.0,0.0
1011,273,2020-03-17 00:29:00,0,1693.0,1358.0,0.802,8.174,486,265,199,66,221,170,51,43,0.0,0.0
1011,274,2020-03-17 00:32:00,0,2613.0,2094.0,0.801,12.612,178,66,24,42,112,65,47,14,0.0,0.0
1011,275,2020-03-17 00:35:00,0,2760.0,2256.0,0.817,13.373,214,80,44,36,134,78,56,55,0.0,0.0
1011,276,2020-03-17 00:38:00,0,2509.0,2146.0,0.855,12.26,245,209,139,70,36,12,24,82,0.0,0.04
1011,277,2020-03-17 00:41:00,0,2914.0,2372.0,0.814,14.107,315,110,71,39,205,133,72,41,0.0,0.0
1011,278,2020-03-17 00:44:00,0,2904.0,2410.0,0.83,14.11,374,213,147,66,161,102,59,33,0.3,0.01
1011,279,2020-03-17 00:47:00,0,2745.0,2308.0,0.841,13.372,449,375,278,97,74,46,28,121,0.07,0.0
1011,280,2020-03-17 00:50:00,0,2427.0,2059.0,0.848,11.844,605,297,236,61,308,227,81,59,0.16,0.02
1011,281,2020-03-17 00:53:00,0,1817.0,1581.0,0.87,8.911,183,157,120,37,26,10,16,57,0.0,0.0
1011,282,2020-03-17 00:56:00,0,2368.0,1976.0,0.835,11.517,589,364,277,87,225,167,58,71,0.0,0.0
1011,283,2020-03-17 00:59:00,0,2890.0,2507.0,0.868,14.161,371,206,145,61,165,117,48,35,0.28,0.01
1011,284,2020-03-17 01:02:00,0,2376.0,1983.0,0.834,11.558,395,252,194,58,143,97,46,20,0.0,0.02
1011,285,2020-03-17 01:05:00,0,2587.0,2218.0,0.857,12.647,272,177,118,59,95,45,50,95,0.0,0.0
1011,286,2020-03-17 01:08:00,0,2953.0,2599.0,0.88,14.514,171,112,69,43,59,30,29,44,0.12,0.0
1011,287,2020-03-17 01:11:00,0,1967.0,1707.0,0.868,9.638,48,43,12,31,5,0,5,8,0.0,0.0
1011,288,2020-03-17 01:14:00,0,2123.0,1836.0,0.865,10.398,167,121,70,51,46,6,40,35,0.0,0.0
1011,289,2020-03-17 01:17:00,0,2185.0,1923.0,0.88,10.738,7,7,1,6,0,0,0,0,0.0,0.0
1011,290,2020-03-17 01:20:00,0,2105.0,1903.0,0.904,10.399,5,0,0,0,5,1,4,0,0.0,0.0
1011,291,2020-03-17 01:23:00,0,2109.0,1888.0,0.895,10.399,12,11,6,5,1,1,0,0,0.0,0.0
1011,292,2020-03-17 01:26:00,0,2125.0,1834.0,0.863,10.403,5,1,1,0,4,1,3,0,0.0,0.0
1011,293,2020-03-17 01:29:00,0,2036.0,1831.0,0.899,10.049,4,3,1,2,1,0,1,0,0.0,0.0
1011,294,2020-03-17 01:32:00,0,1964.0,1751.0,0.891,9.678,181,109,64,45,72,41,31,58,0.0,0.0
1011,295,2020-03-17 01:35:00,0,2339.0,2094.0,0.895,11.532,331,216,159,57,115,62,53,61,0.0,0.02
1011,296,2020-03-17 01:38:00,0,1881.0,1712.0,0.91,9.306,102,87,65,22,15,2,13,98,0.0,0.0
1011,297,2020-03-17 01:41:00,0,1954.0,1793.0,0.917,9.685,78,58,27,31,20,0,20,12,0.0,0.0
1011,298,2020-03-17 01:44:00,0,2345.0,2078.0,0.886,11.541,162,110,76,34,52,28,24,15,0.0,0.0
1011,299,2020-03-17 01:47:00,0,2269.0,1988.0,0.876,11.139,23,14,9,5,9,0,9,0,0.0,0.0
1011,300,2020-03-17 01:50:00,0,2276.0,1957.0,0.86,11.135,12,12,1,11,0,0,0,0,0.0,0.0
1011,301,2020-03-17 01:53:00,0,1951.0,1760.0,0.902,9.636,9,6,3,3,3,0,3,0,0.0,0.0
1011,302,2020-03-17 01:56:00,0,1802.0,1640.0,0.91,8.916,7,1,0,1,6,0,6,0,0.0,0.0
1011,303,2020-03-17 01:59:00,0,1832.0,1543.0,0.842,8.924,2,2,0,2,0,0,0,0,0.0,0.0
1011,304,2020-03-17 02:02:00,0,1661.0,1502.0,0.905,8.207,103,80,60,20,23,12,11,11,0.0,0.0
1011,305,2020-03-17 02:05:00,0,1824.0,1552.0,0.851,8.907,9,9,3,6,0,0,0,0,0.0,0.0
1011,306,2020-03-17 02:08:00,0,1834.0,1532.0,0.835,8.924,0,0,0,0,0,0,0,0,0.0,0.0
1011,307,2020-03-17 02:11:00,0,1841.0,1500.0,0.815,8.915,7,7,2,5,0,0,0,0,0.0,0.0
1011,308,2020-03-17 02:14:00,0,1831.0,1540.0,0.841,8.92,165,105,57,48,60,35,25,30,0.0,0.0
1011,309,2020-03-17 02:17:00,0,2360.0,1975.0,0.837,11.486,195,76,39,37,119,81,38,63,0.0,0.0
1011,310,2020-03-17 02:20:00,0,2488.5,2022.5,0.814,12.045,384,240,178,62,144,98,46,66,0.0,0.0
1011,311,2020-03-17 02:23:00,0,2617.0,2070.0,0.791,12.604,343,199,129,70,144,98,46,113,0.0,0.0
1011,312,2020-03-17 02:26:00,0,2992.0,2400.0,0.802,14.445,368,118,71,47,250,166,84,70,0.0,0.0
1011,313,2020-03-17 02:29:00,0,2980.0,2450.0,0.822,14.456,213,63,24,39,150,82,68,62,0.0,0.0
1011,314,2020-03-17 02:32:00,0,2526.0,2084.0,0.825,12.26,202,114,80,34,88,47,41,66,0.0,0.02
1011,315,2020-03-17 02:35:00,0,2222.0,1840.0,0.828,10.794,473,276,213,63,197,152,45,146,0.0,0.05
1011,316,2020-03-17 02:38:00,0,2833.0,2365.0,0.835,13.78,478,253,189,64,225,177,48,62,0.0,0.03
1011,317,2020-03-17 02:41:00,0,2827.0,2353.0,0.832,13.744,371,233,181,52,138,103,35,31,0.0,0.0
1011,318,2020-03-17 02:44:00,0,2578.0,2262.0,0.877,12.664,243,119,73,46,124,77,47,41,0.0,0.0
1011,319,2020-03-17 02:47:00,0,3206.0,2678.0,0.835,15.598,232,51,27,24,181,103,78,74,0.0,0.0
1011,320,2020-03-17 02:50:00,0,2823.0,2361.0,0.836,13.738,228,175,101,74,53,11,42,105,0.0,0.0
1011,321,2020-03-17 02:53:00,0,2205.0,1841.0,0.835,10.727,155,117,81,36,38,13,25,17,0.26,0.0
1011,322,2020-03-17 02:56:00,0,2280.0,1976.0,0.867,11.17,428,255,195,60,173,114,59,70,0.0,0.13
1011,323,2020-03-17 02:59:00,0,2423.0,2148.0,0.887,11.923,461,275,200,75,186,127,59,125,0.0,0.0
1011,324,2020-03-17 03:02:00,0,2212.0,1884.0,0.852,10.803,226,214,156,58,12,4,8,15,0.0,0.0
1011,325,2020-03-17 03:05:00,0,2452.0,2027.0,0.827,11.905,57,56,19,37,1,0,1,15,0.0,0.0
1011,326,2020-03-17 03:08:00,0,2819.0,2407.0,0.854,13.77,290,230,151,79,60,31,29,35,0.0,0.0
1011,327,2020-03-17 03:11:00,0,2729.0,2403.0,0.88,13.413,344,153,89,64,191,127,64,79,0.0,0.0
1011,328,2020-03-17 03:14:00,0,2954.0,2577.0,0.873,14.491,271,87,44,43,184,103,81,55,0.0,0.08
1011,329,2020-03-17 03:17:00,0,2953.0,2598.0,0.88,14.51,346,85,40,45,261,179,82,62,0.0,0.0
1011,330,2020-03-17 03:20:00,0,2972.0,2541.0,0.855,14.522,414,155,110,45,259,200,59,91,0.12,0.0
1011,331,2020-03-17 03:23:00,0,2443.0,2050.0,0.839,11.895,493,249,191,58,244,185,59,93,0.0,0.0
1011,332,2020-03-17 03:26:00,0,2745.0,2329.0,0.849,13.395,231,174,124,50,57,28,29,42,0.0,0.0
1011,333,2020-03-17 03:29:00,0,2456.0,2026.0,0.825,11.921,258,178,126,52,80,44,36,64,0.0,0.0
1011,334,2020-03-17 03:32:00,0,2215.0,1878.0,0.848,10.808,104,82,34,48,22,0,22,9,0.0,0.0
1011,335,2020-03-17 03:35:00,0,2370.0,1930.0,0.814,11.476,55,53,15,38,2,0,2,2,0.0,0.0
1011,336,2020-03-17 03:38:00,0,2442.0,2049.0,0.839,11.892,184,107,65,42,77,39,38,45,0.0,0.0
1011,337,2020-03-17 03:41:00,0,2582.0,2219.0,0.859,12.631,327,146,96,50,181,110,71,78,0.0,0.01
1011,338,2020-03-17 03:44:00,0,2573.0,2243.0,0.872,12.62,311,205,151,54,106,76,30,26,0.23,0.0
1011,339,2020-03-17 03:47:00,0,2221.0,1856.0,0.836,10.806,121,102,77,25,19,11,8,7,0.0,0.0
1011,340,2020-03-17 03:50:00,0,2049.0,1757.0,0.858,10.02,0,0,0,0,0,0,0,0,0.0,0.0
1011,341,2020-03-17 03:53:00,0,2224.0,1793.0,0.806,10.747,400,309,240,69,91,46,45,97,0.0,0.0
1011,342,2020-03-17 03:56:00,0,2612.0,2119.0,0.811,12.637,244,96,41,55,148,81,67,103,0.0,0.0
1011,343,2020-03-17 03:59:00,0,2900.0,2415.0,0.833,14.102,254,56,24,32,198,121,77,40,0.0,0.0
1011,344,2020-03-17 04:02:00,0,2829.0,2346.0,0.829,13.742,244,106,55,51,138,81,57,61,0.0,0.0
1011,345,2020-03-17 04:05:00,0,2830.0,2387.0,0.844,13.791,180,35,7,28,145,86,59,15,0.0,0.0
1011,346,2020-03-17 04:08:00,0,2292.0,1905.0,0.831,11.141,380,192,143,49,188,132,56,53,0.0,0.0
1011,347,2020-03-17 04:11:00,0,1916.0,1567.0,0.818,9.284,712,415,326,89,297,225,72,125,0.0,0.0
1011,348,2020-03-17 04:14:00,0,2467.0,1981.0,0.803,11.913,749,528,417,111,221,166,55,177,0.0,0.0
1011,349,2020-03-17 04:17:00,0,2233.0,1801.0,0.806,10.792,688,390,290,100,298,225,73,47,0.0,0.0
1011,350,2020-03-17 04:20:00,0,2458.0,1999.0,0.813,11.897,317,215,158,57,102,73,29,89,0.0,0.0
1011,351,2020-03-17 04:23:00,0,2599.0,2189.0,0.842,12.662,640,416,327,89,224,149,75,49,0.0,0.01
1011,352,2020-03-17 04:26:00,0,2670.0,2276.0,0.852,13.041,845,536,413,123,309,218,91,67,0.0,0.0
1011,353,2020-03-17 04:29:00,0,2431.0,2101.0,0.864,11.902,517,331,252,79,186,113,73,41,0.0,0.0
1011,354,2020-03-17 04:32:00,0,2583.0,2226.0,0.862,12.642,749,449,336,113,300,213,87,77,0.0,0.0
1011,355,2020-03-17 04:35:00,0,2578.0,2218.0,0.861,12.612,510,312,235,77,198,144,54,64,0.0,0.0
1011,356,2020-03-17 04:38:00,0,2840.0,2334.0,0.822,13.773,171,63,20,43,108,53,55,74,0.0,0.0
1011,357,2020-03-17 04:41:00,0,3039.0,2619.0,0.862,14.875,116,35,7,28,81,35,46,24,0.0,0.04
1011,358,2020-03-17 04:44:00,0,2955.0,2516.0,0.851,14.43,244,72,26,46,172,117,55,23,0.0,0.07
1011,359,2020-03-17 04:47:00,0,2880.0,2530.0,0.878,14.148,416,198,148,50,218,165,53,42,0.03,0.09
1011,360,2020-03-17 04:50:00,0,1887.0,1672.0,0.886,9.285,731,417,332,85,314,234,80,132,0.0,0.0
1011,361,2020-03-17 04:53:00,0,2573.0,2273.0,0.883,12.656,773,401,309,92,372,284,88,56,0.0,0.0
1011,362,2020-03-17 04:56:00,0,2431.0,2108.0,0.867,11.912,689,445,350,95,244,186,58,83,0.0,0.0
1011,363,2020-03-17 04:59:00,0,2265.0,1992.0,0.879,11.129,95,81,37,44,14,2,12,81,0.0,0.0
1011,364,2020-03-17 05:02:00,0,2589.0,2195.0,0.848,12.63,120,77,38,39,43,0,43,15,0.0,0.0
1011,365,2020-03-17 05:05:00,0,2799.0,2455.0,0.877,13.746,307,245,156,89,62,30,32,34,0.0,0.0
1011,366,2020-03-17 05:08:00,0,2723.0,2417.0,0.888,13.404,631,425,348,77,206,142,64,135,0.03,0.0
1011,367,2020-03-17 05:11:00,0,2559.0,2355.0,0.92,12.688,405,310,233,77,95,60,35,110,0.0,0.0
1011,368,2020-03-17 05:14:00,0,2571.0,2263.0,0.88,12.636,121,108,59,49,13,3,10,132,0.0,0.0
1011,369,2020-03-17 05:17:00,0,2569.0,2237.0,0.871,12.599,104,102,59,43,2,0,2,56,0.0,0.0
1011,370,2020-03-17 05:20:00,0,2493.0,2175.5,0.873,12.231,31,26,6,20,5,0,5,5,0.0,0.0
1011,371,2020-03-17 05:23:00,0,2417.0,2114.0,0.875,11.863,0,0,0,0,0,0,0,0,0.0,0.0
1011,372,2020-03-17 05:26:00,0,2207.0,1890.0,0.856,10.788,0,0,0,0,0,0,0,0,0.0,0.0
1011,373,2020-03-17 05:29:00,0,1893.0,1676.0,0.885,9.315,28,17,13,4,11,0,11,1,0.0,0.0
1011,374,2020-03-17 05:32:00,0,1900.0,1677.0,0.882,9.343,13,13,4,9,0,0,0,0,0.0,0.0
1011,375,2020-03-17 05:35:00,0,1742.0,1524.0,0.875,8.551,2,2,0,2,0,0,0,0,0.0,0.0
1011,376,2020-03-17 05:38:00,0,1679.0,1409.0,0.839,8.175,1,1,1,0,0,0,0,0,0.0,0.0
1011,377,2020-03-17 05:41:00,0,1519.0,1316.0,0.866,7.444,17,17,8,9,0,0,0,0,0.0,0.0
1011,378,2020-03-17 05:44:00,0,1534.0,1262.0,0.823,7.442,5,5,4,1,0,0,0,0,0.0,0.0
1011,379,2020-03-17 05:47:00,0,1550.0,1221.0,0.788,7.457,0,0,0,0,0,0,0,0,0.0,0.0
1011,380,2020-03-17 05:50:00,0,1543.0,1222.0,0.792,7.434,188,125,69,56,63,24,39,68,0.0,0.0
1011,381,2020-03-17 05:53:00,0,2222.0,1814.0,0.816,10.762,259,174,115,59,85,41,44,121,0.0,0.0
1011,382,2020-03-17 05:56:00,0,2754.0,2300.0,0.835,13.398,131,65,38,27,66,36,30,25,0.0,0.0
1011,383,2020-03-17 05:59:00,0,2052.0,1760.0,0.858,10.033,204,138,77,61,66,34,32,99,0.0,0.0
1011,384,2020-03-17 06:02:00,1,2588.0,2209.0,0.853,12.643,912,518,421,97,394,303,91,202,0.0,0.0
1011,385,2020-03-17 06:05:00,1,2797.0,2444.0,0.874,13.726,384,276,214,62,108,73,35,113,0.43,0.0
1011,386,2020-03-17 06:08:00,1,2596.0,2141.0,0.825,12.598,303,198,149,49,105,69,36,46,0.0,0.0
1011,387,2020-03-17 06:11:00,1,2461.0,1981.0,0.805,11.89,0,0,0,0,0,0,0,0,0.0,0.0
1011,388,2020-03-17 06:14:00,1,2452.0,2022.0,0.825,11.898,8,8,1,7,0,0,0,0,0.0,0.0
1011,389,2020-03-17 06:17:00,1,2466.0,1994.0,0.809,11.925,7,6,3,3,1,0,1,0,0.0,0.0
1011,390,2020-03-17 06:20:00,1,2219.0,1845.0,0.832,10.785,2,1,0,1,1,0,1,0,0.0,0.0
1011,391,2020-03-17 06:23:00,1,2078.0,1678.0,0.808,10.044,1,1,0,1,0,0,0,0,0.0,0.0
1011,392,2020-03-17 06:26:00,1,1838.0,1508.0,0.821,8.91,8,8,1,7,0,0,0,0,0.0,0.0
1011,393,2020-03-17 06:29:00,1,1673.0,1423.0,0.851,8.165,0,0,0,0,0,0,0,0,0.0,0.0
1011,394,2020-03-17 06:32:00,1,1679.0,1410.0,0.84,8.175,22,13,2,11,9,0,9,0,0.0,0.0
1011,395,2020-03-17 06:35:00,1,1900.0,1632.0,0.859,9.293,197,156,111,45,41,19,22,65,0.0,0.0
1011,396,2020-03-17 06:38:00,1,2040.0,1811.0,0.888,10.042,65,57,34,23,8,1,7,73,0.0,0.0
1011,397,2020-03-17 06:41:00,1,2294.0,1930.0,0.841,11.176,178,119,65,54,59,14,45,130,0.0,0.0
1011,398,2020-03-17 06:44:00,1,2659.0,2280.0,0.858,13.0,159,27,12,15,132,67,65,35,0.0,0.0
1011,399,2020-03-17 06:47:00,1,2833.0,2329.0,0.822,13.741,288,160,118,42,128,79,49,109,0.08,0.08
1011,400,2020-03-17 06:50:00,1,2063.0,1724.0,0.836,10.038,123,99,68,31,24,9,15,71,0.0,0.0
1011,401,2020-03-17 06:53:00,1,1926.0,1531.0,0.795,9.285,20,14,0,14,6,0,6,0,0.0,0.0
1011,402,2020-03-17 06:56:00,1,1899.0,1635.0,0.861,9.291,9,9,1,8,0,0,0,0,0.0,0.0
1011,403,2020-03-17 06:59:00,1,2072.0,1689.0,0.815,10.035,0,0,0,0,0,0,0,0,0.0,0.0
1011,404,2020-03-17 07:02:00,1,2052.0,1785.0,0.87,10.062,2,1,0,1,1,0,1,0,0.0,0.0
1011,405,2020-03-17 07:05:00,1,2067.0,1711.0,0.828,10.039,4,4,0,4,0,0,0,0,0.0,0.0
1011,406,2020-03-17 07:08:00,1,1890.0,1659.0,0.878,9.282,4,4,2,2,0,0,0,0,0.0,0.0
1011,407,2020-03-17 07:11:00,1,1827.0,1560.0,0.853,8.927,2,2,0,2,0,0,0,0,0.0,0.0
1011,408,2020-03-17 07:14:00,1,1673.0,1454.0,0.869,8.203,0,0,0,0,0,0,0,0,0.0,0.0
1011,409,2020-03-17 07:17:00,1,1736.0,1552.0,0.894,8.558,179,102,62,40,77,45,32,14,0.0,0.0
1011,410,2020-03-17 07:20:00,1,2059.0,1734.0,0.842,10.032,205,148,100,48,57,29,28,89,0.0,0.0
1011,411,2020-03-17 07:23:00,1,2216.0,1850.0,0.835,10.78,180,78,60,18,102,71,31,17,0.0,0.0
1011,412,2020-03-17 07:26:00,1,2210.0,1873.0,0.848,10.78,9,5,2,3,4,2,2,0,0.0,0.06
1011,413,2020-03-17 07:29:00,1,2057.0,1727.0,0.84,10.017,6,4,2,2,2,1,1,0,0.0,0.0
1011,414,2020-03-17 07:32:00,1,1898.0,1643.0,0.866,9.297,0,0,0,0,0,0,0,0,0.0,0.03
1011,415,2020-03-17 07:35:00,1,1913.0,1587.0,0.83,9.294,0,0,0,0,0,0,0,0,0.0,0.0
1011,416,2020-03-17 07:38:00,1,1920.0,1554.0,0.81,9.286,8,3,1,2,5,0,5,0,0.0,0.0
1011,417,2020-03-17 07:41:00,1,1670.0,1444.0,0.865,8.177,15,12,0,12,3,0,3,0,0.0,0.0
1011,418,2020-03-17 07:44:00,1,1691.0,1358.0,0.803,8.168,3,3,0,3,0,0,0,0,0.0,0.0
1011,419,2020-03-17 07:47:00,1,1529.0,1276.0,0.835,7.435,4,4,0,4,0,0,0,0,0.0,0.0
1011,420,2020-03-17 07:50:00,1,1535.0,1221.0,0.795,7.398,5,5,0,5,0,0,0,0,0.0,0.0
1011,421,2020-03-17 07:53:00,1,1546.0,1215.0,0.786,7.438,23,21,12,9,2,0,2,0,0.0,0.0
1011,422,2020-03-17 07:56:00,1,1613.0,1321.0,0.819,7.819,1,1,0,1,0,0,0,0,0.0,0.0
1011,423,2020-03-17 07:59:00,1,1620.0,1288.0,0.795,7.808,0,0,0,0,0,0,0,0,0.0,0.0
1011,424,2020-03-17 08:02:00,1,1530.0,1249.0,0.816,7.413,7,0,0,0,7,0,7,0,0.0,0.0
1011,425,2020-03-17 08:05:00,1,1755.0,1473.0,0.839,8.546,97,83,48,35,14,0,14,67,0.0,0.0
1011,426,2020-03-17 08:08:00,1,2300.0,1899.0,0.826,11.165,222,103,59,44,119,65,54,55,0.0,0.0
1011,427,2020-03-17 08:11:00,1,2463.0,1967.0,0.798,11.882,480,332,255,77,148,106,42,94,0.0,0.0
1011,428,2020-03-17 08:14:00,1,2378.0,1908.0,0.803,11.481,397,260,198,62,137,92,45,29,0.0,0.0
1011,429,2020-03-17 08:17:00,1,2216.0,1823.0,0.823,10.751,542,292,215,77,250,175,75,35,0.0,0.0
1011,430,2020-03-17 08:20:00,1,2305.5,1861.0,0.808,11.1445,460,263,195,68,197,131,66,81,0.0,0.0
1011,431,2020-03-17 08:23:00,1,2395.0,1899.0,0.793,11.538,52,30,9,21,22,0,22,13,0.0,0.0
1011,432,2020-03-17 08:26:00,1,2216.0,1848.0,0.834,10.779,193,117,79,38,76,52,24,23,0.0,0.0
1011,433,2020-03-17 08:29:00,1,2062.0,1711.0,0.83,10.018,695,446,348,98,249,175,74,116,0.0,0.0
1011,434,2020-03-17 08:32:00,1,2062.0,1709.0,0.829,10.016,483,343,245,98,140,81,59,61,0.0,0.0
1011,435,2020-03-17 08:35:00,1,2073.0,1682.0,0.811,10.03,634,398,314,84,236,166,70,84,0.0,0.0
1011,436,2020-03-17 08:38:00,1,2071.0,1672.0,0.807,10.011,491,379,296,83,112,75,37,99,0.0,0.0
1011,437,2020-03-17 08:41:00,1,2077.0,1667.0,0.802,10.029,459,354,262,92,105,64,41,92,0.0,0.0
1011,438,2020-03-17 08:44:00,1,2079.0,1640.0,0.789,10.007,61,59,20,39,2,1,1,65,0.0,0.0
1011,439,2020-03-17 08:47:00,1,2092.0,1611.0,0.77,10.028,27,24,7,17,3,3,0,29,0.0,0.0
1011,440,2020-03-17 08:50:00,1,1995.0,1610.0,0.807,9.644,64,62,27,35,2,0,2,26,0.0,0.0
1011,441,2020-03-17 08:53:00,1,1853.0,1450.0,0.783,8.907,0,0,0,0,0,0,0,0,0.0,0.0
1011,442,2020-03-17 08:56:00,1,1621.0,1281.0,0.79,7.805,11,11,2,9,0,0,0,1,0.0,0.0
1011,443,2020-03-17 08:59:00,1,1547.0,1196.0,0.773,7.42,13,13,8,5,0,0,0,0,0.0,0.0
1011,444,2020-03-17 09:02:00,1,1556.0,1190.0,0.765,7.447,0,0,0,0,0,0,0,0,0.0,0.0
1011,445,2020-03-17 09:05:00,1,1551.0,1193.0,0.769,7.433,0,0,0,0,0,0,0,0,0.0,0.0
1011,446,2020-03-17 09:08:00,1,1541.0,1207.0,0.783,7.409,0,0,0,0,0,0,0,0,0.0,0.0
1011,447,2020-03-17 09:11:00,1,1544.0,1218.0,0.788,7.433,2,2,1,1,0,0,0,0,0.0,0.0
1011,448,2020-03-17 09:14:00,1,1540.0,1228.0,0.798,7.426,0,0,0,0,0,0,0,0,0.0,0.0
1011,449,2020-03-17 09:17:00,1,1547.0,1201.0,0.777,7.425,2,2,2,0,0,0,0,0,0.0,0.0
1011,450,2020-03-17 09:20:00,1,1543.0,1223.0,0.793,7.434,0,0,0,0,0,0,0,0,0.0,0.0
1011,451,2020-03-17 09:23:00,1,1630.0,1242.0,0.762,7.799,24,16,12,4,8,4,4,5,0.0,0.0
1011,452,2020-03-17 09:26:00,1,1713.0,1270.0,0.741,8.155,0,0,0,0,0,0,0,0,0.0,0.0
1011,453,2020-03-17 09:29:00,1,1541.0,1229.0,0.797,7.432,0,0,0,0,0,0,0,0,0.0,0.0
1011,454,2020-03-17 09:32:00,1,1564.0,1147.0,0.734,7.431,4,2,1,1,2,1,1,0,0.0,0.0
1011,455,2020-03-17 09:35:00,1,1700.0,1323.0,0.778,8.162,2,2,1,1,0,0,0,0,0.0,0.0
1011,456,2020-03-17 09:38:00,1,1705.0,1315.0,0.772,8.174,0,0,0,0,0,0,0,0,0.0,0.0
1011,457,2020-03-17 09:41:00,1,1539.0,1237.0,0.804,7.432,27,25,18,7,2,2,0,7,0.0,0.0
1011,458,2020-03-17 09:44:00,1,1626.0,1252.0,0.77,7.793,6,6,2,4,0,0,0,0,0.0,0.0
1011,459,2020-03-17 09:47:00,1,1539.0,1234.0,0.802,7.43,3,3,0,3,0,0,0,0,0.0,0.0
1011,460,2020-03-17 09:50:00,1,1551.0,1212.0,0.781,7.451,5,5,1,4,0,0,0,0,0.0,0.0
1011,461,2020-03-17 09:53:00,1,1548.0,1182.0,0.763,7.408,9,9,1,8,0,0,0,0,0.0,0.0
1011,462,2020-03-17 09:56:00,1,1547.0,1201.0,0.776,7.424,2,2,1,1,0,0,0,0,0.0,0.0
1011,463,2020-03-17 09:59:00,1,1548.0,1215.0,0.785,7.445,3,3,2,1,0,0,0,0,0.0,0.0
1011,464,2020-03-17 10:02:00,1,1709.0,1294.0,0.757,8.167,4,4,1,3,0,0,0,0,0.0,0.0
1011,465,2020-03-17 10:05:00,1,1627.0,1254.0,0.771,7.799,2,2,1,1,0,0,0,0,0.0,0.0
1011,466,2020-03-17 10:08:00,1,1549.0,1199.0,0.774,7.429,7,7,1,6,0,0,0,0,0.0,0.0
1011,467,2020-03-17 10:11:00,1,1390.0,1092.0,0.786,6.688,1,1,0,1,0,0,0,0,0.0,0.0
1011,468,2020-03-17 10:14:00,1,1550.0,1184.0,0.763,7.419,0,0,0,0,0,0,0,0,0.0,0.0
1011,469,2020-03-17 10:17:00,1,1539.0,1194.0,0.776,7.386,5,5,1,4,0,0,0,0,0.0,0.0
1011,470,2020-03-17 10:20:00,1,1542.0,1231.0,0.798,7.438,9,9,1,8,0,0,0,3,0.0,0.0
1011,471,2020-03-17 10:23:00,1,1552.0,1180.0,0.76,7.421,2,2,0,2,0,0,0,0,0.0,0.0
1011,472,2020-03-17 10:26:00,1,1387.0,1103.0,0.795,6.685,1,1,0,1,0,0,0,0,0.0,0.0
1011,473,2020-03-17 10:29:00,1,1308.0,1052.0,0.804,6.317,0,0,0,0,0,0,0,0,0.0,0.0
1011,474,2020-03-17 10:32:00,1,1327.0,973.0,0.733,6.307,21,21,9,12,0,0,0,10,0.0,0.0
1011,475,2020-03-17 10:35:00,1,1461.0,1145.0,0.783,7.025,84,83,32,51,1,0,1,18,0.0,0.0
1011,476,2020-03-17 10:38:00,1,1686.0,1370.0,0.813,8.16,105,101,51,50,4,0,4,46,0.0,0.0
1011,477,2020-03-17 10:41:00,1,1933.0,1523.0,0.788,9.305,69,50,13,37,19,13,6,49,0.0,0.0
1011,478,2020-03-17 10:44:00,1,2063.0,1740.0,0.844,10.054,297,186,122,64,111,77,34,98,0.0,0.0
1011,479,2020-03-17 10:47:00,1,2231.0,1794.0,0.804,10.776,102,78,53,25,24,12,12,45,0.0,0.0
1011,480,2020-03-17 10:50:00,1,2494.0,1899.0,0.762,11.928,216,94,57,37,122,78,44,78,0.0,0.0
1011,481,2020-03-17 10:53:00,1,2223.0,1791.0,0.806,10.743,255,212,157,55,43,22,21,170,0.0,0.0
1011,482,2020-03-17 10:56:00,1,2078.0,1645.0,0.792,10.007,92,91,41,50,1,0,1,85,0.0,0.0
1011,483,2020-03-17 10:59:00,1,2236.0,1760.0,0.787,10.76,109,109,59,50,0,0,0,18,0.0,0.0
1011,484,2020-03-17 11:02:00,1,2313.0,1833.0,0.793,11.142,177,157,87,70,20,0,20,6,0.0,0.0
1011,485,2020-03-17 11:05:00,1,2231.0,1800.0,0.807,10.784,167,111,66,45,56,35,21,10,0.0,0.0
1011,486,2020-03-17 11:08:00,1,2069.0,1695.0,0.819,10.028,0,0,0,0,0,0,0,0,0.0,0.0
1011,487,2020-03-17 11:11:00,1,1936.0,1507.0,0.779,9.296,0,0,0,0,0,0,0,0,0.0,0.0
1011,488,2020-03-17 11:14:00,1,1700.0,1342.0,0.79,8.184,0,0,0,0,0,0,0,0,0.0,0.0
1011,489,2020-03-17 11:17:00,1,1539.0,1231.0,0.8,7.426,2,2,1,1,0,0,0,0,0.0,0.0
1011,490,2020-03-17 11:20:00,1,1416.5,1166.5,0.8255,6.873,1,1,0,1,0,0,0,0,0.0,0.0
1011,491,2020-03-17 11:23:00,1,1294.0,1102.0,0.851,6.32,2,0,0,0,2,0,2,0,0.0,0.0
1011,492,2020-03-17 11:26:00,1,1301.0,1074.0,0.826,6.314,2,0,0,0,2,0,2,0,0.0,0.0
1011,493,2020-03-17 11:29:00,1,1218.0,1037.0,0.851,5.946,1,0,0,0,1,0,1,0,0.0,0.0
1011,494,2020-03-17 11:32:00,1,1229.0,972.0,0.79,5.92,13,10,6,4,3,0,3,0,0.0,0.0
1011,495,2020-03-17 11:35:00,1,1237.0,984.0,0.795,5.963,0,0,0,0,0,0,0,0,0.0,0.0
1011,496,2020-03-17 11:38:00,1,1227.0,1000.0,0.815,5.941,0,0,0,0,0,0,0,0,0.0,0.0
1011,497,2020-03-17 11:41:00,1,1213.0,1050.0,0.865,5.942,41,39,12,27,2,0,2,0,0.0,0.0
1011,498,2020-03-17 11:44:00,1,1468.0,1150.0,0.784,7.056,4,4,0,4,0,0,0,0,0.0,0.0
1011,499,2020-03-17 11:47:00,1,1463.0,1169.0,0.799,7.06,0,0,0,0,0,0,0,0,0.0,0.0
1011,500,2020-03-17 11:50:00,1,1452.0,1195.0,0.823,7.045,0,0,0,0,0,0,0,0,0.0,0.0
1011,501,2020-03-17 11:53:00,1,1455.0,1197.0,0.822,7.059,0,0,0,0,0,0,0,0,0.0,0.0
1011,502,2020-03-17 11:56:00,1,1459.0,1187.0,0.813,7.062,1,1,1,0,0,0,0,0,0.0,0.0
1011,503,2020-03-17 11:59:00,1,1638.0,1232.0,0.752,7.816,16,9,5,4,7,2,5,0,0.0,0.0
1011,504,2020-03-17 12:02:00,1,1546.0,1211.0,0.783,7.431,5,4,1,3,1,0,1,0,0.0,0.0
1011,505,2020-03-17 12:05:00,1,1629.0,1235.0,0.758,7.787,0,0,0,0,0,0,0,0,0.0,0.0
1011,506,2020-03-17 12:08:00,1,1627.0,1239.0,0.761,7.783,1,0,0,0,1,0,1,0,0.0,0.0
1011,507,2020-03-17 12:11:00,1,1541.0,1208.0,0.784,7.41,2,2,1,1,0,0,0,0,0.0,0.0
1011,508,2020-03-17 12:14:00,1,1463.0,1167.0,0.798,7.055,5,5,0,5,0,0,0,0,0.0,0.0
1011,509,2020-03-17 12:17:00,1,1467.0,1171.0,0.799,7.075,2,2,0,2,0,0,0,0,0.0,0.0
1011,510,2020-03-17 12:20:00,1,1392.0,1077.0,0.773,6.677,17,17,0,17,0,0,0,0,0.0,0.0
1011,511,2020-03-17 12:23:00,1,1300.0,1078.0,0.829,6.315,1,1,0,1,0,0,0,0,0.0,0.0
1011,512,2020-03-17 12:26:00,1,1304.0,1064.0,0.816,6.317,0,0,0,0,0,0,0,0,0.0,0.0
1011,513,2020-03-17 12:29:00,1,1302.0,1068.0,0.82,6.313,0,0,0,0,0,0,0,0,0.0,0.0
1011,514,2020-03-17 12:32:00,1,1303.0,1069.0,0.82,6.318,24,15,8,7,9,4,5,1,0.0,0.0
1011,515,2020-03-17 12:35:00,1,1621.0,1268.0,0.782,7.793,206,133,71,62,73,31,42,51,0.0,0.0
1011,516,2020-03-17 12:38:00,1,1844.0,1502.0,0.815,8.927,161,134,89,45,27,12,15,25,0.0,0.0
1011,517,2020-03-17 12:41:00,1,1835.0,1540.0,0.839,8.936,479,321,227,94,158,95,63,55,0.0,0.0
1011,518,2020-03-17 12:44:00,1,1926.0,1550.0,0.805,9.304,371,280,208,72,91,51,40,103,0.0,0.0
1011,519,2020-03-17 12:47:00,1,1981.0,1645.0,0.83,9.628,174,127,71,56,47,3,44,90,0.0,0.01
1011,520,2020-03-17 12:50:00,1,2475.0,1930.0,0.78,11.887,134,41,8,33,93,48,45,39,0.0,0.0
1011,521,2020-03-17 12:53:00,1,2535.0,2018.0,0.796,12.22,364,204,154,50,160,90,70,76,0.0,0.0
1011,522,2020-03-17 12:56:00,1,1861.0,1415.0,0.761,8.899,515,341,251,90,174,118,56,87,0.0,0.0
1011,523,2020-03-17 12:59:00,1,1863.0,1409.0,0.756,8.901,601,402,294,108,199,148,51,115,0.0,0.0
1011,524,2020-03-17 13:02:00,1,2146.0,1732.0,0.807,10.373,681,467,387,80,214,155,59,141,0.09,0.0
1011,525,2020-03-17 13:05:00,1,1981.0,1659.0,0.837,9.642,30,29,14,15,1,0,1,26,0.0,0.0
1011,526,2020-03-17 13:08:00,1,2152.0,1720.0,0.799,10.381,15,15,1,14,0,0,0,54,0.0,0.0
1011,527,2020-03-17 13:11:00,1,2368.0,1978.0,0.835,11.52,39,39,16,23,0,0,0,51,0.0,0.0
1011,528,2020-03-17 13:14:00,1,2368.0,2002.0,0.846,11.545,44,40,17,23,4,0,4,33,0.0,0.01
1011,529,2020-03-17 13:17:00,1,2298.0,1889.0,0.822,11.146,31,31,0,31,0,0,0,0,0.0,0.0
1011,530,2020-03-17 13:20:00,1,1982.0,1680.0,0.848,9.671,6,6,0,6,0,0,0,0,0.0,0.0
1011,531,2020-03-17 13:23:00,1,1826.0,1550.0,0.849,8.911,20,20,0,20,0,0,0,3,0.0,0.0
1011,532,2020-03-17 13:26:00,1,1768.0,1455.0,0.823,8.575,0,0,0,0,0,0,0,0,0.0,0.0
1011,533,2020-03-17 13:29:00,1,1604.0,1342.0,0.837,7.808,0,0,0,0,0,0,0,0,0.0,0.0
1011,534,2020-03-17 13:32:00,1,1605.0,1330.0,0.829,7.799,4,4,1,3,0,0,0,3,0.0,0.0
1011,535,2020-03-17 13:35:00,1,1607.0,1342.0,0.835,7.818,3,3,0,3,0,0,0,3,0.0,0.0
1011,536,2020-03-17 13:38:00,1,1610.0,1310.0,0.813,7.794,3,3,0,3,0,0,0,3,0.0,0.0
1011,537,2020-03-17 13:41:00,1,1621.0,1270.0,0.783,7.794,9,9,0,9,0,0,0,5,0.0,0.0
1011,538,2020-03-17 13:44:00,1,1444.0,1235.0,0.855,7.058,8,8,0,8,0,0,0,0,0.0,0.0
1011,539,2020-03-17 13:47:00,1,1461.0,1170.0,0.801,7.052,21,21,1,20,0,0,0,3,0.0,0.0
1011,540,2020-03-17 13:50:00,1,1466.0,1164.0,0.794,7.063,9,6,5,1,3,0,3,1,0.0,0.0
1011,541,2020-03-17 13:53:00,1,1450.0,1210.0,0.835,7.052,4,4,0,4,0,0,0,0,0.0,0.0
1011,542,2020-03-17 13:56:00,1,1446.0,1237.0,0.856,7.068,10,10,4,6,0,0,0,1,0.0,0.0
1011,543,2020-03-17 13:59:00,1,1618.0,1292.0,0.798,7.806,4,0,0,0,4,1,3,0,0.0,0.0
1011,544,2020-03-17 14:02:00,1,1620.0,1279.0,0.79,7.798,4,0,0,0,4,0,4,0,0.0,0.0
1011,545,2020-03-17 14:05:00,1,1620.0,1242.0,0.767,7.759,2,2,0,2,0,0,0,1,0.0,0.0
1011,546,2020-03-17 14:08:00,1,1613.0,1268.0,0.787,7.758,1,1,0,1,0,0,0,1,0.0,0.0
1011,547,2020-03-17 14:11:00,1,1537.0,1222.0,0.795,7.409,0,0,0,0,0,0,0,0,0.0,0.0
1011,548,2020-03-17 14:14:00,1,1463.0,1165.0,0.796,7.053,4,0,0,0,4,0,4,0,0.0,0.0
1011,549,2020-03-17 14:17:00,1,1303.0,1072.0,0.823,6.319,41,37,19,18,4,1,3,3,0.0,0.0
1011,550,2020-03-17 14:20:00,1,1537.5,1244.5,0.8115,7.434,111,109,55,54,2,0,2,84,0.0,0.0
1011,551,2020-03-17 14:23:00,1,1772.0,1417.0,0.8,8.549,56,55,21,34,1,0,1,41,0.0,0.0
1011,552,2020-03-17 14:26:00,1,1922.0,1535.0,0.799,9.27,70,62,22,40,8,0,8,58,0.0,0.0
1011,553,2020-03-17 14:29:00,1,2004.0,1603.0,0.8,9.672,111,111,61,50,0,0,0,27,0.0,0.0
1011,554,2020-03-17 14:32:00,1,2090.0,1635.0,0.782,10.044,256,227,155,72,29,19,10,57,0.0,0.0
1011,555,2020-03-17 14:35:00,1,2091.0,1635.0,0.782,10.048,16,16,5,11,0,0,0,0,0.0,0.0
1011,556,2020-03-17 14:38:00,1,1940.0,1498.0,0.772,9.303,0,0,0,0,0,0,0,0,0.0,0.0
1011,557,2020-03-17 14:41:00,1,1695.0,1371.0,0.809,8.197,0,0,0,0,0,0,0,0,0.0,0.0
1011,558,2020-03-17 14:44:00,1,1704.0,1293.0,0.759,8.143,0,0,0,0,0,0,0,0,0.0,0.0
1011,559,2020-03-17 14:47:00,1,1714.0,1249.0,0.729,8.138,1,1,1,0,0,0,0,0,0.0,0.0
1011,560,2020-03-17 14:50:00,1,1727.0,1245.0,0.721,8.183,0,0,0,0,0,0,0,0,0.0,0.0
1011,561,2020-03-17 14:53:00,1,1722.0,1241.0,0.721,8.157,0,0,0,0,0,0,0,0,0.0,0.0
1011,562,2020-03-17 14:56:00,1,1720.0,1263.0,0.734,8.176,16,16,6,10,0,0,0,0,0.0,0.0
1011,563,2020-03-17 14:59:00,1,1713.0,1273.0,0.743,8.16,22,22,6,16,0,0,0,0,0.0,0.0
1011,564,2020-03-17 15:02:00,1,1723.0,1240.0,0.72,8.162,16,16,4,12,0,0,0,0,0.0,0.0
1011,565,2020-03-17 15:05:00,1,1722.0,1235.0,0.717,8.154,9,9,3,6,0,0,0,0,0.0,0.0
1011,566,2020-03-17 15:08:00,1,1730.0,1221.0,0.706,8.168,21,21,3,18,0,0,0,0,0.0,0.0
1011,567,2020-03-17 15:11:00,1,1733.0,1215.0,0.701,8.173,6,6,0,6,0,0,0,0,0.0,0.0
1011,568,2020-03-17 15:14:00,1,1548.0,1190.0,0.769,7.417,20,20,2,18,0,0,0,0,0.0,0.0
1011,569,2020-03-17 15:17:00,1,1563.0,1140.0,0.73,7.419,13,13,7,6,0,0,0,0,0.0,0.0
1011,570,2020-03-17 15:20:00,1,1558.0,1184.0,0.76,7.451,8,8,4,4,0,0,0,2,0.0,0.0
1011,571,2020-03-17 15:23:00,1,1633.0,1222.0,0.748,7.787,0,0,0,0,0,0,0,0,0.0,0.0
1011,572,2020-03-17 15:26:00,1,1637.0,1207.0,0.737,7.788,8,8,0,8,0,0,0,0,0.0,0.0
1011,573,2020-03-17 15:29:00,1,1638.0,1205.0,0.735,7.789,1,1,0,1,0,0,0,0,0.0,0.0
1011,574,2020-03-17 15:32:00,1,1730.0,1232.0,0.712,8.181,0,0,0,0,0,0,0,0,0.0,0.0
1011,575,2020-03-17 15:35:00,1,1640.0,1199.0,0.732,7.788,4,0,0,0,4,0,4,0,0.0,0.0
1011,576,2020-03-17 15:38:00,1,1559.0,1132.0,0.726,7.396,7,7,0,7,0,0,0,3,0.0,0.0
1011,577,2020-03-17 15:41:00,1,1561.0,1153.0,0.739,7.426,4,4,2,2,0,0,0,0,0.0,0.0
1011,578,2020-03-17 15:44:00,1,1645.0,1183.0,0.719,7.79,0,0,0,0,0,0,0,0,0.0,0.0
1011,579,2020-03-17 15:47:00,1,1549.0,1186.0,0.766,7.416,0,0,0,0,0,0,0,0,0.0,0.0
1011,580,2020-03-17 15:50:00,1,1549.0,1169.0,0.755,7.398,6,3,0,3,3,0,3,0,0.0,0.0
1011,581,2020-03-17 15:53:00,1,1552.0,1172.0,0.755,7.411,0,0,0,0,0,0,0,0,0.0,0.0
1011,582,2020-03-17 15:56:00,1,1569.0,1114.0,0.71,7.415,71,69,27,42,2,1,1,34,0.0,0.0
1011,583,2020-03-17 15:59:00,1,1949.0,1437.0,0.738,9.269,143,132,82,50,11,4,7,92,0.0,0.0
1011,584,2020-03-17 16:02:00,1,2082.0,1654.0,0.795,10.033,203,127,87,40,76,29,47,100,0.0,0.0
1011,585,2020-03-17 16:05:00,1,2635.0,2054.0,0.78,12.656,260,89,46,43,171,104,67,32,0.0,0.0
1011,586,2020-03-17 16:08:00,1,1701.0,1328.0,0.781,8.174,132,78,44,34,54,34,20,59,0.0,0.0
1011,587,2020-03-17 16:11:00,1,1956.0,1410.0,0.721,9.269,159,83,51,32,76,44,32,38,0.0,0.0
1011,588,2020-03-17 16:14:00,1,2098.0,1611.0,0.768,10.049,409,251,178,73,158,113,45,42,0.0,0.01
1011,589,2020-03-17 16:17:00,1,2100.0,1564.0,0.745,10.007,386,293,215,78,93,64,29,59,0.0,0.0
1011,590,2020-03-17 16:20:00,1,2253.0,1719.0,0.763,10.78,41,38,1,37,3,1,2,43,0.0,0.0
1011,591,2020-03-17 16:23:00,1,2507.0,1820.0,0.726,11.891,51,51,19,32,0,0,0,27,0.0,0.0
1011,592,2020-03-17 16:26:00,1,2461.0,1934.0,0.786,11.839,52,52,32,20,0,0,0,15,0.0,0.0
1011,593,2020-03-17 16:29:00,1,2236.0,1727.0,0.772,10.724,0,0,0,0,0,0,0,0,0.0,0.0
1011,594,2020-03-17 16:32:00,1,2094.0,1571.0,0.75,9.989,7,7,2,5,0,0,0,0,0.0,0.0
1011,595,2020-03-17 16:35:00,1,1947.0,1472.0,0.756,9.3,0,0,0,0,0,0,0,0,0.0,0.0
1011,596,2020-03-17 16:38:00,1,1872.0,1387.0,0.741,8.912,1,1,0,1,0,0,0,0,0.0,0.0
1011,597,2020-03-17 16:41:00,1,1792.0,1329.0,0.742,8.533,8,8,5,3,0,0,0,0,0.0,0.0
1011,598,2020-03-17 16:44:00,1,1713.0,1273.0,0.743,8.161,13,13,0,13,0,0,0,0,0.0,0.0
1011,599,2020-03-17 16:47:00,1,1720.0,1267.0,0.737,8.18,0,0,0,0,0,0,0,0,0.0,0.0
1011,600,2020-03-17 16:50:00,1,1736.0,1202.0,0.693,8.17,4,4,0,4,0,0,0,0,0.0,0.0
1011,601,2020-03-17 16:53:00,1,1641.0,1185.0,0.722,7.779,22,22,0,22,0,0,0,0,0.0,0.0
1011,602,2020-03-17 16:56:00,1,1650.0,1169.0,0.709,7.795,6,6,0,6,0,0,0,0,0.0,0.0
1011,603,2020-03-17 16:59:00,1,1560.0,1163.0,0.746,7.432,13,10,7,3,3,1,2,2,0.0,0.0
1011,604,2020-03-17 17:02:00,1,1713.0,1263.0,0.738,8.148,10,10,0,10,0,0,0,0,0.0,0.0
1011,605,2020-03-17 17:05:00,1,1697.0,1318.0,0.777,8.146,1,1,0,1,0,0,0,0,0.0,0.0
1011,606,2020-03-17 17:08:00,1,1882.0,1356.0,0.72,8.918,3,3,0,3,0,0,0,0,0.0,0.0
1011,607,2020-03-17 17:11:00,1,1793.0,1326.0,0.74,8.532,1,1,0,1,0,0,0,0,0.0,0.0
1011,608,2020-03-17 17:14:00,1,1800.0,1320.0,0.734,8.553,6,1,0,1,5,1,4,0,0.0,0.0
1011,609,2020-03-17 17:17:00,1,1799.0,1328.0,0.738,8.56,27,27,14,13,0,0,0,17,0.0,0.0
1011,610,2020-03-17 17:20:00,1,1827.0,1388.5,0.7595,8.736,158,141,86,55,17,11,6,25,0.0,0.0
1011,611,2020-03-17 17:23:00,1,1855.0,1449.0,0.781,8.912,11,11,0,11,0,0,0,0,0.0,0.0
1011,612,2020-03-17 17:26:00,1,1874.0,1392.0,0.743,8.923,7,7,2,5,0,0,0,0,0.0,0.0
1011,613,2020-03-17 17:29:00,1,1708.0,1323.0,0.775,8.193,14,10,7,3,4,3,1,0,0.0,0.0
1011,614,2020-03-17 17:32:00,1,1615.0,1288.0,0.798,7.788,26,19,8,11,7,1,6,0,0.0,0.0
1011,615,2020-03-17 17:35:00,1,1698.0,1316.0,0.775,8.146,29,24,7,17,5,1,4,0,0.0,0.0
1011,616,2020-03-17 17:38:00,1,1697.0,1309.0,0.772,8.135,33,24,10,14,9,1,8,0,0.0,0.0
1011,617,2020-03-17 17:41:00,1,1788.0,1327.0,0.742,8.516,113,87,51,36,26,15,11,33,0.0,0.0
1011,618,2020-03-17 17:44:00,1,1940.0,1496.0,0.771,9.3,73,69,28,41,4,2,2,24,0.0,0.0
1011,619,2020-03-17 17:47:00,1,2011.0,1594.0,0.792,9.69,114,113,68,45,1,0,1,28,0.0,0.0
1011,620,2020-03-17 17:50:00,1,2082.0,1647.0,0.791,10.028,31,26,10,16,5,1,4,69,0.0,0.0
1011,621,2020-03-17 17:53:00,1,2167.0,1681.0,0.775,10.4,31,30,7,23,1,0,1,42,0.0,0.0
1011,622,2020-03-17 17:56:00,1,2152.0,1746.0,0.811,10.413,367,226,172,54,141,104,37,88,0.0,0.0
1011,623,2020-03-17 17:59:00,1,2228.0,1776.0,0.797,10.745,251,166,103,63,85,50,35,77,0.0,0.0
1011,624,2020-03-17 18:02:00,0,2396.0,1885.0,0.787,11.526,425,260,183,77,165,103,62,128,0.0,0.0
1011,625,2020-03-17 18:05:00,0,2699.0,2096.0,0.776,12.954,335,170,111,59,165,95,70,98,0.0,0.0
1011,626,2020-03-17 18:08:00,0,2394.0,1890.0,0.789,11.525,633,462,385,77,171,124,47,298,0.0,0.0
1011,627,2020-03-17 18:11:00,0,2776.0,2187.0,0.788,13.361,383,215,161,54,168,125,43,211,0.0,0.0
1011,628,2020-03-17 18:14:00,0,2784.0,2160.0,0.776,13.361,541,297,223,74,244,184,60,63,0.0,0.0
1011,629,2020-03-17 18:17:00,0,2556.0,1953.0,0.764,12.234,248,203,135,68,45,29,16,103,0.0,0.0
1011,630,2020-03-17 18:20:00,0,2787.0,2131.0,0.765,13.342,582,367,296,71,215,160,55,157,0.0,0.0
1011,631,2020-03-17 18:23:00,0,2772.0,2207.0,0.796,13.363,673,363,282,81,310,240,70,161,0.0,0.0
1011,632,2020-03-17 18:26:00,0,2783.0,2167.0,0.779,13.363,389,270,200,70,119,82,37,99,0.0,0.0
1011,633,2020-03-17 18:29:00,0,2951.0,2257.0,0.765,14.128,187,167,109,58,20,0,20,107,0.0,0.0
1011,634,2020-03-17 18:32:00,0,2794.0,2121.0,0.759,13.357,508,312,252,60,196,144,52,143,0.0,0.13
1011,635,2020-03-17 18:35:00,0,2793.0,2126.0,0.761,13.357,103,83,28,55,20,3,17,66,0.0,0.02
1011,636,2020-03-17 18:38:00,0,2617.0,2084.0,0.797,12.617,245,226,156,70,19,11,8,39,0.0,0.0
1011,637,2020-03-17 18:41:00,0,2771.0,2178.0,0.786,13.331,170,153,88,65,17,1,16,23,0.0,0.0
1011,638,2020-03-17 18:44:00,0,2776.0,2137.0,0.77,13.303,146,140,70,70,6,0,6,16,0.0,0.0
1011,639,2020-03-17 18:47:00,0,2793.0,2112.0,0.756,13.343,310,287,212,75,23,9,14,80,0.0,0.0
1011,640,2020-03-17 18:50:00,0,2633.0,2062.0,0.783,12.656,477,229,190,39,248,176,72,159,0.0,0.0
1011,641,2020-03-17 18:53:00,0,2875.0,2185.0,0.76,13.747,315,149,83,66,166,102,64,91,0.0,0.0
1011,642,2020-03-17 18:56:00,0,2963.0,2214.0,0.747,14.127,413,222,163,59,191,125,66,136,0.32,0.0
1011,643,2020-03-17 18:59:00,0,2558.0,1969.0,0.77,12.259,718,378,304,74,340,255,85,206,0.0,0.0
1011,644,2020-03-17 19:02:00,0,2793.0,2163.0,0.774,13.398,707,391,308,83,316,241,75,222,0.0,0.0
1011,645,2020-03-17 19:05:00,0,2810.0,2080.0,0.74,13.373,456,240,179,61,216,164,52,172,0.0,0.0
1011,646,2020-03-17 19:08:00,0,2792.0,2148.0,0.769,13.378,258,178,109,69,80,33,47,114,0.0,0.0
1011,647,2020-03-17 19:11:00,0,3015.0,2342.0,0.777,14.473,186,127,61,66,59,20,39,105,0.0,0.0
1011,648,2020-03-17 19:14:00,0,3006.0,2431.0,0.809,14.534,248,169,95,74,79,30,49,106,0.0,0.0
1011,649,2020-03-17 19:17:00,0,2763.0,2255.0,0.816,13.383,357,201,147,54,156,100,56,81,0.0,0.08
1011,650,2020-03-17 19:20:00,0,2922.0,2356.0,0.806,14.121,735,426,341,85,309,235,74,60,0.0,0.02
1011,651,2020-03-17 19:23:00,0,1618.0,1300.0,0.803,7.815,146,128,82,46,18,0,18,15,0.0,0.0
1011,652,2020-03-17 19:26:00,0,1870.0,1389.0,0.743,8.907,182,168,110,58,14,0,14,9,0.0,0.0
1011,653,2020-03-17 19:29:00,0,1988.0,1637.0,0.824,9.645,43,34,15,19,9,0,9,0,0.0,0.0
1011,654,2020-03-17 19:32:00,0,1773.0,1397.0,0.788,8.531,2,2,1,1,0,0,0,0,0.0,0.0
1011,655,2020-03-17 19:35:00,0,1624.0,1288.0,0.793,7.824,12,3,2,1,9,6,3,0,0.0,0.0
1011,656,2020-03-17 19:38:00,0,1999.0,1616.0,0.809,9.664,2,0,0,0,2,0,2,0,0.0,0.0
1011,657,2020-03-17 19:41:00,0,2520.0,2093.0,0.831,12.247,302,149,100,49,153,97,56,103,0.0,0.0
1011,658,2020-03-17 19:44:00,0,2872.0,2537.0,0.883,14.126,208,154,88,66,54,20,34,110,0.1,0.0
1011,659,2020-03-17 19:47:00,0,2871.0,2568.0,0.895,14.153,369,237,164,73,132,82,50,140,0.0,0.0
1011,660,2020-03-17 19:50:00,0,2870.0,2566.0,0.894,14.149,382,242,179,63,140,95,45,185,0.0,0.0
1011,661,2020-03-17 19:53:00,0,2862.0,2561.0,0.895,14.111,442,250,192,58,192,138,54,105,0.0,0.0
1011,662,2020-03-17 19:56:00,0,2715.0,2416.0,0.89,13.372,618,348,282,66,270,204,66,238,0.0,0.0
1011,663,2020-03-17 19:59:00,0,2721.0,2422.0,0.89,13.402,627,321,226,95,306,226,80,66,0.0,0.0
1011,664,2020-03-17 20:02:00,0,3127.0,2656.0,0.849,15.261,191,125,71,54,66,32,34,59,0.0,0.0
1011,665,2020-03-17 20:05:00,0,2036.0,1834.0,0.9,10.053,459,288,224,64,171,121,50,158,0.0,0.0
1011,666,2020-03-17 20:08:00,0,3124.0,2691.0,0.861,15.288,406,220,150,70,186,132,54,86,0.03,0.0
1011,667,2020-03-17 20:11:00,0,2952.0,2605.0,0.883,14.515,269,209,137,72,60,14,46,112,0.0,0.01
1011,668,2020-03-17 20:14:00,0,2267.0,2026.0,0.894,11.175,218,175,117,58,43,19,24,30,0.0,0.06
1011,669,2020-03-17 20:17:00,0,1589.0,1394.0,0.877,7.804,71,66,29,37,5,0,5,16,0.0,0.0
1011,670,2020-03-17 20:20:00,0,2152.0,1916.0,0.8875,10.6005,48,35,7,28,13,0,13,9,0.0,0.0
1011,671,2020-03-17 20:23:00,0,2715.0,2438.0,0.898,13.397,589,394,317,77,195,136,59,184,0.0,0.0
1011,672,2020-03-17 20:26:00,0,3025.0,2674.0,0.884,14.881,479,254,198,56,225,156,69,205,0.0,0.0
1011,673,2020-03-17 20:29:00,0,2855.0,2627.0,0.92,14.156,393,288,220,68,105,63,42,96,0.1,0.0
1011,674,2020-03-17 20:32:00,0,2649.0,2324.0,0.877,13.012,576,329,255,74,247,178,69,100,0.11,0.02
1011,675,2020-03-17 20:35:00,0,2412.0,2143.0,0.889,11.875,501,316,237,79,185,123,62,144,0.0,0.03
1011,676,2020-03-17 20:38:00,0,3119.0,2665.0,0.854,15.239,231,143,80,63,88,21,67,143,0.0,0.0
1011,677,2020-03-17 20:41:00,0,3117.0,2719.0,0.872,15.291,180,118,71,47,62,16,46,54,0.0,0.06
1011,678,2020-03-17 20:44:00,0,2876.0,2540.0,0.883,14.144,459,270,214,56,189,143,46,74,0.0,0.07
1011,679,2020-03-17 20:47:00,0,2886.0,2468.0,0.855,14.104,734,402,322,80,332,248,84,136,0.0,0.0
1011,680,2020-03-17 20:50:00,0,2895.0,2471.0,0.854,14.143,249,163,104,59,86,41,45,217,0.0,0.0
1011,681,2020-03-17 20:53:00,0,2877.0,2488.0,0.865,14.089,219,150,88,62,69,16,53,120,0.0,0.0
1011,682,2020-03-17 20:56:00,0,2723.0,2414.0,0.887,13.401,171,108,61,47,63,14,49,96,0.0,0.0
1011,683,2020-03-17 20:59:00,0,3088.0,2767.0,0.896,15.23,265,172,109,63,93,52,41,97,0.0,0.0
1011,684,2020-03-17 21:02:00,0,3085.0,2797.0,0.907,15.25,225,122,64,58,103,52,51,64,0.05,0.08
1011,685,2020-03-17 21:05:00,0,2697.0,2467.0,0.915,13.358,133,90,49,41,43,10,33,22,0.0,0.0
1011,686,2020-03-17 21:08:00,0,1980.0,1681.0,0.849,9.661,528,274,213,61,254,199,55,100,0.34,0.09
1011,687,2020-03-17 21:11:00,0,2625.0,2401.0,0.914,13.002,691,386,291,95,305,218,87,97,0.0,0.0
1011,688,2020-03-17 21:14:00,0,3091.0,2814.0,0.91,15.295,325,203,137,66,122,62,60,120,0.0,0.0
1011,689,2020-03-17 21:17:00,0,2933.0,2643.0,0.901,14.483,304,192,128,64,112,53,59,105,0.0,0.0
1011,690,2020-03-17 21:20:00,0,2732.0,2383.0,0.872,13.4,260,184,110,74,76,0,76,114,0.0,0.0
1011,691,2020-03-17 21:23:00,0,2713.0,2428.0,0.895,13.375,233,149,90,59,84,15,69,68,0.15,0.0
1011,692,2020-03-17 21:26:00,0,1820.0,1600.0,0.879,8.941,139,98,62,36,41,10,31,25,0.0,0.0
1011,693,2020-03-17 21:29:00,0,1585.0,1420.0,0.896,7.818,48,40,10,30,8,3,5,3,0.0,0.0
1011,694,2020-03-17 21:32:00,0,1984.0,1672.0,0.843,9.668,172,119,73,46,53,28,25,29,0.0,0.0
1011,695,2020-03-17 21:35:00,0,2997.0,2771.0,0.925,14.875,538,319,259,60,219,168,51,144,0.0,0.06
1011,696,2020-03-17 21:38:00,0,2137.0,1821.0,0.852,10.436,38,18,3,15,20,0,20,15,0.0,0.0
1011,697,2020-03-17 21:41:00,0,1970.0,1721.0,0.873,9.667,19,16,9,7,3,0,3,0,0.0,0.0
1011,698,2020-03-17 21:44:00,0,1969.0,1701.0,0.864,9.64,6,6,1,5,0,0,0,0,0.0,0.0
1011,699,2020-03-17 21:47:00,0,2120.0,1847.0,0.871,10.398,28,28,6,22,0,0,0,0,0.0,0.0
1011,700,2020-03-17 21:50:00,0,2358.0,2031.0,0.861,11.539,31,20,12,8,11,3,8,4,0.0,0.0
1011,701,2020-03-17 21:53:00,0,2500.0,2171.0,0.868,12.251,1,1,0,1,0,0,0,0,0.0,0.0
1011,702,2020-03-17 21:56:00,0,2326.0,2162.0,0.929,11.556,5,5,0,5,0,0,0,0,0.0,0.0
1011,703,2020-03-17 21:59:00,0,2344.0,2054.0,0.876,11.508,0,0,0,0,0,0,0,0,0.0,0.0
1011,704,2020-03-17 22:02:00,0,2172.0,1971.0,0.907,10.74,234,188,135,53,46,17,29,74,0.0,0.0
1011,705,2020-03-17 22:05:00,0,2481.0,2224.0,0.896,12.236,217,155,90,65,62,17,45,122,0.0,0.0
1011,706,2020-03-17 22:08:00,0,2642.0,2339.0,0.885,12.997,377,254,184,70,123,74,49,145,0.0,0.0
1011,707,2020-03-17 22:11:00,0,2473.0,2275.0,0.92,12.262,219,153,105,48,66,43,23,125,0.0,0.0
1011,708,2020-03-17 22:14:00,0,1956.0,1769.0,0.904,9.665,41,23,2,21,18,0,18,10,0.0,0.0
1011,709,2020-03-17 22:17:00,0,2430.0,2102.0,0.865,11.9,80,52,18,34,28,2,26,21,0.0,0.0
1011,710,2020-03-17 22:20:00,0,2709.0,2483.0,0.917,13.422,178,155,96,59,23,1,22,27,0.0,0.0
1011,711,2020-03-17 22:23:00,0,2881.0,2543.0,0.883,14.168,261,193,142,51,68,46,22,47,0.0,0.0
1011,712,2020-03-17 22:26:00,0,2717.0,2437.0,0.897,13.402,423,291,219,72,132,95,37,78,0.0,0.0
1011,713,2020-03-17 22:29:00,0,2885.0,2460.0,0.853,14.09,261,165,88,77,96,31,65,122,0.0,0.0
1011,714,2020-03-17 22:32:00,0,2854.0,2586.0,0.906,14.109,291,217,139,78,74,3,71,111,0.0,0.0
1011,715,2020-03-17 22:35:00,0,2486.0,2235.0,0.899,12.268,227,166,90,76,61,0,61,94,0.0,0.01
1011,716,2020-03-17 22:38:00,0,2572.0,2283.0,0.888,12.663,146,110,69,41,36,2,34,49,0.0,0.02
1011,717,2020-03-17 22:41:00,0,1449.0,1230.0,0.849,7.07,11,7,4,3,4,0,4,0,0.0,0.08
1011,718,2020-03-17 22:44:00,0,1442.0,1265.0,0.877,7.08,0,0,0,0,0,0,0,0,0.0,0.0
1011,719,2020-03-17 22:47:00,0,1443.0,1245.0,0.863,7.063,6,6,3,3,0,0,0,0,0.0,0.0
1011,720,2020-03-17 22:50:00,0,1760.0,1448.0,0.823,8.536,0,0,0,0,0,0,0,0,0.0,0.0
1011,721,2020-03-17 22:53:00,0,2487.0,2212.0,0.889,12.25,205,160,96,64,45,12,33,22,0.24,0.07
1011,722,2020-03-17 22:56:00,0,2466.0,2302.0,0.934,12.266,202,152,96,56,50,20,30,46,0.0,0.0
1011,723,2020-03-17 22:59:00,0,3093.0,2786.0,0.901,15.271,231,154,84,70,77,39,38,108,0.0,0.0
1011,724,2020-03-17 23:02:00,0,2850.0,2641.0,0.927,14.155,287,246,165,81,41,0,41,118,0.0,0.0
1011,725,2020-03-17 23:05:00,0,2704.0,2438.0,0.902,13.353,252,206,128,78,46,0,46,132,0.0,0.04
1011,726,2020-03-17 23:08:00,0,3074.0,2816.0,0.916,15.23,326,183,130,53,143,93,50,106,0.28,0.24
1011,727,2020-03-17 23:11:00,0,1825.0,1548.0,0.848,8.906,185,124,79,45,61,12,49,87,0.0,0.01
1011,728,2020-03-17 23:14:00,0,2778.0,2490.0,0.896,13.701,146,90,48,42,56,14,42,92,0.0,0.04
1011,729,2020-03-17 23:17:00,0,1653.0,1500.0,0.907,8.171,141,111,74,37,30,6,24,21,0.0,0.06
1011,730,2020-03-17 23:20:00,0,2259.0,2039.0,0.9035,11.1575,539,298,232,66,241,183,58,125,0.01,0.0
1011,731,2020-03-17 23:23:00,0,2865.0,2578.0,0.9,14.144,264,174,135,39,90,59,31,59,0.0,0.0
1011,732,2020-03-17 23:26:00,0,2843.0,2641.0,0.929,14.124,566,348,267,81,218,165,53,73,0.0,0.0
1011,733,2020-03-17 23:29:00,0,2918.0,2736.0,0.938,14.528,425,291,229,62,134,99,35,55,0.18,0.0
1011,734,2020-03-17 23:32:00,0,3076.0,2797.0,0.91,15.214,252,173,98,75,79,3,76,134,0.0,0.0
1011,735,2020-03-17 23:35:00,0,2990.0,2802.0,0.937,14.884,183,139,89,50,44,3,41,64,0.0,0.14
1011,736,2020-03-17 23:38:00,0,1959.0,1759.0,0.898,9.668,124,88,44,44,36,2,34,8,0.0,0.0
1011,737,2020-03-17 23:41:00,0,2345.0,2055.0,0.876,11.515,58,24,1,23,34,0,34,0,0.0,0.0
1011,738,2020-03-17 23:44:00,0,2695.0,2505.0,0.929,13.392,378,247,196,51,131,89,42,41,0.0,0.0
1011,739,2020-03-17 23:47:00,0,2995.0,2751.0,0.918,14.847,727,364,283,81,363,272,91,157,0.0,0.0
1011,740,2020-03-17 23:50:00,0,3077.0,2821.0,0.917,15.247,733,493,395,98,240,166,74,62,0.0,0.0
1011,741,2020-03-17 23:53:00,0,3086.0,2804.0,0.908,15.264,333,196,150,46,137,100,37,120,0.09,0.1
1011,742,2020-03-17 23:56:00,0,2706.0,2470.0,0.913,13.394,532,342,258,84,190,131,59,70,0.0,0.0
1011,743,2020-03-17 23:59:00,0,2712.0,2442.0,0.9,13.39,523,409,307,102,114,59,55,19,0.0,0.0
1011,744,2020-03-18 00:02:00,0,2840.0,2670.0,0.94,14.145,333,255,167,88,78,37,41,12,0.0,0.0
1011,745,2020-03-18 00:05:00,0,2854.0,2574.0,0.902,14.096,339,207,148,59,132,75,57,160,0.0,0.0
1011,746,2020-03-18 00:08:00,0,2998.0,2732.0,0.911,14.835,123,68,38,30,55,8,47,96,0.0,0.0
1011,747,2020-03-18 00:11:00,0,2703.0,2443.0,0.904,13.354,10,10,1,9,0,0,0,3,0.0,0.07
1011,748,2020-03-18 00:14:00,0,2689.0,2470.0,0.919,13.33,129,94,57,37,35,22,13,28,0.05,0.02
1011,749,2020-03-18 00:17:00,0,2622.0,2431.0,0.927,13.021,461,268,199,69,193,149,44,152,0.06,0.03
1011,750,2020-03-18 00:20:00,0,3213.0,2939.0,0.915,15.914,691,363,263,100,328,251,77,50,0.0,0.0
1011,751,2020-03-18 00:23:00,0,2929.0,2652.0,0.905,14.475,392,232,169,63,160,115,45,100,0.0,0.11
1011,752,2020-03-18 00:26:00,0,2477.0,2286.0,0.923,12.292,660,389,288,101,271,202,69,28,0.0,0.0
1011,753,2020-03-18 00:29:00,0,2448.0,2363.0,0.965,12.262,600,358,275,83,242,171,71,52,0.0,0.0
1011,754,2020-03-18 00:32:00,0,2718.0,2413.0,0.888,13.381,384,267,203,64,117,63,54,61,0.0,0.0
1011,755,2020-03-18 00:35:00,0,2835.0,2633.0,0.929,14.085,448,271,193,78,177,108,69,11,0.0,0.0
1011,756,2020-03-18 00:38:00,0,2782.0,2518.0,0.905,13.749,1319,965,808,157,354,256,98,97,0.0,0.0
1011,757,2020-03-18 00:41:00,0,2706.0,2488.0,0.919,13.418,883,609,495,114,274,202,72,48,0.0,0.0
1011,758,2020-03-18 00:44:00,0,2688.0,2522.0,0.938,13.383,698,582,470,112,116,65,51,91,0.0,0.0
1011,759,2020-03-18 00:47:00,0,2697.0,2492.0,0.924,13.385,764,561,446,115,203,128,75,40,0.0,0.03
1011,760,2020-03-18 00:50:00,0,2712.0,2443.0,0.901,13.389,141,130,79,51,11,5,6,67,0.0,0.0
1011,761,2020-03-18 00:53:00,0,2704.0,2470.0,0.913,13.388,230,158,102,56,72,44,28,57,0.0,0.0
1011,762,2020-03-18 00:56:00,0,2629.0,2383.0,0.906,12.995,786,560,450,110,226,161,65,97,0.0,0.0
1011,763,2020-03-18 00:59:00,0,2474.0,2323.0,0.939,12.318,836,608,500,108,228,175,53,98,0.13,0.0
1011,764,2020-03-18 01:02:00,0,2462.0,2320.0,0.942,12.269,348,239,163,76,109,70,39,143,0.0,0.0
1011,765,2020-03-18 01:05:00,0,2486.0,2263.0,0.91,12.299,245,194,126,68,51,13,38,159,0.0,0.0
1011,766,2020-03-18 01:08:00,0,2191.0,1967.0,0.898,10.809,717,548,442,106,169,108,61,80,0.0,0.0
1011,767,2020-03-18 01:11:00,0,2326.0,2122.0,0.912,11.514,836,566,463,103,270,199,71,56,0.0,0.0
1011,768,2020-03-18 01:14:00,0,2483.0,2228.0,0.897,12.252,889,665,558,107,224,156,68,67,0.0,0.0
1011,769,2020-03-18 01:17:00,0,2640.0,2356.0,0.892,13.008,340,234,169,65,106,55,51,109,0.0,0.0
1011,770,2020-03-18 01:20:00,0,2723.0,2400.0,0.881,13.385,560,381,297,84,179,125,54,51,0.0,0.0
1011,771,2020-03-18 01:23:00,0,2475.0,2252.0,0.91,12.247,238,164,108,56,74,46,28,57,0.0,0.0
1011,772,2020-03-18 01:26:00,0,2551.0,2330.0,0.914,12.629,196,171,118,53,25,8,17,24,0.0,0.0
1011,773,2020-03-18 01:29:00,0,2467.0,2312.0,0.937,12.279,122,81,39,42,41,5,36,42,0.0,0.0
1011,774,2020-03-18 01:32:00,0,2481.0,2286.0,0.921,12.307,261,192,132,60,69,29,40,68,0.0,0.0
1011,775,2020-03-18 01:35:00,0,2500.0,2193.0,0.877,12.279,803,600,486,114,203,146,57,165,0.0,0.0
1011,776,2020-03-18 01:38:00,0,2338.0,2080.0,0.89,11.513,519,363,281,82,156,119,37,150,0.0,0.0
1011,777,2020-03-18 01:41:00,0,2345.0,2084.0,0.889,11.547,218,199,132,67,19,7,12,69,0.0,0.0
1011,778,2020-03-18 01:44:00,0,2498.0,2179.0,0.872,12.254,452,388,290,98,64,34,30,80,0.0,0.0
1011,779,2020-03-18 01:47:00,0,2348.0,2059.0,0.877,11.53,719,478,390,88,241,179,62,138,0.0,0.0
1011,780,2020-03-18 01:50:00,0,2419.0,2139.0,0.884,11.899,520,352,281,71,168,119,49,96,0.0,0.0
1011,781,2020-03-18 01:53:00,0,2335.0,2089.0,0.895,11.511,666,470,364,106,196,131,65,70,0.0,0.0
1011,782,2020-03-18 01:56:00,0,2431.0,2099.0,0.864,11.903,436,368,274,94,68,42,26,79,0.0,0.0
1011,783,2020-03-18 01:59:00,0,2346.0,2079.0,0.886,11.545,157,106,57,49,51,18,33,51,0.0,0.0
1011,784,2020-03-18 02:02:00,0,2335.0,2095.0,0.897,11.519,63,38,14,24,25,4,21,8,0.0,0.0
1011,785,2020-03-18 02:05:00,0,2339.0,2108.0,0.902,11.548,85,55,34,21,30,8,22,8,0.0,0.0
1011,786,2020-03-18 02:08:00,0,2119.0,1878.0,0.886,10.427,34,1,0,1,33,11,22,0,0.0,0.0
1011,787,2020-03-18 02:11:00,0,1988.0,1688.0,0.849,9.703,56,1,0,1,55,13,42,0,0.0,0.0
1011,788,2020-03-18 02:14:00,0,1818.0,1608.0,0.885,8.944,82,0,0,0,82,55,27,0,0.0,0.0
1011,789,2020-03-18 02:17:00,0,1843.0,1504.0,0.816,8.928,47,14,5,9,33,6,27,0,0.0,0.0
1011,790,2020-03-18 02:20:00,0,1722.0,1435.0,0.8345,8.3735,19,0,0,0,19,2,17,0,0.0,0.0
1011,791,2020-03-18 02:23:00,0,1601.0,1366.0,0.853,7.819,27,1,0,1,26,2,24,0,0.0,0.0
1011,792,2020-03-18 02:26:00,0,1600.0,1356.0,0.847,7.805,46,12,0,12,34,0,34,0,0.0,0.0
1011,793,2020-03-18 02:29:00,0,1598.0,1368.0,0.856,7.809,32,1,0,1,31,0,31,0,0.0,0.0
1011,794,2020-03-18 02:32:00,0,1763.0,1462.0,0.829,8.565,47,14,8,6,33,2,31,0,0.0,0.0
1011,795,2020-03-18 02:35:00,0,1834.0,1543.0,0.841,8.936,19,0,0,0,19,0,19,0,0.0,0.0
1011,796,2020-03-18 02:38:00,0,1753.0,1491.0,0.85,8.559,22,0,0,0,22,0,22,0,0.0,0.0
1011,797,2020-03-18 02:41:00,0,1660.0,1476.0,0.889,8.174,24,3,0,3,21,0,21,0,0.0,0.0
1011,798,2020-03-18 02:44:00,0,1573.0,1441.0,0.916,7.793,36,12,5,7,24,4,20,0,0.0,0.0
1011,799,2020-03-18 02:47:00,0,1751.0,1512.0,0.863,8.574,240,164,114,50,76,44,32,38,0.0,0.0
1011,800,2020-03-18 02:50:00,0,2034.0,1823.0,0.896,10.032,267,207,146,61,60,32,28,122,0.0,0.0
1011,801,2020-03-18 02:53:00,0,2359.0,2029.0,0.86,11.54,242,139,97,42,103,65,38,107,0.0,0.0
1011,802,2020-03-18 02:56:00,0,2353.0,2049.0,0.871,11.539,176,117,83,34,59,31,28,56,0.0,0.0
1011,803,2020-03-18 02:59:00,0,2349.0,2080.0,0.886,11.557,277,181,114,67,96,56,40,118,0.0,0.0
1011,804,2020-03-18 03:02:00,0,2490.0,2237.0,0.898,12.286,236,153,83,70,83,28,55,96,0.0,0.0
1011,805,2020-03-18 03:05:00,0,2728.0,2376.0,0.871,13.379,165,113,52,61,52,22,30,118,0.0,0.0
1011,806,2020-03-18 03:08:00,0,2648.0,2342.0,0.884,13.027,563,304,241,63,259,191,68,168,0.0,0.0
1011,807,2020-03-18 03:11:00,0,2727.0,2435.0,0.893,13.438,620,386,304,82,234,176,58,271,0.08,0.0
1011,808,2020-03-18 03:14:00,0,2861.0,2599.0,0.908,14.151,237,137,88,49,100,46,54,112,0.0,0.03
1011,809,2020-03-18 03:17:00,0,2485.0,2242.0,0.902,12.273,407,225,178,47,182,130,52,141,0.0,0.02
1011,810,2020-03-18 03:20:00,0,2546.0,2370.0,0.931,12.654,346,230,166,64,116,72,44,46,0.0,0.0
1011,811,2020-03-18 03:23:00,0,2334.0,2132.0,0.913,11.555,246,165,126,39,81,53,28,58,0.25,0.0
1011,812,2020-03-18 03:26:00,0,2487.0,2250.0,0.905,12.291,346,224,173,51,122,84,38,134,0.0,0.0
1011,813,2020-03-18 03:29:00,0,2506.0,2162.0,0.863,12.268,140,108,71,37,32,15,17,8,0.0,0.0
1011,814,2020-03-18 03:32:00,0,2563.0,2310.0,0.901,12.656,155,121,73,48,34,15,19,49,0.0,0.0
1011,815,2020-03-18 03:35:00,0,2641.0,2370.0,0.897,13.031,148,85,27,58,63,20,43,10,0.0,0.0
1011,816,2020-03-18 03:38:00,0,2544.0,2345.0,0.922,12.619,40,17,7,10,23,7,16,0,0.0,0.0
1011,817,2020-03-18 03:41:00,0,2342.0,2094.0,0.894,11.546,12,0,0,0,12,0,12,0,0.0,0.0
1011,818,2020-03-18 03:44:00,0,2107.0,1877.0,0.891,10.381,13,1,0,1,12,0,12,0,0.0,0.0
1011,819,2020-03-18 03:47:00,0,1976.0,1715.0,0.868,9.686,31,3,2,1,28,0,28,0,0.0,0.0
1011,820,2020-03-18 03:50:00,0,1824.0,1586.0,0.869,8.941,26,1,0,1,25,0,25,0,0.0,0.0
1011,821,2020-03-18 03:53:00,0,1832.0,1539.0,0.84,8.923,37,12,8,4,25,2,23,4,0.0,0.0
1011,822,2020-03-18 03:56:00,0,1753.0,1497.0,0.854,8.563,20,2,0,2,18,0,18,0,0.0,0.0
1011,823,2020-03-18 03:59:00,0,1815.0,1606.0,0.885,8.929,27,0,0,0,27,0,27,0,0.0,0.0
1011,824,2020-03-18 04:02:00,0,1818.0,1591.0,0.875,8.926,14,0,0,0,14,0,14,0,0.0,0.0
1011,825,2020-03-18 04:05:00,0,1662.0,1476.0,0.888,8.181,21,6,0,6,15,0,15,0,0.0,0.0
1011,826,2020-03-18 04:08:00,0,1574.0,1454.0,0.924,7.811,20,7,0,7,13,0,13,0,0.0,0.0
1011,827,2020-03-18 04:11:00,0,1582.0,1425.0,0.901,7.813,216,173,116,57,43,18,25,31,0.0,0.0
1011,828,2020-03-18 04:14:00,0,1971.0,1715.0,0.87,9.665,147,97,50,47,50,19,31,45,0.0,0.0
1011,829,2020-03-18 04:17:00,0,2339.0,2078.0,0.889,11.516,298,211,156,55,87,57,30,101,0.0,0.08
1011,830,2020-03-18 04:20:00,0,2512.0,2154.0,0.857,12.283,207,122,66,56,85,39,46,122,0.0,0.0
1011,831,2020-03-18 04:23:00,0,2729.0,2347.0,0.86,13.352,410,259,170,89,151,97,54,120,0.0,0.01
1011,832,2020-03-18 04:26:00,0,2506.0,2186.0,0.872,12.294,406,225,164,61,181,123,58,138,0.0,0.0
1011,833,2020-03-18 04:29:00,0,2341.0,2067.0,0.883,11.51,481,309,239,70,172,124,48,172,0.15,0.01
1011,834,2020-03-18 04:32:00,0,2343.0,2089.0,0.892,11.544,218,142,88,54,76,25,51,88,0.0,0.0
1011,835,2020-03-18 04:35:00,0,2871.0,2524.0,0.879,14.105,369,222,145,77,147,76,71,103,0.0,0.0
1011,836,2020-03-18 04:38:00,0,2727.0,2389.0,0.876,13.39,398,238,194,44,160,118,42,82,0.0,0.01
1011,837,2020-03-18 04:41:00,0,2467.0,2285.0,0.926,12.251,609,335,266,69,274,207,67,121,0.0,0.04
1011,838,2020-03-18 04:44:00,0,2328.0,2123.0,0.912,11.522,524,299,212,87,225,159,66,147,0.0,0.0
1011,839,2020-03-18 04:47:00,0,2867.0,2559.0,0.893,14.13,216,152,87,65,64,17,47,135,0.0,0.0
1011,840,2020-03-18 04:50:00,0,2857.0,2627.0,0.919,14.163,277,151,98,53,126,83,43,80,0.0,0.05
1011,841,2020-03-18 04:53:00,0,2503.0,2197.0,0.878,12.293,732,413,323,90,319,260,59,96,0.0,0.0
1011,842,2020-03-18 04:56:00,0,2713.0,2376.0,0.876,13.319,323,202,128,74,121,61,60,133,0.0,0.05
1011,843,2020-03-18 04:59:00,0,2838.0,2639.0,0.93,14.104,188,144,82,62,44,7,37,106,0.0,0.0
1011,844,2020-03-18 05:02:00,0,2115.0,1842.0,0.871,10.372,154,113,66,47,41,6,35,7,0.0,0.01
1011,845,2020-03-18 05:05:00,0,2364.0,1992.0,0.843,11.519,633,463,356,107,170,110,60,38,0.0,0.02
1011,846,2020-03-18 05:08:00,0,2717.0,2427.0,0.893,13.393,692,407,338,69,285,202,83,91,0.0,0.04
1011,847,2020-03-18 05:11:00,0,2494.0,2205.0,0.884,12.269,497,407,314,93,90,52,38,52,0.0,0.0
1011,848,2020-03-18 05:14:00,0,2872.0,2542.0,0.885,14.131,916,522,420,102,394,328,66,59,0.0,0.0
1011,849,2020-03-18 05:17:00,0,2694.0,2507.0,0.931,13.388,803,433,341,92,370,325,45,60,0.0,0.0
1011,850,2020-03-18 05:20:00,0,2581.0,2407.5,0.933,12.833,693,358,293,65,335,296,39,83,0.0,0.0
1011,851,2020-03-18 05:23:00,0,2468.0,2308.0,0.935,12.278,241,115,69,46,126,116,10,26,0.0,0.0
1011,852,2020-03-18 05:26:00,0,2714.0,2449.0,0.902,13.406,230,42,20,22,188,172,16,40,0.0,0.02
1011,853,2020-03-18 05:29:00,0,2721.0,2421.0,0.89,13.401,82,40,14,26,42,37,5,6,0.0,0.0
1011,854,2020-03-18 05:32:00,0,2643.0,2353.0,0.891,13.017,46,42,21,21,4,4,0,0,0.0,0.0
1011,855,2020-03-18 05:35:00,0,2413.0,2137.0,0.886,11.871,17,11,7,4,6,6,0,0,0.0,0.0
1011,856,2020-03-18 05:38:00,0,2114.0,1842.0,0.871,10.367,22,2,2,0,20,16,4,0,0.0,0.0
1011,857,2020-03-18 05:41:00,0,1975.0,1663.0,0.842,9.622,5,0,0,0,5,4,1,0,0.0,0.0
1011,858,2020-03-18 05:44:00,0,1830.0,1562.0,0.853,8.938,9,1,0,1,8,8,0,0,0.0,0.0
1011,859,2020-03-18 05:47:00,0,1667.0,1467.0,0.88,8.192,19,7,4,3,12,11,1,0,0.0,0.0
1011,860,2020-03-18 05:50:00,0,1668.0,1449.0,0.869,8.177,11,5,0,5,6,5,1,0,0.0,0.0
1011,861,2020-03-18 05:53:00,0,1752.0,1493.0,0.852,8.557,110,1,0,1,109,92,17,0,0.0,0.0
1011,862,2020-03-18 05:56:00,0,1822.0,1559.0,0.856,8.904,21,17,0,17,4,4,0,0,0.0,0.0
1011,863,2020-03-18 05:59:00,0,1834.0,1528.0,0.833,8.919,5,2,0,2,3,2,1,0,0.0,0.0
1011,864,2020-03-18 06:02:00,1,1667.0,1474.0,0.884,8.201,18,2,0,2,16,14,2,0,0.0,0.0
1011,865,2020-03-18 06:05:00,1,1578.0,1439.0,0.912,7.812,308,110,82,28,198,175,23,22,0.0,0.0
1011,866,2020-03-18 06:08:00,1,1983.0,1680.0,0.847,9.672,377,121,75,46,256,230,26,25,0.0,0.0
1011,867,2020-03-18 06:11:00,1,2373.0,1956.0,0.824,11.515,289,112,77,35,177,162,15,96,0.0,0.0
1011,868,2020-03-18 06:14:00,1,2507.0,2172.0,0.866,12.283,283,132,77,55,151,151,0,126,0.0,0.0
1011,869,2020-03-18 06:17:00,1,2345.0,2055.0,0.876,11.515,490,228,156,72,262,243,19,152,0.0,0.09
1011,870,2020-03-18 06:20:00,1,2743.0,2326.0,0.848,13.382,361,178,127,51,183,157,26,46,0.36,0.04
1011,871,2020-03-18 06:23:00,1,2347.0,2047.0,0.872,11.512,277,172,115,57,105,85,20,21,0.02,0.0
1011,872,2020-03-18 06:26:00,1,2360.0,2013.0,0.853,11.526,157,132,84,48,25,23,2,85,0.0,0.0
1011,873,2020-03-18 06:29:00,1,2430.0,2056.0,0.846,11.852,86,84,47,37,2,2,0,3,0.0,0.0
1011,874,2020-03-18 06:32:00,1,2488.0,2198.0,0.884,12.236,179,54,26,28,125,116,9,0,0.0,0.0
1011,875,2020-03-18 06:35:00,1,2498.0,2166.0,0.867,12.242,21,15,5,10,6,6,0,0,0.0,0.0
1011,876,2020-03-18 06:38:00,1,2361.0,1961.0,0.831,11.476,11,11,0,11,0,0,0,0,0.0,0.0
1011,877,2020-03-18 06:41:00,1,2136.0,1789.0,0.837,10.398,0,0,0,0,0,0,0,0,0.0,0.0
1011,878,2020-03-18 06:44:00,1,1989.0,1642.0,0.825,9.653,4,4,0,4,0,0,0,0,0.0,0.0
1011,879,2020-03-18 06:47:00,1,1833.0,1547.0,0.844,8.936,1,1,0,1,0,0,0,0,0.0,0.0
1011,880,2020-03-18 06:50:00,1,1596.0,1366.0,0.855,7.802,0,0,0,0,0,0,0,0,0.0,0.0
1011,881,2020-03-18 06:53:00,1,1600.0,1360.0,0.85,7.81,0,0,0,0,0,0,0,0,0.0,0.0
1011,882,2020-03-18 06:56:00,1,1597.0,1366.0,0.855,7.806,12,6,4,2,6,6,0,0,0.0,0.0
1011,883,2020-03-18 06:59:00,1,1581.0,1423.0,0.9,7.805,0,0,0,0,0,0,0,0,0.0,0.0
1011,884,2020-03-18 07:02:00,1,1587.0,1415.0,0.891,7.821,1,1,0,1,0,0,0,0,0.0,0.0
1011,885,2020-03-18 07:05:00,1,1593.0,1389.0,0.872,7.813,6,6,3,3,0,0,0,0,0.0,0.0
1011,886,2020-03-18 07:08:00,1,1859.0,1476.0,0.794,8.957,0,0,0,0,0,0,0,0,0.0,0.0
1011,887,2020-03-18 07:11:00,1,1824.0,1572.0,0.862,8.928,0,0,0,0,0,0,0,0,0.0,0.0
1011,888,2020-03-18 07:14:00,1,1844.0,1496.0,0.811,8.92,0,0,0,0,0,0,0,0,0.0,0.0
1011,889,2020-03-18 07:17:00,1,1859.0,1437.0,0.773,8.916,44,28,0,28,16,14,2,0,0.0,0.0
1011,890,2020-03-18 07:20:00,1,1839.0,1517.0,0.825,8.927,135,9,2,7,126,117,9,0,0.0,0.0
1011,891,2020-03-18 07:23:00,1,1833.0,1508.0,0.823,8.894,25,0,0,0,25,21,4,0,0.0,0.0
1011,892,2020-03-18 07:26:00,1,1838.0,1494.0,0.813,8.895,124,94,55,39,30,27,3,17,0.0,0.0
1011,893,2020-03-18 07:29:00,1,1984.0,1662.0,0.838,9.655,193,91,35,56,102,91,11,18,0.0,0.0
1011,894,2020-03-18 07:32:00,1,2378.0,1957.0,0.823,11.535,255,140,87,53,115,114,1,98,0.0,0.0
1011,895,2020-03-18 07:35:00,1,2520.0,2136.0,0.848,12.292,287,160,108,52,127,118,9,94,0.0,0.0
1011,896,2020-03-18 07:38:00,1,2760.0,2257.0,0.818,13.376,363,177,109,68,186,176,10,117,0.0,0.0
1011,897,2020-03-18 07:41:00,1,2901.0,2465.0,0.85,14.161,337,153,99,54,184,171,13,111,0.0,0.0
1011,898,2020-03-18 07:44:00,1,2968.0,2527.0,0.851,14.493,566,234,182,52,332,310,22,59,0.0,0.07
1011,899,2020-03-18 07:47:00,1,2223.0,1838.0,0.827,10.795,1022,489,398,91,533,488,45,69,0.0,0.0
1011,900,2020-03-18 07:50:00,1,2580.0,2236.0,0.867,12.64,692,299,231,68,393,334,59,25,0.0,0.0
1011,901,2020-03-18 07:53:00,1,2362.0,2005.0,0.849,11.526,563,263,204,59,300,257,43,15,0.0,0.0
1011,902,2020-03-18 07:56:00,1,2504.0,2140.0,0.855,12.233,626,306,239,67,320,277,43,37,0.0,0.0
1011,903,2020-03-18 07:59:00,1,2539.0,2071.0,0.815,12.297,820,402,307,95,418,360,58,24,0.0,0.0
1011,904,2020-03-18 08:02:00,1,2441.0,2050.0,0.84,11.888,865,504,401,103,361,303,58,46,0.0,0.0
1011,905,2020-03-18 08:05:00,1,2354.0,2023.0,0.859,11.515,568,255,183,72,313,267,46,11,0.0,0.0
1011,906,2020-03-18 08:08:00,1,2372.0,1981.0,0.835,11.54,315,148,106,42,167,137,30,16,0.0,0.0
1011,907,2020-03-18 08:11:00,1,2380.0,1952.0,0.82,11.538,183,47,13,34,136,106,30,1,0.0,0.0
1011,908,2020-03-18 08:14:00,1,2217.0,1841.0,0.831,10.771,31,7,0,7,24,8,16,0,0.0,0.0
1011,909,2020-03-18 08:17:00,1,2070.0,1720.0,0.831,10.061,36,28,0,28,8,0,8,0,0.0,0.0
1011,910,2020-03-18 08:20:00,1,1784.5,1540.0,0.869,8.737,38,21,8,13,17,0,17,0,0.0,0.0
1011,911,2020-03-18 08:23:00,1,1499.0,1360.0,0.907,7.413,11,2,1,1,9,0,9,0,0.0,0.0
1011,912,2020-03-18 08:26:00,1,1741.0,1547.0,0.889,8.572,404,185,121,64,219,197,22,25,0.0,0.0
1011,913,2020-03-18 08:29:00,1,2601.0,2153.0,0.828,12.632,582,278,199,79,304,263,41,88,0.0,0.0
1011,914,2020-03-18 08:32:00,1,2665.0,2197.0,0.825,12.932,229,154,99,55,75,22,53,81,0.0,0.0
1011,915,2020-03-18 08:35:00,1,2430.0,2073.0,0.853,11.87,89,46,21,25,43,14,29,12,0.0,0.0
1011,916,2020-03-18 08:38:00,1,2314.0,1847.0,0.798,11.161,47,2,1,1,45,0,45,0,0.0,0.0
1011,917,2020-03-18 08:41:00,1,1991.0,1631.0,0.819,9.652,73,3,2,1,70,0,70,0,0.0,0.0
1011,918,2020-03-18 08:44:00,1,1918.0,1557.0,0.812,9.282,87,9,2,7,78,13,65,0,0.0,0.0
1011,919,2020-03-18 08:47:00,1,1840.0,1493.0,0.811,8.905,79,0,0,0,79,13,66,0,0.0,0.0
1011,920,2020-03-18 08:50:00,1,1775.0,1397.0,0.787,8.54,73,0,0,0,73,2,71,0,0.0,0.0
1011,921,2020-03-18 08:53:00,1,1533.0,1273.0,0.83,7.449,88,5,2,3,83,14,69,0,0.0,0.0
1011,922,2020-03-18 08:56:00,1,1519.0,1283.0,0.845,7.408,62,0,0,0,62,4,58,0,0.0,0.0
1011,923,2020-03-18 08:59:00,1,1539.0,1238.0,0.804,7.432,69,3,0,3,66,0,66,0,0.0,0.0
1011,924,2020-03-18 09:02:00,1,1533.0,1247.0,0.814,7.42,98,13,6,7,85,20,65,0,0.0,0.0
1011,925,2020-03-18 09:05:00,1,1786.0,1353.0,0.758,8.537,71,0,0,0,71,0,71,0,0.0,0.0
1011,926,2020-03-18 09:08:00,1,1782.0,1351.0,0.758,8.516,70,0,0,0,70,1,69,0,0.0,0.0
1011,927,2020-03-18 09:11:00,1,1705.0,1314.0,0.771,8.171,64,0,0,0,64,2,62,0,0.0,0.0
1011,928,2020-03-18 09:14:00,1,1703.0,1310.0,0.769,8.16,69,0,0,0,69,8,61,0,0.0,0.0
1011,929,2020-03-18 09:17:00,1,1526.0,1277.0,0.837,7.425,65,0,0,0,65,0,65,0,0.0,0.0
1011,930,2020-03-18 09:20:00,1,1536.0,1240.0,0.807,7.422,215,27,13,14,188,113,75,0,0.0,0.0
1011,931,2020-03-18 09:23:00,1,1533.0,1239.0,0.808,7.412,72,0,0,0,72,0,72,0,0.0,0.0
1011,932,2020-03-18 09:26:00,1,1554.0,1204.0,0.775,7.455,84,0,0,0,84,26,58,0,0.0,0.0
1011,933,2020-03-18 09:29:00,1,1619.0,1272.0,0.786,7.786,60,0,0,0,60,8,52,0,0.0,0.0
1011,934,2020-03-18 09:32:00,1,1705.0,1296.0,0.76,8.154,69,0,0,0,69,6,63,0,0.0,0.0
1011,935,2020-03-18 09:35:00,1,1622.0,1298.0,0.801,7.827,62,1,0,1,61,4,57,0,0.0,0.0
1011,936,2020-03-18 09:38:00,1,1543.0,1232.0,0.798,7.443,57,0,0,0,57,2,55,0,0.0,0.0
1011,937,2020-03-18 09:41:00,1,1549.0,1196.0,0.772,7.426,61,2,0,2,59,4,55,0,0.0,0.0
1011,938,2020-03-18 09:44:00,1,1536.0,1261.0,0.821,7.447,121,5,0,5,116,44,72,0,0.0,0.0
1011,939,2020-03-18 09:47:00,1,1613.0,1312.0,0.813,7.809,200,96,57,39,104,38,66,7,0.0,0.0
1011,940,2020-03-18 09:50:00,1,1759.0,1453.0,0.826,8.538,200,129,71,58,71,12,59,30,0.0,0.0
1011,941,2020-03-18 09:53:00,1,2069.0,1714.0,0.828,10.049,342,137,93,44,205,136,69,60,0.0,0.0
1011,942,2020-03-18 09:56:00,1,2289.0,1913.0,0.836,11.137,220,109,52,57,111,77,34,99,0.0,0.0
1011,943,2020-03-18 09:59:00,1,2916.0,2378.0,0.815,14.123,337,126,70,56,211,158,53,100,0.0,0.0
1011,944,2020-03-18 10:02:00,1,2445.0,2038.0,0.834,11.891,557,265,200,65,292,227,65,141,0.0,0.0
1011,945,2020-03-18 10:05:00,1,2451.0,1989.0,0.812,11.857,286,135,80,55,151,106,45,92,0.0,0.0
1011,946,2020-03-18 10:08:00,1,2448.0,2050.0,0.837,11.915,305,156,103,53,149,110,39,117,0.0,0.0
1011,947,2020-03-18 10:11:00,1,1987.0,1642.0,0.826,9.648,285,132,89,43,153,107,46,85,0.0,0.05
1011,948,2020-03-18 10:14:00,1,2689.0,2200.0,0.818,13.03,549,252,191,61,297,239,58,67,0.01,0.07
1011,949,2020-03-18 10:17:00,1,2306.0,1884.0,0.817,11.171,701,359,281,78,342,272,70,65,0.0,0.0
1011,950,2020-03-18 10:20:00,1,2143.0,1779.0,0.83,10.412,1122,598,485,113,524,418,106,100,0.0,0.0
1011,951,2020-03-18 10:23:00,1,2064.0,1727.0,0.837,10.042,785,433,322,111,352,264,88,28,0.0,0.0
1011,952,2020-03-18 10:26:00,1,2459.0,2006.0,0.816,11.91,805,475,371,104,330,251,79,64,0.0,0.0
1011,953,2020-03-18 10:29:00,1,2441.0,2071.0,0.849,11.911,714,318,249,69,396,291,105,60,0.0,0.0
1011,954,2020-03-18 10:32:00,1,2422.0,2109.0,0.871,11.879,755,472,377,95,283,203,80,62,0.0,0.0
1011,955,2020-03-18 10:35:00,1,2448.0,2029.0,0.829,11.892,150,80,31,49,70,0,70,9,0.0,0.0
1011,956,2020-03-18 10:38:00,1,2444.0,2040.0,0.835,11.888,146,78,38,40,68,0,68,4,0.0,0.0
1011,957,2020-03-18 10:41:00,1,2285.0,1940.0,0.849,11.15,99,28,0,28,71,0,71,0,0.0,0.0
1011,958,2020-03-18 10:44:00,1,2045.0,1784.0,0.872,10.031,92,8,0,8,84,0,84,0,0.0,0.0
1011,959,2020-03-18 10:47:00,1,1830.0,1564.0,0.854,8.942,86,13,8,5,73,0,73,0,0.0,0.0
1011,960,2020-03-18 10:50:00,1,1750.0,1490.0,0.851,8.545,71,0,0,0,71,0,71,0,0.0,0.0
1011,961,2020-03-18 10:53:00,1,1741.0,1513.0,0.869,8.535,73,1,0,1,72,0,72,0,0.0,0.0
1011,962,2020-03-18 10:56:00,1,1743.0,1500.0,0.861,8.529,77,0,0,0,77,0,77,0,0.0,0.0
1011,963,2020-03-18 10:59:00,1,1737.0,1512.0,0.87,8.519,79,0,0,0,79,0,79,0,0.0,0.0
1011,964,2020-03-18 11:02:00,1,1753.0,1464.0,0.835,8.529,74,0,0,0,74,0,74,0,0.0,0.0
1011,965,2020-03-18 11:05:00,1,1741.0,1502.0,0.862,8.524,81,0,0,0,81,0,81,0,0.0,0.0
1011,966,2020-03-18 11:08:00,1,1779.0,1404.0,0.789,8.564,77,0,0,0,77,0,77,0,0.0,0.0
1011,967,2020-03-18 11:11:00,1,1775.0,1414.0,0.797,8.561,74,0,0,0,74,0,74,0,0.0,0.0
1011,968,2020-03-18 11:14:00,1,1687.0,1364.0,0.808,8.156,87,7,3,4,80,0,80,0,0.0,0.0
1011,969,2020-03-18 11:17:00,1,1519.0,1325.0,0.872,7.453,84,4,1,3,80,0,80,0,0.0,0.0
1011,970,2020-03-18 11:20:00,1,1522.0,1317.0,0.865,7.456,80,2,1,1,78,0,78,0,0.0,0.0
1011,971,2020-03-18 11:23:00,1,1525.0,1309.0,0.858,7.459,82,1,0,1,81,0,81,0,0.0,0.0
1011,972,2020-03-18 11:26:00,1,1518.0,1305.0,0.86,7.426,88,7,5,2,81,0,81,0,0.0,0.0
1011,973,2020-03-18 11:29:00,1,1598.0,1373.0,0.859,7.817,84,0,0,0,84,0,84,0,0.0,0.0
1011,974,2020-03-18 11:32:00,1,1602.0,1356.0,0.846,7.814,80,7,4,3,73,0,73,0,0.0,0.0
1011,975,2020-03-18 11:35:00,1,1518.0,1325.0,0.873,7.447,89,9,0,9,80,0,80,0,0.0,0.0
1011,976,2020-03-18 11:38:00,1,1691.0,1357.0,0.803,8.164,80,2,0,2,78,0,78,0,0.0,0.0
1011,977,2020-03-18 11:41:00,1,1514.0,1313.0,0.868,7.419,69,0,0,0,69,0,69,0,0.0,0.0
1011,978,2020-03-18 11:44:00,1,1534.0,1264.0,0.824,7.444,73,0,0,0,73,0,73,0,0.0,0.0
1011,979,2020-03-18 11:47:00,1,1519.0,1301.0,0.857,7.426,218,102,73,29,116,50,66,36,0.0,0.0
1011,980,2020-03-18 11:50:00,1,1923.0,1565.0,0.814,9.308,185,106,57,49,79,0,79,55,0.0,0.0
1011,981,2020-03-18 11:53:00,1,2069.0,1710.0,0.827,10.046,247,133,88,45,114,37,77,87,0.0,0.0
1011,982,2020-03-18 11:56:00,1,2300.0,1881.0,0.818,11.143,321,153,102,51,168,81,87,94,0.0,0.11
1011,983,2020-03-18 11:59:00,1,2289.0,1934.0,0.845,11.161,669,416,330,86,253,161,92,57,0.02,0.01
1011,984,2020-03-18 12:02:00,1,2051.0,1776.0,0.866,10.046,558,325,267,58,233,143,90,60,0.35,0.07
1011,985,2020-03-18 12:05:00,1,2069.0,1728.0,0.835,10.066,659,459,355,104,200,111,89,18,0.0,0.0
1011,986,2020-03-18 12:08:00,1,2297.0,1893.0,0.824,11.147,853,427,327,100,426,316,110,89,0.0,0.0
1011,987,2020-03-18 12:11:00,1,2217.0,1826.0,0.824,10.758,502,291,229,62,211,120,91,54,0.0,0.0
1011,988,2020-03-18 12:14:00,1,2216.0,1853.0,0.836,10.781,133,35,9,26,98,18,80,18,0.0,0.0
1011,989,2020-03-18 12:17:00,1,2063.0,1730.0,0.838,10.045,80,0,0,0,80,0,80,0,0.0,0.0
1011,990,2020-03-18 12:20:00,1,1908.0,1614.0,0.846,9.304,78,5,2,3,73,2,71,1,0.0,0.0
1011,991,2020-03-18 12:23:00,1,1678.0,1412.0,0.842,8.175,105,19,8,11,86,6,80,15,0.0,0.0
1011,992,2020-03-18 12:26:00,1,1764.0,1441.0,0.817,8.545,82,0,0,0,82,0,82,0,0.0,0.0
1011,993,2020-03-18 12:29:00,1,1764.0,1446.0,0.82,8.549,75,1,0,1,74,0,74,0,0.0,0.0
1011,994,2020-03-18 12:32:00,1,1751.0,1465.0,0.837,8.522,90,2,0,2,88,2,86,0,0.0,0.0
1011,995,2020-03-18 12:35:00,1,1763.0,1443.0,0.819,8.545,84,3,0,3,81,0,81,0,0.0,0.0
1011,996,2020-03-18 12:38:00,1,1593.0,1378.0,0.865,7.801,117,16,2,14,101,18,83,2,0.0,0.0
1011,997,2020-03-18 12:41:00,1,1504.0,1332.0,0.886,7.399,90,6,3,3,84,6,78,0,0.0,0.0
1011,998,2020-03-18 12:44:00,1,1516.0,1286.0,0.848,7.399,84,0,0,0,84,0,84,0,0.0,0.0
1011,999,2020-03-18 12:47:00,1,1361.0,1181.0,0.868,6.669,121,6,1,5,115,32,83,0,0.0,0.0
1011,1000,2020-03-18 12:50:00,1,1369.0,1175.0,0.858,6.693,86,0,0,0,86,2,84,0,0.0,0.0
1011,1001,2020-03-18 12:53:00,1,1535.0,1235.0,0.804,7.415,89,4,0,4,85,6,79,0,0.0,0.0
1011,1002,2020-03-18 12:56:00,1,1543.0,1222.0,0.792,7.434,84,0,0,0,84,0,84,0,0.0,0.0
1011,1003,2020-03-18 12:59:00,1,1462.0,1172.0,0.802,7.058,89,0,0,0,89,0,89,0,0.0,0.0
1011,1004,2020-03-18 13:02:00,1,1380.0,1125.0,0.815,6.684,92,2,1,1,90,13,77,0,0.0,0.0
1011,1005,2020-03-18 13:05:00,1,1544.0,1223.0,0.792,7.439,76,0,0,0,76,0,76,0,0.0,0.0
1011,1006,2020-03-18 13:08:00,1,1529.0,1280.0,0.837,7.442,69,0,0,0,69,0,69,0,0.0,0.0
1011,1007,2020-03-18 13:11:00,1,1523.0,1297.0,0.852,7.437,72,0,0,0,72,0,72,0,0.0,0.0
1011,1008,2020-03-18 13:14:00,1,1538.0,1232.0,0.801,7.425,63,4,1,3,59,0,59,0,0.0,0.0
1011,1009,2020-03-18 13:17:00,1,1533.0,1256.0,0.819,7.431,75,3,0,3,72,0,72,0,0.0,0.0
1011,1010,2020-03-18 13:20:00,1,1531.0,1265.0,0.826,7.433,103,16,0,16,87,0,87,0,0.0,0.0
1011,1011,2020-03-18 13:23:00,1,1529.0,1278.0,0.836,7.437,85,7,2,5,78,4,74,0,0.0,0.0
1011,1012,2020-03-18 13:26:00,1,1544.0,1248.0,0.808,7.464,67,0,0,0,67,0,67,0,0.0,0.0
1011,1013,2020-03-18 13:29:00,1,1543.0,1238.0,0.803,7.45,76,0,0,0,76,0,76,0,0.0,0.0
1011,1014,2020-03-18 13:32:00,1,1560.0,1167.0,0.748,7.44,154,33,20,13,121,45,76,4,0.0,0.0
1011,1015,2020-03-18 13:35:00,1,1599.0,1338.0,0.837,7.78,296,107,53,54,189,96,93,52,0.0,0.0
1011,1016,2020-03-18 13:38:00,1,1822.0,1567.0,0.86,8.913,461,223,151,72,238,153,85,91,0.0,0.0
1011,1017,2020-03-18 13:41:00,1,2286.0,1897.0,0.83,11.109,297,86,44,42,211,135,76,123,0.0,0.0
1011,1018,2020-03-18 13:44:00,1,2430.0,2064.0,0.849,11.861,486,257,196,61,229,152,77,139,0.0,0.0
1011,1019,2020-03-18 13:47:00,1,1889.0,1680.0,0.889,9.301,280,108,64,44,172,94,78,87,0.0,0.0
1011,1020,2020-03-18 13:50:00,1,2066.0,1733.0,0.839,10.058,108,43,14,29,65,0,65,2,0.0,0.0
1011,1021,2020-03-18 13:53:00,1,2295.0,1916.0,0.835,11.164,125,45,14,31,80,4,76,6,0.0,0.0
1011,1022,2020-03-18 13:56:00,1,2431.0,2114.0,0.87,11.92,290,150,94,56,140,62,78,20,0.04,0.0
1011,1023,2020-03-18 13:59:00,1,2284.0,1970.0,0.863,11.182,107,22,12,10,85,14,71,2,0.0,0.0
1011,1024,2020-03-18 14:02:00,1,2034.0,1810.0,0.89,10.018,91,11,7,4,80,4,76,0,0.0,0.0
1011,1025,2020-03-18 14:05:00,1,1876.0,1706.0,0.909,9.281,70,1,0,1,69,0,69,0,0.0,0.0
1011,1026,2020-03-18 14:08:00,1,1819.0,1591.0,0.875,8.927,81,2,0,2,79,0,79,0,0.0,0.0
1011,1027,2020-03-18 14:11:00,1,1821.0,1578.0,0.866,8.923,75,1,0,1,74,0,74,0,0.0,0.0
1011,1028,2020-03-18 14:14:00,1,1745.0,1514.0,0.868,8.551,82,4,2,2,78,0,78,0,0.0,0.0
1011,1029,2020-03-18 14:17:00,1,1748.0,1504.0,0.861,8.552,78,3,1,2,75,0,75,0,0.0,0.0
1011,1030,2020-03-18 14:20:00,1,1755.5,1459.0,0.8315,8.5325,84,0,0,0,84,0,84,0,0.0,0.0
1011,1031,2020-03-18 14:23:00,1,1763.0,1414.0,0.802,8.513,118,18,8,10,100,20,80,0,0.0,0.0
1011,1032,2020-03-18 14:26:00,1,1770.0,1428.0,0.807,8.555,84,4,0,4,80,4,76,0,0.0,0.0
1011,1033,2020-03-18 14:29:00,1,1682.0,1402.0,0.834,8.179,85,8,2,6,77,2,75,0,0.0,0.0
1011,1034,2020-03-18 14:32:00,1,1689.0,1374.0,0.813,8.177,75,1,0,1,74,0,74,0,0.0,0.0
1011,1035,2020-03-18 14:35:00,1,1605.0,1333.0,0.83,7.801,72,1,0,1,71,0,71,0,0.0,0.0
1011,1036,2020-03-18 14:38:00,1,1605.0,1317.0,0.821,7.783,69,1,0,1,68,0,68,0,0.0,0.0
1011,1037,2020-03-18 14:41:00,1,1605.0,1309.0,0.816,7.775,75,3,0,3,72,0,72,0,0.0,0.0
1011,1038,2020-03-18 14:44:00,1,1597.0,1333.0,0.835,7.767,73,1,0,1,72,0,72,0,0.0,0.0
1011,1039,2020-03-18 14:47:00,1,1599.0,1338.0,0.837,7.781,72,7,5,2,65,0,65,0,0.0,0.0
1011,1040,2020-03-18 14:50:00,1,1685.0,1384.0,0.821,8.173,78,2,1,1,76,0,76,0,0.0,0.0
1011,1041,2020-03-18 14:53:00,1,1597.0,1390.0,0.87,7.832,185,78,64,14,107,32,75,10,0.0,0.0
1011,1042,2020-03-18 14:56:00,1,1832.0,1524.0,0.832,8.907,189,85,54,31,104,20,84,8,0.0,0.0
1011,1043,2020-03-18 14:59:00,1,1989.0,1653.0,0.831,9.665,183,69,36,33,114,39,75,25,0.0,0.0
1011,1044,2020-03-18 15:02:00,1,2137.0,1802.0,0.843,10.416,598,301,231,70,297,214,83,127,0.0,0.0
1011,1045,2020-03-18 15:05:00,1,2366.0,2003.0,0.847,11.538,201,97,56,41,104,50,54,108,0.0,0.14
1011,1046,2020-03-18 15:08:00,1,2500.0,2164.0,0.866,12.245,220,100,65,35,120,77,43,73,0.0,0.08
1011,1047,2020-03-18 15:11:00,1,1836.0,1523.0,0.829,8.92,477,291,219,72,186,133,53,22,0.14,0.02
1011,1048,2020-03-18 15:14:00,1,1980.0,1674.0,0.845,9.656,818,600,483,117,218,152,66,83,0.0,0.04
1011,1049,2020-03-18 15:17:00,1,2291.0,1873.0,0.817,11.099,817,524,429,95,293,203,90,73,0.0,0.0
1011,1050,2020-03-18 15:20:00,1,2296.0,1909.0,0.832,11.159,144,99,55,44,45,17,28,7,0.0,0.0
1011,1051,2020-03-18 15:23:00,1,2113.0,1863.0,0.882,10.386,37,21,5,16,16,0,16,0,0.0,0.0
1011,1052,2020-03-18 15:26:00,1,2379.0,1939.0,0.815,11.519,21,0,0,0,21,0,21,0,0.0,0.0
1011,1053,2020-03-18 15:29:00,1,2132.0,1838.0,0.862,10.436,27,3,1,2,24,0,24,0,0.0,0.0
1011,1054,2020-03-18 15:32:00,1,1967.0,1725.0,0.877,9.659,23,0,0,0,23,0,23,0,0.0,0.0
1011,1055,2020-03-18 15:35:00,1,1989.0,1655.0,0.832,9.669,31,5,0,5,26,0,26,0,0.0,0.0
1011,1056,2020-03-18 15:38:00,1,1901.0,1645.0,0.865,9.313,16,1,0,1,15,0,15,0,0.0,0.0
1011,1057,2020-03-18 15:41:00,1,1824.0,1579.0,0.866,8.934,29,7,0,7,22,0,22,0,0.0,0.0
1011,1058,2020-03-18 15:44:00,1,1809.0,1625.0,0.898,8.928,20,1,0,1,19,0,19,0,0.0,0.0
1011,1059,2020-03-18 15:47:00,1,1892.0,1659.0,0.877,9.291,29,1,0,1,28,0,28,0,0.0,0.0
1011,1060,2020-03-18 15:50:00,1,1805.0,1642.0,0.91,8.927,27,2,0,2,25,0,25,0,0.0,0.0
1011,1061,2020-03-18 15:53:00,1,1815.0,1614.0,0.889,8.939,21,1,0,1,20,0,20,0,0.0,0.0
1011,1062,2020-03-18 15:56:00,1,1826.0,1556.0,0.852,8.917,27,4,0,4,23,2,21,0,0.0,0.0
1011,1063,2020-03-18 15:59:00,1,1660.0,1472.0,0.887,8.171,18,0,0,0,18,0,18,0,0.0,0.0
1011,1064,2020-03-18 16:02:00,1,1664.0,1455.0,0.875,8.168,18,0,0,0,18,0,18,0,0.0,0.0
1011,1065,2020-03-18 16:05:00,1,1582.0,1435.0,0.907,7.822,30,9,6,3,21,2,19,0,0.0,0.0
1011,1066,2020-03-18 16:08:00,1,1827.0,1558.0,0.852,8.925,22,1,0,1,21,0,21,0,0.0,0.0
1011,1067,2020-03-18 16:11:00,1,1825.0,1559.0,0.854,8.917,25,3,0,3,22,0,22,0,0.0,0.0
1011,1068,2020-03-18 16:14:00,1,1825.0,1573.0,0.862,8.93,17,0,0,0,17,0,17,0,0.0,0.0
1011,1069,2020-03-18 16:17:00,1,1836.0,1561.0,0.85,8.963,29,0,0,0,29,0,29,0,0.0,0.0
1011,1070,2020-03-18 16:20:00,1,1753.0,1492.0,0.851,8.557,47,17,10,7,30,2,28,0,0.0,0.0
1011,1071,2020-03-18 16:23:00,1,1834.0,1529.0,0.834,8.918,33,0,0,0,33,0,33,0,0.0,0.0
1011,1072,2020-03-18 16:26:00,1,1743.0,1516.0,0.87,8.546,34,3,0,3,31,0,31,0,0.0,0.0
1011,1073,2020-03-18 16:29:00,1,1745.0,1487.0,0.852,8.52,27,1,0,1,26,0,26,0,0.0,0.0
1011,1074,2020-03-18 16:32:00,1,1661.0,1451.0,0.874,8.149,40,6,0,6,34,0,34,0,0.0,0.0
1011,1075,2020-03-18 16:35:00,1,1575.0,1436.0,0.912,7.798,26,0,0,0,26,0,26,0,0.0,0.0
1011,1076,2020-03-18 16:38:00,1,1600.0,1356.0,0.847,7.804,131,79,36,43,52,23,29,13,0.0,0.0
1011,1077,2020-03-18 16:41:00,1,1816.0,1569.0,0.864,8.89,115,81,60,21,34,13,21,4,0.0,0.0
1011,1078,2020-03-18 16:44:00,1,1876.0,1667.0,0.889,9.235,38,14,7,7,24,1,23,2,0.0,0.0
1011,1079,2020-03-18 16:47:00,1,2032.0,1838.0,0.905,10.04,189,124,63,61,65,38,27,39,0.0,0.0
1011,1080,2020-03-18 16:50:00,1,2179.0,1977.0,0.907,10.773,141,104,69,35,37,24,13,41,0.0,0.0
1011,1081,2020-03-18 16:53:00,1,2341.0,2075.0,0.886,11.521,194,70,34,36,124,53,71,118,0.0,0.0
1011,1082,2020-03-18 16:56:00,1,2471.0,2302.0,0.932,12.286,116,43,20,23,73,43,30,74,0.0,0.42
1011,1083,2020-03-18 16:59:00,1,2359.0,2033.0,0.862,11.544,461,303,245,58,158,113,45,134,0.0,0.0
1011,1084,2020-03-18 17:02:00,1,2348.0,2072.0,0.883,11.545,360,247,186,61,113,81,32,38,0.23,0.03
1011,1085,2020-03-18 17:05:00,1,1812.0,1606.0,0.886,8.919,111,74,34,40,37,6,31,0,0.0,0.0
1011,1086,2020-03-18 17:08:00,1,2346.0,2089.0,0.891,11.557,148,117,74,43,31,11,20,0,0.0,0.0
1011,1087,2020-03-18 17:11:00,1,2191.0,1942.0,0.886,10.783,46,21,5,16,25,0,25,0,0.0,0.0
1011,1088,2020-03-18 17:14:00,1,2115.0,1889.0,0.893,10.423,18,0,0,0,18,0,18,0,0.0,0.0
1011,1089,2020-03-18 17:17:00,1,2118.0,1891.0,0.893,10.438,15,1,0,1,14,0,14,0,0.0,0.0
1011,1090,2020-03-18 17:20:00,1,2035.5,1838.0,0.9035,10.0545,14,0,0,0,14,0,14,0,0.0,0.0
1011,1091,2020-03-18 17:23:00,1,1953.0,1785.0,0.914,9.671,29,11,3,8,18,0,18,0,0.0,0.0
1011,1092,2020-03-18 17:26:00,1,1967.0,1732.0,0.881,9.669,36,20,7,13,16,0,16,0,0.0,0.0
1011,1093,2020-03-18 17:29:00,1,1878.0,1717.0,0.914,9.3,17,9,5,4,8,0,8,0,0.0,0.0
1011,1094,2020-03-18 17:32:00,1,1809.0,1637.0,0.905,8.938,22,9,4,5,13,0,13,0,0.0,0.0
1011,1095,2020-03-18 17:35:00,1,1812.0,1606.0,0.886,8.918,11,1,0,1,10,0,10,0,0.0,0.0
1011,1096,2020-03-18 17:38:00,1,1820.0,1587.0,0.872,8.93,10,7,2,5,3,0,3,0,0.0,0.0
1011,1097,2020-03-18 17:41:00,1,1795.0,1694.0,0.944,8.946,26,14,8,6,12,2,10,0,0.0,0.0
1011,1098,2020-03-18 17:44:00,1,1925.0,1865.0,0.969,9.649,25,1,0,1,24,0,24,0,0.0,0.0
1011,1099,2020-03-18 17:47:00,1,1932.0,1851.0,0.958,9.66,27,6,3,3,21,0,21,0,0.0,0.0
1011,1100,2020-03-18 17:50:00,1,1937.0,1822.0,0.941,9.648,43,13,8,5,30,0,30,0,0.0,0.0
1011,1101,2020-03-18 17:53:00,1,2107.0,1937.0,0.919,10.445,129,44,28,16,85,43,42,2,0.0,0.0
1011,1102,2020-03-18 17:56:00,1,2085.0,2023.0,0.97,10.454,124,42,25,17,82,39,43,8,0.0,0.0
1011,1103,2020-03-18 17:59:00,1,2316.0,2200.0,0.95,11.562,131,95,48,47,36,4,32,9,0.0,0.0
1011,1104,2020-03-18 18:02:00,0,2307.0,2241.0,0.972,11.569,514,275,220,55,239,177,62,89,0.0,0.0
1011,1105,2020-03-18 18:05:00,0,2617.0,2451.0,0.936,13.026,703,432,365,67,271,206,65,224,0.06,0.0
1011,1106,2020-03-18 18:08:00,0,2684.0,2572.0,0.958,13.421,112,82,41,41,30,11,19,61,0.0,0.0
1011,1107,2020-03-18 18:11:00,0,2851.0,2611.0,0.916,14.125,202,164,105,59,38,14,24,40,0.0,0.0
1011,1108,2020-03-18 18:14:00,0,2846.0,2668.0,0.937,14.168,119,76,46,30,43,17,26,14,0.0,0.0
1011,1109,2020-03-18 18:17:00,0,2817.0,2729.0,0.969,14.121,351,232,187,45,119,91,28,40,0.0,0.0
1011,1110,2020-03-18 18:20:00,0,2670.0,2543.0,0.952,13.336,154,106,80,26,48,25,23,11,0.0,0.0
1011,1111,2020-03-18 18:23:00,0,2436.0,2397.0,0.984,12.252,19,2,2,0,17,0,17,0,0.0,0.0
1011,1112,2020-03-18 18:26:00,0,2388.0,2220.0,0.93,11.865,33,3,1,2,30,9,21,0,0.0,0.0
1011,1113,2020-03-18 18:29:00,0,2332.0,2101.0,0.901,11.514,58,31,14,17,27,7,20,0,0.0,0.0
1011,1114,2020-03-18 18:32:00,0,2169.0,2031.0,0.936,10.793,77,52,25,27,25,14,11,2,0.0,0.0
1011,1115,2020-03-18 18:35:00,0,2321.0,2109.0,0.909,11.482,52,20,4,16,32,10,22,11,0.0,0.0
1011,1116,2020-03-18 18:38:00,0,2462.0,2291.0,0.931,12.235,154,113,49,64,41,16,25,19,0.0,0.0
1011,1117,2020-03-18 18:41:00,0,2666.0,2595.0,0.974,13.377,428,256,199,57,172,132,40,106,0.0,0.0
1011,1118,2020-03-18 18:44:00,0,2669.0,2585.0,0.969,13.378,493,247,188,59,246,189,57,130,0.0,0.06
1011,1119,2020-03-18 18:47:00,0,2518.0,2446.0,0.972,12.627,199,120,92,28,79,54,25,43,0.06,0.0
1011,1120,2020-03-18 18:50:00,0,2450.0,2414.0,0.985,12.324,22,7,0,7,15,0,15,0,0.0,0.0
1011,1121,2020-03-18 18:53:00,0,2304.0,2221.0,0.964,11.536,26,6,0,6,20,0,20,0,0.0,0.0
1011,1122,2020-03-18 18:56:00,0,2161.0,2055.0,0.951,10.789,25,6,1,5,19,0,19,0,0.0,0.0
1011,1123,2020-03-18 18:59:00,0,2106.0,1939.0,0.921,10.445,223,185,131,54,38,18,20,46,0.0,0.0
1011,1124,2020-03-18 19:02:00,0,2308.0,2194.0,0.95,11.523,433,221,173,48,212,172,40,115,0.0,0.0
1011,1125,2020-03-18 19:05:00,0,2318.0,2144.0,0.925,11.506,323,177,124,53,146,112,34,128,0.0,0.02
1011,1126,2020-03-18 19:08:00,0,2317.0,2191.0,0.946,11.553,468,289,213,76,179,115,64,173,0.0,0.0
1011,1127,2020-03-18 19:11:00,0,2445.0,2390.0,0.977,12.279,273,151,88,63,122,69,53,121,0.0,0.0
1011,1128,2020-03-18 19:14:00,0,2609.0,2470.0,0.946,13.015,516,297,227,70,219,157,62,184,0.13,0.0
1011,1129,2020-03-18 19:17:00,0,2440.0,2363.0,0.968,12.231,659,320,254,66,339,270,69,207,0.0,0.0
1011,1130,2020-03-18 19:20:00,0,2478.0,2269.0,0.916,12.275,795,349,276,73,446,338,108,183,0.0,0.01
1011,1131,2020-03-18 19:23:00,0,2444.0,2376.0,0.972,12.26,864,445,353,92,419,325,94,249,0.0,0.02
1011,1132,2020-03-18 19:26:00,0,2463.0,2296.0,0.932,12.248,459,231,166,65,228,155,73,99,0.0,0.0
1011,1133,2020-03-18 19:29:00,0,2470.0,2322.0,0.94,12.301,305,194,128,66,111,68,43,79,0.0,0.03
1011,1134,2020-03-18 19:32:00,0,2687.0,2513.0,0.935,13.369,325,190,131,59,135,75,60,125,0.0,0.0
1011,1135,2020-03-18 19:35:00,0,2674.0,2583.0,0.966,13.395,251,147,89,58,104,53,51,103,0.0,0.0
1011,1136,2020-03-18 19:38:00,0,2694.0,2475.0,0.919,13.355,204,115,55,60,89,31,58,115,0.0,0.05
1011,1137,2020-03-18 19:41:00,0,2699.0,2458.0,0.911,13.354,208,124,76,48,84,38,46,92,0.0,0.13
1011,1138,2020-03-18 19:44:00,0,2770.0,2594.0,0.937,13.785,440,246,168,78,194,137,57,73,0.0,0.05
1011,1139,2020-03-18 19:47:00,0,1560.0,1512.0,0.969,7.821,321,204,150,54,117,80,37,105,0.02,0.01
1011,1140,2020-03-18 19:50:00,0,2439.0,2398.0,0.983,12.264,827,415,331,84,412,328,84,104,0.06,0.0
1011,1141,2020-03-18 19:53:00,0,2671.0,2546.0,0.953,13.34,901,491,388,103,410,310,100,232,0.0,0.14
1011,1142,2020-03-18 19:56:00,0,1926.0,1841.0,0.956,9.627,153,91,42,49,62,27,35,32,0.0,0.0
1011,1143,2020-03-18 19:59:00,0,2319.0,2137.0,0.921,11.503,75,45,22,23,30,15,15,13,0.0,0.0
1011,1144,2020-03-18 20:02:00,0,2855.0,2575.0,0.902,14.099,103,68,33,35,35,5,30,14,0.0,0.0
1011,1145,2020-03-18 20:05:00,0,2862.0,2601.0,0.909,14.156,135,67,29,38,68,35,33,23,0.0,0.0
1011,1146,2020-03-18 20:08:00,0,2824.0,2739.0,0.97,14.157,255,122,98,24,133,97,36,148,0.05,0.0
1011,1147,2020-03-18 20:11:00,0,2310.0,2222.0,0.962,11.56,15,5,3,2,10,0,10,0,0.0,0.0
1011,1148,2020-03-18 20:14:00,0,2313.0,2180.0,0.942,11.528,30,6,4,2,24,9,15,0,0.0,0.0
1011,1149,2020-03-18 20:17:00,0,2453.0,2356.0,0.96,12.271,16,3,1,2,13,2,11,0,0.0,0.0
1011,1150,2020-03-18 20:20:00,0,2462.5,2320.0,0.942,12.27,89,62,35,27,27,10,17,32,0.0,0.0
1011,1151,2020-03-18 20:23:00,0,2472.0,2284.0,0.924,12.269,225,124,61,63,101,62,39,98,0.0,0.0
1011,1152,2020-03-18 20:26:00,0,2700.0,2530.0,0.937,13.438,177,105,60,45,72,22,50,125,0.0,0.0
1011,1153,2020-03-18 20:29:00,0,2747.0,2668.0,0.971,13.775,433,239,179,60,194,143,51,169,0.33,0.11
1011,1154,2020-03-18 20:32:00,0,2447.0,2384.0,0.974,12.282,261,164,109,55,97,75,22,63,0.12,0.0
1011,1155,2020-03-18 20:35:00,0,2094.0,1942.0,0.927,10.401,95,53,17,36,42,15,27,31,0.0,0.0
1011,1156,2020-03-18 20:38:00,0,2695.0,2514.0,0.933,13.401,82,55,21,34,27,11,16,13,0.0,0.0
1011,1157,2020-03-18 20:41:00,0,2832.0,2713.0,0.958,14.162,99,61,31,30,38,12,26,4,0.0,0.0
1011,1158,2020-03-18 20:44:00,0,2673.0,2583.0,0.966,13.391,33,6,1,5,27,0,27,0,0.0,0.0
1011,1159,2020-03-18 20:47:00,0,2701.0,2520.0,0.933,13.431,43,6,0,6,37,4,33,0,0.0,0.0
1011,1160,2020-03-18 20:50:00,0,2466.0,2333.0,0.946,12.3,55,17,8,9,38,6,32,0,0.0,0.0
1011,1161,2020-03-18 20:53:00,0,2307.0,2212.0,0.959,11.538,31,0,0,0,31,0,31,0,0.0,0.0
1011,1162,2020-03-18 20:56:00,0,2322.0,2117.0,0.911,11.494,113,72,47,25,41,15,26,29,0.0,0.0
1011,1163,2020-03-18 20:59:00,0,2454.0,2323.0,0.946,12.241,330,187,134,53,143,102,41,125,0.0,0.08
1011,1164,2020-03-18 21:02:00,0,2315.0,2161.0,0.933,11.516,860,645,527,118,215,160,55,156,0.0,0.0
1011,1165,2020-03-18 21:05:00,0,2607.0,2503.0,0.96,13.041,710,462,363,99,248,190,58,86,0.0,0.0
1011,1166,2020-03-18 21:08:00,0,2438.0,2432.0,0.998,12.297,197,159,102,57,38,11,27,62,0.0,0.0
1011,1167,2020-03-18 21:11:00,0,2837.0,2676.0,0.943,14.14,661,357,284,73,304,235,69,266,0.0,0.27
1011,1168,2020-03-18 21:14:00,0,2767.0,2645.0,0.956,13.829,280,162,108,54,118,66,52,114,0.0,0.0
1011,1169,2020-03-18 21:17:00,0,2316.0,2162.0,0.933,11.516,29,4,1,3,25,6,19,4,0.0,0.0
1011,1170,2020-03-18 21:20:00,0,2029.0,1860.0,0.917,10.055,14,0,0,0,14,2,12,0,0.0,0.0
1011,1171,2020-03-18 21:23:00,0,2334.0,2107.0,0.903,11.531,16,0,0,0,16,2,14,0,0.0,0.0
1011,1172,2020-03-18 21:26:00,0,2340.0,2105.0,0.9,11.548,19,4,2,2,15,4,11,0,0.0,0.0
1011,1173,2020-03-18 21:29:00,0,2330.0,2127.0,0.913,11.535,284,151,119,32,133,96,37,36,0.0,0.0
1011,1174,2020-03-18 21:32:00,0,2446.0,2394.0,0.979,12.286,188,122,77,45,66,34,32,62,0.0,0.0
1011,1175,2020-03-18 21:35:00,0,2453.0,2387.0,0.973,12.31,230,159,120,39,71,42,29,76,0.0,0.0
1011,1176,2020-03-18 21:38:00,0,2676.0,2572.0,0.961,13.391,577,381,309,72,196,151,45,158,0.0,0.0
1011,1177,2020-03-18 21:41:00,0,2601.0,2494.0,0.959,13.01,459,276,202,74,183,122,61,92,0.0,0.0
1011,1178,2020-03-18 21:44:00,0,2846.0,2652.0,0.932,14.148,205,114,66,48,91,27,64,116,0.0,0.0
1011,1179,2020-03-18 21:47:00,0,2818.0,2719.0,0.965,14.112,165,98,56,42,67,36,31,119,0.16,0.1
1011,1180,2020-03-18 21:50:00,0,2682.0,2552.0,0.951,13.391,464,247,190,57,217,167,50,94,0.21,0.04
1011,1181,2020-03-18 21:53:00,0,3058.0,2932.0,0.959,15.293,483,301,235,66,182,130,52,102,0.0,0.08
1011,1182,2020-03-18 21:56:00,0,2244.0,2119.0,0.944,11.185,158,70,47,23,88,38,50,75,0.0,0.0
1011,1183,2020-03-18 21:59:00,0,2607.0,2495.0,0.957,13.035,239,126,77,49,113,69,44,37,0.0,0.0
1011,1184,2020-03-18 22:02:00,0,2753.0,2648.0,0.962,13.777,135,76,29,47,59,29,30,56,0.0,0.0
1011,1185,2020-03-18 22:05:00,0,2815.0,2790.0,0.991,14.181,209,146,97,49,63,19,44,25,0.0,0.0
1011,1186,2020-03-18 22:08:00,0,2735.0,2653.0,0.97,13.713,40,23,15,8,17,6,11,4,0.0,0.0
1011,1187,2020-03-18 22:11:00,0,2432.0,2422.0,0.996,12.263,66,28,17,11,38,12,26,0,0.0,0.0
1011,1188,2020-03-18 22:14:00,0,2297.0,2250.0,0.98,11.539,33,5,2,3,28,0,28,0,0.0,0.0
1011,1189,2020-03-18 22:17:00,0,2326.0,2125.0,0.914,11.516,49,18,3,15,31,0,31,0,0.0,0.0
1011,1190,2020-03-18 22:20:00,0,2080.0,1992.0,0.958,10.398,34,3,0,3,31,0,31,0,0.0,0.0
1011,1191,2020-03-18 22:23:00,0,2070.0,2049.0,0.99,10.424,71,9,2,7,62,28,34,0,0.0,0.0
1011,1192,2020-03-18 22:26:00,0,2087.0,1979.0,0.948,10.415,60,18,8,10,42,14,28,0,0.0,0.0
1011,1193,2020-03-18 22:29:00,0,2081.0,1988.0,0.955,10.398,36,10,3,7,26,2,24,0,0.0,0.0
1011,1194,2020-03-18 22:32:00,0,1922.0,1891.0,0.984,9.665,28,12,2,10,16,4,12,0,0.0,0.0
1011,1195,2020-03-18 22:35:00,0,2100.0,1937.0,0.922,10.416,224,137,83,54,87,46,41,99,0.0,0.0
1011,1196,2020-03-18 22:38:00,0,2461.0,2350.0,0.955,12.299,370,235,173,62,135,97,38,102,0.0,0.0
1011,1197,2020-03-18 22:41:00,0,2689.0,2544.0,0.946,13.41,358,219,162,57,139,99,40,176,0.0,0.15
1011,1198,2020-03-18 22:44:00,0,2458.0,2397.0,0.975,12.336,232,137,89,48,95,52,43,75,0.0,0.0
1011,1199,2020-03-18 22:47:00,0,2474.0,2300.0,0.93,12.293,637,321,248,73,316,250,66,123,0.0,0.0
1011,1200,2020-03-18 22:50:00,0,2608.0,2484.0,0.952,13.027,833,464,377,87,369,285,84,89,0.12,0.0
1011,1201,2020-03-18 22:53:00,0,2818.0,2711.0,0.962,14.103,512,264,194,70,248,197,51,96,0.0,0.0
1011,1202,2020-03-18 22:56:00,0,2823.0,2726.0,0.965,14.14,111,81,36,45,30,12,18,38,0.0,0.0
1011,1203,2020-03-18 22:59:00,0,2819.0,2721.0,0.965,14.121,151,119,64,55,32,12,20,44,0.0,0.0
1011,1204,2020-03-18 23:02:00,0,2687.0,2557.0,0.952,13.416,739,428,346,82,311,233,78,156,0.0,0.0
1011,1205,2020-03-18 23:05:00,0,2892.0,2788.0,0.964,14.481,353,214,164,50,139,85,54,123,0.0,0.12
1011,1206,2020-03-18 23:08:00,0,2663.0,2632.0,0.988,13.406,684,359,286,73,325,262,63,177,0.16,0.05
1011,1207,2020-03-18 23:11:00,0,2533.0,2430.0,0.96,12.67,408,207,158,49,201,154,47,85,0.0,0.02
1011,1208,2020-03-18 23:14:00,0,2831.0,2708.0,0.957,14.154,480,269,204,65,211,154,57,32,0.0,0.0
1011,1209,2020-03-18 23:17:00,0,2755.0,2635.0,0.957,13.772,412,279,212,67,133,92,41,25,0.0,0.0
1011,1210,2020-03-18 23:20:00,0,2721.5,2596.5,0.9545,13.5975,691,558,456,102,133,79,54,35,0.0,0.0
1011,1211,2020-03-18 23:23:00,0,2688.0,2558.0,0.952,13.423,680,504,404,100,176,132,44,136,0.0,0.0
1011,1212,2020-03-18 23:26:00,0,2522.0,2446.0,0.97,12.645,450,300,229,71,150,117,33,200,0.0,0.0
1011,1213,2020-03-18 23:29:00,0,2746.0,2628.0,0.957,13.73,94,78,40,38,16,4,12,57,0.0,0.0
1011,1214,2020-03-18 23:32:00,0,2685.0,2542.0,0.947,13.392,86,79,27,52,7,4,3,73,0.0,0.0
1011,1215,2020-03-18 23:35:00,0,2519.0,2463.0,0.978,12.651,24,13,1,12,11,3,8,3,0.0,0.0
1011,1216,2020-03-18 23:38:00,0,2304.0,2261.0,0.981,11.58,12,8,2,6,4,0,4,0,0.0,0.0
1011,1217,2020-03-18 23:41:00,0,2233.0,2109.0,0.944,11.134,18,10,2,8,8,3,5,6,0.0,0.0
1011,1218,2020-03-18 23:44:00,0,1915.0,1913.0,0.999,9.662,11,4,1,3,7,0,7,0,0.0,0.0
1011,1219,2020-03-18 23:47:00,0,2010.0,1937.0,0.964,10.063,70,56,14,42,14,4,10,0,0.0,0.0
1011,1220,2020-03-18 23:50:00,0,2096.0,1964.0,0.937,10.433,139,106,57,49,33,12,21,23,0.0,0.0
1011,1221,2020-03-18 23:53:00,0,2245.0,2119.0,0.944,11.192,105,76,36,40,29,12,17,21,0.0,0.0
1011,1222,2020-03-18 23:56:00,0,2388.0,2296.0,0.961,11.95,161,94,51,43,67,41,26,44,0.0,0.0
1011,1223,2020-03-18 23:59:00,0,2433.0,2456.0,1.009,12.304,98,56,24,32,42,11,31,107,0.0,0.02
1011,1224,2020-03-19 00:02:00,0,2304.0,2247.0,0.976,11.564,248,143,101,42,105,70,35,46,0.01,0.02
1011,1225,2020-03-19 00:05:00,0,2312.0,2178.0,0.942,11.522,418,254,205,49,164,120,44,80,0.21,0.23
1011,1226,2020-03-19 00:08:00,0,2462.0,2297.0,0.933,12.244,20,11,3,8,9,4,5,23,0.0,0.01
1011,1227,2020-03-19 00:11:00,0,2683.0,2541.0,0.947,13.384,756,403,320,83,353,263,90,204,0.0,0.0
1011,1228,2020-03-19 00:14:00,0,2668.0,2608.0,0.977,13.4,793,518,408,110,275,198,77,57,0.0,0.0
1011,1229,2020-03-19 00:17:00,0,2681.0,2603.0,0.971,13.443,658,346,280,66,312,222,90,154,0.16,0.0
1011,1230,2020-03-19 00:20:00,0,2678.0,2595.0,0.969,13.426,583,329,266,63,254,195,59,105,0.0,0.07
1011,1231,2020-03-19 00:23:00,0,2676.0,2605.0,0.973,13.429,545,297,217,80,248,186,62,42,0.0,0.06
1011,1232,2020-03-19 00:26:00,0,2677.0,2537.0,0.948,13.358,427,289,221,68,138,79,59,23,0.0,0.0
1011,1233,2020-03-19 00:29:00,0,2678.0,2556.0,0.954,13.381,902,617,515,102,285,193,92,45,0.0,0.0
1011,1234,2020-03-19 00:32:00,0,2672.0,2583.0,0.967,13.389,794,456,352,104,338,230,108,71,0.0,0.0
1011,1235,2020-03-19 00:35:00,0,2615.0,2491.0,0.953,13.06,827,563,461,102,264,184,80,95,0.0,0.0
1011,1236,2020-03-19 00:38:00,0,2438.0,2420.0,0.993,12.285,427,317,242,75,110,72,38,108,0.0,0.0
1011,1237,2020-03-19 00:41:00,0,2691.0,2539.0,0.943,13.414,734,564,460,104,170,105,65,38,0.0,0.0
1011,1238,2020-03-19 00:44:00,0,2449.0,2362.0,0.965,12.264,638,558,460,98,80,53,27,114,0.0,0.0
1011,1239,2020-03-19 00:47:00,0,2460.0,2370.0,0.963,12.317,308,258,194,64,50,35,15,57,0.0,0.0
1011,1240,2020-03-19 00:50:00,0,2531.0,2447.0,0.967,12.682,705,541,429,112,164,108,56,48,0.0,0.0
1011,1241,2020-03-19 00:53:00,0,2697.0,2498.0,0.927,13.39,164,114,67,47,50,39,11,51,0.0,0.0
1011,1242,2020-03-19 00:56:00,0,2698.0,2462.0,0.912,13.357,111,102,43,59,9,2,7,32,0.0,0.0
1011,1243,2020-03-19 00:59:00,0,2705.0,2410.0,0.891,13.328,67,62,16,46,5,3,2,8,0.0,0.0
1011,1244,2020-03-19 01:02:00,0,2464.0,2314.0,0.939,12.27,84,75,18,57,9,3,6,9,0.0,0.0
1011,1245,2020-03-19 01:05:00,0,2457.0,2319.0,0.944,12.249,391,336,253,83,55,41,14,53,0.0,0.0
1011,1246,2020-03-19 01:08:00,0,2493.0,2224.0,0.892,12.284,772,534,448,86,238,177,61,73,0.0,0.0
1011,1247,2020-03-19 01:11:00,0,2480.0,2259.0,0.911,12.271,192,106,76,30,86,45,41,39,0.0,0.0
1011,1248,2020-03-19 01:14:00,0,2494.0,2204.0,0.884,12.266,580,399,310,89,181,121,60,45,0.0,0.0
1011,1249,2020-03-19 01:17:00,0,2571.0,2281.0,0.887,12.653,773,520,429,91,253,185,68,102,0.0,0.0
1011,1250,2020-03-19 01:20:00,0,2511.0,2137.0,0.851,12.258,487,351,275,76,136,97,39,79,0.0,0.0
1011,1251,2020-03-19 01:23:00,0,2522.0,2109.0,0.836,12.272,275,154,105,49,121,79,42,17,0.0,0.0
1011,1252,2020-03-19 01:26:00,0,2530.0,2077.0,0.821,12.267,35,16,3,13,19,12,7,3,0.0,0.0
1011,1253,2020-03-19 01:29:00,0,2384.0,1912.0,0.802,11.509,5,0,0,0,5,0,5,0,0.0,0.02
1011,1254,2020-03-19 01:32:00,0,2388.0,1903.0,0.797,11.517,9,3,1,2,6,0,6,0,0.0,0.0
1011,1255,2020-03-19 01:35:00,0,2142.0,1760.0,0.822,10.387,18,11,4,7,7,1,6,0,0.0,0.0
1011,1256,2020-03-19 01:38:00,0,2074.0,1680.0,0.81,10.032,4,0,0,0,4,3,1,0,0.0,0.0
1011,1257,2020-03-19 01:41:00,0,1999.0,1623.0,0.812,9.673,14,6,0,6,8,2,6,0,0.0,0.0
1011,1258,2020-03-19 01:44:00,0,2005.0,1614.0,0.805,9.687,16,12,2,10,4,1,3,0,0.0,0.0
1011,1259,2020-03-19 01:47:00,0,2001.0,1604.0,0.801,9.66,22,14,6,8,8,3,5,0,0.0,0.0
1011,1260,2020-03-19 01:50:00,0,2086.0,1643.0,0.788,10.037,16,4,0,4,12,6,6,0,0.0,0.0
1011,1261,2020-03-19 01:53:00,0,2171.0,1686.0,0.777,10.422,31,0,0,0,31,3,28,0,0.0,0.0
1011,1262,2020-03-19 01:56:00,0,2173.0,1663.0,0.765,10.402,14,0,0,0,14,3,11,0,0.0,0.0
1011,1263,2020-03-19 01:59:00,0,2165.0,1675.0,0.774,10.385,9,3,1,2,6,2,4,0,0.0,0.0
1011,1264,2020-03-19 02:02:00,0,2227.0,1798.0,0.807,10.766,178,135,77,58,43,13,30,85,0.0,0.0
1011,1265,2020-03-19 02:05:00,0,2672.0,2189.0,0.819,12.952,147,101,51,50,46,14,32,100,0.0,0.0
1011,1266,2020-03-19 02:08:00,0,2508.0,2141.0,0.853,12.252,248,168,116,52,80,55,25,79,0.0,0.09
1011,1267,2020-03-19 02:11:00,0,2753.0,2303.0,0.837,13.398,234,172,112,60,62,42,20,96,0.0,0.0
1011,1268,2020-03-19 02:14:00,0,2893.0,2471.0,0.854,14.134,126,70,46,24,56,39,17,71,0.0,0.0
1011,1269,2020-03-19 02:17:00,0,2822.0,2398.0,0.85,13.775,8,5,4,1,3,0,3,4,0.0,0.14
1011,1270,2020-03-19 02:20:00,0,2537.5,2230.5,0.8825,12.468,6,1,0,1,5,0,5,0,0.0,0.0
1011,1271,2020-03-19 02:23:00,0,2253.0,2063.0,0.915,11.161,4,2,0,2,2,0,2,0,0.0,0.0
1011,1272,2020-03-19 02:26:00,0,2107.0,1919.0,0.911,10.427,3,0,0,0,3,0,3,0,0.0,0.0
1011,1273,2020-03-19 02:29:00,0,1943.0,1838.0,0.946,9.691,79,68,40,28,11,3,8,4,0.0,0.0
1011,1274,2020-03-19 02:32:00,0,2096.0,1964.0,0.937,10.432,87,78,40,38,9,5,4,23,0.0,0.0
1011,1275,2020-03-19 02:35:00,0,2225.0,2182.0,0.981,11.183,218,135,82,53,83,54,29,34,0.0,0.0
1011,1276,2020-03-19 02:38:00,0,2617.0,2441.0,0.933,13.013,225,149,91,58,76,27,49,97,0.24,0.0
1011,1277,2020-03-19 02:41:00,0,2845.0,2632.0,0.925,14.125,238,144,98,46,94,46,48,89,0.0,0.0
1011,1278,2020-03-19 02:44:00,0,2681.0,2550.0,0.951,13.389,349,234,172,62,115,77,38,137,0.15,0.0
1011,1279,2020-03-19 02:47:00,0,2676.0,2572.0,0.961,13.389,682,353,277,76,329,267,62,125,0.06,0.0
1011,1280,2020-03-19 02:50:00,0,2766.0,2538.0,0.918,13.71,315,191,126,65,124,60,64,104,0.0,0.0
1011,1281,2020-03-19 02:53:00,0,2607.0,2479.0,0.951,13.016,177,95,53,42,82,54,28,27,0.0,0.0
1011,1282,2020-03-19 02:56:00,0,2082.0,2008.0,0.964,10.424,27,9,4,5,18,0,18,2,0.0,0.0
1011,1283,2020-03-19 02:59:00,0,2406.0,2206.0,0.917,11.923,8,4,1,3,4,0,4,0,0.0,0.0
1011,1284,2020-03-19 03:02:00,0,2227.0,2180.0,0.979,11.185,10,5,2,3,5,0,5,0,0.0,0.0
1011,1285,2020-03-19 03:05:00,0,2234.0,2123.0,0.95,11.153,48,22,13,9,26,10,16,0,0.0,0.0
1011,1286,2020-03-19 03:08:00,0,2226.0,2148.0,0.965,11.15,10,3,2,1,7,2,5,0,0.0,0.0
1011,1287,2020-03-19 03:11:00,0,2257.0,2044.0,0.906,11.154,22,16,2,14,6,3,3,0,0.0,0.0
1011,1288,2020-03-19 03:14:00,0,2260.0,2049.0,0.907,11.171,9,8,3,5,1,1,0,0,0.0,0.0
1011,1289,2020-03-19 03:17:00,0,2167.0,2021.0,0.933,10.776,24,19,10,9,5,0,5,0,0.0,0.0
1011,1290,2020-03-19 03:20:00,0,2091.0,1970.0,0.943,10.419,18,11,7,4,7,2,5,0,0.0,0.0
1011,1291,2020-03-19 03:23:00,0,1943.0,1848.0,0.951,9.702,16,9,4,5,7,2,5,1,0.0,0.0
1011,1292,2020-03-19 03:26:00,0,2026.0,1868.0,0.922,10.05,25,19,4,15,6,0,6,0,0.0,0.0
1011,1293,2020-03-19 03:29:00,0,1861.0,1769.0,0.95,9.292,14,11,3,8,3,2,1,0,0.0,0.0
1011,1294,2020-03-19 03:32:00,0,1870.0,1782.0,0.953,9.34,63,39,30,9,24,17,7,2,0.0,0.0
1011,1295,2020-03-19 03:35:00,0,2099.0,1945.0,0.927,10.422,317,189,128,61,128,85,43,107,0.0,0.0
1011,1296,2020-03-19 03:38:00,0,2627.0,2407.0,0.916,13.015,107,54,21,33,53,28,25,88,0.0,0.01
1011,1297,2020-03-19 03:41:00,0,2617.0,2460.0,0.94,13.037,194,112,77,35,82,37,45,102,0.14,0.05
1011,1298,2020-03-19 03:44:00,0,2461.0,2335.0,0.949,12.281,877,563,473,90,314,237,77,199,0.0,0.19
1011,1299,2020-03-19 03:47:00,0,2612.0,2493.0,0.955,13.05,700,467,396,71,233,160,73,92,0.2,0.0
1011,1300,2020-03-19 03:50:00,0,2611.0,2459.0,0.942,13.009,650,368,278,90,282,208,74,123,0.0,0.0
1011,1301,2020-03-19 03:53:00,0,2778.0,2586.0,0.931,13.807,240,171,99,72,69,30,39,123,0.0,0.0
1011,1302,2020-03-19 03:56:00,0,2223.0,2192.0,0.986,11.186,144,99,57,42,45,28,17,54,0.0,0.0
1011,1303,2020-03-19 03:59:00,0,2630.0,2413.0,0.917,13.035,189,134,90,44,55,37,18,82,0.0,0.0
1011,1304,2020-03-19 04:02:00,0,2607.0,2505.0,0.961,13.047,79,64,36,28,15,7,8,47,0.0,0.0
1011,1305,2020-03-19 04:05:00,0,2686.0,2554.0,0.951,13.41,427,244,162,82,183,125,58,117,0.0,0.0
1011,1306,2020-03-19 04:08:00,0,2837.0,2668.0,0.94,14.13,164,86,30,56,78,22,56,97,0.0,0.0
1011,1307,2020-03-19 04:11:00,0,2980.0,2845.0,0.954,14.892,188,138,90,48,50,21,29,89,0.15,0.05
1011,1308,2020-03-19 04:14:00,0,2783.0,2556.0,0.919,13.794,192,121,64,57,71,46,25,95,0.0,0.0
1011,1309,2020-03-19 04:17:00,0,2467.0,2313.0,0.937,12.282,378,283,224,59,95,67,28,100,0.0,0.0
1011,1310,2020-03-19 04:20:00,0,2628.0,2420.0,0.921,13.035,779,481,372,109,298,221,77,34,0.0,0.0
1011,1311,2020-03-19 04:23:00,0,2404.0,2221.0,0.924,11.931,921,594,487,107,327,249,78,72,0.0,0.0
1011,1312,2020-03-19 04:26:00,0,2825.0,2710.0,0.96,14.129,894,653,530,123,241,176,65,46,0.0,0.03
1011,1313,2020-03-19 04:29:00,0,2620.0,2446.0,0.934,13.03,275,193,127,66,82,41,41,60,0.0,0.0
1011,1314,2020-03-19 04:32:00,0,2693.0,2529.0,0.939,13.409,887,671,546,125,216,144,72,67,0.0,0.0
1011,1315,2020-03-19 04:35:00,0,2678.0,2543.0,0.95,13.366,530,395,314,81,135,93,42,85,0.0,0.0
1011,1316,2020-03-19 04:38:00,0,2778.0,2567.0,0.924,13.788,93,83,37,46,10,1,9,51,0.0,0.0
1011,1317,2020-03-19 04:41:00,0,2696.0,2562.0,0.95,13.457,80,52,18,34,28,4,24,14,0.0,0.0
1011,1318,2020-03-19 04:44:00,0,2629.0,2421.0,0.921,13.04,13,0,0,0,13,2,11,0,0.0,0.0
1011,1319,2020-03-19 04:47:00,0,2235.0,2132.0,0.954,11.167,6,1,0,1,5,4,1,0,0.0,0.0
1011,1320,2020-03-19 04:50:00,0,2088.0,1953.0,0.935,10.388,14,5,3,2,9,7,2,0,0.0,0.0
1011,1321,2020-03-19 04:53:00,0,2118.0,1888.0,0.891,10.437,5,0,0,0,5,3,2,0,0.0,0.0
1011,1322,2020-03-19 04:56:00,0,1868.0,1733.0,0.927,9.279,9,0,0,0,9,2,7,0,0.0,0.0
1011,1323,2020-03-19 04:59:00,0,1730.0,1554.0,0.898,8.534,26,13,8,5,13,6,7,0,0.0,0.0
1011,1324,2020-03-19 05:02:00,0,1570.0,1478.0,0.941,7.821,6,0,0,0,6,1,5,0,0.0,0.0
1011,1325,2020-03-19 05:05:00,0,1558.0,1510.0,0.969,7.809,11,3,0,3,8,5,3,0,0.0,0.0
1011,1326,2020-03-19 05:08:00,0,1728.0,1610.0,0.932,8.59,14,3,0,3,11,6,5,0,0.0,0.0
1011,1327,2020-03-19 05:11:00,0,1792.0,1674.0,0.934,8.915,72,57,29,28,15,4,11,7,0.0,0.0
1011,1328,2020-03-19 05:14:00,0,2232.0,2169.0,0.972,11.197,546,336,265,71,210,144,66,157,0.0,0.0
1011,1329,2020-03-19 05:17:00,0,2482.0,2247.0,0.905,12.266,413,244,185,59,169,133,36,83,0.0,0.0
1011,1330,2020-03-19 05:20:00,0,2555.0,2334.0,0.913,12.6505,252,166,118,48,86,58,28,99,0.0,0.0
1011,1331,2020-03-19 05:23:00,0,2628.0,2421.0,0.921,13.035,553,322,258,64,231,171,60,64,0.0,0.0
1011,1332,2020-03-19 05:26:00,0,2608.0,2512.0,0.963,13.057,678,336,272,64,342,261,81,211,0.0,0.0
1011,1333,2020-03-19 05:29:00,0,2619.0,2453.0,0.937,13.033,611,362,286,76,249,191,58,158,0.0,0.0
1011,1334,2020-03-19 05:32:00,0,2699.0,2540.0,0.941,13.448,468,318,243,75,150,111,39,198,0.0,0.0
1011,1335,2020-03-19 05:35:00,0,2620.0,2433.0,0.929,13.014,530,262,178,84,268,191,77,44,0.0,0.0
1011,1336,2020-03-19 05:38:00,0,2644.0,2355.0,0.891,13.024,447,253,206,47,194,143,51,85,0.0,0.0
1011,1337,2020-03-19 05:41:00,0,2631.0,2358.0,0.896,12.979,705,463,367,96,242,173,69,120,0.0,0.0
1011,1338,2020-03-19 05:44:00,0,2639.0,2360.0,0.894,13.009,751,517,425,92,234,177,57,54,0.0,0.0
1011,1339,2020-03-19 05:47:00,0,2636.0,2385.0,0.905,13.025,477,307,230,77,170,125,45,53,0.0,0.0
1011,1340,2020-03-19 05:50:00,0,2492.0,2252.0,0.904,12.311,564,321,236,85,243,167,76,25,0.0,0.0
1011,1341,2020-03-19 05:53:00,0,2480.0,2276.0,0.918,12.293,1000,481,376,105,519,406,113,51,0.0,0.0
1011,1342,2020-03-19 05:56:00,0,2487.0,2243.0,0.902,12.282,881,600,503,97,281,198,83,125,0.0,0.0
1011,1343,2020-03-19 05:59:00,0,2492.0,2234.0,0.897,12.293,495,232,175,57,263,196,67,143,0.0,0.07
1011,1344,2020-03-19 06:02:00,1,2643.0,2344.0,0.887,13.008,654,376,290,86,278,224,54,139,0.0,0.0
1011,1345,2020-03-19 06:05:00,1,2724.0,2420.0,0.889,13.411,236,156,116,40,80,62,18,38,0.0,0.0
1011,1346,2020-03-19 06:08:00,1,2272.0,2020.0,0.889,11.187,402,266,195,71,136,92,44,41,0.0,0.0
1011,1347,2020-03-19 06:11:00,1,2275.0,2002.0,0.88,11.179,210,160,123,37,50,27,23,58,0.0,0.0
1011,1348,2020-03-19 06:14:00,1,2500.0,2190.0,0.876,12.276,533,399,314,85,134,95,39,22,0.0,0.0
1011,1349,2020-03-19 06:17:00,1,2564.0,2268.0,0.885,12.614,827,409,300,109,418,312,106,21,0.0,0.0
1011,1350,2020-03-19 06:20:00,1,2645.0,2298.0,0.869,12.965,815,376,280,96,439,332,107,7,0.0,0.0
1011,1351,2020-03-19 06:23:00,1,2663.0,2282.0,0.857,13.02,652,380,305,75,272,207,65,29,0.0,0.0
1011,1352,2020-03-19 06:26:00,1,2654.0,2285.0,0.861,12.986,325,215,165,50,110,76,34,10,0.0,0.0
1011,1353,2020-03-19 06:29:00,1,2290.0,1932.0,0.844,11.164,518,370,287,83,148,100,48,11,0.0,0.0
1011,1354,2020-03-19 06:32:00,1,2253.0,2064.0,0.916,11.162,529,362,270,92,167,116,51,26,0.0,0.0
1011,1355,2020-03-19 06:35:00,1,2431.0,2077.0,0.854,11.879,124,111,55,56,13,5,8,34,0.0,0.0
1011,1356,2020-03-19 06:38:00,1,2432.0,2071.0,0.852,11.875,52,52,22,30,0,0,0,30,0.0,0.0
1011,1357,2020-03-19 06:41:00,1,2260.0,1986.0,0.879,11.104,43,40,15,25,3,1,2,0,0.0,0.0
1011,1358,2020-03-19 06:44:00,1,2211.0,1890.0,0.855,10.804,18,16,9,7,2,2,0,0,0.0,0.0
1011,1359,2020-03-19 06:47:00,1,2069.0,1709.0,0.826,10.042,20,20,12,8,0,0,0,0,0.0,0.0
1011,1360,2020-03-19 06:50:00,1,1829.0,1544.0,0.844,8.915,1,0,0,0,1,1,0,0,0.0,0.0
1011,1361,2020-03-19 06:53:00,1,1774.0,1417.0,0.799,8.559,0,0,0,0,0,0,0,0,0.0,0.0
1011,1362,2020-03-19 06:56:00,1,1761.0,1444.0,0.82,8.537,0,0,0,0,0,0,0,0,0.0,0.0
1011,1363,2020-03-19 06:59:00,1,1601.0,1340.0,0.837,7.791,32,31,10,21,1,0,1,7,0.0,0.0
1011,1364,2020-03-19 07:02:00,1,1831.0,1546.0,0.844,8.925,227,170,105,65,57,37,20,54,0.0,0.0
1011,1365,2020-03-19 07:05:00,1,2284.0,1923.0,0.842,11.128,155,104,49,55,51,26,25,99,0.0,0.0
1011,1366,2020-03-19 07:08:00,1,2530.0,2075.0,0.82,12.267,421,257,203,54,164,130,34,193,0.11,0.0
1011,1367,2020-03-19 07:11:00,1,2213.0,1840.0,0.831,10.755,158,106,70,36,52,33,19,45,0.0,0.0
1011,1368,2020-03-19 07:14:00,1,2527.0,2057.0,0.814,12.234,71,65,35,30,6,1,5,1,0.0,0.0
1011,1369,2020-03-19 07:17:00,1,2352.0,1997.0,0.849,11.478,13,0,0,0,13,0,13,0,0.0,0.06
1011,1370,2020-03-19 07:20:00,1,2209.0,1816.0,0.822,10.715,20,14,8,6,6,2,4,0,0.0,0.0
1011,1371,2020-03-19 07:23:00,1,1991.0,1641.0,0.824,9.66,7,4,3,1,3,0,3,0,0.0,0.0
1011,1372,2020-03-19 07:26:00,1,1771.0,1438.0,0.812,8.569,38,32,8,24,6,0,6,0,0.0,0.0
1011,1373,2020-03-19 07:29:00,1,1593.0,1396.0,0.876,7.823,58,46,16,30,12,2,10,0,0.0,0.0
1011,1374,2020-03-19 07:32:00,1,1758.0,1474.0,0.838,8.56,24,17,0,17,7,0,7,0,0.0,0.0
1011,1375,2020-03-19 07:35:00,1,1753.0,1481.0,0.845,8.545,12,6,0,6,6,1,5,0,0.0,0.0
1011,1376,2020-03-19 07:38:00,1,1763.0,1451.0,0.823,8.553,6,3,0,3,3,1,2,0,0.0,0.0
1011,1377,2020-03-19 07:41:00,1,1781.0,1379.0,0.774,8.546,7,5,0,5,2,0,2,0,0.0,0.0
1011,1378,2020-03-19 07:44:00,1,1771.0,1410.0,0.797,8.538,22,19,7,12,3,0,3,4,0.0,0.0
1011,1379,2020-03-19 07:47:00,1,1986.0,1664.0,0.838,9.666,161,133,93,40,28,7,21,56,0.0,0.0
1011,1380,2020-03-19 07:50:00,1,2365.0,1943.0,0.821,11.469,95,46,9,37,49,13,36,84,0.0,0.0
1011,1381,2020-03-19 07:53:00,1,2686.0,2197.0,0.818,13.015,281,177,110,67,104,61,43,66,0.0,0.0
1011,1382,2020-03-19 07:56:00,1,2310.0,1890.0,0.818,11.195,564,359,282,77,205,155,50,39,0.0,0.0
1011,1383,2020-03-19 07:59:00,1,2280.0,1972.0,0.865,11.168,192,160,125,35,32,17,15,74,0.0,0.0
1011,1384,2020-03-19 08:02:00,1,2285.0,1913.0,0.837,11.122,557,465,384,81,92,49,43,41,0.0,0.01
1011,1385,2020-03-19 08:05:00,1,2289.0,1919.0,0.838,11.145,147,145,84,61,2,1,1,46,0.0,0.0
1011,1386,2020-03-19 08:08:00,1,2502.0,2140.0,0.855,12.227,94,94,65,29,0,0,0,27,0.0,0.0
1011,1387,2020-03-19 08:11:00,1,2122.0,1851.0,0.872,10.411,5,5,3,2,0,0,0,0,0.0,0.0
1011,1388,2020-03-19 08:14:00,1,1972.0,1694.0,0.859,9.646,0,0,0,0,0,0,0,0,0.0,0.0
1011,1389,2020-03-19 08:17:00,1,1736.0,1534.0,0.884,8.538,30,30,11,19,0,0,0,0,0.0,0.0
1011,1390,2020-03-19 08:20:00,1,1754.5,1471.5,0.8395,8.543,2,2,0,2,0,0,0,0,0.0,0.0
1011,1391,2020-03-19 08:23:00,1,1773.0,1409.0,0.795,8.548,3,3,0,3,0,0,0,0,0.0,0.0
1011,1392,2020-03-19 08:26:00,1,1912.0,1617.0,0.846,9.324,10,9,6,3,1,0,1,0,0.0,0.0
1011,1393,2020-03-19 08:29:00,1,1910.0,1620.0,0.848,9.321,0,0,0,0,0,0,0,0,0.0,0.0
1011,1394,2020-03-19 08:32:00,1,1744.0,1516.0,0.869,8.551,0,0,0,0,0,0,0,0,0.0,0.0
1011,1395,2020-03-19 08:35:00,1,3133.0,1492.0,0.476,13.996,1,1,0,1,0,0,0,0,0.0,0.0
1011,1396,2020-03-19 08:38:00,1,3151.0,1506.0,0.478,14.084,5,5,4,1,0,0,0,0,0.0,0.0
1011,1397,2020-03-19 08:41:00,1,3151.0,1477.0,0.469,14.051,3,3,2,1,0,0,0,0,0.0,0.0
1011,1398,2020-03-19 08:44:00,1,3314.0,1578.0,0.476,14.806,0,0,0,0,0,0,0,0,0.0,0.0
1011,1399,2020-03-19 08:47:00,1,3144.0,1495.0,0.476,14.045,20,19,9,10,1,1,0,0,0.0,0.0
1011,1400,2020-03-19 08:50:00,1,3140.0,1528.0,0.487,14.065,1,1,0,1,0,0,0,0,0.0,0.0
1011,1401,2020-03-19 08:53:00,1,2878.0,1454.0,0.505,12.95,4,0,0,0,4,1,3,0,0.0,0.0
1011,1402,2020-03-19 08:56:00,1,2873.0,1419.0,0.494,12.893,52,45,32,13,7,2,5,0,0.0,0.0
1011,1403,2020-03-19 08:59:00,1,2802.0,1384.0,0.494,12.573,5,1,0,1,4,0,4,0,0.0,0.0
1011,1404,2020-03-19 09:02:00,1,2870.0,1490.0,0.519,12.959,7,2,1,1,5,0,5,0,0.0,0.0
1011,1405,2020-03-19 09:05:00,1,2696.0,1439.0,0.534,12.215,9,6,0,6,3,0,3,0,0.0,0.0
1011,1406,2020-03-19 09:08:00,1,2439.0,1341.0,0.55,11.096,19,17,7,10,2,0,2,0,0.0,0.0
1011,1407,2020-03-19 09:11:00,1,2456.0,1263.0,0.514,11.075,24,20,7,13,4,0,4,0,0.0,0.0
1011,1408,2020-03-19 09:14:00,1,2293.0,1208.0,0.527,10.374,12,9,2,7,3,0,3,0,0.0,0.0
1011,1409,2020-03-19 09:17:00,1,2212.0,1118.0,0.505,9.952,33,32,9,23,1,0,1,0,0.0,0.0
1011,1410,2020-03-19 09:20:00,1,2281.0,1229.0,0.539,10.349,3,3,0,3,0,0,0,0,0.0,0.0
1011,1411,2020-03-19 09:23:00,1,2445.0,1334.0,0.546,11.109,8,8,2,6,0,0,0,0,0.0,0.0
1011,1412,2020-03-19 09:26:00,1,2418.0,1399.0,0.579,11.078,127,113,66,47,14,6,8,33,0.0,0.0
1011,1413,2020-03-19 09:29:00,1,2961.0,1868.0,0.631,13.735,136,104,74,30,32,24,8,136,0.0,0.0
1011,1414,2020-03-19 09:32:00,1,3080.0,2107.0,0.684,14.469,198,145,103,42,53,25,28,76,0.0,0.0
1011,1415,2020-03-19 09:35:00,1,3132.0,2206.0,0.704,14.783,188,126,67,59,62,9,53,101,0.0,0.0
1011,1416,2020-03-19 09:38:00,1,3134.0,2218.0,0.708,14.806,510,285,219,66,225,168,57,67,0.16,0.05
1011,1417,2020-03-19 09:41:00,1,3002.0,2050.0,0.683,14.099,291,170,125,45,121,83,38,31,0.0,0.0
1011,1418,2020-03-19 09:44:00,1,2987.0,2105.0,0.704,14.101,704,437,342,95,267,190,77,76,0.0,0.0
1011,1419,2020-03-19 09:47:00,1,2983.0,2117.0,0.71,14.096,684,474,390,84,210,160,50,60,0.13,0.0
1011,1420,2020-03-19 09:50:00,1,2902.0,2076.0,0.715,13.731,425,282,214,68,143,103,40,27,0.0,0.0
1011,1421,2020-03-19 09:53:00,1,2990.0,2121.0,0.709,14.129,674,451,366,85,223,154,69,70,0.0,0.0
1011,1422,2020-03-19 09:56:00,1,2908.0,2061.0,0.709,13.738,320,220,145,75,100,61,39,25,0.0,0.02
1011,1423,2020-03-19 09:59:00,1,2734.0,2014.0,0.737,13.002,735,523,423,100,212,151,61,65,0.0,0.0
1011,1424,2020-03-19 10:02:00,1,2746.0,1967.0,0.716,12.999,220,177,135,42,43,31,12,33,0.0,0.0
1011,1425,2020-03-19 10:05:00,1,2749.0,1944.0,0.707,12.983,54,54,9,45,0,0,0,11,0.0,0.0
1011,1426,2020-03-19 10:08:00,1,2756.0,1926.0,0.699,12.99,105,105,61,44,0,0,0,4,0.0,0.0
1011,1427,2020-03-19 10:11:00,1,2585.0,1828.0,0.707,12.21,9,9,4,5,0,0,0,1,0.0,0.0
1011,1428,2020-03-19 10:14:00,1,2365.0,1594.0,0.674,11.085,0,0,0,0,0,0,0,0,0.0,0.0
1011,1429,2020-03-19 10:17:00,1,2219.0,1456.0,0.656,10.356,0,0,0,0,0,0,0,0,0.0,0.0
1011,1430,2020-03-19 10:20:00,1,1972.0,1336.0,0.678,9.251,1,1,0,1,0,0,0,0,0.0,0.0
1011,1431,2020-03-19 10:23:00,1,1986.0,1284.0,0.646,9.248,3,3,2,1,0,0,0,0,0.0,0.0
1011,1432,2020-03-19 10:26:00,1,2230.0,1404.0,0.63,10.339,10,7,4,3,3,1,2,0,0.0,0.0
1011,1433,2020-03-19 10:29:00,1,2049.0,1363.0,0.665,9.584,2,0,0,0,2,0,2,0,0.0,0.0
1011,1434,2020-03-19 10:32:00,1,1910.0,1255.0,0.657,8.914,4,0,0,0,4,0,4,0,0.0,0.0
1011,1435,2020-03-19 10:35:00,1,1814.0,1230.0,0.678,8.511,29,23,15,8,6,0,6,2,0.0,0.0
1011,1436,2020-03-19 10:38:00,1,1990.0,1287.0,0.647,9.266,3,0,0,0,3,0,3,0,0.0,0.0
1011,1437,2020-03-19 10:41:00,1,2001.0,1249.0,0.624,9.268,12,9,6,3,3,0,3,0,0.0,0.0
1011,1438,2020-03-19 10:44:00,1,1980.0,1356.0,0.685,9.304,2,0,0,0,2,0,2,0,0.0,0.0
1011,1439,2020-03-19 10:47:00,1,2061.0,1362.0,0.661,9.629,2,0,0,0,2,0,2,0,0.0,0.0
1011,1440,2020-03-19 10:50:00,1,2391.0,1532.0,0.641,11.117,0,0,0,0,0,0,0,0,0.0,0.0
1011,1441,2020-03-19 10:53:00,1,2214.0,1496.0,0.676,10.381,0,0,0,0,0,0,0,0,0.0,0.0
1011,1442,2020-03-19 10:56:00,1,2230.0,1422.0,0.638,10.362,26,23,15,8,3,0,3,1,0.0,0.0
1011,1443,2020-03-19 10:59:00,1,2226.0,1402.0,0.63,10.324,28,3,0,3,25,0,25,0,0.0,0.0
1011,1444,2020-03-19 11:02:00,1,2203.0,1490.0,0.676,10.328,37,29,17,12,8,5,3,0,0.0,0.0
1011,1445,2020-03-19 11:05:00,1,2376.0,1568.0,0.66,11.098,71,68,17,51,3,1,2,22,0.0,0.0
1011,1446,2020-03-19 11:08:00,1,2350.0,1670.0,0.711,11.107,147,111,64,47,36,12,24,55,0.0,0.0
1011,1447,2020-03-19 11:11:00,1,2765.0,1904.0,0.689,13.002,150,100,47,53,50,17,33,98,0.0,0.0
1011,1448,2020-03-19 11:14:00,1,2824.0,2004.0,0.71,13.347,274,197,151,46,77,50,27,101,0.0,0.02
1011,1449,2020-03-19 11:17:00,1,2664.0,1894.0,0.711,12.593,775,567,481,86,208,146,62,116,0.0,0.01
1011,1450,2020-03-19 11:20:00,1,2514.5,1931.0,0.7715,12.0455,511,370,298,72,141,100,41,31,0.23,0.01
1011,1451,2020-03-19 11:23:00,1,2365.0,1968.0,0.832,11.498,522,328,247,81,194,139,55,55,0.0,0.0
1011,1452,2020-03-19 11:26:00,1,2362.0,1982.0,0.839,11.503,106,70,40,30,36,19,17,7,0.0,0.04
1011,1453,2020-03-19 11:29:00,1,2283.0,1929.0,0.845,11.129,38,37,16,21,1,1,0,17,0.0,0.0
1011,1454,2020-03-19 11:32:00,1,2200.0,1884.0,0.856,10.753,5,4,1,3,1,0,1,2,0.0,0.0
1011,1455,2020-03-19 11:35:00,1,1968.0,1721.0,0.875,9.658,1,0,0,0,1,0,1,0,0.0,0.0
1011,1456,2020-03-19 11:38:00,1,1816.0,1568.0,0.863,8.892,0,0,0,0,0,0,0,1,0.0,0.0
1011,1457,2020-03-19 11:41:00,1,1573.0,1442.0,0.917,7.794,1,1,0,1,0,0,0,0,0.0,0.0
1011,1458,2020-03-19 11:44:00,1,1597.0,1355.0,0.849,7.792,0,0,0,0,0,0,0,0,0.0,0.03
1011,1459,2020-03-19 11:47:00,1,1587.0,1399.0,0.882,7.803,1,0,0,0,1,0,1,0,0.0,0.0
1011,1460,2020-03-19 11:50:00,1,1598.0,1344.0,0.841,7.782,0,0,0,0,0,0,0,0,0.0,0.01
1011,1461,2020-03-19 11:53:00,1,1597.0,1333.0,0.834,7.77,11,11,7,4,0,0,0,0,0.0,0.02
1011,1462,2020-03-19 11:56:00,1,1594.0,1340.0,0.84,7.765,2,0,0,0,2,0,2,0,0.0,0.0
1011,1463,2020-03-19 11:59:00,1,1589.0,1377.0,0.866,7.785,0,0,0,0,0,0,0,0,0.0,0.0
1011,1464,2020-03-19 12:02:00,1,1760.0,1456.0,0.827,8.548,3,0,0,0,3,0,3,0,0.0,0.0
1011,1465,2020-03-19 12:05:00,1,1845.0,1506.0,0.817,8.935,1,0,0,0,1,0,1,0,0.0,0.0
1011,1466,2020-03-19 12:08:00,1,1835.0,1538.0,0.838,8.934,13,9,7,2,4,2,2,0,0.0,0.0
1011,1467,2020-03-19 12:11:00,1,1846.0,1476.0,0.8,8.906,25,24,1,23,1,0,1,0,0.0,0.0
1011,1468,2020-03-19 12:14:00,1,1597.0,1357.0,0.849,7.795,16,16,6,10,0,0,0,0,0.0,0.0
1011,1469,2020-03-19 12:17:00,1,1612.0,1320.0,0.819,7.815,2,1,0,1,1,0,1,0,0.0,0.0
1011,1470,2020-03-19 12:20:00,1,1610.0,1313.0,0.815,7.798,4,4,0,4,0,0,0,0,0.0,0.0
1011,1471,2020-03-19 12:23:00,1,1617.0,1298.0,0.802,7.809,15,13,5,8,2,1,1,0,0.0,0.0
1011,1472,2020-03-19 12:26:00,1,1596.0,1375.0,0.862,7.809,11,11,3,8,0,0,0,0,0.0,0.0
1011,1473,2020-03-19 12:29:00,1,1767.0,1443.0,0.817,8.561,3,3,1,2,0,0,0,0,0.0,0.0
1011,1474,2020-03-19 12:32:00,1,1753.0,1475.0,0.841,8.54,97,94,48,46,3,0,3,27,0.0,0.0
1011,1475,2020-03-19 12:35:00,1,1979.0,1669.0,0.843,9.646,126,122,66,56,4,0,4,46,0.0,0.0
1011,1476,2020-03-19 12:38:00,1,1952.0,1793.0,0.918,9.677,171,128,81,47,43,18,25,25,0.0,0.0
1011,1477,2020-03-19 12:41:00,1,2128.0,1850.0,0.869,10.434,127,90,46,44,37,1,36,106,0.0,0.0
1011,1478,2020-03-19 12:44:00,1,2208.0,1885.0,0.854,10.786,561,450,365,85,111,72,39,110,0.0,0.0
1011,1479,2020-03-19 12:47:00,1,2115.0,1852.0,0.876,10.381,888,580,475,105,308,238,70,100,0.0,0.0
1011,1480,2020-03-19 12:50:00,1,2195.0,1895.0,0.863,10.744,189,167,118,49,22,12,10,50,0.0,0.0
1011,1481,2020-03-19 12:53:00,1,2112.0,1868.0,0.884,10.39,777,533,426,107,244,175,69,123,0.0,0.0
1011,1482,2020-03-19 12:56:00,1,2114.0,1896.0,0.897,10.426,384,270,206,64,114,71,43,13,0.0,0.0
1011,1483,2020-03-19 12:59:00,1,2189.0,1943.0,0.888,10.777,726,532,426,106,194,121,73,104,0.0,0.0
1011,1484,2020-03-19 13:02:00,1,2192.0,1937.0,0.884,10.782,335,246,182,64,89,58,31,21,0.0,0.0
1011,1485,2020-03-19 13:05:00,1,2190.0,1947.0,0.889,10.784,250,191,123,68,59,21,38,12,0.0,0.0
1011,1486,2020-03-19 13:08:00,1,2191.0,1949.0,0.89,10.789,92,80,30,50,12,0,12,8,0.0,0.0
1011,1487,2020-03-19 13:11:00,1,2103.0,1933.0,0.919,10.426,74,21,8,13,53,0,53,0,0.0,0.0
1011,1488,2020-03-19 13:14:00,1,1872.0,1735.0,0.927,9.298,46,0,0,0,46,0,46,0,0.0,0.0
1011,1489,2020-03-19 13:17:00,1,1636.0,1574.0,0.962,8.187,38,6,0,6,32,0,32,0,0.0,0.0
1011,1490,2020-03-19 13:20:00,1,1568.0,1485.0,0.947,7.824,35,0,0,0,35,0,35,0,0.0,0.0
1011,1491,2020-03-19 13:23:00,1,1396.0,1429.0,1.024,7.081,30,0,0,0,30,2,28,0,0.0,0.0
1011,1492,2020-03-19 13:26:00,1,1401.0,1391.0,0.993,7.059,37,0,0,0,37,2,35,0,0.0,0.0
1011,1493,2020-03-19 13:29:00,1,1411.0,1369.0,0.97,7.074,64,17,8,9,47,0,47,0,0.0,0.0
1011,1494,2020-03-19 13:32:00,1,1473.0,1486.0,1.009,7.448,52,0,0,0,52,2,50,0,0.0,0.0
1011,1495,2020-03-19 13:35:00,1,1559.0,1496.0,0.959,7.8,53,0,0,0,53,4,49,0,0.0,0.0
1011,1496,2020-03-19 13:38:00,1,1552.0,1517.0,0.978,7.793,57,0,0,0,57,0,57,0,0.0,0.0
1011,1497,2020-03-19 13:41:00,1,1559.0,1506.0,0.966,7.811,40,0,0,0,40,0,40,0,0.0,0.0
1011,1498,2020-03-19 13:44:00,1,1569.0,1465.0,0.934,7.802,64,13,6,7,51,2,49,0,0.0,0.0
1011,1499,2020-03-19 13:47:00,1,1571.0,1472.0,0.937,7.819,17,0,0,0,17,0,17,0,0.0,0.0
1011,1500,2020-03-19 13:50:00,1,1477.0,1455.0,0.985,7.431,37,0,0,0,37,0,37,0,0.0,0.0
1011,1501,2020-03-19 13:53:00,1,1475.0,1454.0,0.985,7.42,47,2,0,2,45,2,43,0,0.0,0.0
1011,1502,2020-03-19 13:56:00,1,1478.0,1459.0,0.987,7.439,56,2,0,2,54,0,54,0,0.0,0.0
1011,1503,2020-03-19 13:59:00,1,1480.0,1431.0,0.967,7.414,67,10,0,10,57,0,57,0,0.0,0.0
1011,1504,2020-03-19 14:02:00,1,1569.0,1459.0,0.929,7.798,79,71,20,51,8,0,8,20,0.0,0.0
1011,1505,2020-03-19 14:05:00,1,1548.0,1563.0,1.01,7.828,28,28,5,23,0,0,0,0,0.0,0.0
1011,1506,2020-03-19 14:08:00,1,1704.0,1646.0,0.966,8.536,64,64,29,35,0,0,0,15,0.0,0.0
1011,1507,2020-03-19 14:11:00,1,1786.0,1731.0,0.97,8.953,206,206,134,72,0,0,0,5,0.0,0.0
1011,1508,2020-03-19 14:14:00,1,1764.0,1780.0,1.009,8.919,148,145,85,60,3,2,1,89,0.0,0.0
1011,1509,2020-03-19 14:17:00,1,1912.0,1920.0,1.004,9.658,268,157,103,54,111,79,32,109,0.0,0.04
1011,1510,2020-03-19 14:20:00,1,2247.0,2052.0,0.925,11.1245,391,248,186,62,143,112,31,116,0.0,0.0
1011,1511,2020-03-19 14:23:00,1,2582.0,2184.0,0.846,12.591,398,292,228,64,106,81,25,106,0.0,0.01
1011,1512,2020-03-19 14:26:00,1,2601.0,2159.0,0.83,12.639,209,170,131,39,39,12,27,54,0.06,0.03
1011,1513,2020-03-19 14:29:00,1,2753.0,2263.0,0.822,13.353,69,48,14,34,21,0,21,17,0.0,0.0
1011,1514,2020-03-19 14:32:00,1,2591.0,2188.0,0.844,12.632,218,155,103,52,63,24,39,65,0.0,0.0
1011,1515,2020-03-19 14:35:00,1,2604.0,2153.0,0.827,12.642,144,131,82,49,13,7,6,103,0.0,0.01
1011,1516,2020-03-19 14:38:00,1,2435.0,2029.0,0.833,11.839,333,265,196,69,68,53,15,18,0.0,0.06
1011,1517,2020-03-19 14:41:00,1,2214.0,1874.0,0.846,10.798,86,85,29,56,1,0,1,3,0.0,0.0
1011,1518,2020-03-19 14:44:00,1,2435.0,2058.0,0.845,11.871,13,12,4,8,1,0,1,1,0.0,0.0
1011,1519,2020-03-19 14:47:00,1,2271.0,1999.0,0.88,11.159,2,0,0,0,2,0,2,0,0.0,0.0
1011,1520,2020-03-19 14:50:00,1,2192.0,1928.0,0.88,10.77,3,1,1,0,2,0,2,0,0.0,0.0
1011,1521,2020-03-19 14:53:00,1,2040.0,1810.0,0.887,10.043,6,1,0,1,5,0,5,0,0.0,0.0
1011,1522,2020-03-19 14:56:00,1,2031.0,1832.0,0.902,10.029,5,0,0,0,5,0,5,0,0.0,0.0
1011,1523,2020-03-19 14:59:00,1,2123.0,1852.0,0.872,10.416,8,6,0,6,2,0,2,0,0.0,0.0
1011,1524,2020-03-19 15:02:00,1,2045.0,1812.0,0.886,10.063,1,0,0,0,1,0,1,0,0.0,0.0
1011,1525,2020-03-19 15:05:00,1,2059.0,1739.0,0.845,10.038,13,12,9,3,1,1,0,0,0.0,0.0
1011,1526,2020-03-19 15:08:00,1,1985.0,1675.0,0.843,9.676,6,1,1,0,5,2,3,0,0.0,0.0
1011,1527,2020-03-19 15:11:00,1,1985.0,1670.0,0.841,9.669,3,0,0,0,3,2,1,0,0.0,0.0
1011,1528,2020-03-19 15:14:00,1,1898.0,1639.0,0.863,9.294,2,0,0,0,2,0,2,0,0.0,0.0
1011,1529,2020-03-19 15:17:00,1,1821.0,1603.0,0.881,8.948,7,0,0,0,7,3,4,0,0.0,0.0
1011,1530,2020-03-19 15:20:00,1,1823.0,1570.0,0.861,8.92,1,0,0,0,1,0,1,0,0.0,0.0
1011,1531,2020-03-19 15:23:00,1,1829.0,1562.0,0.854,8.935,130,85,70,15,45,35,10,2,0.0,0.0
1011,1532,2020-03-19 15:26:00,1,1815.0,1602.0,0.882,8.926,12,12,2,10,0,0,0,0,0.0,0.0
1011,1533,2020-03-19 15:29:00,1,1828.0,1528.0,0.836,8.894,8,8,5,3,0,0,0,0,0.0,0.0
1011,1534,2020-03-19 15:32:00,1,1661.0,1468.0,0.884,8.171,4,2,1,1,2,1,1,0,0.0,0.0
1011,1535,2020-03-19 15:35:00,1,1681.0,1402.0,0.834,8.177,3,1,0,1,2,0,2,0,0.0,0.0
1011,1536,2020-03-19 15:38:00,1,1600.0,1337.0,0.836,7.785,8,8,2,6,0,0,0,0,0.0,0.0
1011,1537,2020-03-19 15:41:00,1,1603.0,1361.0,0.849,7.823,6,6,0,6,0,0,0,0,0.0,0.0
1011,1538,2020-03-19 15:44:00,1,1523.0,1316.0,0.864,7.457,36,33,18,15,3,1,2,0,0.0,0.0
1011,1539,2020-03-19 15:47:00,1,1845.0,1528.0,0.828,8.961,82,73,37,36,9,2,7,15,0.0,0.0
1011,1540,2020-03-19 15:50:00,1,2048.0,1786.0,0.872,10.045,128,126,74,52,2,0,2,15,0.0,0.0
1011,1541,2020-03-19 15:53:00,1,2208.0,1880.0,0.852,10.78,16,8,4,4,8,0,8,11,0.0,0.0
1011,1542,2020-03-19 15:56:00,1,2185.0,1952.0,0.893,10.771,179,147,80,67,32,15,17,96,0.0,0.0
1011,1543,2020-03-19 15:59:00,1,2437.0,2048.0,0.841,11.868,121,83,36,47,38,8,30,102,0.0,0.13
1011,1544,2020-03-19 16:02:00,1,2583.0,2183.0,0.845,12.594,432,256,189,67,176,122,54,137,0.0,0.0
1011,1545,2020-03-19 16:05:00,1,2194.0,1959.0,0.893,10.815,385,261,200,61,124,80,44,87,0.18,0.0
1011,1546,2020-03-19 16:08:00,1,2284.0,1966.0,0.861,11.175,519,355,287,68,164,117,47,51,0.0,0.0
1011,1547,2020-03-19 16:11:00,1,2142.0,1791.0,0.836,10.421,289,243,180,63,46,23,23,17,0.0,0.0
1011,1548,2020-03-19 16:14:00,1,2278.0,1989.0,0.873,11.177,20,18,3,15,2,1,1,0,0.0,0.0
1011,1549,2020-03-19 16:17:00,1,2211.0,1857.0,0.84,10.766,2,0,0,0,2,0,2,0,0.0,0.0
1011,1550,2020-03-19 16:20:00,1,2056.0,1767.0,0.859,10.059,11,3,1,2,8,0,8,0,0.0,0.0
1011,1551,2020-03-19 16:23:00,1,2060.0,1738.0,0.844,10.042,4,2,0,2,2,0,2,0,0.0,0.0
1011,1552,2020-03-19 16:26:00,1,1810.0,1618.0,0.894,8.922,8,3,1,2,5,0,5,0,0.0,0.0
1011,1553,2020-03-19 16:29:00,1,1802.0,1635.0,0.907,8.91,5,0,0,0,5,0,5,0,0.0,0.0
1011,1554,2020-03-19 16:32:00,1,1796.0,1673.0,0.931,8.929,5,1,0,1,4,0,4,0,0.0,0.0
1011,1555,2020-03-19 16:35:00,1,1891.0,1679.0,0.888,9.311,0,0,0,0,0,0,0,0,0.0,0.0
1011,1556,2020-03-19 16:38:00,1,1803.0,1631.0,0.905,8.907,1,0,0,0,1,0,1,0,0.0,0.0
1011,1557,2020-03-19 16:41:00,1,1825.0,1547.0,0.847,8.904,9,9,7,2,0,0,0,0,0.0,0.0
1011,1558,2020-03-19 16:44:00,1,1817.0,1592.0,0.876,8.921,33,33,20,13,0,0,0,0,0.0,0.0
1011,1559,2020-03-19 16:47:00,1,1809.0,1607.0,0.888,8.908,1,1,1,0,0,0,0,0,0.0,0.0
1011,1560,2020-03-19 16:50:00,1,1805.0,1599.0,0.886,8.881,3,1,0,1,2,0,2,0,0.0,0.0
1011,1561,2020-03-19 16:53:00,1,1821.0,1572.0,0.864,8.915,3,3,0,3,0,0,0,0,0.0,0.0
1011,1562,2020-03-19 16:56:00,1,1837.0,1528.0,0.832,8.929,13,12,0,12,1,0,1,0,0.0,0.0
1011,1563,2020-03-19 16:59:00,1,1826.0,1549.0,0.848,8.911,109,73,50,23,36,23,13,26,0.0,0.0
1011,1564,2020-03-19 17:02:00,1,2211.0,1886.0,0.853,10.798,108,54,19,35,54,22,32,64,0.0,0.21
1011,1565,2020-03-19 17:05:00,1,2268.0,2009.0,0.886,11.159,166,109,61,48,57,34,23,59,0.07,0.0
1011,1566,2020-03-19 17:08:00,1,1975.0,1693.0,0.857,9.657,173,151,96,55,22,15,7,44,0.0,0.0
1011,1567,2020-03-19 17:11:00,1,2196.0,1935.0,0.881,10.796,67,64,21,43,3,0,3,19,0.0,0.0
1011,1568,2020-03-19 17:14:00,1,2416.0,2117.0,0.876,11.863,49,49,14,35,0,0,0,12,0.0,0.0
1011,1569,2020-03-19 17:17:00,1,2410.0,2170.0,0.901,11.899,44,42,17,25,2,1,1,1,0.0,0.0
1011,1570,2020-03-19 17:20:00,1,2297.0,2065.0,0.899,11.3365,3,2,0,2,1,0,1,0,0.0,0.0
1011,1571,2020-03-19 17:23:00,1,2184.0,1960.0,0.897,10.774,2,0,0,0,2,0,2,0,0.0,0.0
1011,1572,2020-03-19 17:26:00,1,2019.0,1889.0,0.936,10.047,29,24,8,16,5,1,4,0,0.0,0.0
1011,1573,2020-03-19 17:29:00,1,2039.0,1827.0,0.896,10.056,35,33,9,24,2,0,2,0,0.0,0.0
1011,1574,2020-03-19 17:32:00,1,2026.0,1837.0,0.907,10.016,1,0,0,0,1,1,0,0,0.0,0.0
1011,1575,2020-03-19 17:35:00,1,1782.0,1715.0,0.962,8.921,0,0,0,0,0,0,0,0,0.0,0.0
1011,1576,2020-03-19 17:38:00,1,1871.0,1748.0,0.934,9.305,7,6,1,5,1,0,1,0,0.0,0.0
1011,1577,2020-03-19 17:41:00,1,1778.0,1749.0,0.984,8.939,73,69,38,31,4,1,3,2,0.0,0.0
1011,1578,2020-03-19 17:44:00,1,2010.0,1925.0,0.958,10.051,88,75,37,38,13,0,13,19,0.0,0.0
1011,1579,2020-03-19 17:47:00,1,2162.0,2054.0,0.95,10.791,68,61,12,49,7,3,4,6,0.0,0.0
1011,1580,2020-03-19 17:50:00,1,2233.0,2145.0,0.96,11.173,58,47,17,30,11,2,9,4,0.0,0.0
1011,1581,2020-03-19 17:53:00,1,2148.0,2108.0,0.981,10.798,272,175,132,43,97,68,29,104,0.0,0.0
1011,1582,2020-03-19 17:56:00,1,2246.0,2104.0,0.937,11.178,132,81,38,43,51,12,39,93,0.0,0.0
1011,1583,2020-03-19 17:59:00,1,2404.0,2223.0,0.925,11.934,307,167,123,44,140,102,38,131,0.09,0.0
1011,1584,2020-03-19 18:02:00,0,2397.0,2245.0,0.937,11.929,660,372,304,68,288,225,63,79,0.0,0.0
1011,1585,2020-03-19 18:05:00,0,2554.0,2347.0,0.919,12.662,831,412,328,84,419,324,95,132,0.0,0.01
1011,1586,2020-03-19 18:08:00,0,2553.0,2330.0,0.913,12.639,598,339,274,65,259,197,62,240,0.0,0.0
1011,1587,2020-03-19 18:11:00,0,2797.0,2483.0,0.888,13.768,283,186,111,75,97,64,33,87,0.0,0.0
1011,1588,2020-03-19 18:14:00,0,2415.0,2153.0,0.892,11.898,117,74,24,50,43,6,37,21,0.0,0.0
1011,1589,2020-03-19 18:17:00,0,2717.0,2404.0,0.885,13.368,124,78,39,39,46,8,38,12,0.0,0.0
1011,1590,2020-03-19 18:20:00,0,2798.0,2456.0,0.878,13.741,74,63,28,35,11,6,5,2,0.0,0.0
1011,1591,2020-03-19 18:23:00,0,2760.0,2589.0,0.938,13.743,247,144,99,45,103,77,26,16,0.0,0.0
1011,1592,2020-03-19 18:26:00,0,2575.0,2291.0,0.89,12.681,33,25,10,15,8,4,4,4,0.0,0.0
1011,1593,2020-03-19 18:29:00,0,2775.0,2580.0,0.93,13.791,278,189,130,59,89,54,35,29,0.0,0.0
1011,1594,2020-03-19 18:32:00,0,2849.0,2588.0,0.908,14.089,914,448,358,90,466,374,92,175,0.0,0.04
1011,1595,2020-03-19 18:35:00,0,2775.0,2563.0,0.924,13.772,698,387,304,83,311,227,84,109,0.0,0.0
1011,1596,2020-03-19 18:38:00,0,2638.0,2384.0,0.904,13.032,646,345,267,78,301,220,81,108,0.0,0.03
1011,1597,2020-03-19 18:41:00,0,2797.0,2498.0,0.893,13.786,843,403,319,84,440,347,93,103,0.0,0.0
1011,1598,2020-03-19 18:44:00,0,2958.0,2570.0,0.869,14.498,714,410,324,86,304,242,62,138,0.0,0.0
1011,1599,2020-03-19 18:47:00,0,2800.0,2494.0,0.891,13.792,661,332,249,83,329,229,100,110,0.0,0.0
1011,1600,2020-03-19 18:50:00,0,2965.0,2538.0,0.856,14.491,425,217,136,81,208,157,51,18,0.0,0.0
1011,1601,2020-03-19 18:53:00,0,2968.0,2531.0,0.853,14.494,540,224,159,65,316,230,86,25,0.0,0.0
1011,1602,2020-03-19 18:56:00,0,2578.0,2243.0,0.87,12.642,502,272,209,63,230,166,64,33,0.0,0.0
1011,1603,2020-03-19 18:59:00,0,2589.0,2182.0,0.843,12.618,606,305,238,67,301,242,59,155,0.0,0.0
1011,1604,2020-03-19 19:02:00,0,2678.0,2252.0,0.841,13.045,847,361,283,78,486,391,95,197,0.0,0.0
1011,1605,2020-03-19 19:05:00,0,2912.0,2376.0,0.816,14.103,719,336,251,85,383,292,91,57,0.0,0.02
1011,1606,2020-03-19 19:08:00,0,2911.0,2388.0,0.82,14.115,530,221,151,70,309,238,71,30,0.0,0.0
1011,1607,2020-03-19 19:11:00,0,2466.0,1970.0,0.799,11.898,140,110,63,47,30,7,23,51,0.0,0.0
1011,1608,2020-03-19 19:14:00,0,2693.0,2194.0,0.815,13.039,350,216,154,62,134,93,41,58,0.0,0.0
1011,1609,2020-03-19 19:17:00,0,2681.0,2207.0,0.823,13.006,598,279,211,68,319,255,64,90,0.0,0.0
1011,1610,2020-03-19 19:20:00,0,2767.0,2203.0,0.796,13.34,706,324,263,61,382,303,79,149,0.0,0.0
1011,1611,2020-03-19 19:23:00,0,2768.0,2215.0,0.8,13.357,599,344,268,76,255,201,54,172,0.0,0.0
1011,1612,2020-03-19 19:26:00,0,2612.0,2119.0,0.811,12.637,514,222,156,66,292,209,83,35,0.0,0.0
1011,1613,2020-03-19 19:29:00,0,2549.0,1986.0,0.779,12.243,158,48,23,25,110,50,60,0,0.0,0.0
1011,1614,2020-03-19 19:32:00,0,2603.0,2124.0,0.816,12.609,537,264,206,58,273,192,81,55,0.0,0.0
1011,1615,2020-03-19 19:35:00,0,2862.0,2229.0,0.779,13.744,866,354,261,93,512,384,128,15,0.0,0.0
1011,1616,2020-03-19 19:38:00,0,2859.0,2219.0,0.776,13.721,521,267,185,82,254,182,72,14,0.0,0.0
1011,1617,2020-03-19 19:41:00,0,2869.0,2186.0,0.762,13.723,367,179,108,71,188,144,44,37,0.0,0.0
1011,1618,2020-03-19 19:44:00,0,2082.0,1653.0,0.794,10.033,360,238,151,87,122,73,49,60,0.0,0.0
1011,1619,2020-03-19 19:47:00,0,2880.0,2212.0,0.768,13.796,329,122,73,49,207,152,55,26,0.0,0.03
1011,1620,2020-03-19 19:50:00,0,2640.0,2010.0,0.761,12.627,133,74,33,41,59,23,36,0,0.0,0.0
1011,1621,2020-03-19 19:53:00,0,2635.0,2044.0,0.776,12.645,771,382,305,77,389,320,69,207,0.0,0.0
1011,1622,2020-03-19 19:56:00,0,2864.0,2197.0,0.767,13.718,713,342,263,79,371,270,101,104,0.0,0.0
1011,1623,2020-03-19 19:59:00,0,2797.0,2116.0,0.756,13.363,246,105,55,50,141,95,46,12,0.0,0.0
1011,1624,2020-03-19 20:02:00,0,2485.0,1882.0,0.757,11.875,359,168,122,46,191,133,58,20,0.0,0.0
1011,1625,2020-03-19 20:05:00,0,2614.0,2083.0,0.797,12.606,516,201,151,50,315,231,84,100,0.0,0.0
1011,1626,2020-03-19 20:08:00,0,2795.0,2124.0,0.76,13.364,672,314,221,93,358,277,81,59,0.0,0.0
1011,1627,2020-03-19 20:11:00,0,2563.0,1937.0,0.756,12.242,514,254,178,76,260,191,69,92,0.0,0.0
1011,1628,2020-03-19 20:14:00,0,2890.0,2158.0,0.747,13.778,455,235,180,55,220,170,50,54,0.0,0.0
1011,1629,2020-03-19 20:17:00,0,2647.0,2003.0,0.757,12.646,1026,676,562,114,350,292,58,396,0.0,0.0
1011,1630,2020-03-19 20:20:00,0,2752.5,2135.0,0.775,13.209,617,391,318,73,226,174,52,255,0.0,0.0
1011,1631,2020-03-19 20:23:00,0,2858.0,2267.0,0.793,13.772,902,440,330,110,462,361,101,36,0.0,0.0
1011,1632,2020-03-19 20:26:00,0,2865.0,2189.0,0.764,13.713,360,172,109,63,188,138,50,7,0.0,0.0
1011,1633,2020-03-19 20:29:00,0,2556.0,1984.0,0.776,12.269,416,236,160,76,180,138,42,29,0.0,0.0
1011,1634,2020-03-19 20:32:00,0,2494.0,1864.0,0.747,11.89,404,210,136,74,194,133,61,60,0.0,0.0
1011,1635,2020-03-19 20:35:00,0,2879.0,2146.0,0.745,13.721,406,245,176,69,161,114,47,59,0.0,0.0
1011,1636,2020-03-19 20:38:00,0,2650.0,1980.0,0.747,12.635,275,155,101,54,120,63,57,42,0.0,0.0
1011,1637,2020-03-19 20:41:00,0,2640.0,2014.0,0.763,12.631,414,178,129,49,236,168,68,73,0.0,0.0
1011,1638,2020-03-19 20:44:00,0,2638.0,2036.0,0.772,12.647,279,122,74,48,157,109,48,25,0.02,0.0
1011,1639,2020-03-19 20:47:00,0,2505.0,1846.0,0.737,11.914,80,56,25,31,24,0,24,18,0.0,0.0
1011,1640,2020-03-19 20:50:00,0,2616.0,2024.0,0.774,12.549,0,0,0,0,0,0,0,0,0.0,0.0
1011,1641,2020-03-19 20:53:00,0,2410.0,1827.0,0.758,11.518,2,2,0,2,0,0,0,0,0.0,0.0
1011,1642,2020-03-19 20:56:00,0,2092.0,1603.0,0.766,10.018,5,3,0,3,2,0,2,0,0.0,0.0
1011,1643,2020-03-19 20:59:00,0,1936.0,1477.0,0.763,9.265,7,3,0,3,4,0,4,0,0.0,0.0
1011,1644,2020-03-19 21:02:00,0,1689.0,1359.0,0.805,8.16,7,3,3,0,4,0,4,0,0.0,0.0
1011,1645,2020-03-19 21:05:00,0,1869.0,1388.0,0.743,8.899,311,186,139,47,125,87,38,4,0.0,0.0
1011,1646,2020-03-19 21:08:00,0,2173.0,1662.0,0.765,10.4,626,299,239,60,327,265,62,95,0.0,0.0
1011,1647,2020-03-19 21:11:00,0,2108.0,1557.0,0.739,10.03,188,109,58,51,79,43,36,4,0.0,0.0
1011,1648,2020-03-19 21:14:00,0,2243.0,1766.0,0.787,10.794,579,272,211,61,307,224,83,52,0.0,0.0
1011,1649,2020-03-19 21:17:00,0,2482.0,1943.0,0.783,11.932,596,297,231,66,299,228,71,97,0.0,0.0
1011,1650,2020-03-19 21:20:00,0,2805.0,2089.0,0.745,13.363,753,419,327,92,334,248,86,90,0.0,0.0
1011,1651,2020-03-19 21:23:00,0,2727.0,2048.0,0.751,13.01,290,128,69,59,162,97,65,7,0.07,0.0
1011,1652,2020-03-19 21:26:00,0,2492.0,1861.0,0.747,11.88,663,337,256,81,326,248,78,61,0.0,0.0
1011,1653,2020-03-19 21:29:00,0,2894.0,2110.0,0.729,13.738,514,313,213,100,201,137,64,12,0.0,0.0
1011,1654,2020-03-19 21:32:00,0,2877.0,2190.0,0.761,13.762,374,184,120,64,190,143,47,3,0.0,0.0
1011,1655,2020-03-19 21:35:00,0,2881.0,2133.0,0.74,13.715,347,176,115,61,171,122,49,0,0.0,0.0
1011,1656,2020-03-19 21:38:00,0,2799.0,2110.0,0.754,13.365,364,156,111,45,208,153,55,18,0.0,0.0
1011,1657,2020-03-19 21:41:00,0,2647.0,1976.0,0.746,12.619,507,285,208,77,222,148,74,28,0.0,0.0
1011,1658,2020-03-19 21:44:00,0,2561.0,1943.0,0.759,12.244,457,250,195,55,207,155,52,79,0.0,0.0
1011,1659,2020-03-19 21:47:00,0,2643.0,1997.0,0.756,12.625,516,281,210,71,235,174,61,197,0.0,0.0
1011,1660,2020-03-19 21:50:00,0,2855.0,2243.0,0.786,13.732,492,321,245,76,171,132,39,248,0.0,0.0
1011,1661,2020-03-19 21:53:00,0,2945.0,2258.0,0.767,14.104,533,238,175,63,295,231,64,136,0.04,0.0
1011,1662,2020-03-19 21:56:00,0,2894.0,2104.0,0.727,13.732,509,260,181,79,249,174,75,41,0.0,0.0
1011,1663,2020-03-19 21:59:00,0,2854.0,2209.0,0.774,13.689,669,287,210,77,382,284,98,7,0.03,0.0
1011,1664,2020-03-19 22:02:00,0,3031.0,2287.0,0.755,14.475,240,101,60,41,139,100,39,3,0.0,0.0
1011,1665,2020-03-19 22:05:00,0,2641.0,2039.0,0.772,12.664,341,199,138,61,142,103,39,17,0.0,0.0
1011,1666,2020-03-19 22:08:00,0,2416.0,1809.0,0.749,11.523,322,201,152,49,121,92,29,140,0.0,0.0
1011,1667,2020-03-19 22:11:00,0,2643.0,1973.0,0.746,12.597,283,190,144,46,93,72,21,152,0.0,0.0
1011,1668,2020-03-19 22:14:00,0,2875.0,2170.0,0.755,13.73,290,172,131,41,118,96,22,154,0.0,0.0
1011,1669,2020-03-19 22:17:00,0,2861.0,2216.0,0.774,13.726,436,209,154,55,227,165,62,84,0.0,0.0
1011,1670,2020-03-19 22:20:00,0,2641.0,2004.0,0.759,12.626,298,139,70,69,159,116,43,2,0.06,0.0
1011,1671,2020-03-19 22:23:00,0,2878.0,2149.0,0.747,13.718,542,288,225,63,254,186,68,65,0.0,0.0
1011,1672,2020-03-19 22:26:00,0,2866.0,2212.0,0.772,13.743,697,353,266,87,344,256,88,48,0.0,0.0
1011,1673,2020-03-19 22:29:00,0,2874.0,2199.0,0.765,13.759,383,227,167,60,156,111,45,67,0.0,0.0
1011,1674,2020-03-19 22:32:00,0,2633.0,2018.0,0.766,12.61,321,174,138,36,147,106,41,116,0.0,0.0
1011,1675,2020-03-19 22:35:00,0,2630.0,2026.0,0.77,12.606,197,74,26,48,123,65,58,1,0.0,0.0
1011,1676,2020-03-19 22:38:00,0,2643.0,1942.0,0.735,12.563,187,142,88,54,45,29,16,53,0.0,0.0
1011,1677,2020-03-19 22:41:00,0,2875.0,2159.0,0.751,13.719,527,263,202,61,264,196,68,146,0.0,0.0
1011,1678,2020-03-19 22:44:00,0,2644.0,1995.0,0.755,12.625,209,128,96,32,81,59,22,143,0.0,0.0
1011,1679,2020-03-19 22:47:00,0,2800.0,2114.0,0.755,13.374,586,315,243,72,271,202,69,109,0.0,0.0
1011,1680,2020-03-19 22:50:00,0,2633.0,2053.0,0.779,12.649,554,270,200,70,284,213,71,38,0.04,0.0
1011,1681,2020-03-19 22:53:00,0,2643.0,1988.0,0.752,12.615,289,165,126,39,124,84,40,109,0.16,0.0
1011,1682,2020-03-19 22:56:00,0,2652.0,1966.0,0.741,12.626,357,144,79,65,213,150,63,50,0.0,0.0
1011,1683,2020-03-19 22:59:00,0,2499.0,1837.0,0.735,11.879,329,142,89,53,187,137,50,5,0.0,0.0
1011,1684,2020-03-19 23:02:00,0,2563.0,1952.0,0.761,12.261,602,289,224,65,313,234,79,100,0.0,0.0
1011,1685,2020-03-19 23:05:00,0,2881.0,2144.0,0.744,13.725,326,170,119,51,156,122,34,62,0.0,0.0
1011,1686,2020-03-19 23:08:00,0,2652.0,1985.0,0.748,12.647,522,248,186,62,274,204,70,56,0.0,0.0
1011,1687,2020-03-19 23:11:00,0,2489.0,1862.0,0.748,11.87,306,139,87,52,167,103,64,23,0.0,0.0
1011,1688,2020-03-19 23:14:00,0,2247.0,1706.0,0.759,10.743,170,84,34,50,86,49,37,43,0.0,0.0
1011,1689,2020-03-19 23:17:00,0,2638.0,1966.0,0.745,12.57,584,300,223,77,284,214,70,93,0.0,0.0
1011,1690,2020-03-19 23:20:00,0,2688.5,1978.5,0.736,12.7825,420,212,167,45,208,157,51,73,0.0,0.0
1011,1691,2020-03-19 23:23:00,0,2739.0,1991.0,0.727,12.995,510,245,171,74,265,193,72,15,0.0,0.0
1011,1692,2020-03-19 23:26:00,0,2573.0,1883.0,0.732,12.222,230,129,77,52,101,55,46,0,0.0,0.0
1011,1693,2020-03-19 23:29:00,0,2361.0,1660.0,0.703,11.141,399,211,153,58,188,132,56,52,0.13,0.0
1011,1694,2020-03-19 23:32:00,0,2335.0,1762.0,0.755,11.15,147,92,72,20,55,48,7,146,0.0,0.0
1011,1695,2020-03-19 23:35:00,0,2737.0,1973.0,0.721,12.97,118,58,18,40,60,36,24,28,0.0,0.0
1011,1696,2020-03-19 23:38:00,0,2575.0,1914.0,0.743,12.265,538,277,211,66,261,203,58,118,0.0,0.0
1011,1697,2020-03-19 23:41:00,0,2584.0,1891.0,0.732,12.273,206,98,63,35,108,77,31,9,0.0,0.0
1011,1698,2020-03-19 23:44:00,0,2112.0,1517.0,0.718,9.999,3,3,0,3,0,0,0,0,0.0,0.0
1011,1699,2020-03-19 23:47:00,0,1949.0,1441.0,0.739,9.275,0,0,0,0,0,0,0,0,0.0,0.0
1011,1700,2020-03-19 23:50:00,0,2202.0,1561.0,0.709,10.403,24,24,14,10,0,0,0,0,0.0,0.0
1011,1701,2020-03-19 23:53:00,0,2206.0,1541.0,0.698,10.398,0,0,0,0,0,0,0,0,0.0,0.0
1011,1702,2020-03-19 23:56:00,0,1956.0,1409.0,0.72,9.268,1,1,0,1,0,0,0,0,0.0,0.0
1011,1703,2020-03-19 23:59:00,0,1800.0,1299.0,0.722,8.532,3,3,1,2,0,0,0,0,0.0,0.0
1011,1704,2020-03-20 00:02:00,0,1635.0,1214.0,0.742,7.788,6,6,3,3,0,0,0,0,0.0,0.0
1011,1705,2020-03-20 00:05:00,0,1640.0,1185.0,0.722,7.775,0,0,0,0,0,0,0,0,0.0,0.0
1011,1706,2020-03-20 00:08:00,0,1724.0,1243.0,0.721,8.169,0,0,0,0,0,0,0,0,0.0,0.0
1011,1707,2020-03-20 00:11:00,0,1654.0,1158.0,0.7,7.799,54,49,20,29,5,0,5,10,0.0,0.0
1011,1708,2020-03-20 00:14:00,0,1806.0,1282.0,0.71,8.538,120,105,46,59,15,0,15,37,0.0,0.0
1011,1709,2020-03-20 00:17:00,0,2404.0,1827.0,0.76,11.493,635,372,293,79,263,201,62,115,0.01,0.0
1011,1710,2020-03-20 00:20:00,0,2323.0,1768.0,0.761,11.109,482,236,176,60,246,193,53,98,0.0,0.0
1011,1711,2020-03-20 00:23:00,0,2567.0,1910.0,0.744,12.228,407,204,147,57,203,145,58,22,0.01,0.0
1011,1712,2020-03-20 00:26:00,0,2334.0,1758.0,0.753,11.141,500,262,189,73,238,185,53,37,0.0,0.0
1011,1713,2020-03-20 00:29:00,0,2589.0,1865.0,0.72,12.264,524,320,249,71,204,144,60,47,0.06,0.0
1011,1714,2020-03-20 00:32:00,0,2563.0,1935.0,0.755,12.242,752,366,278,88,386,285,101,28,0.0,0.0
1011,1715,2020-03-20 00:35:00,0,2731.0,2071.0,0.758,13.051,435,199,132,67,236,173,63,4,0.0,0.0
1011,1716,2020-03-20 00:38:00,0,2575.0,1907.0,0.74,12.258,309,213,162,51,96,69,27,164,0.0,0.0
1011,1717,2020-03-20 00:41:00,0,2723.0,2039.0,0.749,12.987,251,127,86,41,124,73,51,60,0.0,0.0
1011,1718,2020-03-20 00:44:00,0,2794.0,2056.0,0.736,13.284,485,234,178,56,251,180,71,69,0.0,0.0
1011,1719,2020-03-20 00:47:00,0,2729.0,2044.0,0.749,13.016,544,300,238,62,244,181,63,99,0.04,0.0
1011,1720,2020-03-20 00:50:00,0,2588.0,1831.0,0.707,12.225,403,233,170,63,170,107,63,6,0.0,0.0
1011,1721,2020-03-20 00:53:00,0,2722.0,2044.0,0.751,12.988,780,399,306,93,381,288,93,48,0.0,0.0
1011,1722,2020-03-20 00:56:00,0,3134.0,2252.0,0.719,14.844,443,260,187,73,183,143,40,32,0.0,0.0
1011,1723,2020-03-20 00:59:00,0,2419.0,1792.0,0.741,11.515,487,218,168,50,269,194,75,45,0.0,0.0
1011,1724,2020-03-20 01:02:00,0,2507.0,1818.0,0.725,11.891,436,220,146,74,216,150,66,1,0.0,0.0
1011,1725,2020-03-20 01:05:00,0,2578.0,1887.0,0.732,12.245,640,305,223,82,335,258,77,88,0.0,0.0
1011,1726,2020-03-20 01:08:00,0,2722.0,2053.0,0.754,12.996,309,179,143,36,130,99,31,75,0.08,0.0
1011,1727,2020-03-20 01:11:00,0,2544.0,1954.0,0.768,12.185,476,229,160,69,247,184,63,69,0.0,0.0
1011,1728,2020-03-20 01:14:00,0,2334.0,1746.0,0.748,11.13,240,139,101,38,101,61,40,36,0.0,0.0
1011,1729,2020-03-20 01:17:00,0,2399.0,1814.0,0.756,11.461,340,184,144,40,156,108,48,25,0.0,0.0
1011,1730,2020-03-20 01:20:00,0,2356.0,1700.0,0.721,11.166,193,116,78,38,77,46,31,9,0.03,0.0
1011,1731,2020-03-20 01:23:00,0,1806.0,1282.0,0.71,8.534,321,151,104,47,170,131,39,44,0.06,0.0
1011,1732,2020-03-20 01:26:00,0,2347.0,1706.0,0.727,11.137,203,121,74,47,82,61,21,15,0.0,0.0
1011,1733,2020-03-20 01:29:00,0,2351.0,1683.0,0.716,11.126,153,105,84,21,48,34,14,13,0.0,0.0
1011,1734,2020-03-20 01:32:00,0,2199.0,1557.0,0.708,10.386,0,0,0,0,0,0,0,0,0.0,0.0
1011,1735,2020-03-20 01:35:00,0,1953.0,1428.0,0.731,9.277,0,0,0,0,0,0,0,0,0.0,0.0
1011,1736,2020-03-20 01:38:00,0,1797.0,1330.0,0.74,8.552,0,0,0,0,0,0,0,0,0.0,0.0
1011,1737,2020-03-20 01:41:00,0,1798.0,1270.0,0.706,8.492,8,6,4,2,2,0,2,0,0.0,0.0
1011,1738,2020-03-20 01:44:00,0,1788.0,1294.0,0.724,8.48,0,0,0,0,0,0,0,0,0.0,0.0
1011,1739,2020-03-20 01:47:00,0,1651.0,1172.0,0.71,7.803,4,4,1,3,0,0,0,0,0.0,0.0
1011,1740,2020-03-20 01:50:00,0,1570.0,1125.0,0.717,7.431,0,0,0,0,0,0,0,0,0.0,0.0
1011,1741,2020-03-20 01:53:00,0,1399.0,1078.0,0.77,6.705,1,1,0,1,0,0,0,0,0.0,0.0
1011,1742,2020-03-20 01:56:00,0,1404.0,1051.0,0.748,6.695,3,3,0,3,0,0,0,0,0.0,0.0
1011,1743,2020-03-20 01:59:00,0,1473.0,1134.0,0.77,7.06,307,173,118,55,134,97,37,12,0.0,0.0
1011,1744,2020-03-20 02:02:00,0,2189.0,1601.0,0.731,10.399,640,334,268,66,306,240,66,7,0.0,0.04
1011,1745,2020-03-20 02:05:00,0,2105.0,1557.0,0.74,10.02,649,364,292,72,285,223,62,134,0.01,0.0
1011,1746,2020-03-20 02:08:00,0,2113.0,1555.0,0.736,10.045,128,89,45,44,39,26,13,50,0.0,0.0
1011,1747,2020-03-20 02:11:00,0,2331.0,1735.0,0.745,11.106,318,190,152,38,128,85,43,100,0.01,0.0
1011,1748,2020-03-20 02:14:00,0,2336.0,1753.0,0.75,11.147,274,162,130,32,112,90,22,145,0.0,0.0
1011,1749,2020-03-20 02:17:00,0,2346.0,1717.0,0.732,11.145,257,132,90,42,125,84,41,42,0.0,0.0
1011,1750,2020-03-20 02:20:00,0,2389.5,1713.5,0.7175,11.3125,563,333,253,80,230,178,52,85,0.12,0.0
1011,1751,2020-03-20 02:23:00,0,2433.0,1710.0,0.703,11.48,309,134,87,47,175,132,43,5,0.0,0.0
1011,1752,2020-03-20 02:26:00,0,2410.0,1790.0,0.743,11.478,196,110,76,34,86,60,26,47,0.0,0.0
1011,1753,2020-03-20 02:29:00,0,2419.0,1787.0,0.739,11.512,393,253,194,59,140,91,49,60,0.0,0.0
1011,1754,2020-03-20 02:32:00,0,2408.0,1815.0,0.754,11.497,128,73,59,14,55,44,11,8,0.0,0.0
1011,1755,2020-03-20 02:35:00,0,2487.0,1839.0,0.739,11.836,406,206,156,50,200,155,45,32,0.0,0.0
1011,1756,2020-03-20 02:38:00,0,2651.0,1917.0,0.723,12.568,375,205,150,55,170,124,46,68,0.0,0.0
1011,1757,2020-03-20 02:41:00,0,2731.0,1990.0,0.728,12.965,762,394,285,109,368,263,105,17,0.07,0.0
1011,1758,2020-03-20 02:44:00,0,2661.0,1943.0,0.73,12.636,339,203,147,56,136,88,48,14,0.01,0.0
1011,1759,2020-03-20 02:47:00,0,2581.0,1878.0,0.728,12.251,377,166,108,58,211,151,60,43,0.0,0.0
1011,1760,2020-03-20 02:50:00,0,2497.0,1849.0,0.74,11.887,200,83,48,35,117,68,49,18,0.0,0.0
1011,1761,2020-03-20 02:53:00,0,2668.0,1902.0,0.713,12.617,308,173,118,55,135,95,40,7,0.05,0.0
1011,1762,2020-03-20 02:56:00,0,2588.0,1849.0,0.715,12.242,197,74,41,33,123,71,52,3,0.0,0.0
1011,1763,2020-03-20 02:59:00,0,2424.0,1770.0,0.73,11.51,510,256,188,68,254,198,56,24,0.0,0.0
1011,1764,2020-03-20 03:02:00,0,2409.0,1821.0,0.756,11.509,532,266,198,68,266,206,60,84,0.11,0.0
1011,1765,2020-03-20 03:05:00,0,2428.0,1738.0,0.716,11.492,166,116,80,36,50,25,25,15,0.0,0.0
1011,1766,2020-03-20 03:08:00,0,2439.0,1742.0,0.714,11.541,399,222,152,70,177,128,49,65,0.0,0.0
1011,1767,2020-03-20 03:11:00,0,2269.0,1666.0,0.734,10.785,148,90,55,35,58,48,10,7,0.0,0.0
1011,1768,2020-03-20 03:14:00,0,2434.0,1777.0,0.73,11.556,347,187,139,48,160,116,44,7,0.0,0.0
1011,1769,2020-03-20 03:17:00,0,2268.0,1629.0,0.718,10.741,155,75,52,23,80,66,14,68,0.0,0.0
1011,1770,2020-03-20 03:20:00,0,1951.0,1427.0,0.732,9.267,288,140,112,28,148,123,25,104,0.0,0.0
1011,1771,2020-03-20 03:23:00,0,2437.0,1738.0,0.713,11.526,109,72,54,18,37,28,9,131,0.0,0.0
1011,1772,2020-03-20 03:26:00,0,2426.0,1758.0,0.725,11.506,109,55,38,17,54,32,22,23,0.0,0.0
1011,1773,2020-03-20 03:29:00,0,2274.0,1613.0,0.709,10.744,80,17,7,10,63,35,28,21,0.0,0.0
1011,1774,2020-03-20 03:32:00,0,2407.0,1797.0,0.746,11.471,191,90,62,28,101,69,32,6,0.0,0.0
1011,1775,2020-03-20 03:35:00,0,2268.0,1658.0,0.731,10.773,348,167,127,40,181,131,50,64,0.0,0.0
1011,1776,2020-03-20 03:38:00,0,2286.0,1594.0,0.697,10.773,180,75,49,26,105,77,28,7,0.0,0.0
1011,1777,2020-03-20 03:41:00,0,2036.0,1468.0,0.721,9.646,74,5,4,1,69,28,41,0,0.0,0.0
1011,1778,2020-03-20 03:44:00,0,2113.0,1539.0,0.729,10.028,85,14,11,3,71,36,35,0,0.0,0.0
1011,1779,2020-03-20 03:47:00,0,1881.0,1355.0,0.721,8.913,40,0,0,0,40,4,36,0,0.0,0.0
1011,1780,2020-03-20 03:50:00,0,1726.0,1237.0,0.717,8.17,41,0,0,0,41,4,37,0,0.0,0.0
1011,1781,2020-03-20 03:53:00,0,1733.0,1196.0,0.69,8.154,28,0,0,0,28,4,24,0,0.0,0.0
1011,1782,2020-03-20 03:56:00,0,1724.0,1237.0,0.717,8.163,26,1,0,1,25,4,21,0,0.0,0.0
1011,1783,2020-03-20 03:59:00,0,1558.0,1149.0,0.738,7.412,2,0,0,0,2,1,1,0,0.0,0.0
1011,1784,2020-03-20 04:02:00,0,1561.0,1158.0,0.742,7.434,313,175,121,54,138,88,50,7,0.0,0.0
1011,1785,2020-03-20 04:05:00,0,1720.0,1255.0,0.729,8.167,271,95,52,43,176,106,70,22,0.0,0.0
1011,1786,2020-03-20 04:08:00,0,1879.0,1358.0,0.722,8.907,308,152,108,44,156,114,42,39,0.0,0.0
1011,1787,2020-03-20 04:11:00,0,1716.0,1260.0,0.735,8.155,129,74,53,21,55,37,18,28,0.0,0.0
1011,1788,2020-03-20 04:14:00,0,1874.0,1363.0,0.728,8.893,314,165,126,39,149,113,36,19,0.11,0.0
1011,1789,2020-03-20 04:17:00,0,1866.0,1386.0,0.743,8.889,0,0,0,0,0,0,0,0,0.0,0.0
1011,1790,2020-03-20 04:20:00,0,1718.0,1264.0,0.736,8.169,0,0,0,0,0,0,0,0,0.0,0.0
1011,1791,2020-03-20 04:23:00,0,1478.0,1114.0,0.753,7.057,1,1,0,1,0,0,0,0,0.0,0.0
1011,1792,2020-03-20 04:26:00,0,1500.0,1038.0,0.692,7.059,19,19,0,19,0,0,0,0,0.0,0.0
1011,1793,2020-03-20 04:29:00,0,1330.0,980.0,0.737,6.325,3,3,0,3,0,0,0,0,0.0,0.0
1011,1794,2020-03-20 04:32:00,0,1342.0,920.0,0.686,6.308,14,14,0,14,0,0,0,0,0.0,0.0
1011,1795,2020-03-20 04:35:00,0,1339.0,935.0,0.698,6.312,4,3,2,1,1,0,1,0,0.0,0.0
1011,1796,2020-03-20 04:38:00,0,1318.0,1005.0,0.763,6.308,0,0,0,0,0,0,0,0,0.0,0.0
1011,1797,2020-03-20 04:41:00,0,1335.0,958.0,0.718,6.318,1,1,0,1,0,0,0,0,0.0,0.0
1011,1798,2020-03-20 04:44:00,0,1250.0,921.0,0.737,5.946,3,3,1,2,0,0,0,0,0.0,0.0
1011,1799,2020-03-20 04:47:00,0,1256.0,888.0,0.707,5.933,1,1,0,1,0,0,0,0,0.0,0.0
1011,1800,2020-03-20 04:50:00,0,1163.0,879.0,0.756,5.554,52,47,27,20,5,0,5,3,0.0,0.0
1011,1801,2020-03-20 04:53:00,0,1638.0,1215.0,0.741,7.799,347,224,173,51,123,86,37,80,0.0,0.0
1011,1802,2020-03-20 04:56:00,0,1794.0,1344.0,0.749,8.554,198,116,83,33,82,55,27,48,0.0,0.0
1011,1803,2020-03-20 04:59:00,0,1854.0,1455.0,0.785,8.914,288,144,99,45,144,93,51,7,0.38,0.0
1011,1804,2020-03-20 05:02:00,0,1868.0,1371.0,0.734,8.876,272,139,107,32,133,85,48,37,0.0,0.0
1011,1805,2020-03-20 05:05:00,0,2033.0,1476.0,0.726,9.644,400,166,124,42,234,167,67,68,0.0,0.0
1011,1806,2020-03-20 05:08:00,0,1961.0,1432.0,0.73,9.312,260,137,98,39,123,97,26,47,0.0,0.0
1011,1807,2020-03-20 05:11:00,0,2261.0,1673.0,0.74,10.761,303,166,120,46,137,99,38,12,0.0,0.0
1011,1808,2020-03-20 05:14:00,0,2098.0,1582.0,0.754,10.017,303,171,126,45,132,99,33,37,0.0,0.0
1011,1809,2020-03-20 05:17:00,0,2275.0,1622.0,0.713,10.76,274,114,79,35,160,122,38,4,0.0,0.0
1011,1810,2020-03-20 05:20:00,0,2109.5,1541.0,0.732,10.019,197,94,71,23,103,78,25,49,0.0,0.0
1011,1811,2020-03-20 05:23:00,0,1944.0,1460.0,0.751,9.278,289,150,111,39,139,105,34,73,0.0,0.0
1011,1812,2020-03-20 05:26:00,0,2102.0,1579.0,0.751,10.032,421,168,113,55,253,187,66,4,0.0,0.0
1011,1813,2020-03-20 05:29:00,0,2197.0,1603.0,0.729,10.432,350,209,160,49,141,104,37,57,0.0,0.0
1011,1814,2020-03-20 05:32:00,0,1863.0,1424.0,0.764,8.919,286,155,108,47,131,74,57,3,0.0,0.0
1011,1815,2020-03-20 05:35:00,0,2017.0,1521.0,0.754,9.63,22,0,0,0,22,0,22,0,0.0,0.0
1011,1816,2020-03-20 05:38:00,0,1876.0,1347.0,0.718,8.885,1,0,0,0,1,0,1,0,0.0,0.0
1011,1817,2020-03-20 05:41:00,0,1639.0,1222.0,0.745,7.812,2,2,0,2,0,0,0,0,0.0,0.0
1011,1818,2020-03-20 05:44:00,0,1472.0,1127.0,0.765,7.048,4,4,0,4,0,0,0,0,0.0,0.0
1011,1819,2020-03-20 05:47:00,0,1491.0,1069.0,0.717,7.058,3,3,1,2,0,0,0,0,0.0,0.0
1011,1820,2020-03-20 05:50:00,0,1409.0,1026.0,0.728,6.686,0,0,0,0,0,0,0,0,0.0,0.0
1011,1821,2020-03-20 05:53:00,0,1326.0,976.0,0.736,6.306,0,0,0,0,0,0,0,0,0.0,0.0
1011,1822,2020-03-20 05:56:00,0,1338.0,938.0,0.701,6.309,17,16,10,6,1,0,1,0,0.0,0.0
1011,1823,2020-03-20 05:59:00,0,1333.0,933.0,0.7,6.285,20,20,10,10,0,0,0,0,0.0,0.0
1011,1824,2020-03-20 06:02:00,1,1464.0,1162.0,0.794,7.054,129,83,48,35,46,31,15,29,0.0,0.0
1011,1825,2020-03-20 06:05:00,1,2263.0,1652.0,0.73,10.744,169,111,74,37,58,39,19,63,0.0,0.0
1011,1826,2020-03-20 06:08:00,1,2641.0,1988.0,0.753,12.608,110,81,27,54,29,3,26,97,0.0,0.0
1011,1827,2020-03-20 06:11:00,1,2718.0,2044.0,0.752,12.973,85,62,18,44,23,2,21,89,0.0,0.0
1011,1828,2020-03-20 06:14:00,1,2804.0,2122.0,0.757,13.4,150,115,78,37,35,17,18,68,0.0,0.13
1011,1829,2020-03-20 06:17:00,1,2756.0,2267.0,0.822,13.37,179,107,50,57,72,31,41,117,0.06,0.0
1011,1830,2020-03-20 06:20:00,1,2966.0,2511.0,0.847,14.468,100,57,19,38,43,27,16,66,0.06,0.1
1011,1831,2020-03-20 06:23:00,1,2978.0,2419.0,0.812,14.411,378,219,159,60,159,110,49,153,0.11,0.04
1011,1832,2020-03-20 06:26:00,1,2977.0,2504.0,0.841,14.5,96,65,27,38,31,14,17,81,0.0,0.11
1011,1833,2020-03-20 06:29:00,1,2959.0,2548.0,0.861,14.481,432,255,203,52,177,134,43,124,0.22,0.05
1011,1834,2020-03-20 06:32:00,1,2713.0,2427.0,0.894,13.378,169,88,55,33,81,51,30,98,0.1,0.08
1011,1835,2020-03-20 06:35:00,1,2938.0,2649.0,0.902,14.507,99,29,2,27,70,42,28,34,0.04,0.08
1011,1836,2020-03-20 06:38:00,1,2726.0,2423.0,0.889,13.424,155,59,46,13,96,61,35,26,0.41,0.08
1011,1837,2020-03-20 06:41:00,1,2619.0,2416.0,0.923,12.995,467,242,189,53,225,168,57,53,0.0,0.12
1011,1838,2020-03-20 06:44:00,1,2689.0,2531.0,0.941,13.396,84,51,34,17,33,14,19,32,0.0,0.19
1011,1839,2020-03-20 06:47:00,1,2290.0,2273.0,0.993,11.539,230,129,87,42,101,73,28,0,0.0,0.0
1011,1840,2020-03-20 06:50:00,1,1642.0,1538.0,0.937,8.171,417,296,216,80,121,80,41,2,0.0,0.0
1011,1841,2020-03-20 06:53:00,1,2287.0,2288.0,1.001,11.543,251,182,146,36,69,44,25,4,0.0,0.0
1011,1842,2020-03-20 06:56:00,1,2461.0,2341.0,0.951,12.287,821,535,432,103,286,210,76,31,0.0,0.0
1011,1843,2020-03-20 06:59:00,1,2375.0,2315.0,0.975,11.92,258,228,178,50,30,14,16,8,0.05,0.0
1011,1844,2020-03-20 07:02:00,1,2367.0,2352.0,0.994,11.928,30,28,11,17,2,0,2,1,0.0,0.0
1011,1845,2020-03-20 07:05:00,1,2361.0,2353.0,0.997,11.908,48,48,2,46,0,0,0,1,0.0,0.0
1011,1846,2020-03-20 07:08:00,1,2296.0,2267.0,0.987,11.554,13,11,5,6,2,2,0,0,0.0,0.0
1011,1847,2020-03-20 07:11:00,1,2157.0,2051.0,0.951,10.77,0,0,0,0,0,0,0,0,0.0,0.0
1011,1848,2020-03-20 07:14:00,1,1915.0,1911.0,0.998,9.659,0,0,0,0,0,0,0,0,0.0,0.0
1011,1849,2020-03-20 07:17:00,1,1591.0,1741.0,1.094,8.196,0,0,0,0,0,0,0,0,0.0,0.0
1011,1850,2020-03-20 07:20:00,1,1612.0,1639.0,1.017,8.167,2,0,0,0,2,1,1,0,0.0,0.0
1011,1851,2020-03-20 07:23:00,1,1531.0,1622.0,1.06,7.826,16,15,8,7,1,0,1,0,0.0,0.0
1011,1852,2020-03-20 07:26:00,1,1609.0,1673.0,1.04,8.19,11,11,0,11,0,0,0,0,0.0,0.0
1011,1853,2020-03-20 07:29:00,1,1614.0,1655.0,1.026,8.191,13,7,2,5,6,1,5,0,0.0,0.0
1011,1854,2020-03-20 07:32:00,1,1439.0,1589.0,1.104,7.431,3,2,0,2,1,0,1,0,0.0,0.0
1011,1855,2020-03-20 07:35:00,1,1369.0,1523.0,1.113,7.079,4,3,0,3,1,0,1,0,0.0,0.0
1011,1856,2020-03-20 07:38:00,1,1365.0,1530.0,1.121,7.073,44,31,22,9,13,9,4,0,0.14,0.0
1011,1857,2020-03-20 07:41:00,1,1373.0,1515.0,1.103,7.087,115,108,65,43,7,3,4,13,0.0,0.0
1011,1858,2020-03-20 07:44:00,1,1584.0,1783.0,1.126,8.213,32,31,12,19,1,0,1,4,0.0,0.0
1011,1859,2020-03-20 07:47:00,1,1577.0,1808.0,1.146,8.215,1,1,0,1,0,0,0,0,0.0,0.0
1011,1860,2020-03-20 07:50:00,1,1594.0,1735.0,1.088,8.202,9,5,0,5,4,1,3,0,0.0,0.0
1011,1861,2020-03-20 07:53:00,1,1660.0,1822.0,1.098,8.555,1,1,0,1,0,0,0,0,0.0,0.0
1011,1862,2020-03-20 07:56:00,1,1586.0,1774.0,1.118,8.215,4,4,2,2,0,0,0,0,0.0,0.0
1011,1863,2020-03-20 07:59:00,1,1515.0,1686.0,1.113,7.837,6,6,3,3,0,0,0,0,0.0,0.0
1011,1864,2020-03-20 08:02:00,1,1424.0,1658.0,1.165,7.445,16,16,8,8,0,0,0,0,0.0,0.0
1011,1865,2020-03-20 08:05:00,1,1426.0,1660.0,1.164,7.456,2,2,1,1,0,0,0,0,0.0,0.0
1011,1866,2020-03-20 08:08:00,1,1345.0,1631.0,1.212,7.105,12,8,0,8,4,0,4,0,0.0,0.0
1011,1867,2020-03-20 08:11:00,1,1584.0,1759.0,1.111,8.186,121,92,58,34,29,19,10,5,0.0,0.0
1011,1868,2020-03-20 08:14:00,1,1560.0,1837.0,1.177,8.181,151,125,89,36,26,19,7,73,0.05,0.0
1011,1869,2020-03-20 08:17:00,1,2125.0,2192.0,1.032,10.8,226,118,80,38,108,73,35,120,0.03,0.03
1011,1870,2020-03-20 08:20:00,1,2287.0,2288.0,1.0025,11.5435,62,49,18,31,13,1,12,58,0.0,0.04
1011,1871,2020-03-20 08:23:00,1,2449.0,2384.0,0.973,12.287,280,189,128,61,91,63,28,64,0.13,0.27
1011,1872,2020-03-20 08:26:00,1,2285.0,2290.0,1.002,11.538,90,55,23,32,35,18,17,56,0.15,0.0
1011,1873,2020-03-20 08:29:00,1,2422.0,2467.0,1.018,12.275,133,98,54,44,35,13,22,40,0.0,0.0
1011,1874,2020-03-20 08:32:00,1,2087.0,1978.0,0.948,10.413,8,8,4,4,0,0,0,0,0.0,0.0
1011,1875,2020-03-20 08:35:00,1,2319.0,2131.0,0.919,11.498,2,1,0,1,1,1,0,0,0.0,0.0
1011,1876,2020-03-20 08:38:00,1,2059.0,2072.0,1.006,10.405,237,146,99,47,91,53,38,47,0.02,0.0
1011,1877,2020-03-20 08:41:00,1,2286.0,2271.0,0.994,11.52,178,124,75,49,54,20,34,75,0.0,0.0
1011,1878,2020-03-20 08:44:00,1,2299.0,2223.0,0.967,11.518,545,289,215,74,256,200,56,51,0.0,0.08
1011,1879,2020-03-20 08:47:00,1,2317.0,2182.0,0.942,11.546,386,271,203,68,115,71,44,97,0.0,0.0
1011,1880,2020-03-20 08:50:00,1,2287.0,2288.0,1.0,11.543,669,412,331,81,257,177,80,32,0.1,0.0
1011,1881,2020-03-20 08:53:00,1,2359.0,2331.0,0.988,11.874,609,416,339,77,193,133,60,17,0.0,0.0
1011,1882,2020-03-20 08:56:00,1,2291.0,2246.0,0.981,11.511,215,147,93,54,68,53,15,23,0.01,0.0
1011,1883,2020-03-20 08:59:00,1,2294.0,2293.0,0.999,11.577,114,102,51,51,12,8,4,15,0.0,0.0
1011,1884,2020-03-20 09:02:00,1,2440.0,2415.0,0.99,12.287,64,62,18,44,2,1,1,7,0.0,0.0
1011,1885,2020-03-20 09:05:00,1,2457.0,2354.0,0.958,12.286,18,18,9,9,0,0,0,0,0.0,0.0
1011,1886,2020-03-20 09:08:00,1,2322.0,2168.0,0.933,11.551,5,5,2,3,0,0,0,0,0.0,0.0
1011,1887,2020-03-20 09:11:00,1,2089.0,2002.0,0.958,10.448,4,4,0,4,0,0,0,0,0.0,0.0
1011,1888,2020-03-20 09:14:00,1,1932.0,1840.0,0.952,9.648,17,15,1,14,2,1,1,0,0.0,0.0
1011,1889,2020-03-20 09:17:00,1,1785.0,1721.0,0.964,8.936,0,0,0,0,0,0,0,0,0.0,0.0
1011,1890,2020-03-20 09:20:00,1,1619.0,1629.0,1.006,8.183,0,0,0,0,0,0,0,0,0.0,0.0
1011,1891,2020-03-20 09:23:00,1,1545.0,1544.0,1.0,7.796,1,1,0,1,0,0,0,0,0.0,0.0
1011,1892,2020-03-20 09:26:00,1,1477.0,1463.0,0.991,7.44,12,12,1,11,0,0,0,0,0.0,0.0
1011,1893,2020-03-20 09:29:00,1,1483.0,1431.0,0.965,7.425,81,73,20,53,8,2,6,6,0.0,0.0
1011,1894,2020-03-20 09:32:00,1,1786.0,1728.0,0.968,8.949,94,94,51,43,0,0,0,11,0.0,0.0
1011,1895,2020-03-20 09:35:00,1,1767.0,1780.0,1.007,8.933,8,8,3,5,0,0,0,0,0.0,0.0
1011,1896,2020-03-20 09:38:00,1,1701.0,1667.0,0.98,8.549,3,3,1,2,0,0,0,0,0.0,0.0
1011,1897,2020-03-20 09:41:00,1,1542.0,1577.0,1.022,7.821,29,28,13,15,1,0,1,0,0.0,0.0
1011,1898,2020-03-20 09:44:00,1,1548.0,1570.0,1.014,7.837,1,1,1,0,0,0,0,0,0.0,0.0
1011,1899,2020-03-20 09:47:00,1,1537.0,1591.0,1.035,7.818,0,0,0,0,0,0,0,0,0.0,0.0
1011,1900,2020-03-20 09:50:00,1,1542.0,1569.0,1.018,7.811,3,3,1,2,0,0,0,0,0.0,0.0
1011,1901,2020-03-20 09:53:00,1,1535.0,1572.0,1.024,7.789,1,1,1,0,0,0,0,0,0.0,0.0
1011,1902,2020-03-20 09:56:00,1,1535.0,1588.0,1.035,7.804,1,1,0,1,0,0,0,0,0.0,0.0
1011,1903,2020-03-20 09:59:00,1,1541.0,1565.0,1.015,7.805,9,9,4,5,0,0,0,0,0.0,0.0
1011,1904,2020-03-20 10:02:00,1,1540.0,1578.0,1.024,7.816,1,1,1,0,0,0,0,0,0.0,0.0
1011,1905,2020-03-20 10:05:00,1,1532.0,1588.0,1.037,7.792,77,34,17,17,43,30,13,1,0.0,0.0
1011,1906,2020-03-20 10:08:00,1,1705.0,1684.0,0.987,8.583,8,8,2,6,0,0,0,0,0.0,0.0
1011,1907,2020-03-20 10:11:00,1,1784.0,1708.0,0.957,8.921,4,4,0,4,0,0,0,0,0.0,0.0
1011,1908,2020-03-20 10:14:00,1,1692.0,1712.0,1.012,8.561,122,94,51,43,28,8,20,77,0.0,0.0
1011,1909,2020-03-20 10:17:00,1,2062.0,2079.0,1.008,10.428,124,87,26,61,37,11,26,72,0.0,0.0
1011,1910,2020-03-20 10:20:00,1,2217.0,2199.0,0.992,11.169,388,230,157,73,158,110,48,107,0.04,0.0
1011,1911,2020-03-20 10:23:00,1,2294.0,2262.0,0.986,11.542,163,105,58,47,58,23,35,60,0.03,0.04
1011,1912,2020-03-20 10:26:00,1,2272.0,2342.0,1.031,11.545,386,213,148,65,173,119,54,56,0.23,0.03
1011,1913,2020-03-20 10:29:00,1,2262.0,2374.0,1.049,11.541,409,219,172,47,190,148,42,23,0.0,0.0
1011,1914,2020-03-20 10:32:00,1,2281.0,2311.0,1.013,11.547,531,370,281,89,161,108,53,124,0.0,0.0
1011,1915,2020-03-20 10:35:00,1,2421.0,2528.0,1.044,12.336,324,237,172,65,87,26,61,84,0.02,0.0
1011,1916,2020-03-20 10:38:00,1,2286.0,2300.0,1.006,11.552,839,532,429,103,307,225,82,45,0.13,0.04
1011,1917,2020-03-20 10:41:00,1,2310.0,2211.0,0.957,11.549,502,324,243,81,178,117,61,103,0.0,0.0
1011,1918,2020-03-20 10:44:00,1,2506.0,2521.0,1.006,12.664,160,105,53,52,55,9,46,96,0.0,0.0
1011,1919,2020-03-20 10:47:00,1,2585.0,2563.0,0.992,13.021,143,93,37,56,50,19,31,105,0.0,0.0
1011,1920,2020-03-20 10:50:00,1,2291.0,2256.0,0.985,11.524,517,374,299,75,143,86,57,90,0.0,0.1
1011,1921,2020-03-20 10:53:00,1,2057.0,2114.0,1.028,10.444,630,410,331,79,220,157,63,59,0.05,0.01
1011,1922,2020-03-20 10:56:00,1,2002.0,1977.0,0.987,10.075,126,123,64,59,3,0,3,42,0.0,0.0
1011,1923,2020-03-20 10:59:00,1,2284.0,2271.0,0.994,11.513,38,38,8,30,0,0,0,27,0.0,0.0
1011,1924,2020-03-20 11:02:00,1,2446.0,2350.0,0.961,12.237,7,7,2,5,0,0,0,7,0.0,0.0
1011,1925,2020-03-20 11:05:00,1,2278.0,2277.0,0.999,11.496,0,0,0,0,0,0,0,0,0.0,0.0
1011,1926,2020-03-20 11:08:00,1,2303.0,2236.0,0.971,11.551,0,0,0,0,0,0,0,0,0.0,0.0
1011,1927,2020-03-20 11:11:00,1,2058.0,2100.0,1.021,10.435,0,0,0,0,0,0,0,0,0.0,0.01
1011,1928,2020-03-20 11:14:00,1,1925.0,1892.0,0.983,9.678,0,0,0,0,0,0,0,0,0.0,0.0
1011,1929,2020-03-20 11:17:00,1,1768.0,1788.0,1.011,8.945,1,1,0,1,0,0,0,0,0.0,0.0
1011,1930,2020-03-20 11:20:00,1,1643.0,1724.5,1.0525,8.3825,14,13,6,7,1,0,1,0,0.0,0.0
1011,1931,2020-03-20 11:23:00,1,1518.0,1661.0,1.094,7.82,0,0,0,0,0,0,0,0,0.0,0.0
1011,1932,2020-03-20 11:26:00,1,1533.0,1614.0,1.053,7.826,0,0,0,0,0,0,0,0,0.0,0.0
1011,1933,2020-03-20 11:29:00,1,1555.0,1524.0,0.98,7.813,0,0,0,0,0,0,0,0,0.0,0.0
1011,1934,2020-03-20 11:32:00,1,1473.0,1471.0,0.999,7.432,87,51,27,24,36,27,9,3,0.0,0.0
1011,1935,2020-03-20 11:35:00,1,1540.0,1578.0,1.025,7.816,12,12,1,11,0,0,0,0,0.0,0.0
1011,1936,2020-03-20 11:38:00,1,1551.0,1529.0,0.986,7.803,36,36,0,36,0,0,0,0,0.0,0.0
1011,1937,2020-03-20 11:41:00,1,1385.0,1483.0,1.071,7.096,269,269,216,53,0,0,0,0,0.0,0.0
1011,1938,2020-03-20 11:44:00,1,1382.0,1495.0,1.081,7.101,3,3,0,3,0,0,0,0,0.0,0.0
1011,1939,2020-03-20 11:47:00,1,1468.0,1503.0,1.024,7.447,17,17,2,15,0,0,0,0,0.0,0.0
1011,1940,2020-03-20 11:50:00,1,1543.0,1557.0,1.009,7.805,88,42,22,20,46,38,8,4,0.0,0.0
1011,1941,2020-03-20 11:53:00,1,1527.0,1621.0,1.061,7.812,0,0,0,0,0,0,0,0,0.0,0.0
1011,1942,2020-03-20 11:56:00,1,1536.0,1615.0,1.051,7.839,5,5,0,5,0,0,0,0,0.0,0.0
1011,1943,2020-03-20 11:59:00,1,1539.0,1575.0,1.024,7.806,3,3,2,1,0,0,0,0,0.0,0.0
1011,1944,2020-03-20 12:02:00,1,1566.0,1502.0,0.959,7.831,1,1,0,1,0,0,0,0,0.0,0.0
1011,1945,2020-03-20 12:05:00,1,1473.0,1488.0,1.01,7.451,9,9,1,8,0,0,0,0,0.0,0.0
1011,1946,2020-03-20 12:08:00,1,1385.0,1455.0,1.05,7.07,34,34,4,30,0,0,0,1,0.0,0.0
1012,1,2020-03-16 10:53:00,1,4361.0,3429.0,0.786,20.979,625,272,196,76,353,258,95,36,0.0,0.0
1012,2,2020-03-16 10:56:00,1,4374.0,3378.0,0.772,20.973,513,198,145,53,315,249,66,45,0.0,0.0
1012,3,2020-03-16 10:59:00,1,4152.0,3265.0,0.786,19.975,485,186,150,36,299,225,74,25,0.03,0.0
1012,4,2020-03-16 11:02:00,1,4145.0,3195.0,0.771,19.869,293,164,118,46,129,89,40,22,0.0,0.0
1012,5,2020-03-16 11:05:00,1,3978.0,3160.0,0.794,19.173,132,92,47,45,40,8,32,11,0.0,0.0
1012,6,2020-03-16 11:08:00,1,3999.0,3108.0,0.777,19.198,168,113,65,48,55,22,33,13,0.0,0.0
1012,7,2020-03-16 11:11:00,1,3774.0,2972.0,0.787,18.159,150,86,56,30,64,20,44,4,0.01,0.0
1012,8,2020-03-16 11:14:00,1,3698.0,2906.0,0.786,17.789,334,217,165,52,117,77,40,25,0.03,0.0
1012,9,2020-03-16 11:17:00,1,3706.0,2894.0,0.781,17.804,289,128,84,44,161,109,52,12,0.01,0.0
1012,10,2020-03-16 11:20:00,1,3623.0,2795.0,0.772,17.37,198,135,88,47,63,39,24,15,0.0,0.0
1012,11,2020-03-16 11:23:00,1,3552.0,2763.5,0.7785,17.0545,50,32,13,19,18,2,16,2,0.0,0.0
1012,12,2020-03-16 11:26:00,1,3481.0,2732.0,0.785,16.739,66,47,24,23,19,1,18,10,0.0,0.0
1012,13,2020-03-16 11:29:00,1,3484.0,2690.0,0.772,16.707,75,36,5,31,39,9,30,4,0.0,0.0
1012,14,2020-03-16 11:32:00,1,3227.0,2564.0,0.795,15.552,21,7,2,5,14,0,14,0,0.01,0.0
1012,15,2020-03-16 11:35:00,1,3005.0,2325.0,0.774,14.417,0,0,0,0,0,0,0,0,0.0,0.0
1012,16,2020-03-16 11:38:00,1,2871.0,2200.0,0.766,13.746,6,4,2,2,2,1,1,0,0.04,0.0
1012,17,2020-03-16 11:41:00,1,2721.0,2096.0,0.77,13.041,91,65,46,19,26,9,17,11,0.0,0.0
1012,18,2020-03-16 11:44:00,1,3106.0,2377.0,0.765,14.869,186,106,64,42,80,27,53,14,0.0,0.0
1012,19,2020-03-16 11:47:00,1,3101.0,2427.0,0.783,14.908,170,92,64,28,78,54,24,7,0.01,0.0
1012,20,2020-03-16 11:50:00,1,3109.0,2350.0,0.756,14.853,80,37,22,15,43,4,39,2,0.0,0.0
1012,21,2020-03-16 11:53:00,1,2893.0,2211.0,0.764,13.848,13,4,0,4,9,3,6,0,0.0,0.0
1012,22,2020-03-16 11:56:00,1,2577.0,1935.0,0.751,12.296,7,2,0,2,5,3,2,0,0.0,0.0
1012,23,2020-03-16 11:59:00,1,2340.0,1795.0,0.767,11.209,9,9,4,5,0,0,0,0,0.0,0.0
1012,24,2020-03-16 12:02:00,1,2349.0,1813.0,0.772,11.263,6,2,1,1,4,2,2,0,0.0,0.0
1012,25,2020-03-16 12:05:00,1,2344.0,1773.0,0.757,11.198,8,0,0,0,8,2,6,0,0.0,0.0
1012,26,2020-03-16 12:08:00,1,2733.0,2091.0,0.765,13.084,204,98,47,51,106,66,40,19,0.0,0.0
1012,27,2020-03-16 12:11:00,1,2870.0,2242.0,0.781,13.79,319,137,92,45,182,131,51,20,0.0,0.0
1012,28,2020-03-16 12:14:00,1,3039.0,2325.0,0.765,14.548,69,35,11,24,34,9,25,0,0.0,0.0
1012,29,2020-03-16 12:17:00,1,2999.0,2318.0,0.773,14.383,300,114,76,38,186,136,50,12,0.0,0.0
1012,30,2020-03-16 12:20:00,1,3096.0,2408.0,0.778,14.864,252,111,76,35,141,73,68,8,0.0,0.0
1012,31,2020-03-16 12:23:00,1,3250.0,2457.0,0.756,15.524,389,158,112,46,231,166,65,16,0.01,0.0
1012,32,2020-03-16 12:26:00,1,3079.0,2432.0,0.79,14.825,543,267,198,69,276,199,77,7,0.0,0.0
1012,33,2020-03-16 12:29:00,1,3087.0,2389.0,0.774,14.808,443,186,127,59,257,189,68,11,0.0,0.0
1012,34,2020-03-16 12:32:00,1,3272.0,2483.0,0.759,15.641,602,326,257,69,276,194,82,7,0.0,0.0
1012,35,2020-03-16 12:35:00,1,3089.0,2395.0,0.775,14.824,373,230,156,74,143,76,67,3,0.0,0.0
1012,36,2020-03-16 12:38:00,1,3109.0,2371.0,0.763,14.874,646,268,197,71,378,307,71,1,0.04,0.0
1012,37,2020-03-16 12:41:00,1,2937.0,2305.0,0.785,14.124,193,91,47,44,102,69,33,4,0.0,0.0
1012,38,2020-03-16 12:44:00,1,2581.0,1967.0,0.762,12.348,117,76,32,44,41,12,29,8,0.0,0.0
1012,39,2020-03-16 12:47:00,1,2570.0,1986.0,0.773,12.323,143,124,71,53,19,2,17,0,0.0,0.0
1012,40,2020-03-16 12:50:00,1,2721.0,2067.0,0.76,13.011,50,40,17,23,10,1,9,0,0.0,0.0
1012,41,2020-03-16 12:53:00,1,2571.0,1937.0,0.753,12.275,2,0,0,0,2,0,2,0,0.0,0.0
1012,42,2020-03-16 12:56:00,1,2590.0,1937.0,0.748,12.348,18,15,5,10,3,2,1,0,0.0,0.0
1012,43,2020-03-16 12:59:00,1,2593.0,1933.0,0.745,12.356,11,7,3,4,4,3,1,0,0.0,0.0
1012,44,2020-03-16 13:02:00,1,2584.0,1935.0,0.749,12.323,6,5,2,3,1,1,0,0,0.0,0.0
1012,45,2020-03-16 13:05:00,1,2654.0,2004.0,0.755,12.676,19,17,2,15,2,1,1,0,0.0,0.0
1012,46,2020-03-16 13:08:00,1,2711.0,2084.0,0.769,12.987,84,38,18,20,46,11,35,8,0.0,0.0
1012,47,2020-03-16 13:11:00,1,2864.0,2289.0,0.799,13.821,211,104,66,38,107,62,45,12,0.0,0.0
1012,48,2020-03-16 13:14:00,1,2893.0,2183.0,0.755,13.814,15,10,5,5,5,1,4,0,0.0,0.0
1012,49,2020-03-16 13:17:00,1,2723.0,2068.0,0.759,13.019,0,0,0,0,0,0,0,0,0.0,0.0
1012,50,2020-03-16 13:20:00,1,2577.0,1950.0,0.757,12.314,35,26,3,23,9,2,7,0,0.0,0.0
1012,51,2020-03-16 13:23:00,1,2592.0,1942.0,0.749,12.363,2,2,0,2,0,0,0,0,0.0,0.0
1012,52,2020-03-16 13:26:00,1,2282.0,1692.0,0.741,10.866,24,11,2,9,13,0,13,0,0.0,0.0
1012,53,2020-03-16 13:29:00,1,2216.0,1603.0,0.723,10.508,7,7,1,6,0,0,0,0,0.0,0.0
1012,54,2020-03-16 13:32:00,1,2220.0,1572.0,0.708,10.488,26,26,9,17,0,0,0,0,0.0,0.0
1012,55,2020-03-16 13:35:00,1,2215.0,1596.0,0.721,10.496,11,11,3,8,0,0,0,0,0.0,0.0
1012,56,2020-03-16 13:38:00,1,2203.0,1627.0,0.739,10.484,23,23,5,18,0,0,0,0,0.0,0.0
1012,57,2020-03-16 13:41:00,1,2346.0,1738.0,0.741,11.17,4,4,2,2,0,0,0,0,0.0,0.0
1012,58,2020-03-16 13:44:00,1,2347.0,1796.0,0.765,11.237,1,1,1,0,0,0,0,0,0.0,0.0
1012,59,2020-03-16 13:47:00,1,2351.0,1822.0,0.775,11.28,0,0,0,0,0,0,0,0,0.0,0.0
1012,60,2020-03-16 13:50:00,1,2215.0,1612.0,0.727,10.513,16,12,4,8,4,0,4,0,0.0,0.0
1012,61,2020-03-16 13:53:00,1,1988.0,1437.0,0.723,9.425,3,0,0,0,3,2,1,0,0.0,0.0
1012,62,2020-03-16 13:56:00,1,1977.0,1457.0,0.737,9.401,0,0,0,0,0,0,0,0,0.0,0.0
1012,63,2020-03-16 13:59:00,1,1972.0,1488.0,0.754,9.417,16,14,1,13,2,0,2,0,0.0,0.0
1012,64,2020-03-16 14:02:00,1,2129.0,1550.0,0.728,10.103,4,4,0,4,0,0,0,0,0.0,0.0
1012,65,2020-03-16 14:05:00,1,2273.0,1687.0,0.742,10.825,0,0,0,0,0,0,0,0,0.0,0.0
1012,66,2020-03-16 14:08:00,1,2352.0,1826.0,0.776,11.289,4,4,0,4,0,0,0,0,0.0,0.0
1012,67,2020-03-16 14:11:00,1,2425.0,1900.0,0.784,11.657,8,8,0,8,0,0,0,0,0.0,0.0
1012,68,2020-03-16 14:14:00,1,2408.0,1880.0,0.781,11.569,1,1,0,1,0,0,0,0,0.0,0.0
1012,69,2020-03-16 14:17:00,1,2135.0,1554.0,0.728,10.131,8,6,2,4,2,1,1,0,0.0,0.0
1012,70,2020-03-16 14:20:00,1,2204.0,1654.0,0.75,10.517,11,10,0,10,1,0,1,0,0.0,0.0
1012,71,2020-03-16 14:23:00,1,2394.5,1813.0,0.7565,11.443,32,28,6,22,4,0,4,0,0.0,0.0
1012,72,2020-03-16 14:26:00,1,2585.0,1972.0,0.763,12.369,112,85,29,56,27,7,20,4,0.0,0.0
1012,73,2020-03-16 14:29:00,1,2869.0,2289.0,0.798,13.837,132,102,52,50,30,2,28,11,0.0,0.0
1012,74,2020-03-16 14:32:00,1,2909.0,2388.0,0.821,14.105,222,129,87,42,93,47,46,12,0.01,0.0
1012,75,2020-03-16 14:35:00,1,2863.0,2271.0,0.793,13.795,159,78,50,28,81,36,45,4,0.0,0.0
1012,76,2020-03-16 14:38:00,1,2931.0,2385.0,0.814,14.188,80,47,20,27,33,5,28,3,0.0,0.0
1012,77,2020-03-16 14:41:00,1,2835.0,2347.0,0.828,13.769,67,26,9,17,41,0,41,1,0.0,0.0
1012,78,2020-03-16 14:44:00,1,2841.0,2368.0,0.833,13.815,304,148,89,59,156,94,62,11,0.0,0.0
1012,79,2020-03-16 14:47:00,1,2832.0,2331.0,0.823,13.739,213,144,86,58,69,43,26,1,0.0,0.0
1012,80,2020-03-16 14:50:00,1,2841.0,2310.0,0.813,13.749,233,187,139,48,46,25,21,11,0.0,0.0
1012,81,2020-03-16 14:53:00,1,2632.0,2057.0,0.781,12.647,39,39,2,37,0,0,0,0,0.0,0.0
1012,82,2020-03-16 14:56:00,1,2415.0,1888.0,0.782,11.608,28,28,0,28,0,0,0,0,0.0,0.0
1012,83,2020-03-16 14:59:00,1,2347.0,1804.0,0.769,11.245,14,7,3,4,7,2,5,0,0.0,0.0
1012,84,2020-03-16 15:02:00,1,2348.0,1742.0,0.742,11.181,0,0,0,0,0,0,0,0,0.0,0.0
1012,85,2020-03-16 15:05:00,1,2230.0,1582.0,0.71,10.538,9,8,5,3,1,0,1,0,0.0,0.0
1012,86,2020-03-16 15:08:00,1,2131.0,1552.0,0.728,10.115,2,1,0,1,1,0,1,0,0.0,0.0
1012,87,2020-03-16 15:11:00,1,2189.0,1673.0,0.764,10.479,29,26,16,10,3,0,3,0,0.0,0.0
1012,88,2020-03-16 15:14:00,1,2360.0,1783.0,0.755,11.274,13,0,0,0,13,0,13,0,0.0,0.0
1012,89,2020-03-16 15:17:00,1,2363.0,1797.0,0.76,11.298,9,0,0,0,9,0,9,0,0.0,0.0
1012,90,2020-03-16 15:20:00,1,2348.0,1746.0,0.744,11.183,3,0,0,0,3,0,3,0,0.0,0.0
1012,91,2020-03-16 15:23:00,1,2358.0,1765.0,0.748,11.245,0,0,0,0,0,0,0,0,0.0,0.0
1012,92,2020-03-16 15:26:00,1,2345.0,1789.0,0.763,11.222,0,0,0,0,0,0,0,0,0.0,0.0
1012,93,2020-03-16 15:29:00,1,2198.0,1689.0,0.768,10.531,7,0,0,0,7,0,7,0,0.0,0.0
1012,94,2020-03-16 15:32:00,1,2186.0,1689.0,0.773,10.482,2,0,0,0,2,0,2,0,0.0,0.0
1012,95,2020-03-16 15:35:00,1,2219.0,1625.0,0.732,10.542,6,3,1,2,3,0,3,0,0.0,0.0
1012,96,2020-03-16 15:38:00,1,2200.0,1656.0,0.753,10.501,28,12,8,4,16,7,9,0,0.0,0.0
1012,97,2020-03-16 15:41:00,1,2205.0,1665.0,0.755,10.53,2,0,0,0,2,0,2,0,0.0,0.0
1012,98,2020-03-16 15:44:00,1,2208.0,1639.0,0.742,10.512,2,0,0,0,2,0,2,0,0.0,0.0
1012,99,2020-03-16 15:47:00,1,2257.0,1724.0,0.764,10.801,4,1,0,1,3,1,2,0,0.0,0.0
1012,100,2020-03-16 15:50:00,1,2125.0,1567.0,0.737,10.109,4,2,1,1,2,1,1,0,0.0,0.0
1012,101,2020-03-16 15:53:00,1,1904.0,1404.0,0.737,9.056,0,0,0,0,0,0,0,0,0.0,0.0
1012,102,2020-03-16 15:56:00,1,1981.0,1418.0,0.716,9.376,19,5,1,4,14,0,14,0,0.0,0.0
1012,103,2020-03-16 15:59:00,1,1813.0,1397.0,0.77,8.691,35,34,3,31,1,0,1,0,0.0,0.0
1012,104,2020-03-16 16:02:00,1,2202.0,1602.0,0.727,10.449,9,3,2,1,6,0,6,0,0.0,0.0
1012,105,2020-03-16 16:05:00,1,2352.0,1815.0,0.771,11.278,19,15,10,5,4,0,4,0,0.0,0.0
1012,106,2020-03-16 16:08:00,1,2566.0,1946.0,0.759,12.264,130,112,61,51,18,4,14,2,0.0,0.0
1012,107,2020-03-16 16:11:00,1,2856.0,2316.0,0.811,13.819,210,114,77,37,96,57,39,12,0.0,0.0
1012,108,2020-03-16 16:14:00,1,3089.0,2425.0,0.785,14.855,161,102,59,43,59,23,36,16,0.0,0.0
1012,109,2020-03-16 16:17:00,1,2927.0,2371.0,0.81,14.157,390,167,106,61,223,161,62,6,0.0,0.0
1012,110,2020-03-16 16:20:00,1,2940.0,2372.0,0.807,14.209,650,274,208,66,376,271,105,2,0.0,0.0
1012,111,2020-03-16 16:23:00,1,3021.0,2392.0,0.792,14.553,559,256,193,63,303,224,79,28,0.0,0.0
1012,112,2020-03-16 16:26:00,1,3068.0,2453.0,0.799,14.803,123,73,42,31,50,11,39,7,0.0,0.0
1012,113,2020-03-16 16:29:00,1,2834.0,2317.0,0.818,13.731,103,70,31,39,33,12,21,1,0.0,0.0
1012,114,2020-03-16 16:32:00,1,2837.0,2305.0,0.813,13.729,104,66,29,37,38,8,30,3,0.0,0.0
1012,115,2020-03-16 16:35:00,1,2869.0,2243.0,0.782,13.785,30,13,0,13,17,0,17,0,0.0,0.0
1012,116,2020-03-16 16:38:00,1,2875.0,2204.0,0.767,13.768,85,59,29,30,26,6,20,4,0.0,0.0
1012,117,2020-03-16 16:41:00,1,2704.0,2113.0,0.782,12.994,0,0,0,0,0,0,0,0,0.0,0.0
1012,118,2020-03-16 16:44:00,1,2573.0,1987.0,0.772,12.338,1,1,0,1,0,0,0,0,0.0,0.0
1012,119,2020-03-16 16:47:00,1,2324.0,1851.0,0.796,11.207,13,13,0,13,0,0,0,0,0.0,0.0
1012,120,2020-03-16 16:50:00,1,2353.0,1761.0,0.748,11.222,12,12,0,12,0,0,0,0,0.0,0.0
1012,121,2020-03-16 16:53:00,1,2197.0,1680.0,0.765,10.517,2,2,0,2,0,0,0,0,0.0,0.0
1012,122,2020-03-16 16:56:00,1,2216.0,1617.0,0.73,10.522,3,2,0,2,1,0,1,0,0.0,0.0
1012,123,2020-03-16 16:59:00,1,1968.0,1465.0,0.744,9.378,4,2,0,2,2,0,2,0,0.0,0.0
1012,124,2020-03-16 17:02:00,1,1954.0,1533.0,0.785,9.398,16,0,0,0,16,0,16,0,0.0,0.0
1012,125,2020-03-16 17:05:00,1,2218.0,1637.0,0.738,10.55,8,1,0,1,7,0,7,0,0.0,0.0
1012,126,2020-03-16 17:08:00,1,2197.0,1682.0,0.766,10.519,0,0,0,0,0,0,0,0,0.0,0.0
1012,127,2020-03-16 17:11:00,1,2195.0,1636.0,0.745,10.46,3,0,0,0,3,0,3,0,0.0,0.0
1012,128,2020-03-16 17:14:00,1,2192.0,1665.0,0.76,10.482,8,1,0,1,7,0,7,0,0.0,0.0
1012,129,2020-03-16 17:17:00,1,2208.0,1661.0,0.752,10.538,19,10,5,5,9,2,7,0,0.0,0.0
1012,130,2020-03-16 17:20:00,1,2262.0,1723.0,0.762,10.821,0,0,0,0,0,0,0,0,0.0,0.0
1012,131,2020-03-16 17:23:00,1,2221.0,1718.5,0.774,10.6545,5,3,1,2,2,0,2,0,0.0,0.0
1012,132,2020-03-16 17:26:00,1,2180.0,1714.0,0.786,10.488,13,0,0,0,13,0,13,0,0.0,0.0
1012,133,2020-03-16 17:29:00,1,2185.0,1723.0,0.789,10.516,4,4,0,4,0,0,0,0,0.0,0.0
1012,134,2020-03-16 17:32:00,1,2176.0,1721.0,0.791,10.481,15,13,3,10,2,1,1,0,0.0,0.0
1012,135,2020-03-16 17:35:00,1,2281.0,1757.0,0.771,10.931,14,13,7,6,1,0,1,0,0.0,0.0
1012,136,2020-03-16 17:38:00,1,2196.0,1721.0,0.784,10.558,122,114,71,43,8,2,6,1,0.0,0.0
1012,137,2020-03-16 17:41:00,1,2550.0,2017.0,0.791,12.28,201,104,61,43,97,45,52,12,0.0,0.0
1012,138,2020-03-16 17:44:00,1,2637.0,2094.0,0.794,12.707,76,44,22,22,32,12,20,4,0.0,0.0
1012,139,2020-03-16 17:47:00,1,2574.0,1985.0,0.771,12.339,4,3,1,2,1,0,1,0,0.0,0.0
1012,140,2020-03-16 17:50:00,1,2342.0,1819.0,0.777,11.243,2,1,0,1,1,0,1,0,0.0,0.0
1012,141,2020-03-16 17:53:00,1,2188.0,1695.0,0.775,10.497,6,4,0,4,2,0,2,0,0.0,0.0
1012,142,2020-03-16 17:56:00,1,2218.0,1622.0,0.731,10.536,5,2,0,2,3,0,3,0,0.0,0.0
1012,143,2020-03-16 17:59:00,1,2217.0,1637.0,0.739,10.547,0,0,0,0,0,0,0,0,0.0,0.0
1012,144,2020-03-16 18:02:00,0,2208.0,1643.0,0.744,10.519,8,1,0,1,7,0,7,0,0.0,0.0
1012,145,2020-03-16 18:05:00,0,2213.0,1616.0,0.73,10.51,1,1,0,1,0,0,0,0,0.0,0.0
1012,146,2020-03-16 18:08:00,0,2212.0,1611.0,0.729,10.498,4,1,0,1,3,0,3,0,0.0,0.0
1012,147,2020-03-16 18:11:00,0,2128.0,1567.0,0.736,10.121,72,42,11,31,30,4,26,2,0.0,0.0
1012,148,2020-03-16 18:14:00,0,2478.0,1935.0,0.781,11.904,238,97,68,29,141,72,69,28,0.0,0.0
1012,149,2020-03-16 18:17:00,0,2866.0,2257.0,0.788,13.79,430,251,180,71,179,123,56,23,0.0,0.0
1012,150,2020-03-16 18:20:00,0,2882.0,2235.0,0.776,13.829,87,62,23,39,25,2,23,4,0.0,0.0
1012,151,2020-03-16 18:23:00,0,3020.0,2380.0,0.788,14.533,68,53,10,43,15,6,9,2,0.0,0.0
1012,152,2020-03-16 18:26:00,0,3083.0,2444.0,0.793,14.855,169,111,68,43,58,21,37,15,0.0,0.0
1012,153,2020-03-16 18:29:00,0,2995.0,2398.0,0.801,14.455,84,53,29,24,31,1,30,4,0.0,0.0
1012,154,2020-03-16 18:32:00,0,3086.0,2485.0,0.805,14.911,100,76,34,42,24,5,19,3,0.0,0.0
1012,155,2020-03-16 18:35:00,0,3146.0,2519.0,0.801,15.184,237,136,91,45,101,54,47,18,0.0,0.0
1012,156,2020-03-16 18:38:00,0,3096.0,2405.0,0.777,14.862,10,8,6,2,2,0,2,0,0.0,0.0
1012,157,2020-03-16 18:41:00,0,2857.0,2266.0,0.793,13.765,5,5,0,5,0,0,0,0,0.0,0.0
1012,158,2020-03-16 18:44:00,0,2724.0,2110.0,0.775,13.069,9,9,2,7,0,0,0,0,0.0,0.0
1012,159,2020-03-16 18:47:00,0,2560.0,2018.0,0.788,12.322,41,12,5,7,29,2,27,3,0.0,0.0
1012,160,2020-03-16 18:50:00,0,2894.0,2224.0,0.768,13.865,194,126,80,46,68,9,59,38,0.0,0.0
1012,161,2020-03-16 18:53:00,0,2928.0,2350.0,0.803,14.139,569,261,218,43,308,222,86,54,0.0,0.0
1012,162,2020-03-16 18:56:00,0,3105.0,2397.0,0.772,14.89,70,52,17,35,18,2,16,5,0.0,0.0
1012,163,2020-03-16 18:59:00,0,2935.0,2325.0,0.792,14.138,197,129,73,56,68,26,42,26,0.0,0.0
1012,164,2020-03-16 19:02:00,0,3095.0,2392.0,0.773,14.844,411,213,154,59,198,119,79,59,0.0,0.0
1012,165,2020-03-16 19:05:00,0,2734.0,2045.0,0.748,13.036,56,29,9,20,27,11,16,8,0.0,0.0
1012,166,2020-03-16 19:08:00,0,3020.0,2332.0,0.772,14.479,59,39,11,28,20,8,12,9,0.0,0.0
1012,167,2020-03-16 19:11:00,0,3229.0,2578.0,0.798,15.578,42,24,8,16,18,3,15,3,0.0,0.0
1012,168,2020-03-16 19:14:00,0,2930.0,2330.0,0.795,14.123,3,0,0,0,3,0,3,0,0.0,0.0
1012,169,2020-03-16 19:17:00,0,2881.0,2202.0,0.764,13.79,22,12,4,8,10,2,8,0,0.0,0.0
1012,170,2020-03-16 19:20:00,0,2783.0,2159.0,0.776,13.357,9,9,0,9,0,0,0,0,0.0,0.0
1012,171,2020-03-16 19:23:00,0,2632.0,2050.0,0.779,12.641,0,0,0,0,0,0,0,0,0.0,0.0
1012,172,2020-03-16 19:26:00,0,2563.0,1997.0,0.779,12.31,6,1,1,0,5,1,4,0,0.0,0.0
1012,173,2020-03-16 19:29:00,0,2582.0,1919.0,0.743,12.298,17,7,6,1,10,0,10,0,0.0,0.0
1012,174,2020-03-16 19:32:00,0,2564.0,1972.0,0.769,12.286,135,76,50,26,59,26,33,25,0.0,0.0
1012,175,2020-03-16 19:35:00,0,2866.0,2230.0,0.778,13.763,533,215,156,59,318,237,81,62,0.0,0.0
1012,176,2020-03-16 19:38:00,0,2873.0,2244.0,0.781,13.805,291,80,51,29,211,149,62,45,0.0,0.0
1012,177,2020-03-16 19:41:00,0,3156.0,2497.0,0.791,15.2,243,117,77,40,126,69,57,46,0.0,0.0
1012,178,2020-03-16 19:44:00,0,2721.0,2049.0,0.753,12.992,35,22,4,18,13,1,12,7,0.0,0.0
1012,179,2020-03-16 19:47:00,0,3095.0,2363.0,0.763,14.813,274,117,68,49,157,106,51,48,0.0,0.0
1012,180,2020-03-16 19:50:00,0,3085.0,2423.0,0.785,14.838,238,104,80,24,134,95,39,26,0.0,0.0
1012,181,2020-03-16 19:53:00,0,2880.0,2199.0,0.764,13.783,4,0,0,0,4,0,4,0,0.0,0.0
1012,182,2020-03-16 19:56:00,0,2720.0,2098.0,0.771,13.041,8,6,2,4,2,0,2,0,0.0,0.0
1012,183,2020-03-16 19:59:00,0,2720.0,2067.0,0.76,13.004,11,11,0,11,0,0,0,0,0.0,0.0
1012,184,2020-03-16 20:02:00,0,2714.0,2065.0,0.761,12.98,66,46,15,31,20,10,10,13,0.0,0.0
1012,185,2020-03-16 20:05:00,0,2883.0,2215.0,0.768,13.812,324,164,115,49,160,75,85,66,0.0,0.0
1012,186,2020-03-16 20:08:00,0,2712.0,2130.0,0.786,13.044,377,167,124,43,210,131,79,55,0.0,0.0
1012,187,2020-03-16 20:11:00,0,3027.0,2317.0,0.765,14.491,401,132,87,45,269,181,88,26,0.0,0.0
1012,188,2020-03-16 20:14:00,0,3088.0,2414.0,0.782,14.838,471,193,149,44,278,207,71,53,0.0,0.0
1012,189,2020-03-16 20:17:00,0,3560.0,2711.0,0.761,17.028,518,212,163,49,306,219,87,47,0.0,0.0
1012,190,2020-03-16 20:20:00,0,3067.0,2440.0,0.795,14.786,247,115,71,44,132,32,100,74,0.0,0.0
1012,191,2020-03-16 20:23:00,0,3083.5,2396.5,0.777,14.8035,233,155,108,47,78,31,47,39,0.0,0.0
1012,192,2020-03-16 20:26:00,0,3100.0,2353.0,0.759,14.821,404,152,98,54,252,162,90,40,0.0,0.0
1012,193,2020-03-16 20:29:00,0,2886.0,2189.0,0.759,13.796,80,25,6,19,55,6,49,6,0.0,0.0
1012,194,2020-03-16 20:32:00,0,3109.0,2346.0,0.755,14.845,89,47,8,39,42,6,36,7,0.0,0.0
1012,195,2020-03-16 20:35:00,0,3098.0,2373.0,0.766,14.836,214,83,49,34,131,70,61,28,0.0,0.0
1012,196,2020-03-16 20:38:00,0,3094.0,2351.0,0.76,14.793,308,95,66,29,213,141,72,27,0.0,0.0
1012,197,2020-03-16 20:41:00,0,2721.0,2022.0,0.743,12.961,5,1,0,1,4,0,4,0,0.0,0.0
1012,198,2020-03-16 20:44:00,0,2577.0,1953.0,0.758,12.316,18,11,9,2,7,0,7,0,0.0,0.0
1012,199,2020-03-16 20:47:00,0,2581.0,1920.0,0.744,12.295,61,50,16,34,11,1,10,9,0.0,0.0
1012,200,2020-03-16 20:50:00,0,2922.0,2298.0,0.786,14.059,224,151,101,50,73,17,56,46,0.0,0.0
1012,201,2020-03-16 20:53:00,0,2889.0,2210.0,0.765,13.83,182,101,66,35,81,21,60,56,0.0,0.0
1012,202,2020-03-16 20:56:00,0,3472.0,2663.0,0.767,16.628,277,169,116,53,108,34,74,69,0.0,0.0
1012,203,2020-03-16 20:59:00,0,3082.0,2389.0,0.775,14.789,160,94,61,33,66,15,51,62,0.0,0.0
1012,204,2020-03-16 21:02:00,0,3251.0,2536.0,0.78,15.618,241,98,65,33,143,58,85,67,0.0,0.0
1012,205,2020-03-16 21:05:00,0,2408.0,1873.0,0.778,11.56,219,85,52,33,134,75,59,24,0.0,0.0
1012,206,2020-03-16 21:08:00,0,3642.0,2742.0,0.753,17.386,159,77,41,36,82,23,59,53,0.0,0.0
1012,207,2020-03-16 21:11:00,0,2334.0,1844.0,0.79,11.239,13,8,4,4,5,1,4,0,0.0,0.0
1012,208,2020-03-16 21:14:00,0,2576.0,1928.0,0.748,12.286,110,68,32,36,42,2,40,9,0.0,0.0
1012,209,2020-03-16 21:17:00,0,3146.0,2503.0,0.796,15.166,400,192,142,50,208,147,61,41,0.0,0.0
1012,210,2020-03-16 21:20:00,0,2918.0,2335.0,0.8,14.084,326,154,121,33,172,114,58,47,0.0,0.0
1012,211,2020-03-16 21:23:00,0,3477.0,2671.0,0.768,16.655,326,109,72,37,217,121,96,78,0.0,0.0
1012,212,2020-03-16 21:26:00,0,3842.0,3022.0,0.787,18.483,219,88,57,31,131,52,79,58,0.0,0.0
1012,213,2020-03-16 21:29:00,0,2571.0,1957.0,0.761,12.297,250,113,79,34,137,93,44,26,0.0,0.0
1012,214,2020-03-16 21:32:00,0,3452.0,2715.0,0.787,16.606,172,119,73,46,53,15,38,27,0.0,0.0
1012,215,2020-03-16 21:35:00,0,2590.0,1970.0,0.761,12.384,126,71,38,33,55,16,39,0,0.0,0.0
1012,216,2020-03-16 21:38:00,0,2854.0,2305.0,0.807,13.797,245,102,63,39,143,96,47,15,0.0,0.0
1012,217,2020-03-16 21:41:00,0,2650.0,2040.0,0.77,12.7,45,24,11,13,21,5,16,0,0.0,0.0
1012,218,2020-03-16 21:44:00,0,2730.0,2049.0,0.751,13.027,8,1,1,0,7,6,1,0,0.0,0.0
1012,219,2020-03-16 21:47:00,0,2863.0,2249.0,0.786,13.771,130,67,41,26,63,44,19,5,0.0,0.0
1012,220,2020-03-16 21:50:00,0,2571.0,1973.0,0.767,12.315,7,2,0,2,5,4,1,0,0.0,0.0
1012,221,2020-03-16 21:53:00,0,2576.0,1947.0,0.756,12.305,4,1,0,1,3,0,3,0,0.0,0.0
1012,222,2020-03-16 21:56:00,0,2564.0,1949.0,0.76,12.261,33,13,3,10,20,5,15,0,0.0,0.0
1012,223,2020-03-16 21:59:00,0,2491.0,1950.0,0.783,11.972,24,5,0,5,19,14,5,0,0.0,0.0
1012,224,2020-03-16 22:02:00,0,2478.0,1948.0,0.786,11.92,42,14,5,9,28,13,15,7,0.0,0.0
1012,225,2020-03-16 22:05:00,0,2693.0,2192.0,0.814,13.039,254,132,89,43,122,37,85,60,0.0,0.0
1012,226,2020-03-16 22:08:00,0,2843.0,2342.0,0.824,13.796,306,135,89,46,171,92,79,79,0.0,0.0
1012,227,2020-03-16 22:11:00,0,2782.0,2177.0,0.783,13.37,191,100,62,38,91,41,50,40,0.0,0.0
1012,228,2020-03-16 22:14:00,0,3081.0,2400.0,0.779,14.797,107,54,11,43,53,10,43,37,0.0,0.0
1012,229,2020-03-16 22:17:00,0,3090.0,2434.0,0.788,14.87,252,121,78,43,131,86,45,21,0.0,0.0
1012,230,2020-03-16 22:20:00,0,3082.0,2443.0,0.792,14.848,131,67,38,29,64,16,48,27,0.0,0.0
1012,231,2020-03-16 22:23:00,0,3090.0,2384.0,0.771,14.816,375,134,91,43,241,160,81,29,0.0,0.0
1012,232,2020-03-16 22:26:00,0,3084.0,2412.0,0.782,14.82,297,135,96,39,162,113,49,49,0.0,0.0
1012,233,2020-03-16 22:29:00,0,3108.0,2427.0,0.781,14.933,420,233,195,38,187,133,54,123,0.0,0.0
1012,234,2020-03-16 22:32:00,0,3240.0,2541.0,0.784,15.578,407,207,174,33,200,135,65,102,0.0,0.0
1012,235,2020-03-16 22:35:00,0,3505.0,2651.0,0.756,16.743,579,277,227,50,302,233,69,73,0.0,0.0
1012,236,2020-03-16 22:38:00,0,3239.0,2511.0,0.775,15.543,25,24,5,19,1,0,1,6,0.0,0.0
1012,237,2020-03-16 22:41:00,0,3018.0,2303.0,0.763,14.439,1,0,0,0,1,0,1,0,0.0,0.0
1012,238,2020-03-16 22:44:00,0,2792.0,2129.0,0.763,13.358,4,2,0,2,2,0,2,0,0.0,0.0
1012,239,2020-03-16 22:47:00,0,2570.0,1979.0,0.77,12.317,81,38,27,11,43,22,21,4,0.0,0.0
1012,240,2020-03-16 22:50:00,0,2564.0,1971.0,0.769,12.284,216,107,73,34,109,60,49,81,0.0,0.0
1012,241,2020-03-16 22:53:00,0,2573.0,2027.0,0.788,12.382,229,112,66,46,117,42,75,66,0.0,0.0
1012,242,2020-03-16 22:56:00,0,2812.0,2138.0,0.76,13.448,295,130,102,28,165,118,47,59,0.0,0.0
1012,243,2020-03-16 22:59:00,0,2725.0,2060.0,0.756,13.017,86,37,23,14,49,15,34,30,0.0,0.0
1012,244,2020-03-16 23:02:00,0,2887.0,2192.0,0.759,13.801,126,75,52,23,51,15,36,47,0.0,0.0
1012,245,2020-03-16 23:05:00,0,2707.0,2119.0,0.783,13.012,239,108,57,51,131,84,47,35,0.0,0.0
1012,246,2020-03-16 23:08:00,0,2876.0,2212.0,0.769,13.78,250,86,59,27,164,115,49,38,0.0,0.0
1012,247,2020-03-16 23:11:00,0,2895.0,2179.0,0.752,13.82,307,114,72,42,193,143,50,27,0.19,0.0
1012,248,2020-03-16 23:14:00,0,2868.0,2219.0,0.774,13.757,228,98,53,45,130,76,54,54,0.0,0.0
1012,249,2020-03-16 23:17:00,0,2716.0,2108.0,0.776,13.035,123,66,35,31,57,16,41,20,0.0,0.0
1012,250,2020-03-16 23:20:00,0,2660.0,2011.0,0.756,12.709,100,53,20,33,47,6,41,13,0.0,0.0
1012,251,2020-03-16 23:23:00,0,2770.5,2087.0,0.7535,13.228,104,59,18,41,45,10,35,25,0.0,0.0
1012,252,2020-03-16 23:26:00,0,2881.0,2163.0,0.751,13.747,269,152,95,57,117,54,63,42,0.0,0.0
1012,253,2020-03-16 23:29:00,0,2570.0,1964.0,0.764,12.3,297,162,117,45,135,96,39,22,0.0,0.0
1012,254,2020-03-16 23:32:00,0,2886.0,2181.0,0.756,13.785,255,121,75,46,134,87,47,47,0.0,0.0
1012,255,2020-03-16 23:35:00,0,2649.0,2044.0,0.772,12.699,5,0,0,0,5,0,5,0,0.0,0.0
1012,256,2020-03-16 23:38:00,0,2494.0,1902.0,0.763,11.932,4,1,1,0,3,0,3,0,0.0,0.0
1012,257,2020-03-16 23:41:00,0,2344.0,1795.0,0.766,11.222,67,27,5,22,40,8,32,4,0.0,0.0
1012,258,2020-03-16 23:44:00,0,2593.0,1940.0,0.748,12.367,341,172,107,65,169,103,66,50,0.0,0.0
1012,259,2020-03-16 23:47:00,0,2568.0,1947.0,0.759,12.272,200,90,58,32,110,63,47,57,0.0,0.0
1012,260,2020-03-16 23:50:00,0,2551.0,2013.0,0.789,12.278,134,72,44,28,62,22,40,28,0.0,0.0
1012,261,2020-03-16 23:53:00,0,2592.0,1965.0,0.758,12.39,26,25,2,23,1,0,1,0,0.0,0.0
1012,262,2020-03-16 23:56:00,0,2341.0,1783.0,0.762,11.197,6,5,0,5,1,0,1,0,0.0,0.0
1012,263,2020-03-16 23:59:00,0,2195.0,1669.0,0.76,10.495,21,8,2,6,13,0,13,0,0.0,0.0
1012,264,2020-03-17 00:02:00,0,2138.0,1580.0,0.739,10.175,3,0,0,0,3,0,3,0,0.0,0.0
1012,265,2020-03-17 00:05:00,0,2134.0,1572.0,0.737,10.148,41,26,17,9,15,7,8,2,0.0,0.0
1012,266,2020-03-17 00:08:00,0,2047.0,1546.0,0.755,9.779,1,0,0,0,1,0,1,0,0.0,0.0
1012,267,2020-03-17 00:11:00,0,1963.0,1522.0,0.775,9.42,1,1,0,1,0,0,0,0,0.0,0.0
1012,268,2020-03-17 00:14:00,0,2207.0,1607.0,0.728,10.473,208,98,63,35,110,57,53,41,0.0,0.0
1012,269,2020-03-17 00:17:00,0,2334.0,1855.0,0.795,11.249,244,97,58,39,147,80,67,67,0.0,0.0
1012,270,2020-03-17 00:20:00,0,2587.0,1912.0,0.739,12.312,252,119,66,53,133,91,42,29,0.0,0.0
1012,271,2020-03-17 00:23:00,0,2892.0,2172.0,0.751,13.799,346,145,86,59,201,130,71,21,0.0,0.0
1012,272,2020-03-17 00:26:00,0,3027.0,2336.0,0.772,14.511,409,213,159,54,196,137,59,46,0.0,0.0
1012,273,2020-03-17 00:29:00,0,2853.0,2255.0,0.79,13.738,268,115,82,33,153,83,70,59,0.0,0.0
1012,274,2020-03-17 00:32:00,0,2950.0,2292.0,0.777,14.162,163,75,55,20,88,40,48,46,0.0,0.0
1012,275,2020-03-17 00:35:00,0,3017.0,2312.0,0.766,14.446,392,179,133,46,213,153,60,37,0.0,0.0
1012,276,2020-03-17 00:38:00,0,3100.0,2405.0,0.776,14.876,287,106,70,36,181,109,72,54,0.0,0.0
1012,277,2020-03-17 00:41:00,0,2940.0,2288.0,0.778,14.118,427,173,120,53,254,191,63,37,0.0,0.0
1012,278,2020-03-17 00:44:00,0,3112.0,2306.0,0.741,14.816,288,98,60,38,190,134,56,9,0.0,0.0
1012,279,2020-03-17 00:47:00,0,2861.0,2251.0,0.787,13.767,174,97,55,42,77,35,42,15,0.0,0.0
1012,280,2020-03-17 00:50:00,0,2956.0,2272.0,0.769,14.162,206,133,77,56,73,15,58,115,0.0,0.0
1012,281,2020-03-17 00:53:00,0,2722.0,2107.0,0.774,13.057,350,153,94,59,197,111,86,112,0.0,0.0
1012,282,2020-03-17 00:56:00,0,2854.0,2255.0,0.79,13.74,265,107,74,33,158,102,56,57,0.32,0.0
1012,283,2020-03-17 00:59:00,0,2896.0,2149.0,0.742,13.79,284,95,64,31,189,142,47,45,0.0,0.0
1012,284,2020-03-17 01:02:00,0,2203.0,1642.0,0.745,10.496,204,85,55,30,119,89,30,10,0.0,0.0
1012,285,2020-03-17 01:05:00,0,2593.0,1865.0,0.719,12.283,385,179,128,51,206,149,57,17,0.0,0.0
1012,286,2020-03-17 01:08:00,0,3020.0,2302.0,0.762,14.449,340,142,99,43,198,149,49,44,0.0,0.0
1012,287,2020-03-17 01:11:00,0,2421.0,1879.0,0.776,11.621,404,151,103,48,253,178,75,40,0.0,0.0
1012,288,2020-03-17 01:14:00,0,2563.0,1964.0,0.766,12.272,249,152,99,53,97,54,43,26,0.0,0.0
1012,289,2020-03-17 01:17:00,0,2591.0,1897.0,0.732,12.31,822,339,268,71,483,381,102,12,0.0,0.0
1012,290,2020-03-17 01:20:00,0,3134.0,2335.0,0.745,14.935,538,247,202,45,291,228,63,35,0.0,0.0
1012,291,2020-03-17 01:23:00,0,3119.0,2373.0,0.761,14.917,322,167,106,61,155,68,87,113,0.0,0.0
1012,292,2020-03-17 01:26:00,0,3238.0,2543.0,0.786,15.574,321,122,68,54,199,121,78,103,0.0,0.0
1012,293,2020-03-17 01:29:00,0,3415.0,2579.0,0.755,16.311,275,119,77,42,156,98,58,73,0.0,0.0
1012,294,2020-03-17 01:32:00,0,3258.0,2445.0,0.751,15.542,327,112,69,43,215,139,76,65,0.0,0.0
1012,295,2020-03-17 01:35:00,0,3269.0,2479.0,0.758,15.624,193,91,42,49,102,55,47,54,0.0,0.0
1012,296,2020-03-17 01:38:00,0,3483.0,2620.0,0.752,16.625,186,76,43,33,110,43,67,71,0.0,0.0
1012,297,2020-03-17 01:41:00,0,2863.0,2239.0,0.782,13.761,332,155,111,44,177,114,63,79,0.0,0.0
1012,298,2020-03-17 01:44:00,0,2580.0,1957.0,0.759,12.334,96,53,26,27,43,12,31,36,0.0,0.0
1012,299,2020-03-17 01:47:00,0,2641.0,2006.0,0.76,12.629,237,137,98,39,100,55,45,33,0.0,0.0
1012,300,2020-03-17 01:50:00,0,2879.0,2194.0,0.762,13.773,372,140,94,46,232,162,70,54,0.0,0.0
1012,301,2020-03-17 01:53:00,0,3497.0,2664.0,0.762,16.729,124,90,33,57,34,15,19,79,0.0,0.0
1012,302,2020-03-17 01:56:00,0,3463.0,2696.0,0.779,16.631,139,73,26,47,66,28,38,59,0.0,0.0
1012,303,2020-03-17 01:59:00,0,2645.0,2055.0,0.777,12.697,174,83,57,26,91,52,39,33,0.0,0.0
1012,304,2020-03-17 02:02:00,0,2401.0,1869.0,0.779,11.529,349,169,116,53,180,109,71,50,0.0,0.0
1012,305,2020-03-17 02:05:00,0,2867.0,2197.0,0.766,13.729,93,62,28,34,31,10,21,12,0.16,0.0
1012,306,2020-03-17 02:08:00,0,2359.0,1754.0,0.744,11.237,126,98,56,42,28,8,20,12,0.0,0.0
1012,307,2020-03-17 02:11:00,0,2356.0,1814.0,0.77,11.292,112,90,44,46,22,2,20,0,0.0,0.0
1012,308,2020-03-17 02:14:00,0,2331.0,1795.0,0.77,11.171,1,1,0,1,0,0,0,0,0.0,0.0
1012,309,2020-03-17 02:17:00,0,2276.0,1712.0,0.752,10.864,2,2,0,2,0,0,0,0,0.0,0.0
1012,310,2020-03-17 02:20:00,0,2202.0,1637.0,0.743,10.487,4,2,0,2,2,0,2,0,0.0,0.0
1012,311,2020-03-17 02:23:00,0,2265.0,1752.5,0.7725,10.865,8,5,0,5,3,0,3,0,0.0,0.0
1012,312,2020-03-17 02:26:00,0,2328.0,1868.0,0.802,11.243,39,21,12,9,18,2,16,2,0.0,0.0
1012,313,2020-03-17 02:29:00,0,2184.0,1728.0,0.791,10.518,1,0,0,0,1,0,1,0,0.0,0.0
1012,314,2020-03-17 02:32:00,0,2181.0,1706.0,0.782,10.481,1,0,0,0,1,0,1,0,0.0,0.0
1012,315,2020-03-17 02:35:00,0,2326.0,1844.0,0.793,11.209,26,12,4,8,14,4,10,0,0.0,0.0
1012,316,2020-03-17 02:38:00,0,2562.0,2015.0,0.787,12.327,6,4,1,3,2,0,2,0,0.0,0.0
1012,317,2020-03-17 02:41:00,0,2567.0,1988.0,0.774,12.315,21,7,1,6,14,0,14,0,0.0,0.0
1012,318,2020-03-17 02:44:00,0,2642.0,2062.0,0.78,12.692,2,0,0,0,2,0,2,0,0.0,0.0
1012,319,2020-03-17 02:47:00,0,2400.0,1897.0,0.79,11.555,14,6,1,5,8,0,8,0,0.0,0.0
1012,320,2020-03-17 02:50:00,0,2326.0,1878.0,0.807,11.244,86,43,21,22,43,10,33,15,0.0,0.0
1012,321,2020-03-17 02:53:00,0,2845.0,2285.0,0.803,13.739,333,132,91,41,201,125,76,76,0.0,0.0
1012,322,2020-03-17 02:56:00,0,3089.0,2391.0,0.774,14.82,246,127,82,45,119,62,57,97,0.0,0.0
1012,323,2020-03-17 02:59:00,0,3451.0,2663.0,0.772,16.547,137,76,31,45,61,26,35,82,0.0,0.01
1012,324,2020-03-17 03:02:00,0,3630.0,2776.0,0.765,17.375,143,41,10,31,102,44,58,52,0.0,0.02
1012,325,2020-03-17 03:05:00,0,3453.0,2720.0,0.788,16.617,190,56,23,33,134,68,66,50,0.0,0.03
1012,326,2020-03-17 03:08:00,0,3089.0,2435.0,0.788,14.867,313,171,134,37,142,96,46,62,0.13,0.07
1012,327,2020-03-17 03:11:00,0,3452.0,2760.0,0.799,16.655,257,104,55,49,153,86,67,79,0.0,0.0
1012,328,2020-03-17 03:14:00,0,3673.0,2972.0,0.809,17.761,152,94,46,48,58,15,43,74,0.0,0.0
1012,329,2020-03-17 03:17:00,0,2856.0,2284.0,0.8,13.782,330,131,87,44,199,135,64,92,0.0,0.0
1012,330,2020-03-17 03:20:00,0,3056.0,2531.0,0.828,14.842,351,202,149,53,149,89,60,87,0.0,0.0
1012,331,2020-03-17 03:23:00,0,3135.0,2623.0,0.837,15.255,565,207,162,45,358,282,76,47,0.05,0.0
1012,332,2020-03-17 03:26:00,0,2846.0,2350.0,0.826,13.813,149,104,64,40,45,20,25,22,0.0,0.0
1012,333,2020-03-17 03:29:00,0,2320.0,1867.0,0.805,11.207,81,60,20,40,21,4,17,7,0.0,0.0
1012,334,2020-03-17 03:32:00,0,2315.0,1907.0,0.824,11.233,90,52,21,31,38,12,26,10,0.0,0.0
1012,335,2020-03-17 03:35:00,0,2617.0,2164.0,0.827,12.705,143,86,53,33,57,21,36,63,0.0,0.03
1012,336,2020-03-17 03:38:00,0,3733.0,3083.0,0.826,18.123,187,126,68,58,61,20,41,90,0.0,0.0
1012,337,2020-03-17 03:41:00,0,2461.0,2018.0,0.82,11.929,227,128,78,50,99,51,48,23,0.0,0.0
1012,338,2020-03-17 03:44:00,0,2832.0,2337.0,0.825,13.745,318,140,100,40,178,119,59,21,0.0,0.0
1012,339,2020-03-17 03:47:00,0,2315.0,1925.0,0.831,11.251,553,257,182,75,296,207,89,33,0.0,0.0
1012,340,2020-03-17 03:50:00,0,2554.0,2035.0,0.797,12.317,281,90,57,33,191,116,75,14,0.0,0.0
1012,341,2020-03-17 03:53:00,0,2696.0,2126.0,0.789,12.975,134,88,56,32,46,9,37,41,0.0,0.0
1012,342,2020-03-17 03:56:00,0,2995.0,2425.0,0.81,14.485,60,41,2,39,19,2,17,3,0.0,0.0
1012,343,2020-03-17 03:59:00,0,3057.0,2552.0,0.835,14.871,44,14,0,14,30,2,28,1,0.0,0.0
1012,344,2020-03-17 04:02:00,0,2860.0,2265.0,0.792,13.775,2,1,0,1,1,0,1,0,0.0,0.0
1012,345,2020-03-17 04:05:00,0,2709.0,2170.0,0.801,13.079,0,0,0,0,0,0,0,0,0.0,0.0
1012,346,2020-03-17 04:08:00,0,2700.0,2146.0,0.795,13.013,17,5,0,5,12,0,12,0,0.0,0.0
1012,347,2020-03-17 04:11:00,0,2550.0,2076.0,0.814,12.347,13,4,2,2,9,0,9,0,0.0,0.0
1012,348,2020-03-17 04:14:00,0,2545.0,2043.0,0.803,12.291,10,6,3,3,4,2,2,0,0.0,0.0
1012,349,2020-03-17 04:17:00,0,2320.0,1926.0,0.83,11.273,2,2,0,2,0,0,0,0,0.0,0.0
1012,350,2020-03-17 04:20:00,0,2333.0,1882.0,0.807,11.277,0,0,0,0,0,0,0,0,0.0,0.0
1012,351,2020-03-17 04:23:00,0,2174.0,1761.0,0.81,10.515,5,5,2,3,0,0,0,0,0.0,0.0
1012,352,2020-03-17 04:26:00,0,2189.0,1741.0,0.795,10.552,12,11,0,11,1,0,1,0,0.0,0.0
1012,353,2020-03-17 04:29:00,0,2193.0,1691.0,0.771,10.512,28,28,4,24,0,0,0,0,0.0,0.0
1012,354,2020-03-17 04:32:00,0,2098.0,1646.0,0.784,10.09,31,28,13,15,3,0,3,0,0.0,0.0
1012,355,2020-03-17 04:35:00,0,1945.0,1585.0,0.815,9.417,21,21,6,15,0,0,0,0,0.0,0.0
1012,356,2020-03-17 04:38:00,0,1942.0,1586.0,0.817,9.408,28,18,6,12,10,0,10,0,0.0,0.0
1012,357,2020-03-17 04:41:00,0,1950.0,1589.0,0.815,9.441,10,10,2,8,0,0,0,0,0.0,0.0
1012,358,2020-03-17 04:44:00,0,2193.0,1690.0,0.771,10.51,163,87,48,39,76,30,46,31,0.0,0.04
1012,359,2020-03-17 04:47:00,0,2538.0,2017.0,0.795,12.233,150,96,48,48,54,21,33,76,0.0,0.0
1012,360,2020-03-17 04:50:00,0,2538.0,2076.0,0.818,12.299,170,95,57,38,75,50,25,34,0.0,0.0
1012,361,2020-03-17 04:53:00,0,2404.0,1916.0,0.797,11.592,97,86,41,45,11,4,7,3,0.0,0.0
1012,362,2020-03-17 04:56:00,0,3083.0,2500.0,0.811,14.915,402,179,131,48,223,165,58,78,0.0,0.0
1012,363,2020-03-17 04:59:00,0,2845.0,2325.0,0.817,13.783,20,10,4,6,10,5,5,0,0.0,0.0
1012,364,2020-03-17 05:02:00,0,2862.0,2233.0,0.78,13.747,4,3,2,1,1,1,0,0,0.0,0.0
1012,365,2020-03-17 05:05:00,0,2710.0,2118.0,0.782,13.023,1,1,0,1,0,0,0,0,0.0,0.0
1012,366,2020-03-17 05:08:00,0,2564.0,2027.0,0.79,12.347,152,78,38,40,74,33,41,22,0.0,0.0
1012,367,2020-03-17 05:11:00,0,2868.0,2249.0,0.784,13.791,177,65,24,41,112,55,57,78,0.0,0.0
1012,368,2020-03-17 05:14:00,0,2916.0,2361.0,0.81,14.105,233,100,58,42,133,78,55,62,0.0,0.0
1012,369,2020-03-17 05:17:00,0,1938.0,1583.0,0.817,9.39,112,79,25,54,33,8,25,7,0.0,0.0
1012,370,2020-03-17 05:20:00,0,2695.0,2154.0,0.799,13.005,271,120,76,44,151,115,36,14,0.0,0.0
1012,371,2020-03-17 05:23:00,0,2692.5,2164.0,0.8035,13.0055,299,129,82,47,170,113,57,6,0.0,0.0
1012,372,2020-03-17 05:26:00,0,2690.0,2174.0,0.808,13.006,510,173,119,54,337,260,77,35,0.0,0.0
1012,373,2020-03-17 05:29:00,0,2338.0,1781.0,0.762,11.184,463,146,98,48,317,241,76,20,0.0,0.0
1012,374,2020-03-17 05:32:00,0,2712.0,2098.0,0.774,13.007,465,229,180,49,236,165,71,46,0.0,0.0
1012,375,2020-03-17 05:35:00,0,2870.0,2286.0,0.797,13.838,388,210,158,52,178,117,61,75,0.0,0.0
1012,376,2020-03-17 05:38:00,0,2334.0,1796.0,0.77,11.183,226,98,55,43,128,90,38,0,0.0,0.0
1012,377,2020-03-17 05:41:00,0,2868.0,2213.0,0.772,13.749,570,239,177,62,331,244,87,35,0.0,0.0
1012,378,2020-03-17 05:44:00,0,2564.0,2027.0,0.791,12.345,240,115,70,45,125,77,48,37,0.0,0.0
1012,379,2020-03-17 05:47:00,0,2942.0,2350.0,0.799,14.193,353,168,118,50,185,133,52,31,0.0,0.0
1012,380,2020-03-17 05:50:00,0,2862.0,2247.0,0.785,13.765,62,57,10,47,5,2,3,5,0.0,0.0
1012,381,2020-03-17 05:53:00,0,2880.0,2207.0,0.766,13.789,19,8,1,7,11,0,11,0,0.0,0.0
1012,382,2020-03-17 05:56:00,0,2640.0,2059.0,0.78,12.682,6,0,0,0,6,0,6,0,0.0,0.0
1012,383,2020-03-17 05:59:00,0,2505.0,1909.0,0.762,11.985,6,4,1,3,2,0,2,0,0.0,0.0
1012,384,2020-03-17 06:02:00,1,2345.0,1786.0,0.762,11.219,152,77,52,25,75,35,40,26,0.0,0.0
1012,385,2020-03-17 06:05:00,1,2566.0,2004.0,0.781,12.33,118,73,44,29,45,20,25,18,0.0,0.0
1012,386,2020-03-17 06:08:00,1,2491.0,1961.0,0.787,11.988,216,109,67,42,107,75,32,54,0.0,0.0
1012,387,2020-03-17 06:11:00,1,2702.0,2150.0,0.796,13.025,181,88,52,36,93,57,36,14,0.0,0.0
1012,388,2020-03-17 06:14:00,1,2727.0,2111.0,0.774,13.08,268,123,73,50,145,91,54,13,0.0,0.0
1012,389,2020-03-17 06:17:00,1,2718.0,2096.0,0.771,13.03,364,160,107,53,204,139,65,16,0.0,0.0
1012,390,2020-03-17 06:20:00,1,2717.0,2040.0,0.751,12.965,168,106,62,44,62,27,35,5,0.0,0.0
1012,391,2020-03-17 06:23:00,1,2653.0,2022.0,0.762,12.693,56,40,11,29,16,6,10,1,0.0,0.0
1012,392,2020-03-17 06:26:00,1,2571.0,1993.0,0.775,12.337,95,62,32,30,33,2,31,1,0.0,0.0
1012,393,2020-03-17 06:29:00,1,2579.0,1961.0,0.761,12.331,18,13,1,12,5,0,5,0,0.0,0.0
1012,394,2020-03-17 06:32:00,1,2328.0,1832.0,0.787,11.201,16,16,3,13,0,0,0,0,0.0,0.0
1012,395,2020-03-17 06:35:00,1,2275.0,1735.0,0.763,10.886,0,0,0,0,0,0,0,0,0.0,0.0
1012,396,2020-03-17 06:38:00,1,2206.0,1592.0,0.722,10.455,4,4,1,3,0,0,0,0,0.0,0.0
1012,397,2020-03-17 06:41:00,1,1966.0,1511.0,0.768,9.419,29,25,2,23,4,2,2,0,0.0,0.0
1012,398,2020-03-17 06:44:00,1,1982.0,1504.0,0.759,9.474,9,8,4,4,1,0,1,0,0.0,0.0
1012,399,2020-03-17 06:47:00,1,1961.0,1516.0,0.773,9.406,8,6,1,5,2,0,2,0,0.0,0.0
1012,400,2020-03-17 06:50:00,1,1960.0,1471.0,0.751,9.35,0,0,0,0,0,0,0,0,0.0,0.0
1012,401,2020-03-17 06:53:00,1,1975.0,1460.0,0.739,9.399,0,0,0,0,0,0,0,0,0.0,0.0
1012,402,2020-03-17 06:56:00,1,1897.0,1446.0,0.762,9.074,18,18,4,14,0,0,0,0,0.0,0.0
1012,403,2020-03-17 06:59:00,1,1975.0,1464.0,0.741,9.404,13,13,0,13,0,0,0,0,0.0,0.0
1012,404,2020-03-17 07:02:00,1,1891.0,1453.0,0.769,9.059,1,1,0,1,0,0,0,0,0.0,0.0
1012,405,2020-03-17 07:05:00,1,1888.0,1437.0,0.761,9.03,25,25,4,21,0,0,0,0,0.0,0.0
1012,406,2020-03-17 07:08:00,1,1815.0,1423.0,0.784,8.729,2,2,1,1,0,0,0,0,0.0,0.0
1012,407,2020-03-17 07:11:00,1,1983.0,1476.0,0.744,9.447,0,0,0,0,0,0,0,0,0.0,0.0
1012,408,2020-03-17 07:14:00,1,1977.0,1482.0,0.75,9.431,11,11,0,11,0,0,0,0,0.0,0.0
1012,409,2020-03-17 07:17:00,1,1977.0,1497.0,0.757,9.446,32,28,5,23,4,0,4,0,0.0,0.0
1012,410,2020-03-17 07:20:00,1,1981.0,1476.0,0.745,9.439,6,4,0,4,2,0,2,0,0.0,0.0
1012,411,2020-03-17 07:23:00,1,1975.0,1479.0,0.749,9.418,11,10,0,10,1,0,1,0,0.0,0.0
1012,412,2020-03-17 07:26:00,1,1967.0,1497.0,0.761,9.408,38,28,10,18,10,3,7,2,0.0,0.0
1012,413,2020-03-17 07:29:00,1,2202.0,1668.0,0.758,10.522,82,32,14,18,50,19,31,19,0.0,0.0
1012,414,2020-03-17 07:32:00,1,2720.0,2092.0,0.769,13.035,129,33,10,23,96,41,55,47,0.0,0.0
1012,415,2020-03-17 07:35:00,1,2184.0,1719.0,0.787,10.508,154,52,24,28,102,66,36,22,0.0,0.0
1012,416,2020-03-17 07:38:00,1,1662.0,1306.0,0.786,7.995,227,79,47,32,148,105,43,39,0.0,0.0
1012,417,2020-03-17 07:41:00,1,2575.0,1958.0,0.76,12.313,156,91,51,40,65,31,34,22,0.0,0.0
1012,418,2020-03-17 07:44:00,1,2574.0,1984.0,0.771,12.34,302,120,75,45,182,119,63,5,0.0,0.0
1012,419,2020-03-17 07:47:00,1,2572.0,1976.0,0.768,12.323,397,186,135,51,211,154,57,14,0.0,0.02
1012,420,2020-03-17 07:50:00,1,2549.0,2007.0,0.787,12.266,346,180,137,43,166,109,57,19,0.0,0.0
1012,421,2020-03-17 07:53:00,1,2564.0,1987.0,0.775,12.303,281,131,98,33,150,103,47,17,0.09,0.0
1012,422,2020-03-17 07:56:00,1,2559.0,1976.0,0.772,12.27,372,177,124,53,195,141,54,5,0.0,0.0
1012,423,2020-03-17 07:59:00,1,2567.0,2016.0,0.785,12.346,497,294,219,75,203,139,64,13,0.0,0.0
1012,424,2020-03-17 08:02:00,1,2564.0,1950.0,0.76,12.262,388,173,129,44,215,150,65,13,0.0,0.0
1012,425,2020-03-17 08:05:00,1,2501.0,1912.0,0.765,11.97,43,20,7,13,23,12,11,6,0.0,0.0
1012,426,2020-03-17 08:08:00,1,2591.0,1922.0,0.742,12.336,37,5,1,4,32,0,32,7,0.0,0.0
1012,427,2020-03-17 08:11:00,1,2419.0,1889.0,0.781,11.624,74,36,17,19,38,4,34,15,0.0,0.0
1012,428,2020-03-17 08:14:00,1,2409.0,1903.0,0.79,11.598,248,140,87,53,108,55,53,62,0.0,0.0
1012,429,2020-03-17 08:17:00,1,2332.0,1874.0,0.804,11.262,259,165,112,53,94,46,48,61,0.0,0.0
1012,430,2020-03-17 08:20:00,1,2418.0,1904.0,0.787,11.636,64,55,10,45,9,2,7,8,0.0,0.0
1012,431,2020-03-17 08:23:00,1,2308.5,1797.5,0.778,11.0855,2,0,0,0,2,0,2,0,0.0,0.0
1012,432,2020-03-17 08:26:00,1,2199.0,1691.0,0.769,10.535,0,0,0,0,0,0,0,0,0.0,0.0
1012,433,2020-03-17 08:29:00,1,2130.0,1551.0,0.728,10.109,35,26,11,15,9,0,9,0,0.0,0.0
1012,434,2020-03-17 08:32:00,1,1969.0,1517.0,0.771,9.439,0,0,0,0,0,0,0,0,0.0,0.0
1012,435,2020-03-17 08:35:00,1,1973.0,1472.0,0.746,9.402,0,0,0,0,0,0,0,0,0.0,0.0
1012,436,2020-03-17 08:38:00,1,1976.0,1465.0,0.742,9.407,2,1,1,0,1,0,1,0,0.0,0.0
1012,437,2020-03-17 08:41:00,1,1971.0,1467.0,0.744,9.391,4,0,0,0,4,0,4,0,0.0,0.0
1012,438,2020-03-17 08:44:00,1,1978.0,1496.0,0.757,9.449,0,0,0,0,0,0,0,0,0.0,0.0
1012,439,2020-03-17 08:47:00,1,2045.0,1530.0,0.748,9.749,20,10,4,6,10,0,10,0,0.0,0.0
1012,440,2020-03-17 08:50:00,1,1959.0,1521.0,0.776,9.402,0,0,0,0,0,0,0,0,0.0,0.0
1012,441,2020-03-17 08:53:00,1,1963.0,1516.0,0.772,9.412,13,3,1,2,10,0,10,0,0.0,0.0
1012,442,2020-03-17 08:56:00,1,1981.0,1468.0,0.741,9.43,9,5,3,2,4,0,4,0,0.0,0.0
1012,443,2020-03-17 08:59:00,1,1973.0,1491.0,0.756,9.425,16,13,5,8,3,0,3,0,0.0,0.0
1012,444,2020-03-17 09:02:00,1,2124.0,1604.0,0.755,10.147,28,17,8,9,11,2,9,0,0.0,0.0
1012,445,2020-03-17 09:05:00,1,2047.0,1568.0,0.766,9.8,3,3,0,3,0,0,0,0,0.0,0.0
1012,446,2020-03-17 09:08:00,1,1962.0,1527.0,0.778,9.422,4,4,1,3,0,0,0,0,0.0,0.0
1012,447,2020-03-17 09:11:00,1,1961.0,1500.0,0.765,9.388,12,7,1,6,5,0,5,0,0.0,0.0
1012,448,2020-03-17 09:14:00,1,1966.0,1493.0,0.76,9.399,3,3,0,3,0,0,0,0,0.0,0.0
1012,449,2020-03-17 09:17:00,1,1976.0,1486.0,0.752,9.43,4,3,0,3,1,0,1,0,0.0,0.0
1012,450,2020-03-17 09:20:00,1,1892.0,1434.0,0.758,9.042,2,2,0,2,0,0,0,0,0.0,0.0
1012,451,2020-03-17 09:23:00,1,1890.0,1424.0,0.754,9.023,1,1,1,0,0,0,0,0,0.0,0.0
1012,452,2020-03-17 09:26:00,1,1984.0,1451.0,0.731,9.422,22,7,2,5,15,1,14,0,0.0,0.0
1012,453,2020-03-17 09:29:00,1,1972.0,1472.0,0.746,9.401,22,21,0,21,1,0,1,0,0.0,0.0
1012,454,2020-03-17 09:32:00,1,1977.0,1476.0,0.747,9.422,104,67,38,29,37,22,15,0,0.0,0.0
1012,455,2020-03-17 09:35:00,1,2388.0,1916.0,0.803,11.529,333,184,138,46,149,89,60,36,0.0,0.0
1012,456,2020-03-17 09:38:00,1,2544.0,2063.0,0.811,12.307,175,92,45,47,83,40,43,47,0.0,0.0
1012,457,2020-03-17 09:41:00,1,2713.0,2097.0,0.773,13.013,150,92,61,31,58,36,22,19,0.0,0.0
1012,458,2020-03-17 09:44:00,1,2551.0,2052.0,0.804,12.325,121,56,34,22,65,38,27,8,0.0,0.0
1012,459,2020-03-17 09:47:00,1,2627.0,2070.0,0.788,12.644,517,235,173,62,282,193,89,37,0.0,0.0
1012,460,2020-03-17 09:50:00,1,2557.0,2042.0,0.798,12.337,450,198,148,50,252,175,77,12,0.0,0.0
1012,461,2020-03-17 09:53:00,1,2553.0,2007.0,0.786,12.281,285,107,83,24,178,134,44,20,0.0,0.0
1012,462,2020-03-17 09:56:00,1,2579.0,1984.0,0.769,12.359,26,26,8,18,0,0,0,0,0.0,0.0
1012,463,2020-03-17 09:59:00,1,2479.0,1918.0,0.774,11.892,24,17,3,14,7,1,6,2,0.0,0.0
1012,464,2020-03-17 10:02:00,1,2488.0,1924.0,0.773,11.933,95,81,37,44,14,1,13,0,0.0,0.0
1012,465,2020-03-17 10:05:00,1,2416.0,1891.0,0.783,11.614,13,13,5,8,0,0,0,0,0.0,0.0
1012,466,2020-03-17 10:08:00,1,2357.0,1732.0,0.735,11.206,7,7,0,7,0,0,0,0,0.0,0.0
1012,467,2020-03-17 10:11:00,1,2223.0,1606.0,0.722,10.538,32,32,9,23,0,0,0,0,0.0,0.0
1012,468,2020-03-17 10:14:00,1,2050.0,1543.0,0.753,9.786,10,8,2,6,2,0,2,0,0.0,0.0
1012,469,2020-03-17 10:17:00,1,1980.0,1499.0,0.757,9.461,6,5,3,2,1,0,1,0,0.0,0.0
1012,470,2020-03-17 10:20:00,1,1974.0,1479.0,0.749,9.415,17,15,8,7,2,0,2,0,0.0,0.0
1012,471,2020-03-17 10:23:00,1,1972.0,1468.0,0.744,9.398,15,13,8,5,2,0,2,0,0.0,0.0
1012,472,2020-03-17 10:26:00,1,1982.0,1484.0,0.749,9.453,12,12,1,11,0,0,0,0,0.0,0.0
1012,473,2020-03-17 10:29:00,1,1969.0,1504.0,0.764,9.425,25,20,11,9,5,3,2,0,0.0,0.0
1012,474,2020-03-17 10:32:00,1,1958.0,1532.0,0.782,9.41,7,7,5,2,0,0,0,0,0.0,0.0
1012,475,2020-03-17 10:35:00,1,2118.0,1569.0,0.741,10.082,8,8,3,5,0,0,0,0,0.0,0.0
1012,476,2020-03-17 10:38:00,1,2133.0,1583.0,0.742,10.157,3,3,1,2,0,0,0,0,0.0,0.0
1012,477,2020-03-17 10:41:00,1,1951.0,1551.0,0.795,9.405,1,1,0,1,0,0,0,0,0.0,0.0
1012,478,2020-03-17 10:44:00,1,1964.0,1546.0,0.787,9.448,17,11,5,6,6,2,4,0,0.0,0.0
1012,479,2020-03-17 10:47:00,1,1949.0,1527.0,0.784,9.368,8,3,2,1,5,0,5,0,0.0,0.0
1012,480,2020-03-17 10:50:00,1,1950.0,1526.0,0.783,9.373,11,9,2,7,2,1,1,0,0.0,0.0
1012,481,2020-03-17 10:53:00,1,1969.0,1471.0,0.747,9.385,12,9,4,5,3,0,3,0,0.0,0.0
1012,482,2020-03-17 10:56:00,1,1977.0,1476.0,0.747,9.426,16,16,0,16,0,0,0,0,0.0,0.0
1012,483,2020-03-17 10:59:00,1,1960.0,1504.0,0.767,9.386,10,2,0,2,8,0,8,0,0.0,0.0
1012,484,2020-03-17 11:02:00,1,1964.0,1502.0,0.765,9.402,13,0,0,0,13,0,13,0,0.0,0.0
1012,485,2020-03-17 11:05:00,1,1960.0,1533.0,0.782,9.42,0,0,0,0,0,0,0,0,0.0,0.0
1012,486,2020-03-17 11:08:00,1,1964.0,1497.0,0.762,9.397,7,2,0,2,5,0,5,0,0.0,0.0
1012,487,2020-03-17 11:11:00,1,1955.0,1509.0,0.772,9.376,0,0,0,0,0,0,0,0,0.0,0.0
1012,488,2020-03-17 11:14:00,1,2038.0,1567.0,0.769,9.763,149,114,73,41,35,18,17,13,0.0,0.0
1012,489,2020-03-17 11:17:00,1,2581.0,1964.0,0.761,12.342,150,72,37,35,78,50,28,87,0.0,0.0
1012,490,2020-03-17 11:20:00,1,2206.0,1635.0,0.741,10.502,217,140,95,45,77,46,31,63,0.0,0.0
1012,491,2020-03-17 11:23:00,1,2394.5,1783.0,0.7445,11.408,86,74,41,33,12,6,6,24,0.0,0.0
1012,492,2020-03-17 11:26:00,1,2583.0,1931.0,0.748,12.314,104,74,39,35,30,13,17,9,0.0,0.0
1012,493,2020-03-17 11:29:00,1,2572.0,1939.0,0.754,12.281,624,326,253,73,298,220,78,54,0.0,0.0
1012,494,2020-03-17 11:32:00,1,2574.0,2005.0,0.779,12.36,679,263,204,59,416,320,96,14,0.0,0.0
1012,495,2020-03-17 11:35:00,1,2568.0,1980.0,0.771,12.31,386,184,135,49,202,147,55,13,0.0,0.0
1012,496,2020-03-17 11:38:00,1,2488.0,1900.0,0.764,11.905,472,214,147,67,258,190,68,14,0.0,0.0
1012,497,2020-03-17 11:41:00,1,2327.0,1868.0,0.803,11.235,130,77,46,31,53,27,26,11,0.0,0.0
1012,498,2020-03-17 11:44:00,1,2414.0,1886.0,0.781,11.599,28,17,3,14,11,4,7,2,0.0,0.0
1012,499,2020-03-17 11:47:00,1,2346.0,1774.0,0.756,11.208,0,0,0,0,0,0,0,0,0.0,0.0
1012,500,2020-03-17 11:50:00,1,2195.0,1676.0,0.764,10.506,0,0,0,0,0,0,0,0,0.0,0.0
1012,501,2020-03-17 11:53:00,1,2056.0,1546.0,0.752,9.811,0,0,0,0,0,0,0,0,0.0,0.0
1012,502,2020-03-17 11:56:00,1,1965.0,1512.0,0.77,9.416,0,0,0,0,0,0,0,0,0.0,0.0
1012,503,2020-03-17 11:59:00,1,1973.0,1440.0,0.73,9.367,1,1,0,1,0,0,0,0,0.0,0.0
1012,504,2020-03-17 12:02:00,1,1972.0,1442.0,0.731,9.367,0,0,0,0,0,0,0,0,0.0,0.0
1012,505,2020-03-17 12:05:00,1,1974.0,1480.0,0.75,9.415,0,0,0,0,0,0,0,0,0.0,0.0
1012,506,2020-03-17 12:08:00,1,1978.0,1485.0,0.751,9.439,0,0,0,0,0,0,0,0,0.0,0.0
1012,507,2020-03-17 12:11:00,1,1975.0,1481.0,0.75,9.42,7,7,0,7,0,0,0,0,0.0,0.0
1012,508,2020-03-17 12:14:00,1,1982.0,1466.0,0.74,9.434,0,0,0,0,0,0,0,0,0.0,0.0
1012,509,2020-03-17 12:17:00,1,1994.0,1404.0,0.704,9.412,17,9,2,7,8,0,8,0,0.0,0.0
1012,510,2020-03-17 12:20:00,1,1906.0,1414.0,0.742,9.073,7,4,1,3,3,0,3,0,0.0,0.0
1012,511,2020-03-17 12:23:00,1,1995.0,1435.0,0.719,9.451,2,1,0,1,1,0,1,0,0.0,0.0
1012,512,2020-03-17 12:26:00,1,1992.0,1434.0,0.72,9.434,1,0,0,0,1,0,1,0,0.0,0.0
1012,513,2020-03-17 12:29:00,1,1898.0,1440.0,0.759,9.072,13,0,0,0,13,0,13,0,0.0,0.0
1012,514,2020-03-17 12:32:00,1,2036.0,1554.0,0.763,9.744,54,38,19,19,16,2,14,0,0.0,0.0
1012,515,2020-03-17 12:35:00,1,2045.0,1561.0,0.763,9.784,3,3,1,2,0,0,0,0,0.0,0.0
1012,516,2020-03-17 12:38:00,1,1955.0,1519.0,0.777,9.383,1,1,1,0,0,0,0,0,0.0,0.0
1012,517,2020-03-17 12:41:00,1,1975.0,1497.0,0.758,9.437,3,3,1,2,0,0,0,0,0.0,0.0
1012,518,2020-03-17 12:44:00,1,1967.0,1513.0,0.769,9.427,0,0,0,0,0,0,0,0,0.0,0.0
1012,519,2020-03-17 12:47:00,1,1959.0,1527.0,0.78,9.409,2,2,1,1,0,0,0,0,0.0,0.0
1012,520,2020-03-17 12:50:00,1,1979.0,1484.0,0.75,9.441,0,0,0,0,0,0,0,0,0.0,0.0
1012,521,2020-03-17 12:53:00,1,1973.0,1478.0,0.749,9.411,1,1,0,1,0,0,0,0,0.0,0.0
1012,522,2020-03-17 12:56:00,1,1982.0,1478.0,0.746,9.444,0,0,0,0,0,0,0,0,0.0,0.0
1012,523,2020-03-17 12:59:00,1,1977.0,1477.0,0.747,9.423,0,0,0,0,0,0,0,0,0.0,0.0
1012,524,2020-03-17 13:02:00,1,1974.0,1508.0,0.764,9.449,1,1,0,1,0,0,0,0,0.0,0.0
1012,525,2020-03-17 13:05:00,1,1962.0,1497.0,0.763,9.387,18,8,2,6,10,5,5,0,0.0,0.0
1012,526,2020-03-17 13:08:00,1,1959.0,1524.0,0.778,9.405,2,2,1,1,0,0,0,0,0.0,0.0
1012,527,2020-03-17 13:11:00,1,1970.0,1517.0,0.77,9.443,0,0,0,0,0,0,0,0,0.0,0.0
1012,528,2020-03-17 13:14:00,1,1954.0,1520.0,0.778,9.383,0,0,0,0,0,0,0,0,0.0,0.0
1012,529,2020-03-17 13:17:00,1,2032.0,1564.0,0.77,9.738,46,34,15,19,12,1,11,5,0.0,0.0
1012,530,2020-03-17 13:20:00,1,2187.0,1714.0,0.783,10.515,89,49,3,46,40,3,37,3,0.0,0.0
1012,531,2020-03-17 13:23:00,1,2347.0,1823.0,0.777,11.266,115,62,34,28,53,23,30,13,0.0,0.0
1012,532,2020-03-17 13:26:00,1,2319.0,1879.0,0.81,11.219,438,164,120,44,274,200,74,27,0.0,0.0
1012,533,2020-03-17 13:29:00,1,2327.0,1883.0,0.809,11.253,239,108,70,38,131,86,45,16,0.0,0.0
1012,534,2020-03-17 13:32:00,1,2407.0,1894.0,0.787,11.581,41,36,18,18,5,2,3,3,0.0,0.0
1012,535,2020-03-17 13:35:00,1,2324.0,1867.0,0.803,11.225,99,93,58,35,6,1,5,0,0.0,0.0
1012,536,2020-03-17 13:38:00,1,2330.0,1826.0,0.784,11.201,3,1,0,1,2,1,1,0,0.0,0.0
1012,537,2020-03-17 13:41:00,1,2186.0,1678.0,0.768,10.472,0,0,0,0,0,0,0,0,0.0,0.0
1012,538,2020-03-17 13:44:00,1,2213.0,1619.0,0.731,10.513,0,0,0,0,0,0,0,0,0.0,0.0
1012,539,2020-03-17 13:47:00,1,2060.0,1552.0,0.753,9.834,17,10,3,7,7,2,5,0,0.0,0.0
1012,540,2020-03-17 13:50:00,1,2049.0,1549.0,0.756,9.787,0,0,0,0,0,0,0,0,0.0,0.0
1012,541,2020-03-17 13:53:00,1,1956.0,1511.0,0.772,9.38,4,1,1,0,3,0,3,0,0.0,0.0
1012,542,2020-03-17 13:56:00,1,1972.0,1495.0,0.758,9.425,0,0,0,0,0,0,0,0,0.0,0.0
1012,543,2020-03-17 13:59:00,1,1985.0,1453.0,0.732,9.431,0,0,0,0,0,0,0,0,0.0,0.0
1012,544,2020-03-17 14:02:00,1,1971.0,1507.0,0.765,9.436,2,2,1,1,0,0,0,0,0.0,0.0
1012,545,2020-03-17 14:05:00,1,1971.0,1534.0,0.778,9.466,2,2,0,2,0,0,0,0,0.0,0.0
1012,546,2020-03-17 14:08:00,1,1966.0,1527.0,0.777,9.436,1,1,0,1,0,0,0,0,0.0,0.0
1012,547,2020-03-17 14:11:00,1,1978.0,1473.0,0.744,9.426,1,1,0,1,0,0,0,0,0.0,0.0
1012,548,2020-03-17 14:14:00,1,1962.0,1492.0,0.761,9.382,5,4,1,3,1,0,1,0,0.0,0.0
1012,549,2020-03-17 14:17:00,1,1969.0,1512.0,0.768,9.433,9,9,0,9,0,0,0,0,0.0,0.0
1012,550,2020-03-17 14:20:00,1,1970.0,1494.0,0.758,9.418,16,16,0,16,0,0,0,0,0.0,0.0
1012,551,2020-03-17 14:23:00,1,2017.5,1474.0,0.731,9.583,7,7,0,7,0,0,0,0,0.0,0.0
1012,552,2020-03-17 14:26:00,1,2065.0,1454.0,0.704,9.748,0,0,0,0,0,0,0,0,0.0,0.0
1012,553,2020-03-17 14:29:00,1,2057.0,1450.0,0.705,9.712,1,0,0,0,1,0,1,0,0.0,0.0
1012,554,2020-03-17 14:32:00,1,2071.0,1457.0,0.704,9.773,1,1,0,1,0,0,0,0,0.0,0.0
1012,555,2020-03-17 14:35:00,1,2059.0,1487.0,0.722,9.76,0,0,0,0,0,0,0,0,0.0,0.0
1012,556,2020-03-17 14:38:00,1,2080.0,1457.0,0.7,9.809,17,11,8,3,6,2,4,0,0.0,0.0
1012,557,2020-03-17 14:41:00,1,2050.0,1526.0,0.744,9.767,20,15,5,10,5,0,5,0,0.0,0.0
1012,558,2020-03-17 14:44:00,1,2052.0,1552.0,0.756,9.804,0,0,0,0,0,0,0,0,0.0,0.0
1012,559,2020-03-17 14:47:00,1,2040.0,1556.0,0.763,9.761,9,5,2,3,4,0,4,0,0.0,0.0
1012,560,2020-03-17 14:50:00,1,2043.0,1552.0,0.76,9.769,9,0,0,0,9,0,9,0,0.0,0.0
1012,561,2020-03-17 14:53:00,1,2050.0,1518.0,0.74,9.758,1,0,0,0,1,0,1,0,0.0,0.0
1012,562,2020-03-17 14:56:00,1,2068.0,1491.0,0.721,9.801,6,0,0,0,6,0,6,0,0.0,0.0
1012,563,2020-03-17 14:59:00,1,2056.0,1494.0,0.727,9.757,0,0,0,0,0,0,0,0,0.0,0.0
1012,564,2020-03-17 15:02:00,1,1890.0,1420.0,0.751,9.018,41,30,7,23,11,6,5,0,0.0,0.0
1012,565,2020-03-17 15:05:00,1,2062.0,1489.0,0.722,9.774,0,0,0,0,0,0,0,0,0.0,0.0
1012,566,2020-03-17 15:08:00,1,2064.0,1488.0,0.721,9.782,0,0,0,0,0,0,0,0,0.0,0.0
1012,567,2020-03-17 15:11:00,1,2064.0,1483.0,0.718,9.774,0,0,0,0,0,0,0,0,0.0,0.0
1012,568,2020-03-17 15:14:00,1,2062.0,1496.0,0.725,9.781,0,0,0,0,0,0,0,0,0.0,0.0
1012,569,2020-03-17 15:17:00,1,2056.0,1509.0,0.734,9.771,3,2,1,1,1,0,1,0,0.0,0.0
1012,570,2020-03-17 15:20:00,1,2121.0,1588.0,0.749,10.115,146,83,56,27,63,30,33,33,0.0,0.0
1012,571,2020-03-17 15:23:00,1,2659.0,1965.0,0.739,12.651,238,115,72,43,123,93,30,32,0.0,0.0
1012,572,2020-03-17 15:26:00,1,2347.0,1765.0,0.752,11.201,63,54,15,39,9,3,6,7,0.0,0.0
1012,573,2020-03-17 15:29:00,1,2422.0,1838.0,0.759,11.577,35,25,6,19,10,0,10,0,0.0,0.0
1012,574,2020-03-17 15:32:00,1,2403.0,1881.0,0.783,11.552,88,34,7,27,54,23,31,0,0.0,0.0
1012,575,2020-03-17 15:35:00,1,2412.0,1897.0,0.787,11.605,199,103,58,45,96,66,30,3,0.0,0.0
1012,576,2020-03-17 15:38:00,1,2416.0,1849.0,0.766,11.565,0,0,0,0,0,0,0,0,0.0,0.0
1012,577,2020-03-17 15:41:00,1,2276.0,1721.0,0.756,10.875,0,0,0,0,0,0,0,0,0.0,0.0
1012,578,2020-03-17 15:44:00,1,2208.0,1611.0,0.729,10.483,1,0,0,0,1,0,1,0,0.0,0.0
1012,579,2020-03-17 15:47:00,1,2055.0,1574.0,0.766,9.842,0,0,0,0,0,0,0,0,0.0,0.0
1012,580,2020-03-17 15:50:00,1,2129.0,1576.0,0.74,10.131,3,0,0,0,3,0,3,0,0.0,0.0
1012,581,2020-03-17 15:53:00,1,2047.0,1556.0,0.76,9.788,9,4,3,1,5,1,4,0,0.0,0.0
1012,582,2020-03-17 15:56:00,1,2132.0,1574.0,0.739,10.142,7,2,1,1,5,1,4,0,0.0,0.0
1012,583,2020-03-17 15:59:00,1,2133.0,1570.0,0.736,10.144,1,0,0,0,1,0,1,0,0.0,0.0
1012,584,2020-03-17 16:02:00,1,2042.0,1550.0,0.759,9.762,1,0,0,0,1,0,1,0,0.0,0.0
1012,585,2020-03-17 16:05:00,1,2042.0,1557.0,0.763,9.769,6,2,1,1,4,0,4,0,0.0,0.0
1012,586,2020-03-17 16:08:00,1,2046.0,1562.0,0.764,9.79,5,3,0,3,2,0,2,0,0.0,0.0
1012,587,2020-03-17 16:11:00,1,2138.0,1581.0,0.739,10.175,13,7,3,4,6,0,6,0,0.0,0.0
1012,588,2020-03-17 16:14:00,1,2133.0,1588.0,0.744,10.161,0,0,0,0,0,0,0,0,0.0,0.0
1012,589,2020-03-17 16:17:00,1,2127.0,1574.0,0.74,10.122,0,0,0,0,0,0,0,0,0.0,0.0
1012,590,2020-03-17 16:20:00,1,2053.0,1526.0,0.743,9.779,0,0,0,0,0,0,0,0,0.0,0.0
1012,591,2020-03-17 16:23:00,1,2079.0,1443.0,0.694,9.788,2,2,1,1,0,0,0,0,0.0,0.0
1012,592,2020-03-17 16:26:00,1,2059.0,1502.0,0.73,9.774,0,0,0,0,0,0,0,0,0.0,0.0
1012,593,2020-03-17 16:29:00,1,2046.0,1522.0,0.744,9.748,0,0,0,0,0,0,0,0,0.0,0.0
1012,594,2020-03-17 16:32:00,1,2052.0,1541.0,0.751,9.793,0,0,0,0,0,0,0,0,0.0,0.0
1012,595,2020-03-17 16:35:00,1,2047.0,1535.0,0.75,9.765,0,0,0,0,0,0,0,0,0.0,0.0
1012,596,2020-03-17 16:38:00,1,2125.0,1546.0,0.727,10.083,2,0,0,0,2,0,2,0,0.0,0.0
1012,597,2020-03-17 16:41:00,1,2139.0,1549.0,0.724,10.141,15,11,8,3,4,0,4,0,0.0,0.0
1012,598,2020-03-17 16:44:00,1,2287.0,1695.0,0.741,10.888,130,90,54,36,40,21,19,4,0.0,0.0
1012,599,2020-03-17 16:47:00,1,2438.0,1778.0,0.73,11.573,39,33,7,26,6,1,5,1,0.0,0.0
1012,600,2020-03-17 16:50:00,1,2426.0,1821.0,0.751,11.577,116,104,46,58,12,3,9,0,0.0,0.0
1012,601,2020-03-17 16:53:00,1,2420.0,1843.0,0.762,11.573,72,68,27,41,4,1,3,0,0.0,0.0
1012,602,2020-03-17 16:56:00,1,2409.0,1869.0,0.776,11.562,103,82,41,41,21,6,15,0,0.0,0.0
1012,603,2020-03-17 16:59:00,1,2430.0,1838.0,0.756,11.611,20,20,5,15,0,0,0,0,0.0,0.0
1012,604,2020-03-17 17:02:00,1,2266.0,1726.0,0.762,10.838,63,49,14,35,14,4,10,1,0.0,0.0
1012,605,2020-03-17 17:05:00,1,2277.0,1673.0,0.735,10.826,8,6,2,4,2,0,2,0,0.0,0.0
1012,606,2020-03-17 17:08:00,1,2128.0,1594.0,0.749,10.151,0,0,0,0,0,0,0,0,0.0,0.0
1012,607,2020-03-17 17:11:00,1,2055.0,1554.0,0.756,9.82,3,3,0,3,0,0,0,0,0.0,0.0
1012,608,2020-03-17 17:14:00,1,2037.0,1550.0,0.761,9.743,1,0,0,0,1,0,1,0,0.0,0.0
1012,609,2020-03-17 17:17:00,1,2135.0,1589.0,0.744,10.173,2,0,0,0,2,0,2,0,0.0,0.0
1012,610,2020-03-17 17:20:00,1,2133.0,1586.0,0.744,10.161,12,10,0,10,2,0,2,0,0.0,0.0
1012,611,2020-03-17 17:23:00,1,2132.0,1575.0,0.739,10.1455,14,14,0,14,0,0,0,0,0.0,0.0
1012,612,2020-03-17 17:26:00,1,2131.0,1564.0,0.734,10.13,13,11,1,10,2,0,2,0,0.0,0.0
1012,613,2020-03-17 17:29:00,1,2291.0,1644.0,0.718,10.847,107,64,25,39,43,13,30,5,0.0,0.0
1012,614,2020-03-17 17:32:00,1,2440.0,1777.0,0.728,11.58,82,48,32,16,34,26,8,13,0.0,0.0
1012,615,2020-03-17 17:35:00,1,2421.0,1819.0,0.751,11.554,45,32,4,28,13,0,13,1,0.0,0.0
1012,616,2020-03-17 17:38:00,1,2432.0,1845.0,0.759,11.624,68,63,39,24,5,0,5,0,0.0,0.0
1012,617,2020-03-17 17:41:00,1,2432.0,1800.0,0.74,11.576,4,4,0,4,0,0,0,0,0.0,0.0
1012,618,2020-03-17 17:44:00,1,2289.0,1691.0,0.739,10.892,4,4,0,4,0,0,0,0,0.0,0.0
1012,619,2020-03-17 17:47:00,1,2292.0,1622.0,0.708,10.826,1,1,0,1,0,0,0,0,0.0,0.0
1012,620,2020-03-17 17:50:00,1,2218.0,1603.0,0.723,10.515,14,11,4,7,3,0,3,0,0.0,0.0
1012,621,2020-03-17 17:53:00,1,2304.0,1644.0,0.714,10.899,3,2,0,2,1,0,1,0,0.0,0.0
1012,622,2020-03-17 17:56:00,1,2288.0,1689.0,0.738,10.885,14,1,0,1,13,0,13,0,0.0,0.0
1012,623,2020-03-17 17:59:00,1,2290.0,1683.0,0.735,10.886,14,9,0,9,5,0,5,0,0.0,0.0
1012,624,2020-03-17 18:02:00,0,2293.0,1666.0,0.726,10.88,35,26,16,10,9,5,4,0,0.0,0.0
1012,625,2020-03-17 18:05:00,0,2750.0,2045.0,0.744,13.1,355,169,128,41,186,129,57,80,0.0,0.0
1012,626,2020-03-17 18:08:00,0,2418.0,1893.0,0.783,11.624,435,199,143,56,236,177,59,111,0.0,0.0
1012,627,2020-03-17 18:11:00,0,2962.0,2219.0,0.749,14.127,182,67,22,45,115,69,46,75,0.0,0.0
1012,628,2020-03-17 18:14:00,0,3181.0,2357.0,0.741,15.143,146,56,17,39,90,55,35,46,0.0,0.0
1012,629,2020-03-17 18:17:00,0,3211.0,2373.0,0.739,15.28,169,74,44,30,95,67,28,56,0.0,0.0
1012,630,2020-03-17 18:20:00,0,2658.0,1988.0,0.748,12.673,299,143,96,47,156,108,48,79,0.0,0.0
1012,631,2020-03-17 18:23:00,0,3160.0,2448.0,0.775,15.162,215,82,41,41,133,93,40,58,0.0,0.0
1012,632,2020-03-17 18:26:00,0,3099.0,2389.0,0.771,14.857,137,71,38,33,66,38,28,54,0.0,0.0
1012,633,2020-03-17 18:29:00,0,3158.0,2519.0,0.798,15.233,163,86,47,39,77,49,28,37,0.0,0.0
1012,634,2020-03-17 18:32:00,0,3248.0,2569.0,0.791,15.64,144,76,39,37,68,36,32,58,0.0,0.0
1012,635,2020-03-17 18:35:00,0,3301.0,2662.0,0.806,15.953,146,67,25,42,79,16,63,81,0.0,0.0
1012,636,2020-03-17 18:38:00,0,3512.0,2816.0,0.802,16.956,126,38,14,24,88,13,75,79,0.0,0.0
1012,637,2020-03-17 18:41:00,0,2906.0,2419.0,0.832,14.128,279,156,123,33,123,68,55,60,0.0,0.05
1012,638,2020-03-17 18:44:00,0,2906.0,2388.0,0.822,14.096,293,174,114,60,119,79,40,63,0.0,0.0
1012,639,2020-03-17 18:47:00,0,2386.0,1951.0,0.818,11.56,111,95,63,32,16,2,14,0,0.0,0.0
1012,640,2020-03-17 18:50:00,0,2419.0,1870.0,0.773,11.602,115,85,39,46,30,2,28,0,0.0,0.0
1012,641,2020-03-17 18:53:00,0,2906.0,2472.0,0.851,14.186,258,140,91,49,118,65,53,62,0.0,0.0
1012,642,2020-03-17 18:56:00,0,3654.0,2995.0,0.82,17.715,233,94,52,42,139,45,94,77,0.0,0.0
1012,643,2020-03-17 18:59:00,0,3653.0,3044.0,0.833,17.762,280,124,88,36,156,77,79,90,0.0,0.0
1012,644,2020-03-17 19:02:00,0,3728.0,3075.0,0.825,18.093,144,59,20,39,85,0,85,75,0.0,0.0
1012,645,2020-03-17 19:05:00,0,3802.0,3180.0,0.836,18.502,150,59,23,36,91,4,87,84,0.0,0.0
1012,646,2020-03-17 19:08:00,0,3726.0,3121.0,0.838,18.135,161,57,23,34,104,31,73,77,0.0,0.0
1012,647,2020-03-17 19:11:00,0,3488.0,2961.0,0.849,17.02,251,99,64,35,152,92,60,58,0.39,0.1
1012,648,2020-03-17 19:14:00,0,3321.0,2842.0,0.856,16.232,597,266,206,60,331,246,85,133,0.0,0.0
1012,649,2020-03-17 19:17:00,0,2953.0,2581.0,0.874,14.491,674,285,241,44,389,299,90,135,0.01,0.0
1012,650,2020-03-17 19:20:00,0,3555.0,2999.0,0.844,17.328,363,148,105,43,215,116,99,70,0.0,0.0
1012,651,2020-03-17 19:23:00,0,3647.0,3052.0,0.837,17.748,225,113,90,23,112,52,60,87,0.0,0.0
1012,652,2020-03-17 19:26:00,0,3646.0,3121.0,0.856,17.82,513,210,154,56,303,231,72,62,0.15,0.09
1012,653,2020-03-17 19:29:00,0,3108.0,2689.0,0.865,15.222,375,159,118,41,216,154,62,118,0.0,0.0
1012,654,2020-03-17 19:32:00,0,3312.0,2928.0,0.884,16.291,432,214,163,51,218,147,71,172,0.0,0.0
1012,655,2020-03-17 19:35:00,0,3679.0,3227.0,0.877,18.069,403,179,137,42,224,139,85,133,0.0,0.0
1012,656,2020-03-17 19:38:00,0,3258.0,2829.0,0.868,15.968,562,277,217,60,285,207,78,140,0.0,0.0
1012,657,2020-03-17 19:41:00,0,3180.0,2787.0,0.876,15.614,254,144,98,46,110,72,38,95,0.0,0.0
1012,658,2020-03-17 19:44:00,0,2876.0,2542.0,0.884,14.147,616,260,220,40,356,273,83,177,0.0,0.0
1012,659,2020-03-17 19:47:00,0,3495.0,2996.0,0.857,17.089,563,234,194,40,329,261,68,260,0.0,0.0
1012,660,2020-03-17 19:50:00,0,2898.0,2432.0,0.839,14.112,488,240,188,52,248,174,74,169,0.0,0.0
1012,661,2020-03-17 19:53:00,0,3862.0,3319.0,0.859,18.893,382,201,138,63,181,103,78,101,0.0,0.0
1012,662,2020-03-17 19:56:00,0,3799.0,3225.0,0.849,18.537,160,69,33,36,91,25,66,86,0.0,0.0
1012,663,2020-03-17 19:59:00,0,3641.0,3160.0,0.868,17.845,141,57,16,41,84,14,70,87,0.0,0.0
1012,664,2020-03-17 20:02:00,0,3793.0,3212.0,0.847,18.501,148,66,20,46,82,40,42,69,0.0,0.0
1012,665,2020-03-17 20:05:00,0,3573.0,3050.0,0.854,17.453,114,72,29,43,42,13,29,59,0.0,0.12
1012,666,2020-03-17 20:08:00,0,3394.0,2924.0,0.861,16.609,481,231,179,52,250,186,64,77,0.0,0.02
1012,667,2020-03-17 20:11:00,0,3622.0,3166.0,0.874,17.775,592,259,207,52,333,262,71,186,0.0,0.02
1012,668,2020-03-17 20:14:00,0,3600.0,3151.0,0.875,17.671,599,261,185,76,338,249,89,140,0.0,0.0
1012,669,2020-03-17 20:17:00,0,3253.0,2894.0,0.89,16.021,893,379,312,67,514,416,98,263,0.0,0.01
1012,670,2020-03-17 20:20:00,0,3438.0,3106.0,0.903,16.983,758,329,267,62,429,338,91,200,0.0,0.04
1012,671,2020-03-17 20:23:00,0,3112.0,2822.5,0.907,15.386,148,97,57,40,51,32,19,43,0.22,0.0
1012,672,2020-03-17 20:26:00,0,2786.0,2539.0,0.911,13.789,115,65,29,36,50,7,43,26,0.0,0.0
1012,673,2020-03-17 20:29:00,0,3539.0,3140.0,0.887,17.418,443,182,132,50,261,194,67,121,0.0,0.0
1012,674,2020-03-17 20:32:00,0,3746.0,3481.0,0.929,18.612,554,192,129,63,362,278,84,118,0.0,0.0
1012,675,2020-03-17 20:35:00,0,3498.0,3275.0,0.936,17.409,534,215,157,58,319,233,86,206,0.0,0.0
1012,676,2020-03-17 20:38:00,0,3383.0,3059.0,0.904,16.716,566,247,202,45,319,239,80,240,0.0,0.02
1012,677,2020-03-17 20:41:00,0,3362.0,3076.0,0.915,16.653,386,210,160,50,176,125,51,113,0.0,0.0
1012,678,2020-03-17 20:44:00,0,3216.0,2988.0,0.929,15.98,317,141,94,47,176,125,51,116,0.0,0.0
1012,679,2020-03-17 20:47:00,0,3590.0,3280.0,0.914,17.774,409,143,88,55,266,188,78,101,0.0,0.0
1012,680,2020-03-17 20:50:00,0,3362.0,3160.0,0.94,16.744,657,204,144,60,453,351,102,104,0.0,0.0
1012,681,2020-03-17 20:53:00,0,3501.0,3232.0,0.923,17.374,201,143,74,69,58,26,32,46,0.0,0.0
1012,682,2020-03-17 20:56:00,0,3529.0,3196.0,0.906,17.443,234,136,80,56,98,51,47,47,0.0,0.03
1012,683,2020-03-17 20:59:00,0,3272.0,3055.0,0.934,16.276,565,273,212,61,292,221,71,137,0.0,0.03
1012,684,2020-03-17 21:02:00,0,3664.0,3355.0,0.916,18.153,708,234,175,59,474,373,101,101,0.0,0.08
1012,685,2020-03-17 21:05:00,0,3662.0,3330.0,0.909,18.115,455,155,103,52,300,221,79,73,0.0,0.0
1012,686,2020-03-17 21:08:00,0,2928.0,2727.0,0.931,14.556,632,270,215,55,362,283,79,146,0.0,0.0
1012,687,2020-03-17 21:11:00,0,2755.0,2685.0,0.974,13.826,686,286,215,71,400,291,109,103,0.0,0.0
1012,688,2020-03-17 21:14:00,0,3600.0,3330.0,0.925,17.872,381,157,104,53,224,160,64,99,0.11,0.0
1012,689,2020-03-17 21:17:00,0,3460.0,3161.0,0.914,17.131,291,107,56,51,184,108,76,98,0.0,0.0
1012,690,2020-03-17 21:20:00,0,3634.0,3467.0,0.954,18.156,248,103,68,35,145,88,57,126,0.0,0.0
1012,691,2020-03-17 21:23:00,0,3358.0,3078.0,0.917,16.64,206,71,30,41,135,64,71,46,0.0,0.0
1012,692,2020-03-17 21:26:00,0,3127.0,2995.0,0.958,15.637,179,80,52,28,99,51,48,43,0.0,0.0
1012,693,2020-03-17 21:29:00,0,2614.0,2416.0,0.924,12.976,220,92,62,30,128,86,42,39,0.0,0.01
1012,694,2020-03-17 21:32:00,0,3202.0,3035.0,0.948,15.974,684,264,201,63,420,322,98,91,0.0,0.03
1012,695,2020-03-17 21:35:00,0,3575.0,3318.0,0.928,17.758,390,179,117,62,211,143,68,148,0.0,0.0
1012,696,2020-03-17 21:38:00,0,3351.0,3083.0,0.92,16.617,593,237,167,70,356,273,83,103,0.0,0.06
1012,697,2020-03-17 21:41:00,0,2925.0,2687.0,0.919,14.501,313,154,105,49,159,117,42,148,0.0,0.0
1012,698,2020-03-17 21:44:00,0,2778.0,2547.0,0.917,13.765,598,269,212,57,329,247,82,177,0.0,0.0
1012,699,2020-03-17 21:47:00,0,2705.0,2468.0,0.912,13.389,401,240,178,62,161,105,56,155,0.03,0.0
1012,700,2020-03-17 21:50:00,0,2286.0,1979.0,0.866,11.199,971,513,388,125,458,345,113,138,0.0,0.0
1012,701,2020-03-17 21:53:00,0,2125.0,1913.0,0.9,10.491,999,430,324,106,569,439,130,135,0.0,0.0
1012,702,2020-03-17 21:56:00,0,3653.0,3363.0,0.921,18.116,314,148,95,53,166,113,53,191,0.0,0.0
1012,703,2020-03-17 21:59:00,0,3621.0,3432.0,0.948,18.065,265,91,50,41,174,122,52,193,0.0,0.0
1012,704,2020-03-17 22:02:00,0,3523.0,3230.0,0.917,17.457,346,149,97,52,197,153,44,184,0.0,0.0
1012,705,2020-03-17 22:05:00,0,3669.0,3348.0,0.912,18.162,287,103,64,39,184,135,49,155,0.0,0.0
1012,706,2020-03-17 22:08:00,0,3593.0,3269.0,0.91,17.775,515,211,152,59,304,241,63,188,0.02,0.01
1012,707,2020-03-17 22:11:00,0,3542.0,3217.0,0.908,17.515,506,205,152,53,301,217,84,260,0.0,0.0
1012,708,2020-03-17 22:14:00,0,3539.0,3164.0,0.894,17.448,273,95,50,45,178,125,53,103,0.0,0.0
1012,709,2020-03-17 22:17:00,0,3904.0,3530.0,0.904,19.289,153,86,45,41,67,33,34,95,0.0,0.0
1012,710,2020-03-17 22:20:00,0,3538.0,3197.0,0.904,17.481,204,65,27,38,139,80,59,109,0.0,0.04
1012,711,2020-03-17 22:23:00,0,3160.0,2825.0,0.894,15.577,124,76,48,28,48,12,36,109,0.28,0.0
1012,712,2020-03-17 22:26:00,0,2634.0,2393.0,0.909,13.025,124,70,32,38,54,15,39,129,0.0,0.0
1012,713,2020-03-17 22:29:00,0,2990.0,2772.0,0.927,14.847,708,268,210,58,440,351,89,199,0.0,0.0
1012,714,2020-03-17 22:32:00,0,3501.0,3203.0,0.915,17.341,373,158,100,58,215,161,54,50,0.0,0.0
1012,715,2020-03-17 22:35:00,0,3605.0,3264.0,0.906,17.816,217,91,43,48,126,71,55,51,0.0,0.0
1012,716,2020-03-17 22:38:00,0,3888.0,3543.0,0.911,19.242,185,96,42,54,89,54,35,34,0.0,0.03
1012,717,2020-03-17 22:41:00,0,3519.0,3136.0,0.891,17.338,279,120,78,42,159,105,54,46,0.0,0.04
1012,718,2020-03-17 22:44:00,0,3218.0,2977.0,0.925,15.976,482,178,133,45,304,234,70,119,0.0,0.03
1012,719,2020-03-17 22:47:00,0,3059.0,2833.0,0.926,15.188,775,349,263,86,426,317,109,120,0.0,0.02
1012,720,2020-03-17 22:50:00,0,3146.0,2967.0,0.943,15.682,557,236,180,56,321,236,85,165,0.0,0.0
1012,721,2020-03-17 22:53:00,0,2648.0,2402.0,0.907,13.091,581,325,255,70,256,184,72,130,0.0,0.0
1012,722,2020-03-17 22:56:00,0,3520.0,3277.0,0.931,17.499,477,196,153,43,281,222,59,115,0.0,0.0
1012,723,2020-03-17 22:59:00,0,2499.0,2223.0,0.889,12.308,537,288,214,74,249,172,77,83,0.0,0.0
1012,724,2020-03-17 23:02:00,0,3516.0,3192.0,0.908,17.385,599,229,166,63,370,284,86,82,0.0,0.0
1012,725,2020-03-17 23:05:00,0,2764.0,2562.0,0.927,13.724,358,195,140,55,163,105,58,97,0.0,0.0
1012,726,2020-03-17 23:08:00,0,2259.0,2113.0,0.936,11.238,171,103,62,41,68,35,33,59,0.0,0.0
1012,727,2020-03-17 23:11:00,0,2813.0,2487.0,0.884,13.837,636,389,300,89,247,182,65,76,0.0,0.0
1012,728,2020-03-17 23:14:00,0,3540.0,3150.0,0.89,17.433,252,99,51,48,153,98,55,87,0.0,0.0
1012,729,2020-03-17 23:17:00,0,3716.0,3456.0,0.93,18.465,136,68,34,34,68,33,35,63,0.0,0.0
1012,730,2020-03-17 23:20:00,0,3532.0,3149.0,0.892,17.401,164,76,33,43,88,47,41,100,0.0,0.02
1012,731,2020-03-17 23:23:00,0,3051.0,2715.5,0.89,15.027,107,50,11,39,57,7,50,70,0.0,0.0
1012,732,2020-03-17 23:26:00,0,2570.0,2282.0,0.888,12.653,532,270,202,68,262,192,70,113,0.0,0.03
1012,733,2020-03-17 23:29:00,0,3517.0,3241.0,0.922,17.445,534,259,198,61,275,200,75,89,0.0,0.0
1012,734,2020-03-17 23:32:00,0,2649.0,2403.0,0.907,13.1,641,316,233,83,325,237,88,59,0.0,0.0
1012,735,2020-03-17 23:35:00,0,2987.0,2809.0,0.94,14.88,781,412,328,84,369,282,87,84,0.0,0.0
1012,736,2020-03-17 23:38:00,0,3137.0,2932.0,0.935,15.606,544,338,259,79,206,152,54,80,0.0,0.0
1012,737,2020-03-17 23:41:00,0,3689.0,3282.0,0.89,18.167,234,85,39,46,149,92,57,121,0.0,0.0
1012,738,2020-03-17 23:44:00,0,3643.0,3409.0,0.936,18.128,180,90,41,49,90,44,46,94,0.0,0.05
1012,739,2020-03-17 23:47:00,0,3646.0,3411.0,0.935,18.143,318,148,92,56,170,109,61,103,0.04,0.09
1012,740,2020-03-17 23:50:00,0,2921.0,2677.0,0.917,14.474,439,221,170,51,218,163,55,95,0.01,0.0
1012,741,2020-03-17 23:53:00,0,2717.0,2436.0,0.896,13.403,932,349,268,81,583,472,111,74,0.0,0.02
1012,742,2020-03-17 23:56:00,0,3132.0,2913.0,0.93,15.566,442,190,136,54,252,192,60,108,0.38,0.0
1012,743,2020-03-17 23:59:00,0,3356.0,3106.0,0.926,16.66,420,210,140,70,210,157,53,103,0.0,0.0
1012,744,2020-03-18 00:02:00,0,3129.0,2942.0,0.94,15.584,388,197,144,53,191,137,54,35,0.0,0.0
1012,745,2020-03-18 00:05:00,0,2511.0,2239.0,0.892,12.372,957,465,374,91,492,382,110,63,0.0,0.0
1012,746,2020-03-18 00:08:00,0,2800.0,2527.0,0.902,13.831,409,205,141,64,204,145,59,70,0.0,0.0
1012,747,2020-03-18 00:11:00,0,2775.0,2525.0,0.91,13.731,764,304,225,79,460,361,99,101,0.0,0.0
1012,748,2020-03-18 00:14:00,0,2201.0,1976.0,0.898,10.86,71,39,15,24,32,10,22,95,0.0,0.0
1012,749,2020-03-18 00:17:00,0,2287.0,1995.0,0.872,11.22,142,36,8,28,106,52,54,89,0.0,0.0
1012,750,2020-03-18 00:20:00,0,2771.0,2592.0,0.936,13.788,71,16,5,11,55,19,36,74,0.0,0.0
1012,751,2020-03-18 00:23:00,0,3007.0,2777.0,0.924,14.922,45,26,4,22,19,9,10,83,0.0,0.0
1012,752,2020-03-18 00:26:00,0,2763.0,2625.0,0.95,13.794,0,0,0,0,0,0,0,82,0.0,0.0
1012,753,2020-03-18 00:29:00,0,2848.0,2697.0,0.947,14.208,6,1,0,1,5,3,2,77,0.0,0.0
1012,754,2020-03-18 00:32:00,0,2786.0,2598.0,0.933,13.852,119,56,36,20,63,40,23,77,0.0,0.0
1012,755,2020-03-18 00:35:00,0,2985.0,2784.0,0.933,14.844,494,231,158,73,263,196,67,123,0.0,0.0
1012,756,2020-03-18 00:38:00,0,2996.0,2786.0,0.93,14.89,702,277,222,55,425,336,89,188,0.0,0.0
1012,757,2020-03-18 00:41:00,0,2836.0,2696.0,0.951,14.158,122,91,51,40,31,17,14,131,0.0,0.0
1012,758,2020-03-18 00:44:00,0,3012.0,2737.0,0.909,14.898,184,79,50,29,105,65,40,124,0.0,0.01
1012,759,2020-03-18 00:47:00,0,3210.0,2962.0,0.923,15.927,126,46,20,26,80,35,45,143,0.0,0.01
1012,760,2020-03-18 00:50:00,0,2148.0,1875.0,0.873,10.539,0,0,0,0,0,0,0,108,0.0,0.02
1012,761,2020-03-18 00:53:00,0,1913.0,1712.0,0.895,9.434,2,2,0,2,0,0,0,88,0.0,0.0
1012,762,2020-03-18 00:56:00,0,2301.0,1977.0,0.859,11.256,15,15,8,7,0,0,0,99,0.0,0.0
1012,763,2020-03-18 00:59:00,0,2255.0,2109.0,0.936,11.219,14,14,6,8,0,0,0,104,0.0,0.0
1012,764,2020-03-18 01:02:00,0,2427.0,2165.0,0.892,11.959,16,3,1,2,13,3,10,101,0.0,0.0
1012,765,2020-03-18 01:05:00,0,2479.0,2304.0,0.929,12.319,9,3,1,2,6,4,2,91,0.0,0.0
1012,766,2020-03-18 01:08:00,0,2621.0,2369.0,0.904,12.951,10,5,2,3,5,1,4,85,0.0,0.0
1012,767,2020-03-18 01:11:00,0,2651.0,2401.0,0.906,13.101,6,3,2,1,3,1,2,80,0.0,0.0
1012,768,2020-03-18 01:14:00,0,2625.0,2415.0,0.92,13.016,16,6,2,4,10,3,7,81,0.0,0.0
1012,769,2020-03-18 01:17:00,0,2649.0,2435.0,0.919,13.134,83,53,20,33,30,18,12,98,0.0,0.0
1012,770,2020-03-18 01:20:00,0,2923.0,2674.0,0.915,14.477,243,140,107,33,103,66,37,114,0.0,0.0
1012,771,2020-03-18 01:23:00,0,2503.0,2255.0,0.901,12.357,161,80,34,46,81,43,38,97,0.0,0.0
1012,772,2020-03-18 01:26:00,0,3021.0,2717.0,0.9,14.911,199,96,47,49,103,58,45,83,0.0,0.0
1012,773,2020-03-18 01:29:00,0,2998.0,2750.0,0.917,14.856,76,27,7,20,49,13,36,80,0.0,0.01
1012,774,2020-03-18 01:32:00,0,2980.0,2803.0,0.941,14.843,91,57,23,34,34,12,22,81,0.0,0.0
1012,775,2020-03-18 01:35:00,0,2752.0,2645.0,0.961,13.77,25,6,4,2,19,8,11,83,0.0,0.0
1012,776,2020-03-18 01:38:00,0,2716.0,2484.0,0.915,13.452,34,27,3,24,7,4,3,84,0.0,0.0
1012,777,2020-03-18 01:41:00,0,2497.0,2315.0,0.927,12.402,66,43,19,24,23,12,11,98,0.0,0.0
1012,778,2020-03-18 01:44:00,0,2432.0,2192.0,0.902,12.009,7,3,2,1,4,3,1,99,0.0,0.0
1012,779,2020-03-18 01:47:00,0,2261.0,2085.0,0.922,11.214,11,7,2,5,4,3,1,110,0.0,0.0
1012,780,2020-03-18 01:50:00,0,2340.0,2127.0,0.909,11.575,48,33,14,19,15,8,7,120,0.0,0.0
1012,781,2020-03-18 01:53:00,0,2778.0,2560.0,0.922,13.779,474,192,137,55,282,219,63,143,0.0,0.0
1012,782,2020-03-18 01:56:00,0,2947.0,2627.0,0.892,14.519,262,100,64,36,162,106,56,135,0.0,0.0
1012,783,2020-03-18 01:59:00,0,3156.0,2810.0,0.89,15.545,141,44,18,26,97,46,51,126,0.0,0.0
1012,784,2020-03-18 02:02:00,0,3094.0,2813.0,0.909,15.304,177,45,16,29,132,74,58,145,0.0,0.08
1012,785,2020-03-18 02:05:00,0,2852.0,2620.0,0.918,14.139,381,165,125,40,216,160,56,140,0.0,0.04
1012,786,2020-03-18 02:08:00,0,2786.0,2558.0,0.918,13.809,417,205,137,68,212,162,50,105,0.24,0.04
1012,787,2020-03-18 02:11:00,0,3591.0,3253.0,0.906,17.751,316,141,84,57,175,104,71,22,0.0,0.01
1012,788,2020-03-18 02:14:00,0,2858.0,2641.0,0.924,14.184,250,79,50,29,171,115,56,33,0.02,0.01
1012,789,2020-03-18 02:17:00,0,3165.0,2848.0,0.9,15.623,432,163,126,37,269,203,66,60,0.0,0.01
1012,790,2020-03-18 02:20:00,0,3551.0,3207.0,0.903,17.54,260,115,81,34,145,111,34,24,0.0,0.03
1012,791,2020-03-18 02:23:00,0,3272.0,3011.5,0.922,16.2255,550,172,121,51,378,292,86,60,0.0,0.01
1012,792,2020-03-18 02:26:00,0,2993.0,2816.0,0.941,14.911,525,210,156,54,315,228,87,18,0.0,0.0
1012,793,2020-03-18 02:29:00,0,2755.0,2607.0,0.946,13.743,401,190,149,41,211,152,59,38,0.0,0.06
1012,794,2020-03-18 02:32:00,0,2500.0,2209.0,0.884,12.296,494,219,164,55,275,201,74,7,0.0,0.0
1012,795,2020-03-18 02:35:00,0,2837.0,2659.0,0.937,14.122,580,247,199,48,333,259,74,51,0.0,0.0
1012,796,2020-03-18 02:38:00,0,2655.0,2384.0,0.898,13.099,108,58,16,42,50,25,25,1,0.0,0.0
1012,797,2020-03-18 02:41:00,0,2511.0,2227.0,0.887,12.36,86,52,24,28,34,12,22,0,0.0,0.0
1012,798,2020-03-18 02:44:00,0,2483.0,2318.0,0.933,12.35,8,0,0,0,8,0,8,0,0.0,0.0
1012,799,2020-03-18 02:47:00,0,2504.0,2229.0,0.89,12.333,20,0,0,0,20,0,20,0,0.0,0.0
1012,800,2020-03-18 02:50:00,0,2268.0,2102.0,0.927,11.262,27,5,3,2,22,3,19,0,0.0,0.0
1012,801,2020-03-18 02:53:00,0,2275.0,2089.0,0.918,11.277,6,0,0,0,6,1,5,0,0.0,0.0
1012,802,2020-03-18 02:56:00,0,2205.0,2014.0,0.913,10.915,17,2,1,1,15,8,7,0,0.0,0.0
1012,803,2020-03-18 02:59:00,0,2113.0,1953.0,0.924,10.488,21,0,0,0,21,10,11,0,0.0,0.0
1012,804,2020-03-18 03:02:00,0,2124.0,1919.0,0.904,10.493,1,0,0,0,1,0,1,0,0.0,0.0
1012,805,2020-03-18 03:05:00,0,2124.0,1946.0,0.916,10.521,0,0,0,0,0,0,0,0,0.0,0.0
1012,806,2020-03-18 03:08:00,0,2281.0,2024.0,0.887,11.23,22,22,1,21,0,0,0,0,0.0,0.0
1012,807,2020-03-18 03:11:00,0,2638.0,2416.0,0.916,13.067,43,12,10,2,31,17,14,1,0.0,0.0
1012,808,2020-03-18 03:14:00,0,3073.0,2861.0,0.931,15.274,5,0,0,0,5,0,5,0,0.0,0.0
1012,809,2020-03-18 03:17:00,0,2996.0,2757.0,0.92,14.857,15,2,1,1,13,1,12,0,0.0,0.0
1012,810,2020-03-18 03:20:00,0,3014.0,2693.0,0.894,14.855,22,0,0,0,22,8,14,0,0.0,0.0
1012,811,2020-03-18 03:23:00,0,3012.0,2687.0,0.892,14.842,266,91,50,41,175,109,66,26,0.0,0.0
1012,812,2020-03-18 03:26:00,0,3007.0,2714.0,0.903,14.851,374,182,114,68,192,129,63,48,0.0,0.0
1012,813,2020-03-18 03:29:00,0,2986.0,2760.0,0.924,14.82,389,146,109,37,243,185,58,38,0.0,0.0
1012,814,2020-03-18 03:32:00,0,3143.0,2851.0,0.907,15.54,233,67,42,25,166,112,54,38,0.0,0.0
1012,815,2020-03-18 03:35:00,0,3070.0,2771.0,0.902,15.164,118,33,8,25,85,33,52,32,0.0,0.01
1012,816,2020-03-18 03:38:00,0,3085.0,2809.0,0.911,15.264,169,60,25,35,109,57,52,40,0.0,0.08
1012,817,2020-03-18 03:41:00,0,2865.0,2615.0,0.913,14.182,535,227,182,45,308,239,69,167,0.0,0.0
1012,818,2020-03-18 03:44:00,0,3156.0,2904.0,0.92,15.65,320,125,79,46,195,137,58,84,0.0,0.0
1012,819,2020-03-18 03:47:00,0,2660.0,2389.0,0.898,13.127,526,178,132,46,348,266,82,44,0.0,0.03
1012,820,2020-03-18 03:50:00,0,2640.0,2400.0,0.909,13.057,487,170,113,57,317,232,85,49,0.0,0.0
1012,821,2020-03-18 03:53:00,0,2284.0,2026.0,0.887,11.243,584,254,181,73,330,235,95,4,0.0,0.0
1012,822,2020-03-18 03:56:00,0,2982.0,2819.0,0.945,14.871,570,274,201,73,296,205,91,22,0.05,0.0
1012,823,2020-03-18 03:59:00,0,2717.0,2449.0,0.901,13.415,809,360,289,71,449,364,85,25,0.0,0.0
1012,824,2020-03-18 04:02:00,0,2778.0,2603.0,0.937,13.828,209,80,48,32,129,104,25,28,0.0,0.0
1012,825,2020-03-18 04:05:00,0,2289.0,1998.0,0.873,11.23,55,23,5,18,32,6,26,0,0.0,0.0
1012,826,2020-03-18 04:08:00,0,2302.0,1951.0,0.848,11.23,35,15,2,13,20,5,15,1,0.0,0.0
1012,827,2020-03-18 04:11:00,0,2306.0,1955.0,0.848,11.249,0,0,0,0,0,0,0,0,0.0,0.0
1012,828,2020-03-18 04:14:00,0,2302.0,1968.0,0.855,11.25,6,6,1,5,0,0,0,0,0.0,0.0
1012,829,2020-03-18 04:17:00,0,2647.0,2386.0,0.901,13.073,0,0,0,0,0,0,0,0,0.0,0.0
1012,830,2020-03-18 04:20:00,0,2929.0,2653.0,0.906,14.476,0,0,0,0,0,0,0,0,0.0,0.0
1012,831,2020-03-18 04:23:00,0,2780.0,2605.0,0.937,13.837,21,8,5,3,13,5,8,0,0.0,0.0
1012,832,2020-03-18 04:26:00,0,2779.0,2578.0,0.928,13.804,9,6,3,3,3,1,2,0,0.0,0.0
1012,833,2020-03-18 04:29:00,0,2712.0,2467.0,0.91,13.416,0,0,0,0,0,0,0,0,0.0,0.0
1012,834,2020-03-18 04:32:00,0,2648.0,2399.0,0.906,13.089,7,5,0,5,2,0,2,0,0.0,0.0
1012,835,2020-03-18 04:35:00,0,2493.0,2266.0,0.909,12.331,3,1,0,1,2,1,1,0,0.0,0.0
1012,836,2020-03-18 04:38:00,0,2427.0,2145.0,0.884,11.935,16,8,1,7,8,5,3,0,0.0,0.0
1012,837,2020-03-18 04:41:00,0,2276.0,2106.0,0.925,11.3,0,0,0,0,0,0,0,0,0.0,0.0
1012,838,2020-03-18 04:44:00,0,2286.0,2033.0,0.89,11.256,0,0,0,0,0,0,0,0,0.0,0.0
1012,839,2020-03-18 04:47:00,0,2291.0,1972.0,0.861,11.208,0,0,0,0,0,0,0,0,0.0,0.0
1012,840,2020-03-18 04:50:00,0,2305.0,1960.0,0.851,11.251,0,0,0,0,0,0,0,0,0.0,0.0
1012,841,2020-03-18 04:53:00,0,2305.0,1961.0,0.851,11.252,0,0,0,0,0,0,0,0,0.0,0.0
1012,842,2020-03-18 04:56:00,0,2297.0,1974.0,0.859,11.236,1,1,0,1,0,0,0,0,0.0,0.0
1012,843,2020-03-18 04:59:00,0,2221.0,1927.0,0.868,10.883,1,1,1,0,0,0,0,0,0.0,0.0
1012,844,2020-03-18 05:02:00,0,2220.0,1917.0,0.863,10.871,118,67,32,35,51,29,22,0,0.0,0.0
1012,845,2020-03-18 05:05:00,0,2538.0,2158.0,0.851,12.388,205,85,55,30,120,86,34,59,0.0,0.01
1012,846,2020-03-18 05:08:00,0,2213.0,1919.0,0.867,10.844,143,101,50,51,42,22,20,39,0.0,0.0
1012,847,2020-03-18 05:11:00,0,2217.0,1903.0,0.858,10.841,112,76,32,44,36,9,27,4,0.0,0.0
1012,848,2020-03-18 05:14:00,0,2487.0,2248.0,0.904,12.287,164,63,28,35,101,54,47,3,0.0,0.0
1012,849,2020-03-18 05:17:00,0,2583.0,2267.0,0.877,12.688,17,0,0,0,17,0,17,0,0.0,0.0
1012,850,2020-03-18 05:20:00,0,2514.0,2180.0,0.867,12.319,22,0,0,0,22,0,22,0,0.0,0.0
1012,851,2020-03-18 05:23:00,0,2405.0,2085.5,0.867,11.7845,6,0,0,0,6,1,5,0,0.0,0.0
1012,852,2020-03-18 05:26:00,0,2296.0,1991.0,0.867,11.25,29,11,7,4,18,10,8,2,0.0,0.0
1012,853,2020-03-18 05:29:00,0,2308.0,2005.0,0.869,11.314,2,1,1,0,1,0,1,0,0.0,0.0
1012,854,2020-03-18 05:32:00,0,2315.0,1914.0,0.827,11.24,1,1,0,1,0,0,0,0,0.0,0.0
1012,855,2020-03-18 05:35:00,0,2308.0,1941.0,0.841,11.244,0,0,0,0,0,0,0,0,0.0,0.0
1012,856,2020-03-18 05:38:00,0,2306.0,1942.0,0.842,11.237,12,2,1,1,10,1,9,0,0.0,0.0
1012,857,2020-03-18 05:41:00,0,2309.0,1952.0,0.846,11.257,18,12,0,12,6,0,6,0,0.0,0.0
1012,858,2020-03-18 05:44:00,0,2283.0,2044.0,0.896,11.258,2,1,0,1,1,0,1,0,0.0,0.0
1012,859,2020-03-18 05:47:00,0,2289.0,2007.0,0.877,11.239,2,2,1,1,0,0,0,0,0.0,0.0
1012,860,2020-03-18 05:50:00,0,2284.0,2041.0,0.894,11.259,184,90,49,41,94,63,31,23,0.0,0.0
1012,861,2020-03-18 05:53:00,0,3177.0,2768.0,0.871,15.581,255,119,57,62,136,86,50,26,0.0,0.0
1012,862,2020-03-18 05:56:00,0,3400.0,2966.0,0.872,16.681,223,111,58,53,112,70,42,13,0.0,0.01
1012,863,2020-03-18 05:59:00,0,2353.0,2078.0,0.883,11.57,440,185,135,50,255,201,54,88,0.0,0.02
1012,864,2020-03-18 06:02:00,1,2439.0,2102.0,0.862,11.938,682,260,204,56,422,341,81,190,0.07,0.0
1012,865,2020-03-18 06:05:00,1,2807.0,2446.0,0.871,13.769,356,151,111,40,205,151,54,75,0.07,0.01
1012,866,2020-03-18 06:08:00,1,2955.0,2560.0,0.866,14.476,327,113,79,34,214,151,63,64,0.0,0.02
1012,867,2020-03-18 06:11:00,1,3018.0,2688.0,0.891,14.867,263,91,57,34,172,123,49,67,0.0,0.0
1012,868,2020-03-18 06:14:00,1,3024.0,2665.0,0.881,14.865,314,116,74,42,198,137,61,27,0.0,0.0
1012,869,2020-03-18 06:17:00,1,3714.0,3147.0,0.847,18.118,202,80,32,48,122,65,57,9,0.0,0.01
1012,870,2020-03-18 06:20:00,1,3543.0,3091.0,0.872,17.381,165,70,35,35,95,49,46,28,0.0,0.0
1012,871,2020-03-18 06:23:00,1,3402.0,2957.0,0.869,16.676,110,40,13,27,70,29,41,38,0.0,0.07
1012,872,2020-03-18 06:26:00,1,2856.0,2565.0,0.898,14.093,278,100,71,29,178,127,51,21,0.07,0.09
1012,873,2020-03-18 06:29:00,1,2737.0,2390.0,0.873,13.431,410,160,115,45,250,167,83,35,0.0,0.0
1012,874,2020-03-18 06:32:00,1,2663.0,2290.0,0.86,13.027,471,264,175,89,207,137,70,17,0.0,0.0
1012,875,2020-03-18 06:35:00,1,2450.0,2089.0,0.853,11.968,1027,399,306,93,628,498,130,30,0.0,0.0
1012,876,2020-03-18 06:38:00,1,2520.0,2187.0,0.868,12.349,655,326,253,73,329,239,90,4,0.0,0.0
1012,877,2020-03-18 06:41:00,1,2595.0,2277.0,0.877,12.744,257,104,55,49,153,93,60,21,0.0,0.03
1012,878,2020-03-18 06:44:00,1,2225.0,1913.0,0.86,10.883,118,36,3,33,82,38,44,0,0.0,0.0
1012,879,2020-03-18 06:47:00,1,2144.0,1898.0,0.885,10.547,70,47,14,33,23,10,13,0,0.0,0.0
1012,880,2020-03-18 06:50:00,1,2158.0,1835.0,0.851,10.533,0,0,0,0,0,0,0,0,0.0,0.0
1012,881,2020-03-18 06:53:00,1,2155.0,1801.0,0.836,10.484,0,0,0,0,0,0,0,0,0.0,0.0
1012,882,2020-03-18 06:56:00,1,2310.0,1934.0,0.837,11.242,40,14,3,11,26,16,10,0,0.0,0.0
1012,883,2020-03-18 06:59:00,1,2517.0,2251.0,0.894,12.41,0,0,0,0,0,0,0,0,0.0,0.0
1012,884,2020-03-18 07:02:00,1,2726.0,2394.0,0.878,13.39,28,10,5,5,18,12,6,0,0.0,0.0
1012,885,2020-03-18 07:05:00,1,2817.0,2447.0,0.869,13.807,3,3,0,3,0,0,0,0,0.0,0.0
1012,886,2020-03-18 07:08:00,1,2820.0,2429.0,0.861,13.802,0,0,0,0,0,0,0,0,0.0,0.0
1012,887,2020-03-18 07:11:00,1,2664.0,2298.0,0.863,13.039,11,11,0,11,0,0,0,0,0.0,0.0
1012,888,2020-03-18 07:14:00,1,2505.0,2239.0,0.894,12.349,1,1,0,1,0,0,0,0,0.0,0.0
1012,889,2020-03-18 07:17:00,1,2510.0,2166.0,0.863,12.287,6,4,0,4,2,0,2,0,0.0,0.0
1012,890,2020-03-18 07:20:00,1,2361.0,2075.0,0.879,11.6,13,8,0,8,5,0,5,0,0.0,0.0
1012,891,2020-03-18 07:23:00,1,2288.0,2006.0,0.877,11.233,25,10,0,10,15,5,10,0,0.0,0.0
1012,892,2020-03-18 07:26:00,1,2293.0,1948.0,0.849,11.193,8,0,0,0,8,0,8,0,0.0,0.0
1012,893,2020-03-18 07:29:00,1,2218.0,1901.0,0.857,10.842,28,11,6,5,17,7,10,0,0.0,0.0
1012,894,2020-03-18 07:32:00,1,2305.0,1948.0,0.845,11.238,5,1,1,0,4,0,4,0,0.0,0.0
1012,895,2020-03-18 07:35:00,1,2140.0,1892.0,0.884,10.526,0,0,0,0,0,0,0,0,0.0,0.0
1012,896,2020-03-18 07:38:00,1,2142.0,1858.0,0.867,10.498,2,2,0,2,0,0,0,0,0.0,0.0
1012,897,2020-03-18 07:41:00,1,2157.0,1826.0,0.847,10.52,20,0,0,0,20,5,15,0,0.0,0.0
1012,898,2020-03-18 07:44:00,1,2150.0,1813.0,0.843,10.477,7,1,1,0,6,2,4,0,0.0,0.0
1012,899,2020-03-18 07:47:00,1,2172.0,1779.0,0.819,10.529,12,11,0,11,1,0,1,0,0.0,0.0
1012,900,2020-03-18 07:50:00,1,2000.0,1741.0,0.87,9.807,12,4,0,4,8,0,8,0,0.0,0.0
1012,901,2020-03-18 07:53:00,1,1994.0,1717.0,0.861,9.757,3,2,0,2,1,0,1,0,0.0,0.0
1012,902,2020-03-18 07:56:00,1,2160.0,1806.0,0.836,10.511,137,65,25,40,72,40,32,0,0.0,0.0
1012,903,2020-03-18 07:59:00,1,2292.0,2005.0,0.875,11.252,202,78,20,58,124,72,52,0,0.0,0.0
1012,904,2020-03-18 08:02:00,1,2494.0,2200.0,0.882,12.262,222,130,92,38,92,65,27,22,0.0,0.0
1012,905,2020-03-18 08:05:00,1,3343.0,2826.0,0.845,16.299,250,121,67,54,129,77,52,13,0.0,0.0
1012,906,2020-03-18 08:08:00,1,3544.0,3120.0,0.881,17.417,175,72,32,40,103,58,45,10,0.0,0.02
1012,907,2020-03-18 08:11:00,1,3556.0,3109.0,0.874,17.453,249,109,60,49,140,99,41,15,0.11,0.12
1012,908,2020-03-18 08:14:00,1,2419.0,2150.0,0.889,11.912,424,166,121,45,258,190,68,72,0.0,0.01
1012,909,2020-03-18 08:17:00,1,2649.0,2381.0,0.899,13.071,447,185,133,52,262,192,70,5,0.0,0.01
1012,910,2020-03-18 08:20:00,1,2807.0,2467.0,0.879,13.79,369,175,124,51,194,148,46,18,0.49,0.0
1012,911,2020-03-18 08:23:00,1,2567.5,2303.0,0.899,12.6655,287,129,91,38,158,115,43,17,0.0,0.0
1012,912,2020-03-18 08:26:00,1,2328.0,2139.0,0.919,11.541,197,79,46,33,118,79,39,60,0.0,0.0
1012,913,2020-03-18 08:29:00,1,2786.0,2496.0,0.896,13.739,320,145,96,49,175,115,60,74,0.0,0.0
1012,914,2020-03-18 08:32:00,1,2628.0,2420.0,0.921,13.032,215,118,65,53,97,55,42,23,0.0,0.0
1012,915,2020-03-18 08:35:00,1,3038.0,2678.0,0.882,14.934,107,21,6,15,86,40,46,0,0.0,0.0
1012,916,2020-03-18 08:38:00,1,3012.0,2707.0,0.899,14.864,43,9,3,6,34,13,21,0,0.0,0.0
1012,917,2020-03-18 08:41:00,1,2777.0,2557.0,0.921,13.771,1,0,0,0,1,1,0,0,0.0,0.0
1012,918,2020-03-18 08:44:00,1,2637.0,2427.0,0.92,13.076,6,4,1,3,2,0,2,0,0.0,0.0
1012,919,2020-03-18 08:47:00,1,2497.0,2219.0,0.889,12.293,3,1,0,1,2,0,2,0,0.0,0.0
1012,920,2020-03-18 08:50:00,1,2427.0,2163.0,0.891,11.957,12,7,0,7,5,0,5,0,0.0,0.0
1012,921,2020-03-18 08:53:00,1,2490.0,2243.0,0.901,12.295,0,0,0,0,0,0,0,0,0.0,0.0
1012,922,2020-03-18 08:56:00,1,2514.0,2240.0,0.891,12.386,117,50,22,28,67,40,27,0,0.0,0.0
1012,923,2020-03-18 08:59:00,1,2504.0,2282.0,0.911,12.391,0,0,0,0,0,0,0,0,0.0,0.0
1012,924,2020-03-18 09:02:00,1,2412.0,2165.0,0.897,11.901,3,0,0,0,3,0,3,0,0.0,0.0
1012,925,2020-03-18 09:05:00,1,2278.0,2036.0,0.894,11.228,0,0,0,0,0,0,0,0,0.0,0.0
1012,926,2020-03-18 09:08:00,1,2198.0,1951.0,0.888,10.819,0,0,0,0,0,0,0,0,0.0,0.0
1012,927,2020-03-18 09:11:00,1,2299.0,1952.0,0.849,11.218,117,49,22,27,68,32,36,4,0.0,0.0
1012,928,2020-03-18 09:14:00,1,2432.0,2142.0,0.881,11.955,190,109,73,36,81,54,27,46,0.0,0.0
1012,929,2020-03-18 09:17:00,1,3041.0,2599.0,0.855,14.86,190,100,53,47,90,42,48,1,0.0,0.0
1012,930,2020-03-18 09:20:00,1,3183.0,2834.0,0.89,15.678,190,114,56,58,76,42,34,7,0.0,0.0
1012,931,2020-03-18 09:23:00,1,2648.0,2383.0,0.9,13.07,51,27,15,12,24,16,8,1,0.0,0.18
1012,932,2020-03-18 09:26:00,1,2136.0,1875.0,0.878,10.49,196,62,46,16,134,93,41,26,0.0,0.01
1012,933,2020-03-18 09:29:00,1,2297.0,1951.0,0.849,11.212,634,305,231,74,329,248,81,25,0.0,0.0
1012,934,2020-03-18 09:32:00,1,2510.0,2200.0,0.877,12.327,642,293,216,77,349,257,92,25,0.0,0.08
1012,935,2020-03-18 09:35:00,1,2580.0,2289.0,0.887,12.7,629,258,184,74,371,275,96,12,0.0,0.0
1012,936,2020-03-18 09:38:00,1,2350.0,2146.0,0.913,11.634,647,270,202,68,377,285,92,12,0.0,0.0
1012,937,2020-03-18 09:41:00,1,2352.0,2115.0,0.899,11.61,166,107,59,48,59,32,27,0,0.0,0.0
1012,938,2020-03-18 09:44:00,1,2664.0,2339.0,0.878,13.087,72,40,12,28,32,3,29,0,0.0,0.0
1012,939,2020-03-18 09:47:00,1,2773.0,2634.0,0.95,13.841,91,54,6,48,37,12,25,0,0.0,0.0
1012,940,2020-03-18 09:50:00,1,2852.0,2686.0,0.942,14.209,82,67,33,34,15,5,10,0,0.0,0.0
1012,941,2020-03-18 09:53:00,1,2801.0,2534.0,0.905,13.841,3,0,0,0,3,1,2,0,0.0,0.0
1012,942,2020-03-18 09:56:00,1,2643.0,2372.0,0.897,13.037,12,9,3,6,3,1,2,0,0.0,0.0
1012,943,2020-03-18 09:59:00,1,2500.0,2266.0,0.906,12.359,10,10,0,10,0,0,0,0,0.0,0.0
1012,944,2020-03-18 10:02:00,1,2422.0,2197.0,0.907,11.976,9,4,1,3,5,1,4,0,0.0,0.0
1012,945,2020-03-18 10:05:00,1,2243.0,2145.0,0.956,11.213,0,0,0,0,0,0,0,0,0.0,0.0
1012,946,2020-03-18 10:08:00,1,2268.0,2116.0,0.933,11.28,5,1,1,0,4,2,2,0,0.0,0.0
1012,947,2020-03-18 10:11:00,1,2268.0,2081.0,0.918,11.238,0,0,0,0,0,0,0,0,0.0,0.0
1012,948,2020-03-18 10:14:00,1,2291.0,2039.0,0.89,11.286,1,0,0,0,1,0,1,0,0.0,0.0
1012,949,2020-03-18 10:17:00,1,2205.0,1984.0,0.9,10.884,7,3,2,1,4,1,3,0,0.0,0.0
1012,950,2020-03-18 10:20:00,1,2133.0,1969.0,0.923,10.583,8,8,0,8,0,0,0,0,0.0,0.0
1012,951,2020-03-18 10:23:00,1,2119.0,1955.0,0.923,10.512,6,4,0,4,2,1,1,0,0.0,0.0
1012,952,2020-03-18 10:26:00,1,2126.0,1946.0,0.915,10.529,10,2,1,1,8,2,6,0,0.0,0.0
1012,953,2020-03-18 10:29:00,1,2116.0,1930.0,0.912,10.474,27,14,7,7,13,4,9,0,0.0,0.0
1012,954,2020-03-18 10:32:00,1,2289.0,2002.0,0.875,11.233,0,0,0,0,0,0,0,0,0.0,0.0
1012,955,2020-03-18 10:35:00,1,2126.0,1954.0,0.919,10.539,3,1,0,1,2,1,1,0,0.0,0.0
1012,956,2020-03-18 10:38:00,1,2140.0,1909.0,0.892,10.546,2,0,0,0,2,0,2,0,0.0,0.0
1012,957,2020-03-18 10:41:00,1,2134.0,1889.0,0.885,10.501,0,0,0,0,0,0,0,0,0.0,0.0
1012,958,2020-03-18 10:44:00,1,2141.0,1886.0,0.881,10.525,1,0,0,0,1,0,1,0,0.0,0.0
1012,959,2020-03-18 10:47:00,1,2120.0,1932.0,0.911,10.493,7,4,1,3,3,1,2,0,0.0,0.0
1012,960,2020-03-18 10:50:00,1,2269.0,2044.0,0.901,11.204,160,75,46,29,85,61,24,0,0.0,0.0
1012,961,2020-03-18 10:53:00,1,2291.0,1993.0,0.87,11.234,1,0,0,0,1,0,1,0,0.0,0.0
1012,962,2020-03-18 10:56:00,1,2136.0,1897.0,0.888,10.517,2,2,0,2,0,0,0,0,0.0,0.0
1012,963,2020-03-18 10:59:00,1,2150.0,1844.0,0.858,10.51,6,2,0,2,4,3,1,0,0.0,0.0
1012,964,2020-03-18 11:02:00,1,2146.0,1790.0,0.834,10.439,0,0,0,0,0,0,0,0,0.0,0.0
1012,965,2020-03-18 11:05:00,1,2081.0,1764.0,0.848,10.154,5,1,0,1,4,0,4,0,0.0,0.0
1012,966,2020-03-18 11:08:00,1,1985.0,1752.0,0.883,9.761,0,0,0,0,0,0,0,0,0.0,0.0
1012,967,2020-03-18 11:11:00,1,2168.0,1795.0,0.828,10.528,0,0,0,0,0,0,0,0,0.0,0.0
1012,968,2020-03-18 11:14:00,1,2158.0,1787.0,0.828,10.48,16,10,5,5,6,2,4,0,0.0,0.0
1012,969,2020-03-18 11:17:00,1,2292.0,1984.0,0.866,11.227,71,24,7,17,47,18,29,0,0.0,0.0
1012,970,2020-03-18 11:20:00,1,2467.0,2288.0,0.927,12.251,284,136,96,40,148,110,38,28,0.0,0.0
1012,971,2020-03-18 11:23:00,1,2473.5,2299.0,0.9295,12.289,142,64,30,34,78,42,36,10,0.0,0.0
1012,972,2020-03-18 11:26:00,1,2480.0,2310.0,0.932,12.327,73,36,17,19,37,22,15,10,0.0,0.0
1012,973,2020-03-18 11:29:00,1,2508.0,2192.0,0.874,12.308,27,22,0,22,5,4,1,0,0.0,0.0
1012,974,2020-03-18 11:32:00,1,2294.0,2045.0,0.892,11.3,5,3,1,2,2,1,1,0,0.0,0.0
1012,975,2020-03-18 11:35:00,1,2223.0,1923.0,0.865,10.885,18,17,0,17,1,0,1,0,0.0,0.0
1012,976,2020-03-18 11:38:00,1,2151.0,1828.0,0.85,10.497,5,2,0,2,3,0,3,0,0.0,0.0
1012,977,2020-03-18 11:41:00,1,2166.0,1800.0,0.831,10.528,5,4,0,4,1,0,1,0,0.0,0.0
1012,978,2020-03-18 11:44:00,1,2165.0,1822.0,0.842,10.547,1,1,0,1,0,0,0,0,0.0,0.0
1012,979,2020-03-18 11:47:00,1,2164.0,1765.0,0.816,10.482,10,9,0,9,1,0,1,0,0.0,0.0
1012,980,2020-03-18 11:50:00,1,2162.0,1773.0,0.82,10.479,19,9,0,9,10,3,7,0,0.0,0.0
1012,981,2020-03-18 11:53:00,1,2160.0,1821.0,0.843,10.527,13,2,0,2,11,7,4,0,0.0,0.0
1012,982,2020-03-18 11:56:00,1,2166.0,1806.0,0.834,10.532,0,0,0,0,0,0,0,0,0.0,0.0
1012,983,2020-03-18 11:59:00,1,2166.0,1807.0,0.834,10.532,4,0,0,0,4,0,4,0,0.0,0.0
1012,984,2020-03-18 12:02:00,1,2150.0,1790.0,0.833,10.454,14,2,0,2,12,2,10,0,0.0,0.0
1012,985,2020-03-18 12:05:00,1,2154.0,1797.0,0.834,10.478,0,0,0,0,0,0,0,0,0.0,0.0
1012,986,2020-03-18 12:08:00,1,2173.0,1766.0,0.813,10.517,4,0,0,0,4,1,3,0,0.0,0.0
1012,987,2020-03-18 12:11:00,1,1917.0,1681.0,0.877,9.413,6,0,0,0,6,2,4,0,0.0,0.0
1012,988,2020-03-18 12:14:00,1,1923.0,1690.0,0.879,9.448,34,2,1,1,32,7,25,0,0.0,0.0
1012,989,2020-03-18 12:17:00,1,2090.0,1731.0,0.828,10.149,17,2,0,2,15,5,10,0,0.0,0.0
1012,990,2020-03-18 12:20:00,1,2174.0,1744.0,0.802,10.496,23,10,2,8,13,8,5,0,0.0,0.0
1012,991,2020-03-18 12:23:00,1,2304.0,1941.0,0.842,11.226,260,115,82,33,145,98,47,51,0.0,0.0
1012,992,2020-03-18 12:26:00,1,2440.0,2130.0,0.873,11.971,337,252,207,45,85,42,43,0,0.0,0.0
1012,993,2020-03-18 12:29:00,1,2498.0,2227.0,0.892,12.307,909,845,720,125,64,17,47,4,0.0,0.0
1012,994,2020-03-18 12:32:00,1,2659.0,2372.0,0.892,13.102,1056,974,842,132,82,51,31,7,0.0,0.14
1012,995,2020-03-18 12:35:00,1,2881.0,2569.0,0.892,14.194,833,825,698,127,8,0,8,0,0.0,0.0
1012,996,2020-03-18 12:38:00,1,2873.0,2577.0,0.897,14.171,900,748,632,116,152,118,34,30,0.0,0.0
1012,997,2020-03-18 12:41:00,1,2568.0,2301.0,0.896,12.665,540,222,161,61,318,239,79,56,0.0,0.01
1012,998,2020-03-18 12:44:00,1,2646.0,2364.0,0.893,13.043,445,234,172,62,211,153,58,13,0.0,0.0
1012,999,2020-03-18 12:47:00,1,2780.0,2502.0,0.9,13.722,499,223,158,65,276,193,83,67,0.04,0.0
1012,1000,2020-03-18 12:50:00,1,2780.0,2487.0,0.895,13.707,822,278,204,74,544,441,103,6,0.0,0.0
1012,1001,2020-03-18 12:53:00,1,2814.0,2472.0,0.878,13.822,338,141,98,43,197,133,64,18,0.0,0.01
1012,1002,2020-03-18 12:56:00,1,2671.0,2338.0,0.875,13.113,26,7,2,5,19,5,14,0,0.0,0.0
1012,1003,2020-03-18 12:59:00,1,2805.0,2469.0,0.88,13.786,154,74,23,51,80,42,38,0,0.0,0.0
1012,1004,2020-03-18 13:02:00,1,2631.0,2437.0,0.926,13.065,9,0,0,0,9,4,5,0,0.0,0.0
1012,1005,2020-03-18 13:05:00,1,2488.0,2297.0,0.923,12.346,17,12,4,8,5,3,2,0,0.0,0.0
1012,1006,2020-03-18 13:08:00,1,2433.0,2160.0,0.888,11.977,9,9,0,9,0,0,0,0,0.0,0.0
1012,1007,2020-03-18 13:11:00,1,2240.0,2102.0,0.938,11.151,8,2,0,2,6,0,6,0,0.0,0.0
1012,1008,2020-03-18 13:14:00,1,2256.0,2116.0,0.938,11.233,3,1,0,1,2,0,2,0,0.0,0.0
1012,1009,2020-03-18 13:17:00,1,2278.0,2069.0,0.908,11.264,1,0,0,0,1,0,1,0,0.0,0.0
1012,1010,2020-03-18 13:20:00,1,2285.0,2006.0,0.878,11.222,4,4,1,3,0,0,0,0,0.0,0.0
1012,1011,2020-03-18 13:23:00,1,2290.0,1997.0,0.872,11.232,1,0,0,0,1,0,1,0,0.0,0.0
1012,1012,2020-03-18 13:26:00,1,2206.0,1955.0,0.886,10.857,26,4,0,4,22,0,22,0,0.0,0.0
1012,1013,2020-03-18 13:29:00,1,2119.0,1935.0,0.913,10.493,5,2,0,2,3,0,3,0,0.0,0.0
1012,1014,2020-03-18 13:32:00,1,2218.0,1965.0,0.886,10.915,2,0,0,0,2,0,2,0,0.0,0.0
1012,1015,2020-03-18 13:35:00,1,2125.0,1940.0,0.913,10.519,1,1,0,1,0,0,0,0,0.0,0.0
1012,1016,2020-03-18 13:38:00,1,2129.0,1918.0,0.901,10.513,57,7,3,4,50,10,40,0,0.0,0.0
1012,1017,2020-03-18 13:41:00,1,2204.0,1941.0,0.881,10.835,1,0,0,0,1,0,1,0,0.0,0.0
1012,1018,2020-03-18 13:44:00,1,2223.0,1942.0,0.874,10.908,0,0,0,0,0,0,0,0,0.0,0.0
1012,1019,2020-03-18 13:47:00,1,2132.0,1908.0,0.895,10.512,18,4,1,3,14,1,13,0,0.0,0.0
1012,1020,2020-03-18 13:50:00,1,2130.0,1923.0,0.903,10.519,13,3,0,3,10,0,10,0,0.0,0.0
1012,1021,2020-03-18 13:53:00,1,2291.0,2026.0,0.884,11.269,199,71,33,38,128,53,75,2,0.0,0.0
1012,1022,2020-03-18 13:56:00,1,2435.0,2158.0,0.886,11.983,229,136,74,62,93,45,48,3,0.0,0.0
1012,1023,2020-03-18 13:59:00,1,2491.0,2235.0,0.897,12.291,218,122,84,38,96,59,37,20,0.0,0.0
1012,1024,2020-03-18 14:02:00,1,2503.0,2237.0,0.894,12.338,8,5,0,5,3,1,2,0,0.0,0.0
1012,1025,2020-03-18 14:05:00,1,2265.0,2115.0,0.934,11.265,17,17,10,7,0,0,0,0,0.0,0.0
1012,1026,2020-03-18 14:08:00,1,2284.0,2023.0,0.886,11.238,5,4,0,4,1,1,0,0,0.0,0.0
1012,1027,2020-03-18 14:11:00,1,2296.0,1942.0,0.846,11.195,6,6,0,6,0,0,0,0,0.0,0.0
1012,1028,2020-03-18 14:14:00,1,2131.0,1921.0,0.901,10.524,4,4,0,4,0,0,0,0,0.0,0.0
1012,1029,2020-03-18 14:17:00,1,2132.0,1902.0,0.892,10.507,10,6,3,3,4,0,4,0,0.0,0.0
1012,1030,2020-03-18 14:20:00,1,2143.0,1900.0,0.887,10.545,0,0,0,0,0,0,0,0,0.0,0.0
1012,1031,2020-03-18 14:23:00,1,2144.0,1889.5,0.8815,10.539,4,2,1,1,2,1,1,0,0.0,0.0
1012,1032,2020-03-18 14:26:00,1,2145.0,1879.0,0.876,10.533,37,21,8,13,16,8,8,0,0.0,0.0
1012,1033,2020-03-18 14:29:00,1,2148.0,1879.0,0.875,10.543,3,1,0,1,2,1,1,0,0.0,0.0
1012,1034,2020-03-18 14:32:00,1,2138.0,1841.0,0.861,10.46,58,30,20,10,28,12,16,2,0.0,0.0
1012,1035,2020-03-18 14:35:00,1,2296.0,1983.0,0.864,11.24,188,90,57,33,98,59,39,1,0.0,0.0
1012,1036,2020-03-18 14:38:00,1,2264.0,2084.0,0.92,11.225,23,0,0,0,23,11,12,0,0.0,0.0
1012,1037,2020-03-18 14:41:00,1,2279.0,2002.0,0.879,11.194,41,22,13,9,19,12,7,0,0.0,0.0
1012,1038,2020-03-18 14:44:00,1,2293.0,1989.0,0.867,11.237,7,5,0,5,2,2,0,0,0.0,0.0
1012,1039,2020-03-18 14:47:00,1,2131.0,1931.0,0.906,10.535,22,9,0,9,13,4,9,0,0.0,0.0
1012,1040,2020-03-18 14:50:00,1,2287.0,2003.0,0.876,11.229,273,150,116,34,123,91,32,32,0.0,0.0
1012,1041,2020-03-18 14:53:00,1,2137.0,1927.0,0.902,10.554,0,0,0,0,0,0,0,0,0.0,0.0
1012,1042,2020-03-18 14:56:00,1,2134.0,1900.0,0.89,10.511,0,0,0,0,0,0,0,0,0.0,0.0
1012,1043,2020-03-18 14:59:00,1,2152.0,1861.0,0.865,10.541,30,12,6,6,18,6,12,0,0.0,0.0
1012,1044,2020-03-18 15:02:00,1,2163.0,1806.0,0.835,10.522,26,7,5,2,19,1,18,0,0.0,0.0
1012,1045,2020-03-18 15:05:00,1,2155.0,1820.0,0.845,10.505,29,5,2,3,24,3,21,0,0.0,0.0
1012,1046,2020-03-18 15:08:00,1,2162.0,1809.0,0.837,10.523,8,4,2,2,4,1,3,0,0.0,0.0
1012,1047,2020-03-18 15:11:00,1,2159.0,1833.0,0.849,10.534,12,9,2,7,3,1,2,0,0.0,0.0
1012,1048,2020-03-18 15:14:00,1,2150.0,1853.0,0.862,10.521,17,13,0,13,4,0,4,0,0.0,0.0
1012,1049,2020-03-18 15:17:00,1,2139.0,1870.0,0.874,10.5,11,7,2,5,4,0,4,0,0.0,0.0
1012,1050,2020-03-18 15:20:00,1,2133.0,1856.0,0.87,10.461,8,1,0,1,7,4,3,0,0.0,0.0
1012,1051,2020-03-18 15:23:00,1,2134.0,1894.0,0.887,10.504,2,0,0,0,2,0,2,0,0.0,0.0
1012,1052,2020-03-18 15:26:00,1,2155.0,1848.0,0.857,10.538,0,0,0,0,0,0,0,0,0.0,0.0
1012,1053,2020-03-18 15:29:00,1,2172.0,1779.0,0.819,10.526,9,2,2,0,7,4,3,0,0.0,0.0
1012,1054,2020-03-18 15:32:00,1,2160.0,1800.0,0.833,10.503,0,0,0,0,0,0,0,0,0.0,0.0
1012,1055,2020-03-18 15:35:00,1,2148.0,1811.0,0.843,10.47,0,0,0,0,0,0,0,0,0.0,0.0
1012,1056,2020-03-18 15:38:00,1,2152.0,1827.0,0.849,10.5,88,41,24,17,47,26,21,0,0.0,0.0
1012,1057,2020-03-18 15:41:00,1,2297.0,2016.0,0.878,11.282,105,57,17,40,48,14,34,2,0.0,0.0
1012,1058,2020-03-18 15:44:00,1,2508.0,2207.0,0.88,12.326,182,82,37,45,100,46,54,2,0.0,0.0
1012,1059,2020-03-18 15:47:00,1,2638.0,2346.0,0.889,12.99,176,82,47,35,94,41,53,8,0.0,0.0
1012,1060,2020-03-18 15:50:00,1,3155.0,2793.0,0.885,15.525,117,52,21,31,65,40,25,12,0.0,0.0
1012,1061,2020-03-18 15:53:00,1,3187.0,2788.0,0.875,15.645,148,68,39,29,80,53,27,31,0.14,0.05
1012,1062,2020-03-18 15:56:00,1,3018.0,2668.0,0.884,14.845,219,122,75,47,97,62,35,59,0.0,0.02
1012,1063,2020-03-18 15:59:00,1,3180.0,2807.0,0.883,15.636,214,78,48,30,136,93,43,24,0.0,0.08
1012,1064,2020-03-18 16:02:00,1,2654.0,2353.0,0.886,13.064,598,223,163,60,375,292,83,35,0.0,0.03
1012,1065,2020-03-18 16:05:00,1,2522.0,2166.0,0.859,12.337,732,326,243,83,406,316,90,10,0.0,0.01
1012,1066,2020-03-18 16:08:00,1,2518.0,2188.0,0.869,12.343,393,179,127,52,214,141,73,22,0.0,0.0
1012,1067,2020-03-18 16:11:00,1,2286.0,1994.0,0.872,11.213,804,380,290,90,424,325,99,9,0.0,0.0
1012,1068,2020-03-18 16:14:00,1,2795.0,2457.0,0.879,13.735,301,108,66,42,193,129,64,6,0.0,0.0
1012,1069,2020-03-18 16:17:00,1,2277.0,2051.0,0.901,11.241,93,46,9,37,47,23,24,0,0.0,0.0
1012,1070,2020-03-18 16:20:00,1,2286.0,1988.0,0.87,11.209,38,18,1,17,20,7,13,1,0.0,0.0
1012,1071,2020-03-18 16:23:00,1,2264.0,2108.0,0.931,11.255,14,9,2,7,5,2,3,0,0.0,0.0
1012,1072,2020-03-18 16:26:00,1,2265.0,2110.0,0.932,11.258,4,4,0,4,0,0,0,0,0.0,0.0
1012,1073,2020-03-18 16:29:00,1,2290.0,1978.0,0.864,11.211,6,2,2,0,4,0,4,0,0.0,0.0
1012,1074,2020-03-18 16:32:00,1,2139.0,1885.0,0.881,10.513,23,3,0,3,20,10,10,0,0.0,0.0
1012,1075,2020-03-18 16:35:00,1,2153.0,1848.0,0.858,10.53,18,17,1,16,1,0,1,0,0.0,0.0
1012,1076,2020-03-18 16:38:00,1,2153.0,1823.0,0.847,10.501,2,2,0,2,0,0,0,0,0.0,0.0
1012,1077,2020-03-18 16:41:00,1,2151.0,1828.0,0.85,10.499,49,45,2,43,4,2,2,0,0.0,0.0
1012,1078,2020-03-18 16:44:00,1,2142.0,1856.0,0.866,10.495,39,18,10,8,21,13,8,0,0.0,0.0
1012,1079,2020-03-18 16:47:00,1,2219.0,1911.0,0.861,10.858,451,0,0,0,451,386,65,0,0.0,0.0
1012,1080,2020-03-18 16:50:00,1,2357.0,2092.0,0.888,11.601,254,2,0,2,252,223,29,0,0.0,0.0
1012,1081,2020-03-18 16:53:00,1,2794.0,2526.0,0.904,13.806,10,5,0,5,5,2,3,0,0.0,0.0
1012,1082,2020-03-18 16:56:00,1,2802.0,2512.0,0.897,13.819,6,3,0,3,3,0,3,0,0.0,0.0
1012,1083,2020-03-18 16:59:00,1,2820.0,2425.0,0.86,13.796,1,1,0,1,0,0,0,0,0.0,0.0
1012,1084,2020-03-18 17:02:00,1,2661.0,2366.0,0.889,13.102,12,5,0,5,7,2,5,0,0.0,0.0
1012,1085,2020-03-18 17:05:00,1,2667.0,2278.0,0.854,13.031,6,0,0,0,6,0,6,0,0.0,0.0
1012,1086,2020-03-18 17:08:00,1,2506.0,2221.0,0.886,12.332,2,0,0,0,2,0,2,0,0.0,0.0
1012,1087,2020-03-18 17:11:00,1,2525.0,2131.0,0.844,12.309,5,1,0,1,4,0,4,0,0.0,0.0
1012,1088,2020-03-18 17:14:00,1,2445.0,2114.0,0.865,11.973,14,13,0,13,1,0,1,0,0.0,0.0
1012,1089,2020-03-18 17:17:00,1,2525.0,2155.0,0.853,12.334,121,56,27,29,65,24,41,0,0.0,0.0
1012,1090,2020-03-18 17:20:00,1,2574.0,2281.0,0.886,12.667,140,49,27,22,91,36,55,3,0.0,0.0
1012,1091,2020-03-18 17:23:00,1,2614.0,2313.5,0.885,12.861,47,14,2,12,33,13,20,0,0.0,0.0
1012,1092,2020-03-18 17:26:00,1,2654.0,2346.0,0.884,13.055,74,53,22,31,21,7,14,4,0.0,0.0
1012,1093,2020-03-18 17:29:00,1,2812.0,2437.0,0.867,13.778,234,118,71,47,116,77,39,7,0.0,0.0
1012,1094,2020-03-18 17:32:00,1,2489.0,2279.0,0.916,12.331,3,2,0,2,1,1,0,0,0.0,0.0
1012,1095,2020-03-18 17:35:00,1,2349.0,2110.0,0.898,11.592,20,7,4,3,13,4,9,0,0.0,0.0
1012,1096,2020-03-18 17:38:00,1,2298.0,2020.0,0.879,11.29,16,11,0,11,5,0,5,0,0.0,0.0
1012,1097,2020-03-18 17:41:00,1,2281.0,2046.0,0.897,11.253,14,10,1,9,4,0,4,0,0.0,0.0
1012,1098,2020-03-18 17:44:00,1,2291.0,1989.0,0.868,11.229,6,1,0,1,5,1,4,0,0.0,0.0
1012,1099,2020-03-18 17:47:00,1,2378.0,2047.0,0.861,11.634,40,22,12,10,18,10,8,0,0.0,0.0
1012,1100,2020-03-18 17:50:00,1,2369.0,2027.0,0.856,11.576,4,2,0,2,2,0,2,0,0.0,0.0
1012,1101,2020-03-18 17:53:00,1,2361.0,2025.0,0.858,11.545,4,1,0,1,3,0,3,0,0.0,0.0
1012,1102,2020-03-18 17:56:00,1,2458.0,2037.0,0.829,11.94,20,10,6,4,10,5,5,0,0.0,0.0
1012,1103,2020-03-18 17:59:00,1,2543.0,2066.0,0.813,12.309,137,49,20,29,88,44,44,2,0.0,0.0
1012,1104,2020-03-18 18:02:00,0,2609.0,2214.0,0.849,12.729,121,67,24,43,54,19,35,1,0.0,0.0
1012,1105,2020-03-18 18:05:00,0,2665.0,2319.0,0.87,13.067,97,50,22,28,47,16,31,2,0.0,0.0
1012,1106,2020-03-18 18:08:00,0,2818.0,2401.0,0.852,13.76,358,162,105,57,196,129,67,67,0.0,0.0
1012,1107,2020-03-18 18:11:00,0,3051.0,2556.0,0.838,14.849,353,180,133,47,173,113,60,75,0.0,0.0
1012,1108,2020-03-18 18:14:00,0,3209.0,2629.0,0.819,15.555,272,117,68,49,155,104,51,38,0.0,0.0
1012,1109,2020-03-18 18:17:00,0,3281.0,2753.0,0.839,15.975,220,103,49,54,117,68,49,41,0.0,0.0
1012,1110,2020-03-18 18:20:00,0,3563.0,3071.0,0.862,17.437,291,140,77,63,151,92,59,37,0.0,0.08
1012,1111,2020-03-18 18:23:00,0,3038.0,2626.0,0.864,14.879,399,201,146,55,198,145,53,93,0.0,0.09
1012,1112,2020-03-18 18:26:00,0,3196.0,2730.0,0.854,15.614,247,101,54,47,146,99,47,54,0.0,0.0
1012,1113,2020-03-18 18:29:00,0,3238.0,2805.0,0.866,15.864,142,40,12,28,102,53,49,35,0.0,0.0
1012,1114,2020-03-18 18:32:00,0,3182.0,2780.0,0.874,15.615,100,17,4,13,83,41,42,53,0.0,0.06
1012,1115,2020-03-18 18:35:00,0,3007.0,2719.0,0.904,14.857,227,106,62,44,121,80,41,34,0.07,0.05
1012,1116,2020-03-18 18:38:00,0,3239.0,2910.0,0.898,15.982,105,30,6,24,75,38,37,56,0.0,0.05
1012,1117,2020-03-18 18:41:00,0,3144.0,2912.0,0.926,15.612,282,127,72,55,155,110,45,51,0.09,0.07
1012,1118,2020-03-18 18:44:00,0,3302.0,3019.0,0.914,16.353,336,163,123,40,173,114,59,94,0.06,0.0
1012,1119,2020-03-18 18:47:00,0,2809.0,2490.0,0.886,13.825,76,26,13,13,50,24,26,1,0.0,0.0
1012,1120,2020-03-18 18:50:00,0,2491.0,2244.0,0.901,12.299,124,36,9,27,88,38,50,5,0.0,0.0
1012,1121,2020-03-18 18:53:00,0,2484.0,2279.0,0.917,12.311,89,31,18,13,58,39,19,8,0.0,0.01
1012,1122,2020-03-18 18:56:00,0,2485.0,2294.0,0.923,12.331,10,6,2,4,4,2,2,0,0.0,0.0
1012,1123,2020-03-18 18:59:00,0,2505.0,2248.0,0.897,12.358,0,0,0,0,0,0,0,0,0.0,0.0
1012,1124,2020-03-18 19:02:00,0,2252.0,2136.0,0.948,11.239,1,0,0,0,1,0,1,0,0.0,0.0
1012,1125,2020-03-18 19:05:00,0,2262.0,2090.0,0.924,11.226,8,2,1,1,6,2,4,0,0.0,0.01
1012,1126,2020-03-18 19:08:00,0,2205.0,1986.0,0.901,10.886,2,1,0,1,1,1,0,0,0.0,0.0
1012,1127,2020-03-18 19:11:00,0,2123.0,1986.0,0.935,10.564,39,13,9,4,26,16,10,0,0.0,0.0
1012,1128,2020-03-18 19:14:00,0,2119.0,1983.0,0.936,10.543,20,1,0,1,19,13,6,0,0.0,0.0
1012,1129,2020-03-18 19:17:00,0,2285.0,2019.0,0.884,11.239,7,0,0,0,7,3,4,0,0.0,0.0
1012,1130,2020-03-18 19:20:00,0,2268.0,2093.0,0.923,11.255,62,28,21,7,34,25,9,2,0.0,0.0
1012,1131,2020-03-18 19:23:00,0,2252.0,2135.0,0.948,11.236,23,16,1,15,7,1,6,0,0.0,0.0
1012,1132,2020-03-18 19:26:00,0,2484.0,2272.0,0.915,12.302,27,14,6,8,13,6,7,0,0.0,0.0
1012,1133,2020-03-18 19:29:00,0,3465.0,3348.0,0.966,17.361,164,82,39,43,82,44,38,3,0.0,0.0
1012,1134,2020-03-18 19:32:00,0,3670.0,3664.0,0.999,18.516,232,82,42,40,150,101,49,11,0.0,0.03
1012,1135,2020-03-18 19:35:00,0,3971.0,3921.0,0.988,19.985,125,45,21,24,80,55,25,45,0.0,0.03
1012,1136,2020-03-18 19:38:00,0,3851.0,3728.0,0.968,19.299,608,222,164,58,386,302,84,149,0.12,0.0
1012,1137,2020-03-18 19:41:00,0,3606.0,3581.0,0.993,18.171,573,205,145,60,368,279,89,148,0.0,0.04
1012,1138,2020-03-18 19:44:00,0,3614.0,3580.0,0.991,18.201,174,69,36,33,105,71,34,56,0.0,0.24
1012,1139,2020-03-18 19:47:00,0,2768.0,2600.0,0.939,13.783,15,2,1,1,13,2,11,0,0.0,0.01
1012,1140,2020-03-18 19:50:00,0,2554.0,2435.0,0.954,12.758,301,133,99,34,168,124,44,49,0.03,0.01
1012,1141,2020-03-18 19:53:00,0,3981.0,3879.0,0.974,19.981,345,131,91,40,214,152,62,78,0.08,0.01
1012,1142,2020-03-18 19:56:00,0,3606.0,3611.0,1.001,18.203,674,296,236,60,378,296,82,223,0.0,0.0
1012,1143,2020-03-18 19:59:00,0,3832.0,3713.0,0.969,19.208,429,178,129,49,251,199,52,188,0.0,0.0
1012,1144,2020-03-18 20:02:00,0,3680.0,3628.0,0.986,18.515,146,47,17,30,99,57,42,92,0.02,0.06
1012,1145,2020-03-18 20:05:00,0,3843.0,3701.0,0.963,19.237,319,135,94,41,184,133,51,85,0.08,0.05
1012,1146,2020-03-18 20:08:00,0,3711.0,3590.0,0.967,18.597,273,99,61,38,174,110,64,52,0.0,0.02
1012,1147,2020-03-18 20:11:00,0,3311.0,3263.0,0.986,16.657,512,203,149,54,309,233,76,48,0.05,0.01
1012,1148,2020-03-18 20:14:00,0,2804.0,2786.0,0.994,14.134,629,301,220,81,328,250,78,5,0.0,0.0
1012,1149,2020-03-18 20:17:00,0,3329.0,3233.0,0.971,16.695,477,218,161,57,259,187,72,19,0.02,0.05
1012,1150,2020-03-18 20:20:00,0,2742.0,2716.0,0.99,13.811,229,118,73,45,111,68,43,45,0.0,0.0
1012,1151,2020-03-18 20:23:00,0,2675.0,2607.5,0.974,13.427,103,84,22,62,19,7,12,18,0.0,0.0
1012,1152,2020-03-18 20:26:00,0,2608.0,2499.0,0.958,13.043,148,76,31,45,72,34,38,51,0.0,0.0
1012,1153,2020-03-18 20:29:00,0,2757.0,2626.0,0.953,13.77,31,27,14,13,4,1,3,0,0.0,0.0
1012,1154,2020-03-18 20:32:00,0,2629.0,2460.0,0.936,13.082,0,0,0,0,0,0,0,0,0.0,0.0
1012,1155,2020-03-18 20:35:00,0,2479.0,2330.0,0.94,12.346,15,15,0,15,0,0,0,0,0.0,0.0
1012,1156,2020-03-18 20:38:00,0,2230.0,2231.0,1.0,11.258,42,42,0,42,0,0,0,0,0.0,0.0
1012,1157,2020-03-18 20:41:00,0,2244.0,2190.0,0.976,11.267,18,16,2,14,2,1,1,0,0.0,0.0
1012,1158,2020-03-18 20:44:00,0,2229.0,2191.0,0.983,11.207,6,6,1,5,0,0,0,0,0.0,0.0
1012,1159,2020-03-18 20:47:00,0,2245.0,2116.0,0.942,11.188,0,0,0,0,0,0,0,0,0.0,0.0
1012,1160,2020-03-18 20:50:00,0,2318.0,2241.0,0.967,11.615,8,7,3,4,1,1,0,0,0.0,0.0
1012,1161,2020-03-18 20:53:00,0,2735.0,2750.0,1.005,13.821,301,135,79,56,166,110,56,31,0.0,0.0
1012,1162,2020-03-18 20:56:00,0,3400.0,3343.0,0.983,17.098,163,89,54,35,74,43,31,19,0.0,0.0
1012,1163,2020-03-18 20:59:00,0,3321.0,3323.0,1.0,16.764,201,99,51,48,102,60,42,41,0.0,0.0
1012,1164,2020-03-18 21:02:00,0,3253.0,3217.0,0.989,16.379,201,97,72,25,104,68,36,46,0.0,0.0
1012,1165,2020-03-18 21:05:00,0,3264.0,3174.0,0.972,16.375,125,38,17,21,87,46,41,45,0.0,0.0
1012,1166,2020-03-18 21:08:00,0,3613.0,3620.0,1.002,18.241,113,39,18,21,74,46,28,51,0.0,0.0
1012,1167,2020-03-18 21:11:00,0,3101.0,3016.0,0.973,15.557,397,162,126,36,235,179,56,98,0.0,0.03
1012,1168,2020-03-18 21:14:00,0,2970.0,2904.0,0.978,14.916,319,150,108,42,169,132,37,136,0.05,0.01
1012,1169,2020-03-18 21:17:00,0,3559.0,3456.0,0.971,17.849,187,81,41,40,106,74,32,61,0.0,0.01
1012,1170,2020-03-18 21:20:00,0,3490.0,3382.0,0.969,17.494,433,201,141,60,232,168,64,67,0.0,0.03
1012,1171,2020-03-18 21:23:00,0,3495.0,3379.0,0.967,17.511,345,151,101,50,194,135,59,59,0.0,0.0
1012,1172,2020-03-18 21:26:00,0,3112.0,3015.0,0.969,15.599,394,210,165,45,184,140,44,72,0.0,0.0
1012,1173,2020-03-18 21:29:00,0,3164.0,3126.0,0.988,15.926,404,152,107,45,252,184,68,21,0.0,0.0
1012,1174,2020-03-18 21:32:00,0,2595.0,2539.0,0.979,13.035,592,274,210,64,318,236,82,5,0.06,0.05
1012,1175,2020-03-18 21:35:00,0,2810.0,2747.0,0.977,14.114,301,131,94,37,170,118,52,197,0.02,0.0
1012,1176,2020-03-18 21:38:00,0,3621.0,3494.0,0.965,18.135,455,184,132,52,271,209,62,204,0.0,0.0
1012,1177,2020-03-18 21:41:00,0,2905.0,2800.0,0.964,14.545,699,359,274,85,340,259,81,20,0.0,0.0
1012,1178,2020-03-18 21:44:00,0,2767.0,2625.0,0.949,13.81,844,484,390,94,360,271,89,33,0.0,0.0
1012,1179,2020-03-18 21:47:00,0,3649.0,3441.0,0.943,18.186,335,159,99,60,176,113,63,75,0.0,0.0
1012,1180,2020-03-18 21:50:00,0,2973.0,2869.0,0.965,14.888,358,151,100,51,207,157,50,63,0.0,0.0
1012,1181,2020-03-18 21:53:00,0,3644.0,3455.0,0.948,18.183,161,58,20,38,103,76,27,49,0.0,0.01
1012,1182,2020-03-18 21:56:00,0,3771.0,3678.0,0.975,18.929,101,46,19,27,55,37,18,7,0.0,0.08
1012,1183,2020-03-18 21:59:00,0,3344.0,3195.0,0.955,16.712,318,136,89,47,182,137,45,79,0.0,0.0
1012,1184,2020-03-18 22:02:00,0,3553.0,3404.0,0.958,17.768,116,67,31,36,49,19,30,24,0.0,0.0
1012,1185,2020-03-18 22:05:00,0,3079.0,3044.0,0.989,15.501,269,111,69,42,158,106,52,9,0.07,0.1
1012,1186,2020-03-18 22:08:00,0,2827.0,2714.0,0.96,14.142,443,186,132,54,257,185,72,79,0.03,0.01
1012,1187,2020-03-18 22:11:00,0,2998.0,2829.0,0.944,14.945,523,219,155,64,304,217,87,123,0.03,0.0
1012,1188,2020-03-18 22:14:00,0,2615.0,2497.0,0.955,13.066,630,296,209,87,334,240,94,103,0.0,0.0
1012,1189,2020-03-18 22:17:00,0,2552.0,2374.0,0.93,12.685,851,382,292,90,469,363,106,95,0.01,0.0
1012,1190,2020-03-18 22:20:00,0,3623.0,3482.0,0.961,18.131,170,85,35,50,85,49,36,47,0.04,0.0
1012,1191,2020-03-18 22:23:00,0,3646.0,3465.0,0.951,18.201,112,52,26,26,60,31,29,31,0.0,0.02
1012,1192,2020-03-18 22:26:00,0,3036.0,2955.0,0.973,15.231,99,64,35,29,35,16,19,11,0.0,0.04
1012,1193,2020-03-18 22:29:00,0,2784.0,2563.0,0.921,13.805,87,43,10,33,44,7,37,0,0.0,0.0
1012,1194,2020-03-18 22:32:00,0,2624.0,2470.0,0.941,13.073,116,68,35,33,48,17,31,6,0.0,0.0
1012,1195,2020-03-18 22:35:00,0,2637.0,2461.0,0.933,13.114,17,4,3,1,13,2,11,0,0.0,0.0
1012,1196,2020-03-18 22:38:00,0,2459.0,2387.0,0.971,12.331,6,1,0,1,5,0,5,0,0.0,0.01
1012,1197,2020-03-18 22:41:00,0,2496.0,2282.0,0.914,12.36,41,15,0,15,26,23,3,0,0.0,0.0
1012,1198,2020-03-18 22:44:00,0,2477.0,2341.0,0.945,12.351,95,23,10,13,72,8,64,0,0.0,0.0
1012,1199,2020-03-18 22:47:00,0,2482.0,2336.0,0.941,12.367,314,163,119,44,151,101,50,23,0.02,0.0
1012,1200,2020-03-18 22:50:00,0,3340.0,3193.0,0.956,16.695,643,347,280,67,296,224,72,30,0.0,0.03
1012,1201,2020-03-18 22:53:00,0,3495.0,3298.0,0.944,17.42,164,64,22,42,100,53,47,59,0.0,0.0
1012,1202,2020-03-18 22:56:00,0,2736.0,2744.0,1.003,13.816,199,95,59,36,104,54,50,32,0.0,0.02
1012,1203,2020-03-18 22:59:00,0,2484.0,2355.0,0.948,12.393,429,176,132,44,253,179,74,66,0.05,0.0
1012,1204,2020-03-18 23:02:00,0,3183.0,3087.0,0.97,15.96,759,256,195,61,503,412,91,69,0.0,0.04
1012,1205,2020-03-18 23:05:00,0,3503.0,3285.0,0.938,17.44,546,232,171,61,314,243,71,83,0.01,0.04
1012,1206,2020-03-18 23:08:00,0,3643.0,3469.0,0.952,18.195,161,65,26,39,96,58,38,59,0.0,0.0
1012,1207,2020-03-18 23:11:00,0,3486.0,3392.0,0.973,17.488,176,86,44,42,90,61,29,31,0.0,0.0
1012,1208,2020-03-18 23:14:00,0,2744.0,2727.0,0.994,13.828,144,44,3,41,100,42,58,5,0.0,0.0
1012,1209,2020-03-18 23:17:00,0,2772.0,2639.0,0.952,13.845,77,55,23,32,22,10,12,4,0.0,0.0
1012,1210,2020-03-18 23:20:00,0,2696.0,2543.0,0.944,13.436,29,6,2,4,23,1,22,0,0.0,0.0
1012,1211,2020-03-18 23:23:00,0,2510.5,2382.5,0.95,12.5275,19,1,0,1,18,1,17,1,0.0,0.0
1012,1212,2020-03-18 23:26:00,0,2325.0,2222.0,0.956,11.619,26,2,1,1,24,0,24,2,0.0,0.0
1012,1213,2020-03-18 23:29:00,0,2319.0,2208.0,0.952,11.581,8,4,2,2,4,0,4,1,0.0,0.0
1012,1214,2020-03-18 23:32:00,0,2496.0,2253.0,0.902,12.33,2,0,0,0,2,0,2,1,0.0,0.0
1012,1215,2020-03-18 23:35:00,0,2480.0,2339.0,0.943,12.361,46,15,13,2,31,20,11,0,0.0,0.0
1012,1216,2020-03-18 23:38:00,0,3203.0,3101.0,0.968,16.052,6,4,1,3,2,1,1,2,0.0,0.0
1012,1217,2020-03-18 23:41:00,0,3096.0,3040.0,0.982,15.562,25,19,0,19,6,3,3,7,0.0,0.0
1012,1218,2020-03-18 23:44:00,0,3196.0,3093.0,0.968,16.018,262,147,94,53,115,85,30,28,0.0,0.0
1012,1219,2020-03-18 23:47:00,0,3276.0,3119.0,0.952,16.359,222,101,65,36,121,91,30,51,0.0,0.0
1012,1220,2020-03-18 23:50:00,0,3118.0,3061.0,0.981,15.674,108,38,9,29,70,34,36,67,0.0,0.0
1012,1221,2020-03-18 23:53:00,0,3275.0,3135.0,0.957,16.375,171,83,46,37,88,64,24,31,0.08,0.03
1012,1222,2020-03-18 23:56:00,0,2491.0,2290.0,0.919,12.35,168,84,26,58,84,37,47,21,0.0,0.0
1012,1223,2020-03-18 23:59:00,0,2267.0,2091.0,0.923,11.246,441,168,110,58,273,204,69,56,0.05,0.0
1012,1224,2020-03-19 00:02:00,0,3355.0,3185.0,0.949,16.746,330,145,98,47,185,132,53,70,0.0,0.08
1012,1225,2020-03-19 00:05:00,0,3485.0,3345.0,0.96,17.433,158,63,24,39,95,61,34,58,0.0,0.0
1012,1226,2020-03-19 00:08:00,0,3648.0,3469.0,0.951,18.215,155,68,35,33,87,59,28,47,0.0,0.0
1012,1227,2020-03-19 00:11:00,0,2764.0,2638.0,0.954,13.811,142,67,26,41,75,30,45,23,0.0,0.0
1012,1228,2020-03-19 00:14:00,0,2647.0,2372.0,0.896,13.056,61,55,6,49,6,3,3,21,0.0,0.0
1012,1229,2020-03-19 00:17:00,0,2503.0,2239.0,0.894,12.341,60,24,11,13,36,12,24,33,0.0,0.0
1012,1230,2020-03-19 00:20:00,0,2505.0,2246.0,0.897,12.357,11,5,3,2,6,0,6,22,0.0,0.0
1012,1231,2020-03-19 00:23:00,0,2632.0,2449.0,0.931,13.079,14,5,0,5,9,0,9,21,0.0,0.0
1012,1232,2020-03-19 00:26:00,0,2775.0,2576.0,0.928,13.786,30,16,10,6,14,6,8,18,0.0,0.0
1012,1233,2020-03-19 00:29:00,0,2972.0,2816.0,0.948,14.826,11,4,0,4,7,3,4,24,0.0,0.0
1012,1234,2020-03-19 00:32:00,0,2970.0,2797.0,0.942,14.799,9,4,0,4,5,0,5,34,0.0,0.0
1012,1235,2020-03-19 00:35:00,0,2982.0,2877.0,0.965,14.935,5,3,0,3,2,0,2,26,0.0,0.0
1012,1236,2020-03-19 00:38:00,0,2956.0,2896.0,0.98,14.854,0,0,0,0,0,0,0,28,0.0,0.0
1012,1237,2020-03-19 00:41:00,0,3136.0,2952.0,0.941,15.625,0,0,0,0,0,0,0,28,0.0,0.0
1012,1238,2020-03-19 00:44:00,0,3119.0,2943.0,0.943,15.547,35,19,14,5,16,9,7,28,0.0,0.0
1012,1239,2020-03-19 00:47:00,0,2981.0,2806.0,0.941,14.851,9,2,0,2,7,1,6,23,0.0,0.0
1012,1240,2020-03-19 00:50:00,0,2977.0,2844.0,0.955,14.878,233,116,75,41,117,74,43,34,0.0,0.0
1012,1241,2020-03-19 00:53:00,0,2973.0,2776.0,0.934,14.787,196,106,53,53,90,48,42,62,0.0,0.0
1012,1242,2020-03-19 00:56:00,0,3131.0,3026.0,0.967,15.684,311,129,83,46,182,135,47,98,0.3,0.0
1012,1243,2020-03-19 00:59:00,0,3363.0,3116.0,0.927,16.701,315,119,77,42,196,150,46,184,0.0,0.0
1012,1244,2020-03-19 01:02:00,0,3212.0,3034.0,0.945,16.014,204,92,61,31,112,78,34,191,0.0,0.0
1012,1245,2020-03-19 01:05:00,0,3142.0,2958.0,0.941,15.653,106,30,6,24,76,39,37,189,0.0,0.06
1012,1246,2020-03-19 01:08:00,0,3508.0,3239.0,0.923,17.407,410,157,113,44,253,192,61,177,0.0,0.04
1012,1247,2020-03-19 01:11:00,0,3132.0,2954.0,0.943,15.613,509,217,180,37,292,238,54,171,0.0,0.0
1012,1248,2020-03-19 01:14:00,0,3002.0,2788.0,0.929,14.914,527,175,116,59,352,270,82,83,0.0,0.03
1012,1249,2020-03-19 01:17:00,0,3115.0,2984.0,0.958,15.577,683,248,180,68,435,336,99,53,0.0,0.03
1012,1250,2020-03-19 01:20:00,0,2839.0,2686.0,0.946,14.157,924,356,273,83,568,452,116,80,0.0,0.0
1012,1251,2020-03-19 01:23:00,0,3656.0,3370.0,0.922,18.137,413,186,126,60,227,159,68,32,0.0,0.02
1012,1252,2020-03-19 01:26:00,0,3631.0,3507.0,0.966,18.186,122,41,6,35,81,35,46,46,0.0,0.0
1012,1253,2020-03-19 01:29:00,0,3522.0,3223.0,0.915,17.444,170,58,28,30,112,67,45,45,0.0,0.02
1012,1254,2020-03-19 01:32:00,0,2742.0,2626.0,0.958,13.71,490,246,174,72,244,180,64,15,0.0,0.0
1012,1255,2020-03-19 01:35:00,0,3582.0,3329.0,0.929,17.799,309,109,65,44,200,149,51,51,0.0,0.0
1012,1256,2020-03-19 01:38:00,0,3644.0,3346.0,0.918,18.062,157,59,17,42,98,55,43,39,0.1,0.06
1012,1257,2020-03-19 01:41:00,0,2973.0,2793.0,0.939,14.807,571,211,158,53,360,277,83,30,0.0,0.01
1012,1258,2020-03-19 01:44:00,0,2762.0,2600.0,0.941,13.762,192,53,24,29,139,83,56,4,0.0,0.0
1012,1259,2020-03-19 01:47:00,0,2806.0,2458.0,0.876,13.776,101,47,17,30,54,17,37,0,0.0,0.0
1012,1260,2020-03-19 01:50:00,0,2676.0,2352.0,0.879,13.149,129,76,34,42,53,17,36,7,0.0,0.0
1012,1261,2020-03-19 01:53:00,0,2624.0,2412.0,0.919,13.008,109,70,40,30,39,19,20,0,0.0,0.0
1012,1262,2020-03-19 01:56:00,0,2667.0,2337.0,0.876,13.097,128,62,33,29,66,42,24,27,0.0,0.0
1012,1263,2020-03-19 01:59:00,0,2852.0,2639.0,0.925,14.159,2,2,0,2,0,0,0,0,0.0,0.01
1012,1264,2020-03-19 02:02:00,0,3128.0,2891.0,0.924,15.525,12,7,0,7,5,1,4,0,0.0,0.0
1012,1265,2020-03-19 02:05:00,0,2994.0,2817.0,0.941,14.914,6,6,0,6,0,0,0,0,0.0,0.01
1012,1266,2020-03-19 02:08:00,0,3000.0,2733.0,0.911,14.846,10,10,0,10,0,0,0,0,0.0,0.0
1012,1267,2020-03-19 02:11:00,0,2986.0,2802.0,0.938,14.869,4,1,0,1,3,1,2,0,0.0,0.0
1012,1268,2020-03-19 02:14:00,0,3157.0,2850.0,0.903,15.594,67,1,0,1,66,25,41,0,0.0,0.0
1012,1269,2020-03-19 02:17:00,0,3069.0,2836.0,0.924,15.231,54,18,6,12,36,21,15,0,0.0,0.0
1012,1270,2020-03-19 02:20:00,0,3000.0,2793.0,0.931,14.913,4,1,1,0,3,0,3,0,0.0,0.0
1012,1271,2020-03-19 02:23:00,0,3006.0,2755.5,0.917,14.8945,5,1,0,1,4,2,2,0,0.0,0.0
1012,1272,2020-03-19 02:26:00,0,3012.0,2718.0,0.903,14.876,3,2,0,2,1,0,1,0,0.0,0.0
1012,1273,2020-03-19 02:29:00,0,2992.0,2726.0,0.911,14.806,247,133,88,45,114,73,41,29,0.0,0.0
1012,1274,2020-03-19 02:32:00,0,3529.0,3210.0,0.91,17.457,90,51,25,26,39,17,22,14,0.0,0.09
1012,1275,2020-03-19 02:35:00,0,3650.0,3450.0,0.945,18.2,89,28,6,22,61,29,32,28,0.0,0.1
1012,1276,2020-03-19 02:38:00,0,3293.0,3007.0,0.913,16.303,260,128,93,35,132,93,39,73,0.14,0.06
1012,1277,2020-03-19 02:41:00,0,3128.0,2946.0,0.942,15.585,573,233,169,64,340,277,63,131,0.0,0.01
1012,1278,2020-03-19 02:44:00,0,2977.0,2811.0,0.944,14.842,642,227,164,63,415,323,92,107,0.0,0.0
1012,1279,2020-03-19 02:47:00,0,2765.0,2605.0,0.942,13.779,543,240,161,79,303,212,91,119,0.0,0.0
1012,1280,2020-03-19 02:50:00,0,2521.0,2201.0,0.873,12.369,1108,531,395,136,577,437,140,123,0.0,0.0
1012,1281,2020-03-19 02:53:00,0,2503.0,2243.0,0.896,12.343,1027,627,528,99,400,299,101,140,0.0,0.0
1012,1282,2020-03-19 02:56:00,0,3296.0,3033.0,0.92,16.342,1087,603,499,104,484,358,126,114,0.0,0.0
1012,1283,2020-03-19 02:59:00,0,3645.0,3370.0,0.924,18.094,732,345,267,78,387,304,83,133,0.0,0.53
1012,1284,2020-03-19 03:02:00,0,3124.0,3015.0,0.965,15.646,0,0,0,0,0,0,0,84,0.0,0.0
1012,1285,2020-03-19 03:05:00,0,3516.0,3301.0,0.939,17.508,86,47,35,12,39,31,8,94,0.0,0.0
1012,1286,2020-03-19 03:08:00,0,3485.0,3348.0,0.961,17.439,600,276,216,60,324,242,82,121,0.19,0.0
1012,1287,2020-03-19 03:11:00,0,3489.0,3316.0,0.95,17.419,559,286,208,78,273,190,83,116,0.0,0.02
1012,1288,2020-03-19 03:14:00,0,3496.0,3287.0,0.94,17.413,568,198,147,51,370,272,98,119,0.15,0.0
1012,1289,2020-03-19 03:17:00,0,3101.0,3030.0,0.977,15.571,708,314,227,87,394,299,95,94,0.0,0.0
1012,1290,2020-03-19 03:20:00,0,3287.0,3051.0,0.928,16.328,673,271,194,77,402,305,97,87,0.0,0.02
1012,1291,2020-03-19 03:23:00,0,2991.0,2883.0,0.964,14.975,158,83,27,56,75,34,41,58,0.0,0.0
1012,1292,2020-03-19 03:26:00,0,3200.0,3055.0,0.954,15.991,88,48,8,40,40,9,31,49,0.0,0.0
1012,1293,2020-03-19 03:29:00,0,3104.0,2953.0,0.951,15.499,16,11,4,7,5,2,3,65,0.0,0.0
1012,1294,2020-03-19 03:32:00,0,2989.0,2784.0,0.931,14.857,19,9,2,7,10,3,7,71,0.0,0.0
1012,1295,2020-03-19 03:35:00,0,2755.0,2615.0,0.949,13.749,7,1,0,1,6,2,4,80,0.0,0.0
1012,1296,2020-03-19 03:38:00,0,2692.0,2503.0,0.93,13.379,1,0,0,0,1,0,1,64,0.0,0.0
1012,1297,2020-03-19 03:41:00,0,2640.0,2435.0,0.922,13.098,0,0,0,0,0,0,0,73,0.0,0.0
1012,1298,2020-03-19 03:44:00,0,2634.0,2434.0,0.924,13.073,64,26,13,13,38,19,19,72,0.0,0.0
1012,1299,2020-03-19 03:47:00,0,2791.0,2562.0,0.918,13.831,11,10,0,10,1,0,1,91,0.0,0.0
1012,1300,2020-03-19 03:50:00,0,2796.0,2572.0,0.92,13.865,6,3,0,3,3,2,1,81,0.0,0.0
1012,1301,2020-03-19 03:53:00,0,2637.0,2431.0,0.922,13.081,49,19,8,11,30,12,18,77,0.0,0.0
1012,1302,2020-03-19 03:56:00,0,2637.0,2441.0,0.926,13.09,1,1,1,0,0,0,0,77,0.0,0.0
1012,1303,2020-03-19 03:59:00,0,2543.0,2386.0,0.938,12.662,0,0,0,0,0,0,0,75,0.0,0.0
1012,1304,2020-03-19 04:02:00,0,2460.0,2355.0,0.957,12.298,6,5,2,3,1,1,0,86,0.0,0.0
1012,1305,2020-03-19 04:05:00,0,2461.0,2364.0,0.961,12.311,13,8,1,7,5,0,5,74,0.0,0.0
1012,1306,2020-03-19 04:08:00,0,2624.0,2489.0,0.949,13.093,158,65,32,33,93,65,28,76,0.0,0.0
1012,1307,2020-03-19 04:11:00,0,2778.0,2558.0,0.921,13.778,29,10,3,7,19,5,14,68,0.0,0.0
1012,1308,2020-03-19 04:14:00,0,2752.0,2596.0,0.943,13.718,273,138,101,37,135,101,34,113,0.06,0.0
1012,1309,2020-03-19 04:17:00,0,3364.0,3132.0,0.931,16.721,438,169,117,52,269,207,62,119,0.2,0.0
1012,1310,2020-03-19 04:20:00,0,2910.0,2783.0,0.956,14.548,655,265,205,60,390,301,89,24,0.0,0.0
1012,1311,2020-03-19 04:23:00,0,2979.0,2806.0,0.942,14.842,247,118,68,50,129,79,50,60,0.0,0.0
1012,1312,2020-03-19 04:26:00,0,3054.0,2914.0,0.954,15.259,114,51,15,36,63,35,28,49,0.0,0.0
1012,1313,2020-03-19 04:29:00,0,2481.0,2278.0,0.918,12.298,455,173,109,64,282,207,75,75,0.0,0.0
1012,1314,2020-03-19 04:32:00,0,2640.0,2454.0,0.929,13.12,96,49,39,10,47,32,15,31,0.0,0.0
1012,1315,2020-03-19 04:35:00,0,2273.0,2028.0,0.892,11.202,175,81,36,45,94,50,44,31,0.0,0.0
1012,1316,2020-03-19 04:38:00,0,2779.0,2585.0,0.93,13.811,334,105,78,27,229,162,67,62,0.0,0.0
1012,1317,2020-03-19 04:41:00,0,2998.0,2777.0,0.926,14.885,101,36,16,20,65,21,44,17,0.0,0.0
1012,1318,2020-03-19 04:44:00,0,3350.0,3238.0,0.967,16.785,178,73,25,48,105,59,46,3,0.0,0.0
1012,1319,2020-03-19 04:47:00,0,3355.0,3161.0,0.942,16.719,13,6,3,3,7,3,4,0,0.0,0.0
1012,1320,2020-03-19 04:50:00,0,3102.0,3065.0,0.988,15.617,18,10,5,5,8,2,6,0,0.0,0.0
1012,1321,2020-03-19 04:53:00,0,2972.0,2861.0,0.963,14.877,47,25,7,18,22,12,10,0,0.0,0.0
1012,1322,2020-03-19 04:56:00,0,2736.0,2688.0,0.983,13.754,9,2,1,1,7,1,6,0,0.0,0.0
1012,1323,2020-03-19 04:59:00,0,2605.0,2525.0,0.969,13.058,0,0,0,0,0,0,0,0,0.0,0.0
1012,1324,2020-03-19 05:02:00,0,2615.0,2500.0,0.956,13.07,5,2,0,2,3,0,3,0,0.0,0.0
1012,1325,2020-03-19 05:05:00,0,2700.0,2549.0,0.944,13.462,23,9,4,5,14,7,7,0,0.0,0.0
1012,1326,2020-03-19 05:08:00,0,2987.0,2773.0,0.928,14.841,128,48,22,26,80,36,44,17,0.0,0.0
1012,1327,2020-03-19 05:11:00,0,2959.0,2838.0,0.959,14.801,194,98,40,58,96,49,47,13,0.0,0.0
1012,1328,2020-03-19 05:14:00,0,3024.0,2943.0,0.973,15.174,182,77,30,47,105,54,51,9,0.0,0.0
1012,1329,2020-03-19 05:17:00,0,3049.0,2952.0,0.968,15.279,275,105,74,31,170,127,43,45,0.15,0.0
1012,1330,2020-03-19 05:20:00,0,2973.0,2885.0,0.97,14.906,296,130,82,48,166,124,42,84,0.0,0.0
1012,1331,2020-03-19 05:23:00,0,2872.0,2722.5,0.947,14.329,153,63,29,34,90,57,33,39,0.0,0.0
1012,1332,2020-03-19 05:26:00,0,2771.0,2560.0,0.924,13.752,620,254,198,56,366,271,95,72,0.0,0.0
1012,1333,2020-03-19 05:29:00,0,2758.0,2677.0,0.97,13.831,565,226,177,49,339,262,77,155,0.0,0.0
1012,1334,2020-03-19 05:32:00,0,2475.0,2329.0,0.941,12.329,498,182,124,58,316,234,82,31,0.0,0.0
1012,1335,2020-03-19 05:35:00,0,2476.0,2337.0,0.944,12.342,684,380,305,75,304,216,88,79,0.0,0.0
1012,1336,2020-03-19 05:38:00,0,2919.0,2705.0,0.927,14.497,192,91,47,44,101,56,45,39,0.0,0.0
1012,1337,2020-03-19 05:41:00,0,3130.0,2901.0,0.927,15.543,41,13,5,8,28,5,23,25,0.0,0.0
1012,1338,2020-03-19 05:44:00,0,3115.0,2963.0,0.951,15.552,120,58,12,46,62,19,43,28,0.0,0.0
1012,1339,2020-03-19 05:47:00,0,3126.0,2901.0,0.928,15.527,114,77,26,51,37,16,21,42,0.0,0.0
1012,1340,2020-03-19 05:50:00,0,2979.0,2862.0,0.961,14.905,73,48,12,36,25,4,21,47,0.0,0.0
1012,1341,2020-03-19 05:53:00,0,2839.0,2667.0,0.939,14.14,4,4,0,4,0,0,0,55,0.0,0.0
1012,1342,2020-03-19 05:56:00,0,2795.0,2532.0,0.906,13.813,3,0,0,0,3,0,3,59,0.0,0.0
1012,1343,2020-03-19 05:59:00,0,2713.0,2462.0,0.908,13.415,5,0,0,0,5,0,5,68,0.0,0.0
1012,1344,2020-03-19 06:02:00,1,2925.0,2684.0,0.917,14.497,353,167,116,51,186,126,60,95,0.0,0.0
1012,1345,2020-03-19 06:05:00,1,3083.0,2806.0,0.91,15.253,288,117,92,25,171,129,42,117,0.0,0.0
1012,1346,2020-03-19 06:08:00,1,2978.0,2822.0,0.948,14.857,321,163,135,28,158,106,52,145,0.0,0.0
1012,1347,2020-03-19 06:11:00,1,3075.0,2843.0,0.924,15.261,547,231,156,75,316,226,90,51,0.0,0.0
1012,1348,2020-03-19 06:14:00,1,2991.0,2810.0,0.939,14.896,612,342,250,92,270,183,87,21,0.0,0.0
1012,1349,2020-03-19 06:17:00,1,3211.0,2956.0,0.921,15.924,869,532,425,107,337,249,88,29,0.0,0.0
1012,1350,2020-03-19 06:20:00,1,3142.0,2939.0,0.935,15.634,512,233,184,49,279,205,74,15,0.0,0.0
1012,1351,2020-03-19 06:23:00,1,2862.0,2628.0,0.918,14.184,470,207,148,59,263,200,63,90,0.0,0.0
1012,1352,2020-03-19 06:26:00,1,3147.0,2861.0,0.909,15.565,247,141,94,47,106,68,38,117,0.0,0.0
1012,1353,2020-03-19 06:29:00,1,3068.0,2791.0,0.91,15.179,256,115,76,39,141,102,39,100,0.0,0.0
1012,1354,2020-03-19 06:32:00,1,3001.0,2755.0,0.918,14.874,600,225,157,68,375,294,81,88,0.0,0.0
1012,1355,2020-03-19 06:35:00,1,3022.0,2681.0,0.887,14.872,195,62,35,27,133,88,45,111,0.0,0.0
1012,1356,2020-03-19 06:38:00,1,2847.0,2607.0,0.916,14.104,574,192,126,66,382,285,97,113,0.0,0.0
1012,1357,2020-03-19 06:41:00,1,2773.0,2566.0,0.925,13.766,135,68,35,33,67,31,36,27,0.0,0.0
1012,1358,2020-03-19 06:44:00,1,2778.0,2581.0,0.929,13.801,55,32,10,22,23,6,17,0,0.0,0.0
1012,1359,2020-03-19 06:47:00,1,2790.0,2474.0,0.887,13.732,0,0,0,0,0,0,0,0,0.0,0.0
1012,1360,2020-03-19 06:50:00,1,2672.0,2302.0,0.861,13.078,41,23,15,8,18,11,7,0,0.0,0.0
1012,1361,2020-03-19 06:53:00,1,2498.0,2200.0,0.881,12.277,7,4,2,2,3,1,2,0,0.0,0.0
1012,1362,2020-03-19 06:56:00,1,2442.0,2148.0,0.88,12.001,13,7,0,7,6,1,5,0,0.0,0.0
1012,1363,2020-03-19 06:59:00,1,2509.0,2190.0,0.873,12.311,6,5,0,5,1,1,0,0,0.0,0.0
1012,1364,2020-03-19 07:02:00,1,2430.0,2134.0,0.878,11.936,2,0,0,0,2,0,2,0,0.0,0.0
1012,1365,2020-03-19 07:05:00,1,2522.0,2148.0,0.852,12.314,30,15,5,10,15,1,14,0,0.0,0.0
1012,1366,2020-03-19 07:08:00,1,2521.0,2147.0,0.852,12.309,6,4,0,4,2,1,1,0,0.0,0.0
1012,1367,2020-03-19 07:11:00,1,2519.0,2188.0,0.869,12.348,15,15,0,15,0,0,0,0,0.0,0.0
1012,1368,2020-03-19 07:14:00,1,2595.0,2243.0,0.864,12.709,15,5,3,2,10,3,7,0,0.0,0.0
1012,1369,2020-03-19 07:17:00,1,2516.0,2191.0,0.871,12.34,17,0,0,0,17,2,15,0,0.0,0.0
1012,1370,2020-03-19 07:20:00,1,2499.0,2214.0,0.886,12.297,4,0,0,0,4,0,4,0,0.0,0.0
1012,1371,2020-03-19 07:23:00,1,2590.0,2246.0,0.867,12.693,126,66,41,25,60,31,29,2,0.0,0.0
1012,1372,2020-03-19 07:26:00,1,2664.0,2323.0,0.872,13.067,62,20,12,8,42,24,18,0,0.0,0.0
1012,1373,2020-03-19 07:29:00,1,2814.0,2414.0,0.858,13.76,147,75,32,43,72,35,37,4,0.0,0.0
1012,1374,2020-03-19 07:32:00,1,2728.0,2412.0,0.884,13.418,357,149,108,41,208,147,61,40,0.0,0.0
1012,1375,2020-03-19 07:35:00,1,2809.0,2412.0,0.859,13.739,243,71,32,39,172,133,39,38,0.0,0.0
1012,1376,2020-03-19 07:38:00,1,2872.0,2565.0,0.893,14.153,163,55,29,26,108,66,42,32,0.0,0.0
1012,1377,2020-03-19 07:41:00,1,2515.0,2188.0,0.87,12.333,442,185,142,43,257,189,68,17,0.0,0.0
1012,1378,2020-03-19 07:44:00,1,2519.0,2200.0,0.873,12.36,297,164,100,64,133,90,43,5,0.0,0.0
1012,1379,2020-03-19 07:47:00,1,2651.0,2344.0,0.884,13.04,45,32,13,19,13,4,9,2,0.0,0.0
1012,1380,2020-03-19 07:50:00,1,2657.0,2343.0,0.882,13.062,4,0,0,0,4,1,3,0,0.0,0.0
1012,1381,2020-03-19 07:53:00,1,2670.0,2306.0,0.864,13.073,3,0,0,0,3,1,2,0,0.0,0.0
1012,1382,2020-03-19 07:56:00,1,2673.0,2290.0,0.857,13.067,3,0,0,0,3,0,3,0,0.0,0.01
1012,1383,2020-03-19 07:59:00,1,2660.0,2298.0,0.864,13.023,1,0,0,0,1,0,1,0,0.0,0.0
1012,1384,2020-03-19 08:02:00,1,2503.0,2254.0,0.901,12.359,1,1,0,1,0,0,0,0,0.0,0.0
1012,1385,2020-03-19 08:05:00,1,2656.0,2299.0,0.866,13.01,0,0,0,0,0,0,0,0,0.0,0.0
1012,1386,2020-03-19 08:08:00,1,2664.0,2362.0,0.887,13.11,1,0,0,0,1,1,0,0,0.0,0.0
1012,1387,2020-03-19 08:11:00,1,2663.0,2373.0,0.891,13.119,5,0,0,0,5,0,5,0,0.0,0.0
1012,1388,2020-03-19 08:14:00,1,2665.0,2299.0,0.863,13.046,10,2,1,1,8,0,8,0,0.0,0.0
1012,1389,2020-03-19 08:17:00,1,2657.0,2319.0,0.873,13.035,52,25,8,17,27,8,19,1,0.0,0.0
1012,1390,2020-03-19 08:20:00,1,2499.0,2243.0,0.898,12.327,7,2,1,1,5,0,5,0,0.0,0.0
1012,1391,2020-03-19 08:23:00,1,2516.0,2198.5,0.874,12.346,12,7,3,4,5,1,4,0,0.0,0.0
1012,1392,2020-03-19 08:26:00,1,2533.0,2154.0,0.85,12.365,18,1,0,1,17,2,15,0,0.0,0.0
1012,1393,2020-03-19 08:29:00,1,2518.0,2175.0,0.864,12.33,125,68,30,38,57,11,46,3,0.0,0.0
1012,1394,2020-03-19 08:32:00,1,2489.0,2247.0,0.903,12.293,74,62,16,46,12,3,9,0,0.0,0.0
1012,1395,2020-03-19 08:35:00,1,2511.0,2258.0,0.899,12.395,56,30,15,15,26,13,13,0,0.0,0.0
1012,1396,2020-03-19 08:38:00,1,2516.0,2153.0,0.856,12.297,14,11,1,10,3,1,2,0,0.0,0.0
1012,1397,2020-03-19 08:41:00,1,2285.0,2026.0,0.887,11.247,1,0,0,0,1,0,1,0,0.0,0.0
1012,1398,2020-03-19 08:44:00,1,2312.0,1950.0,0.844,11.268,1,0,0,0,1,0,1,0,0.0,0.0
1012,1399,2020-03-19 08:47:00,1,2316.0,1950.0,0.842,11.282,2,0,0,0,2,0,2,0,0.0,0.0
1012,1400,2020-03-19 08:50:00,1,2317.0,1957.0,0.844,11.297,2,0,0,0,2,0,2,0,0.0,0.0
1012,1401,2020-03-19 08:53:00,1,2228.0,1893.0,0.85,10.876,11,7,5,2,4,3,1,0,0.0,0.0
1012,1402,2020-03-19 08:56:00,1,2145.0,1872.0,0.873,10.525,5,5,1,4,0,0,0,0,0.0,0.0
1012,1403,2020-03-19 08:59:00,1,2236.0,1867.0,0.835,10.875,1,0,0,0,1,1,0,0,0.0,0.0
1012,1404,2020-03-19 09:02:00,1,2155.0,1823.0,0.846,10.511,2,0,0,0,2,0,2,0,0.0,0.0
1012,1405,2020-03-19 09:05:00,1,2176.0,1756.0,0.807,10.516,0,0,0,0,0,0,0,0,0.0,0.0
1012,1406,2020-03-19 09:08:00,1,2177.0,1755.0,0.806,10.522,0,0,0,0,0,0,0,0,0.0,0.0
1012,1407,2020-03-19 09:11:00,1,2170.0,1807.0,0.833,10.55,0,0,0,0,0,0,0,0,0.0,0.0
1012,1408,2020-03-19 09:14:00,1,2330.0,1857.0,0.797,11.238,0,0,0,0,0,0,0,0,0.0,0.0
1012,1409,2020-03-19 09:17:00,1,2296.0,1959.0,0.853,11.216,24,18,8,10,6,3,3,0,0.0,0.0
1012,1410,2020-03-19 09:20:00,1,2307.0,1933.0,0.838,11.228,0,0,0,0,0,0,0,0,0.0,0.0
1012,1411,2020-03-19 09:23:00,1,2321.0,1897.0,0.817,11.245,8,8,0,8,0,0,0,0,0.0,0.0
1012,1412,2020-03-19 09:26:00,1,2317.0,1863.0,0.804,11.191,110,51,30,21,59,35,24,1,0.0,0.0
1012,1413,2020-03-19 09:29:00,1,2537.0,2120.0,0.836,12.345,130,81,44,37,49,14,35,2,0.0,0.0
1012,1414,2020-03-19 09:32:00,1,2851.0,2364.0,0.829,13.85,234,125,75,50,109,72,37,82,0.0,0.0
1012,1415,2020-03-19 09:35:00,1,2832.0,2431.0,0.858,13.849,515,195,143,52,320,250,70,22,0.05,0.0
1012,1416,2020-03-19 09:38:00,1,2850.0,2353.0,0.825,13.835,361,146,95,51,215,156,59,10,0.0,0.0
1012,1417,2020-03-19 09:41:00,1,2830.0,2350.0,0.831,13.752,682,261,192,69,421,327,94,23,0.0,0.0
1012,1418,2020-03-19 09:44:00,1,2673.0,2263.0,0.847,13.039,419,199,144,55,220,149,71,21,0.0,0.0
1012,1419,2020-03-19 09:47:00,1,2689.0,2280.0,0.848,13.119,232,158,119,39,74,47,27,0,0.0,0.0
1012,1420,2020-03-19 09:50:00,1,2675.0,2259.0,0.845,13.038,583,295,223,72,288,215,73,50,0.0,0.0
1012,1421,2020-03-19 09:53:00,1,2686.0,2232.0,0.831,13.053,520,248,187,61,272,202,70,21,0.04,0.0
1012,1422,2020-03-19 09:56:00,1,2696.0,2213.0,0.821,13.071,424,146,97,49,278,208,70,6,0.0,0.0
1012,1423,2020-03-19 09:59:00,1,2702.0,2190.0,0.811,13.069,425,179,129,50,246,174,72,14,0.0,0.0
1012,1424,2020-03-19 10:02:00,1,2703.0,2160.0,0.799,13.043,98,49,11,38,49,9,40,0,0.0,0.0
1012,1425,2020-03-19 10:05:00,1,2521.0,2122.0,0.842,12.282,1,0,0,0,1,0,1,0,0.0,0.0
1012,1426,2020-03-19 10:08:00,1,2471.0,1975.0,0.799,11.921,19,1,0,1,18,3,15,0,0.0,0.0
1012,1427,2020-03-19 10:11:00,1,2323.0,1868.0,0.804,11.222,12,6,3,3,6,0,6,0,0.0,0.0
1012,1428,2020-03-19 10:14:00,1,2262.0,1789.0,0.791,10.895,13,9,0,9,4,0,4,0,0.0,0.0
1012,1429,2020-03-19 10:17:00,1,2257.0,1772.0,0.785,10.856,7,5,1,4,2,0,2,0,0.0,0.0
1012,1430,2020-03-19 10:20:00,1,2186.0,1745.0,0.798,10.547,2,1,0,1,1,0,1,0,0.0,0.0
1012,1431,2020-03-19 10:23:00,1,2174.0,1739.0,0.8,10.49,10,0,0,0,10,0,10,0,0.0,0.0
1012,1432,2020-03-19 10:26:00,1,2167.0,1736.0,0.801,10.463,13,0,0,0,13,0,13,0,0.0,0.0
1012,1433,2020-03-19 10:29:00,1,2271.0,1791.0,0.789,10.929,13,5,1,4,8,0,8,0,0.0,0.0
1012,1434,2020-03-19 10:32:00,1,2170.0,1756.0,0.809,10.494,0,0,0,0,0,0,0,0,0.0,0.0
1012,1435,2020-03-19 10:35:00,1,2179.0,1748.0,0.802,10.521,7,7,5,2,0,0,0,0,0.0,0.0
1012,1436,2020-03-19 10:38:00,1,2178.0,1737.0,0.798,10.503,5,5,1,4,0,0,0,0,0.0,0.0
1012,1437,2020-03-19 10:41:00,1,2174.0,1724.0,0.793,10.474,6,5,2,3,1,0,1,0,0.0,0.0
1012,1438,2020-03-19 10:44:00,1,2178.0,1731.0,0.795,10.498,4,2,1,1,2,0,2,0,0.0,0.0
1012,1439,2020-03-19 10:47:00,1,2350.0,1795.0,0.764,11.246,17,10,6,4,7,4,3,0,0.0,0.0
1012,1440,2020-03-19 10:50:00,1,2347.0,1774.0,0.756,11.211,0,0,0,0,0,0,0,0,0.0,0.0
1012,1441,2020-03-19 10:53:00,1,2361.0,1780.0,0.754,11.273,0,0,0,0,0,0,0,0,0.0,0.0
1012,1442,2020-03-19 10:56:00,1,2342.0,1775.0,0.758,11.195,0,0,0,0,0,0,0,0,0.0,0.0
1012,1443,2020-03-19 10:59:00,1,2347.0,1769.0,0.754,11.204,0,0,0,0,0,0,0,0,0.0,0.0
1012,1444,2020-03-19 11:02:00,1,2346.0,1784.0,0.76,11.22,19,11,8,3,8,4,4,2,0.0,0.0
1012,1445,2020-03-19 11:05:00,1,2347.0,1779.0,0.758,11.218,0,0,0,0,0,0,0,0,0.0,0.0
1012,1446,2020-03-19 11:08:00,1,2350.0,1759.0,0.748,11.206,10,6,3,3,4,2,2,0,0.0,0.0
1012,1447,2020-03-19 11:11:00,1,2281.0,1751.0,0.767,10.926,0,0,0,0,0,0,0,0,0.0,0.0
1012,1448,2020-03-19 11:14:00,1,2359.0,1763.0,0.748,11.246,8,2,1,1,6,0,6,0,0.0,0.0
1012,1449,2020-03-19 11:17:00,1,2350.0,1775.0,0.755,11.226,20,0,0,0,20,0,20,0,0.0,0.0
1012,1450,2020-03-19 11:20:00,1,2357.0,1772.0,0.752,11.249,3,2,1,1,1,0,1,0,0.0,0.0
1012,1451,2020-03-19 11:23:00,1,2307.0,1766.0,0.766,11.045,1,1,0,1,0,0,0,0,0.0,0.0
1012,1452,2020-03-19 11:26:00,1,2257.0,1760.0,0.78,10.841,22,21,0,21,1,0,1,0,0.0,0.0
1012,1453,2020-03-19 11:29:00,1,2345.0,1808.0,0.771,11.242,104,84,38,46,20,8,12,0,0.0,0.0
1012,1454,2020-03-19 11:32:00,1,2315.0,1918.0,0.828,11.243,107,78,28,50,29,11,18,4,0.0,0.0
1012,1455,2020-03-19 11:35:00,1,2557.0,2021.0,0.79,12.313,44,29,11,18,15,8,7,1,0.0,0.0
1012,1456,2020-03-19 11:38:00,1,2402.0,1964.0,0.818,11.636,1,1,1,0,0,0,0,0,0.0,0.0
1012,1457,2020-03-19 11:41:00,1,2329.0,1841.0,0.791,11.214,1,1,0,1,0,0,0,0,0.0,0.0
1012,1458,2020-03-19 11:44:00,1,2271.0,1800.0,0.793,10.942,0,0,0,0,0,0,0,0,0.0,0.0
1012,1459,2020-03-19 11:47:00,1,2172.0,1745.0,0.803,10.491,7,1,0,1,6,1,5,0,0.0,0.0
1012,1460,2020-03-19 11:50:00,1,2361.0,1775.0,0.752,11.267,4,4,1,3,0,0,0,0,0.0,0.0
1012,1461,2020-03-19 11:53:00,1,2332.0,1810.0,0.776,11.191,11,6,2,4,5,1,4,0,0.0,0.0
1012,1462,2020-03-19 11:56:00,1,2346.0,1815.0,0.773,11.254,1,0,0,0,1,0,1,0,0.0,0.0
1012,1463,2020-03-19 11:59:00,1,2340.0,1791.0,0.765,11.204,18,5,1,4,13,0,13,0,0.0,0.0
1012,1464,2020-03-19 12:02:00,1,2351.0,1774.0,0.754,11.229,12,1,1,0,11,0,11,0,0.0,0.0
1012,1465,2020-03-19 12:05:00,1,2181.0,1738.0,0.797,10.517,13,4,2,2,9,0,9,0,0.0,0.0
1012,1466,2020-03-19 12:08:00,1,2270.0,1760.0,0.775,10.89,2,2,1,1,0,0,0,0,0.0,0.0
1012,1467,2020-03-19 12:11:00,1,2179.0,1748.0,0.802,10.519,166,98,66,32,68,38,30,3,0.0,0.0
1012,1468,2020-03-19 12:14:00,1,2330.0,1885.0,0.809,11.267,114,85,38,47,29,6,23,0,0.0,0.0
1012,1469,2020-03-19 12:17:00,1,2569.0,1995.0,0.776,12.331,15,12,6,6,3,0,3,0,0.0,0.0
1012,1470,2020-03-19 12:20:00,1,2786.0,2221.0,0.797,13.436,162,81,44,37,81,45,36,23,0.0,0.0
1012,1471,2020-03-19 12:23:00,1,2833.0,2356.0,0.832,13.771,209,86,52,34,123,64,59,30,0.0,0.02
1012,1472,2020-03-19 12:26:00,1,2768.0,2226.0,0.804,13.371,241,125,93,32,116,71,45,50,0.0,0.04
1012,1473,2020-03-19 12:29:00,1,3088.0,2420.0,0.784,14.847,273,133,90,43,140,104,36,102,0.0,0.0
1012,1474,2020-03-19 12:32:00,1,2778.0,2246.0,0.808,13.434,493,249,195,54,244,182,62,131,0.0,0.0
1012,1475,2020-03-19 12:35:00,1,2543.0,2089.0,0.822,12.331,525,220,159,61,305,229,76,128,0.0,0.02
1012,1476,2020-03-19 12:38:00,1,2911.0,2461.0,0.845,14.195,948,300,220,80,648,504,144,96,0.0,0.0
1012,1477,2020-03-19 12:41:00,1,2313.0,1951.0,0.844,11.273,61,43,25,18,18,1,17,103,0.0,0.0
1012,1478,2020-03-19 12:44:00,1,2829.0,2367.0,0.837,13.768,36,28,1,27,8,1,7,91,0.0,0.01
1012,1479,2020-03-19 12:47:00,1,2800.0,2481.0,0.886,13.778,71,33,21,12,38,2,36,85,0.0,0.0
1012,1480,2020-03-19 12:50:00,1,2810.0,2416.0,0.86,13.747,21,2,1,1,19,0,19,82,0.0,0.0
1012,1481,2020-03-19 12:53:00,1,2676.0,2249.0,0.84,13.035,5,2,0,2,3,0,3,88,0.0,0.0
1012,1482,2020-03-19 12:56:00,1,2663.0,2335.0,0.877,13.077,0,0,0,0,0,0,0,76,0.0,0.0
1012,1483,2020-03-19 12:59:00,1,2749.0,2368.0,0.861,13.453,54,23,11,12,31,10,21,92,0.0,0.0
1012,1484,2020-03-19 13:02:00,1,2673.0,2261.0,0.846,13.036,10,8,5,3,2,0,2,89,0.0,0.0
1012,1485,2020-03-19 13:05:00,1,2526.0,2137.0,0.846,12.318,0,0,0,0,0,0,0,111,0.0,0.0
1012,1486,2020-03-19 13:08:00,1,2445.0,2054.0,0.84,11.908,11,9,5,4,2,0,2,85,0.0,0.0
1012,1487,2020-03-19 13:11:00,1,2294.0,2009.0,0.876,11.262,14,13,4,9,1,0,1,76,0.0,0.01
1012,1488,2020-03-19 13:14:00,1,2295.0,2016.0,0.878,11.275,0,0,0,0,0,0,0,81,0.0,0.0
1012,1489,2020-03-19 13:17:00,1,2297.0,1993.0,0.868,11.256,1,1,0,1,0,0,0,68,0.0,0.0
1012,1490,2020-03-19 13:20:00,1,2306.0,2001.0,0.868,11.302,7,4,0,4,3,0,3,88,0.0,0.0
1012,1491,2020-03-19 13:23:00,1,2316.0,1948.0,0.841,11.281,8,6,1,5,2,0,2,95,0.0,0.0
1012,1492,2020-03-19 13:26:00,1,2326.0,1884.0,0.81,11.25,42,31,17,14,11,2,9,97,0.0,0.0
1012,1493,2020-03-19 13:29:00,1,2313.0,1915.0,0.828,11.232,18,16,6,10,2,0,2,128,0.0,0.0
1012,1494,2020-03-19 13:32:00,1,2315.0,1879.0,0.812,11.202,3,2,0,2,1,0,1,108,0.0,0.0
1012,1495,2020-03-19 13:35:00,1,2320.0,1877.0,0.809,11.221,17,9,1,8,8,0,8,103,0.0,0.0
1012,1496,2020-03-19 13:38:00,1,2320.0,1883.0,0.812,11.226,1,0,0,0,1,0,1,92,0.0,0.0
1012,1497,2020-03-19 13:41:00,1,2333.0,1873.0,0.803,11.267,3,0,0,0,3,0,3,93,0.0,0.0
1012,1498,2020-03-19 13:44:00,1,2327.0,1886.0,0.811,11.256,16,0,0,0,16,0,16,85,0.0,0.0
1012,1499,2020-03-19 13:47:00,1,2322.0,1889.0,0.814,11.241,14,11,8,3,3,1,2,94,0.0,0.0
1012,1500,2020-03-19 13:50:00,1,2327.0,1865.0,0.801,11.235,5,3,0,3,2,1,1,90,0.0,0.0
1012,1501,2020-03-19 13:53:00,1,2326.0,1883.0,0.81,11.249,2,1,0,1,1,0,1,99,0.0,0.0
1012,1502,2020-03-19 13:56:00,1,2253.0,1827.0,0.811,10.9,0,0,0,0,0,0,0,76,0.0,0.0
1012,1503,2020-03-19 13:59:00,1,2177.0,1785.0,0.82,10.553,0,0,0,0,0,0,0,92,0.0,0.0
1012,1504,2020-03-19 14:02:00,1,2347.0,1836.0,0.782,11.279,0,0,0,0,0,0,0,75,0.0,0.0
1012,1505,2020-03-19 14:05:00,1,2251.0,1808.0,0.803,10.872,0,0,0,0,0,0,0,84,0.0,0.0
1012,1506,2020-03-19 14:08:00,1,2247.0,1812.0,0.807,10.859,1,1,1,0,0,0,0,79,0.0,0.0
1012,1507,2020-03-19 14:11:00,1,2162.0,1782.0,0.824,10.493,1,1,0,1,0,0,0,84,0.0,0.0
1012,1508,2020-03-19 14:14:00,1,2158.0,1808.0,0.838,10.505,3,3,0,3,0,0,0,84,0.0,0.0
1012,1509,2020-03-19 14:17:00,1,2318.0,1955.0,0.843,11.298,124,37,15,22,87,44,43,81,0.0,0.0
1012,1510,2020-03-19 14:20:00,1,2448.0,2061.0,0.842,11.927,163,84,51,33,79,45,34,121,0.0,0.0
1012,1511,2020-03-19 14:23:00,1,2640.5,2197.5,0.833,12.836,287,153,97,56,134,86,48,134,0.0,0.0
1012,1512,2020-03-19 14:26:00,1,2833.0,2334.0,0.824,13.745,98,51,21,30,47,28,19,156,0.0,0.0
1012,1513,2020-03-19 14:29:00,1,2836.0,2314.0,0.816,13.734,88,68,24,44,20,6,14,126,0.0,0.01
1012,1514,2020-03-19 14:32:00,1,2847.0,2324.0,0.816,13.791,213,163,141,22,50,37,13,117,0.0,0.01
1012,1515,2020-03-19 14:35:00,1,3229.0,2603.0,0.806,15.605,331,249,219,30,82,41,41,130,0.0,0.0
1012,1516,2020-03-19 14:38:00,1,3586.0,2948.0,0.822,17.391,423,310,283,27,113,64,49,120,0.0,0.04
1012,1517,2020-03-19 14:41:00,1,2706.0,2150.0,0.795,13.041,322,214,145,69,108,75,33,106,0.1,0.01
1012,1518,2020-03-19 14:44:00,1,3266.0,2738.0,0.838,15.901,250,195,115,80,55,27,28,132,0.0,0.0
1012,1519,2020-03-19 14:47:00,1,2686.0,2272.0,0.846,13.099,705,430,366,64,275,206,69,132,0.02,0.05
1012,1520,2020-03-19 14:50:00,1,2822.0,2408.0,0.853,13.784,566,202,133,69,364,283,81,106,0.0,0.03
1012,1521,2020-03-19 14:53:00,1,2907.0,2489.0,0.856,14.208,407,170,121,49,237,167,70,110,0.0,0.0
1012,1522,2020-03-19 14:56:00,1,2250.0,1826.0,0.812,10.885,104,73,34,39,31,2,29,116,0.0,0.0
1012,1523,2020-03-19 14:59:00,1,2325.0,1880.0,0.809,11.242,153,143,77,66,10,2,8,126,0.0,0.0
1012,1524,2020-03-19 15:02:00,1,2370.0,2007.0,0.847,11.558,29,18,6,12,11,1,10,107,0.0,0.0
1012,1525,2020-03-19 15:05:00,1,2293.0,2004.0,0.874,11.252,8,7,3,4,1,0,1,98,0.0,0.0
1012,1526,2020-03-19 15:08:00,1,2376.0,2010.0,0.846,11.586,7,6,3,3,1,0,1,90,0.0,0.0
1012,1527,2020-03-19 15:11:00,1,2537.0,2092.0,0.825,12.314,10,9,6,3,1,0,1,110,0.0,0.0
1012,1528,2020-03-19 15:14:00,1,2549.0,2075.0,0.814,12.34,25,22,1,21,3,0,3,104,0.0,0.0
1012,1529,2020-03-19 15:17:00,1,2684.0,2251.0,0.839,13.065,4,3,2,1,1,0,1,91,0.0,0.0
1012,1530,2020-03-19 15:20:00,1,2671.0,2291.0,0.858,13.059,25,14,7,7,11,2,9,91,0.0,0.0
1012,1531,2020-03-19 15:23:00,1,2677.0,2295.0,0.857,13.089,11,11,0,11,0,0,0,108,0.0,0.0
1012,1532,2020-03-19 15:26:00,1,2793.0,2494.0,0.893,13.767,2,2,0,2,0,0,0,88,0.0,0.0
1012,1533,2020-03-19 15:29:00,1,2823.0,2398.0,0.849,13.777,8,8,2,6,0,0,0,80,0.0,0.0
1012,1534,2020-03-19 15:32:00,1,2672.0,2277.0,0.852,13.051,5,5,2,3,0,0,0,81,0.0,0.0
1012,1535,2020-03-19 15:35:00,1,2688.0,2268.0,0.844,13.101,1,1,0,1,0,0,0,88,0.0,0.0
1012,1536,2020-03-19 15:38:00,1,2688.0,2209.0,0.822,13.038,0,0,0,0,0,0,0,88,0.0,0.0
1012,1537,2020-03-19 15:41:00,1,2526.0,2138.0,0.847,12.319,29,19,13,6,10,5,5,90,0.0,0.0
1012,1538,2020-03-19 15:44:00,1,2695.0,2217.0,0.823,13.071,118,86,42,44,32,5,27,95,0.0,0.0
1012,1539,2020-03-19 15:47:00,1,2597.0,2220.0,0.855,12.691,60,40,14,26,20,2,18,88,0.0,0.0
1012,1540,2020-03-19 15:50:00,1,2678.0,2282.0,0.852,13.079,76,51,17,34,25,0,25,85,0.0,0.0
1012,1541,2020-03-19 15:53:00,1,2678.0,2265.0,0.846,13.06,14,12,2,10,2,1,1,84,0.0,0.0
1012,1542,2020-03-19 15:56:00,1,2535.0,2110.0,0.832,12.324,7,7,0,7,0,0,0,88,0.0,0.0
1012,1543,2020-03-19 15:59:00,1,2292.0,1999.0,0.872,11.246,5,4,0,4,1,1,0,98,0.0,0.0
1012,1544,2020-03-19 16:02:00,1,2308.0,1941.0,0.841,11.243,7,6,0,6,1,0,1,98,0.0,0.0
1012,1545,2020-03-19 16:05:00,1,2301.0,1983.0,0.862,11.262,5,5,0,5,0,0,0,109,0.0,0.0
1012,1546,2020-03-19 16:08:00,1,2314.0,1940.0,0.839,11.265,22,4,0,4,18,0,18,89,0.0,0.0
1012,1547,2020-03-19 16:11:00,1,2331.0,1868.0,0.801,11.254,15,5,0,5,10,0,10,103,0.0,0.0
1012,1548,2020-03-19 16:14:00,1,2324.0,1915.0,0.824,11.278,32,16,10,6,16,7,9,95,0.0,0.0
1012,1549,2020-03-19 16:17:00,1,2480.0,2012.0,0.811,12.0,59,55,14,41,4,0,4,103,0.0,0.0
1012,1550,2020-03-19 16:20:00,1,2298.0,1959.0,0.852,11.223,43,42,2,40,1,1,0,122,0.0,0.0
1012,1551,2020-03-19 16:23:00,1,2311.0,1908.0,0.826,11.216,44,44,6,38,0,0,0,134,0.0,0.0
1012,1552,2020-03-19 16:26:00,1,2319.0,1884.0,0.812,11.221,37,37,0,37,0,0,0,128,0.0,0.0
1012,1553,2020-03-19 16:29:00,1,2333.0,1874.0,0.804,11.266,43,43,2,41,0,0,0,124,0.0,0.0
1012,1554,2020-03-19 16:32:00,1,2338.0,1857.0,0.794,11.269,221,142,107,35,79,54,25,127,0.0,0.0
1012,1555,2020-03-19 16:35:00,1,2209.0,1638.0,0.741,10.518,209,175,148,27,34,4,30,109,0.0,0.0
1012,1556,2020-03-19 16:38:00,1,2678.0,2223.0,0.83,13.011,319,233,186,47,86,35,51,130,0.0,0.0
1012,1557,2020-03-19 16:41:00,1,3200.0,2684.0,0.839,15.581,413,289,180,109,124,75,49,124,0.0,0.02
1012,1558,2020-03-19 16:44:00,1,3370.0,2758.0,0.818,16.333,359,176,107,69,183,134,49,161,0.0,0.07
1012,1559,2020-03-19 16:47:00,1,2534.0,2098.0,0.828,12.308,465,64,31,33,401,329,72,87,0.0,0.01
1012,1560,2020-03-19 16:50:00,1,2188.0,1697.0,0.776,10.498,266,134,81,53,132,77,55,77,0.0,0.0
1012,1561,2020-03-19 16:53:00,1,2321.0,1902.0,0.819,11.251,255,123,73,50,132,77,55,101,0.34,0.0
1012,1562,2020-03-19 16:56:00,1,2530.0,2139.0,0.846,12.335,364,194,152,42,170,122,48,68,0.0,0.0
1012,1563,2020-03-19 16:59:00,1,3539.0,3097.0,0.875,17.373,97,48,31,17,49,29,20,86,0.0,0.02
1012,1564,2020-03-19 17:02:00,1,2672.0,2269.0,0.849,13.041,8,4,0,4,4,2,2,92,0.0,0.01
1012,1565,2020-03-19 17:05:00,1,2376.0,1999.0,0.841,11.577,56,41,13,28,15,9,6,86,0.0,0.0
1012,1566,2020-03-19 17:08:00,1,2305.0,1968.0,0.854,11.263,30,14,4,10,16,3,13,76,0.0,0.01
1012,1567,2020-03-19 17:11:00,1,2530.0,2147.0,0.849,12.345,47,27,6,21,20,2,18,78,0.0,0.01
1012,1568,2020-03-19 17:14:00,1,2521.0,2128.0,0.844,12.287,0,0,0,0,0,0,0,82,0.0,0.0
1012,1569,2020-03-19 17:17:00,1,2670.0,2330.0,0.873,13.1,57,35,5,30,22,4,18,81,0.0,0.0
1012,1570,2020-03-19 17:20:00,1,3024.0,2703.0,0.894,14.908,101,81,20,61,20,3,17,73,0.0,0.0
1012,1571,2020-03-19 17:23:00,1,3010.0,2729.5,0.907,14.882,124,91,41,50,33,4,29,77,0.0,0.0
1012,1572,2020-03-19 17:26:00,1,2996.0,2756.0,0.92,14.856,30,26,11,15,4,1,3,76,0.0,0.0
1012,1573,2020-03-19 17:29:00,1,2942.0,2642.0,0.898,14.517,1,1,0,1,0,0,0,81,0.0,0.0
1012,1574,2020-03-19 17:32:00,1,2854.0,2640.0,0.925,14.167,0,0,0,0,0,0,0,61,0.0,0.0
1012,1575,2020-03-19 17:35:00,1,2783.0,2508.0,0.901,13.741,0,0,0,0,0,0,0,87,0.0,0.0
1012,1576,2020-03-19 17:38:00,1,2815.0,2444.0,0.868,13.798,3,3,0,3,0,0,0,72,0.0,0.0
1012,1577,2020-03-19 17:41:00,1,2655.0,2361.0,0.889,13.076,0,0,0,0,0,0,0,84,0.0,0.0
1012,1578,2020-03-19 17:44:00,1,2822.0,2426.0,0.86,13.805,146,96,40,56,50,20,30,96,0.0,0.0
1012,1579,2020-03-19 17:47:00,1,2780.0,2551.0,0.918,13.776,112,62,28,34,50,6,44,110,0.0,0.0
1012,1580,2020-03-19 17:50:00,1,3041.0,2619.0,0.861,14.881,228,132,83,49,96,37,59,113,0.0,0.0
1012,1581,2020-03-19 17:53:00,1,3412.0,2945.0,0.863,16.703,126,63,32,31,63,31,32,101,0.0,0.02
1012,1582,2020-03-19 17:56:00,1,3541.0,3131.0,0.884,17.416,213,109,53,56,104,60,44,106,0.0,0.03
1012,1583,2020-03-19 17:59:00,1,3156.0,2824.0,0.895,15.562,246,110,74,36,136,98,38,114,0.0,0.09
1012,1584,2020-03-19 18:02:00,0,3005.0,2737.0,0.911,14.872,358,205,158,47,153,112,41,158,0.0,0.07
1012,1585,2020-03-19 18:05:00,0,3391.0,2994.0,0.883,16.676,329,173,131,42,156,101,55,75,0.0,0.0
1012,1586,2020-03-19 18:08:00,0,2877.0,2531.0,0.879,14.138,399,194,139,55,205,143,62,63,0.0,0.0
1012,1587,2020-03-19 18:11:00,0,2859.0,2599.0,0.909,14.142,246,126,84,42,120,78,42,56,0.03,0.0
1012,1588,2020-03-19 18:14:00,0,2281.0,2038.0,0.894,11.242,97,69,35,34,28,4,24,6,0.0,0.0
1012,1589,2020-03-19 18:17:00,0,2500.0,2215.0,0.886,12.304,80,61,34,27,19,4,15,10,0.0,0.0
1012,1590,2020-03-19 18:20:00,0,2453.0,2075.0,0.846,11.964,1,1,0,1,0,0,0,9,0.0,0.0
1012,1591,2020-03-19 18:23:00,0,2279.0,2050.0,0.9,11.248,4,2,0,2,2,1,1,7,0.0,0.0
1012,1592,2020-03-19 18:26:00,0,2648.0,2336.0,0.882,13.019,0,0,0,0,0,0,0,2,0.0,0.0
1012,1593,2020-03-19 18:29:00,0,2971.0,2817.0,0.948,14.825,15,13,2,11,2,0,2,6,0.0,0.0
1012,1594,2020-03-19 18:32:00,0,2714.0,2482.0,0.914,13.442,19,10,6,4,9,2,7,4,0.0,0.0
1012,1595,2020-03-19 18:35:00,0,3122.0,3021.0,0.968,15.645,79,53,22,31,26,9,17,13,0.0,0.0
1012,1596,2020-03-19 18:38:00,0,3369.0,3137.0,0.931,16.745,177,108,70,38,69,37,32,29,0.0,0.0
1012,1597,2020-03-19 18:41:00,0,3674.0,3544.0,0.964,18.4,708,308,219,89,400,315,85,44,0.0,0.07
1012,1598,2020-03-19 18:44:00,0,3504.0,3272.0,0.934,17.427,797,389,307,82,408,307,101,137,0.0,0.02
1012,1599,2020-03-19 18:47:00,0,3426.0,3196.0,0.933,17.036,251,113,65,48,138,105,33,122,0.0,0.0
1012,1600,2020-03-19 18:50:00,0,2504.0,2221.0,0.887,12.323,235,186,114,72,49,19,30,130,0.0,0.0
1012,1601,2020-03-19 18:53:00,0,3651.0,3395.0,0.93,18.142,678,315,236,79,363,282,81,165,0.0,0.06
1012,1602,2020-03-19 18:56:00,0,3680.0,3329.0,0.905,18.185,519,297,212,85,222,157,65,188,0.0,0.0
1012,1603,2020-03-19 18:59:00,0,3669.0,3298.0,0.899,18.108,675,289,209,80,386,284,102,131,0.0,0.0
1012,1604,2020-03-19 19:02:00,0,3668.0,3286.0,0.896,18.091,570,264,198,66,306,215,91,168,0.0,0.0
1012,1605,2020-03-19 19:05:00,0,2844.0,2603.0,0.915,14.086,140,79,32,47,61,24,37,234,0.0,0.0
1012,1606,2020-03-19 19:08:00,0,2821.0,2426.0,0.86,13.802,250,138,90,48,112,66,46,227,0.0,0.0
1012,1607,2020-03-19 19:11:00,0,2804.0,2419.0,0.863,13.726,457,180,124,56,277,192,85,172,0.0,0.0
1012,1608,2020-03-19 19:14:00,0,3101.0,2738.0,0.883,15.251,362,112,58,54,250,161,89,148,0.0,0.0
1012,1609,2020-03-19 19:17:00,0,3172.0,2790.0,0.88,15.586,461,185,128,57,276,209,67,186,0.0,0.0
1012,1610,2020-03-19 19:20:00,0,3188.0,2779.0,0.872,15.638,313,151,101,50,162,105,57,160,0.0,0.0
1012,1611,2020-03-19 19:23:00,0,2822.0,2417.0,0.856,13.796,92,46,11,35,46,8,38,140,0.0,0.0
1012,1612,2020-03-19 19:26:00,0,2750.0,2296.0,0.835,13.379,99,65,5,60,34,1,33,132,0.0,0.0
1012,1613,2020-03-19 19:29:00,0,2681.0,2272.0,0.848,13.079,9,5,1,4,4,0,4,147,0.0,0.0
1012,1614,2020-03-19 19:32:00,0,3432.0,2851.0,0.831,16.679,507,295,228,67,212,151,61,278,0.0,0.0
1012,1615,2020-03-19 19:35:00,0,3573.0,3016.0,0.844,17.416,635,334,242,92,301,213,88,142,0.0,0.0
1012,1616,2020-03-19 19:38:00,0,3048.0,2589.0,0.849,14.877,349,172,118,54,177,126,51,174,0.0,0.0
1012,1617,2020-03-19 19:41:00,0,3428.0,2816.0,0.821,16.624,282,163,113,50,119,79,40,165,0.0,0.0
1012,1618,2020-03-19 19:44:00,0,3520.0,2835.0,0.805,17.008,630,275,194,81,355,274,81,116,0.0,0.01
1012,1619,2020-03-19 19:47:00,0,2828.0,2381.0,0.842,13.778,206,96,58,38,110,74,36,80,0.0,0.0
1012,1620,2020-03-19 19:50:00,0,2568.0,1984.0,0.772,12.316,166,81,36,45,85,51,34,78,0.0,0.0
1012,1621,2020-03-19 19:53:00,0,2558.0,2031.0,0.794,12.328,54,38,19,19,16,1,15,48,0.0,0.0
1012,1622,2020-03-19 19:56:00,0,2708.0,2155.0,0.796,13.055,86,44,14,30,42,3,39,54,0.0,0.0
1012,1623,2020-03-19 19:59:00,0,3372.0,2706.0,0.802,16.284,18,11,4,7,7,1,6,45,0.0,0.0
1012,1624,2020-03-19 20:02:00,0,3070.0,2482.0,0.808,14.845,4,4,0,4,0,0,0,34,0.0,0.0
1012,1625,2020-03-19 20:05:00,0,2849.0,2271.0,0.797,13.742,2,2,0,2,0,0,0,31,0.0,0.0
1012,1626,2020-03-19 20:08:00,0,2719.0,2087.0,0.768,13.025,8,4,1,3,4,1,3,38,0.0,0.0
1012,1627,2020-03-19 20:11:00,0,2473.0,1905.0,0.771,11.853,5,3,0,3,2,0,2,36,0.0,0.0
1012,1628,2020-03-19 20:14:00,0,2347.0,1785.0,0.76,11.225,22,12,6,6,10,1,9,49,0.0,0.0
1012,1629,2020-03-19 20:17:00,0,2323.0,1866.0,0.803,11.22,1,0,0,0,1,0,1,27,0.0,0.0
1012,1630,2020-03-19 20:20:00,0,2492.0,1892.0,0.759,11.915,2,2,1,1,0,0,0,32,0.0,0.0
1012,1631,2020-03-19 20:23:00,0,2536.0,1927.5,0.76,12.127,119,104,68,36,15,1,14,37,0.0,0.0
1012,1632,2020-03-19 20:26:00,0,2580.0,1963.0,0.761,12.339,77,70,33,37,7,1,6,35,0.0,0.0
1012,1633,2020-03-19 20:29:00,0,2866.0,2236.0,0.78,13.767,482,175,119,56,307,224,83,92,0.0,0.0
1012,1634,2020-03-19 20:32:00,0,2861.0,2223.0,0.777,13.734,468,210,152,58,258,190,68,97,0.0,0.0
1012,1635,2020-03-19 20:35:00,0,2857.0,2268.0,0.794,13.768,678,293,219,74,385,288,97,48,0.0,0.0
1012,1636,2020-03-19 20:38:00,0,3084.0,2451.0,0.795,14.863,520,291,205,86,229,172,57,23,0.0,0.0
1012,1637,2020-03-19 20:41:00,0,2865.0,2242.0,0.782,13.772,439,188,128,60,251,182,69,18,0.0,0.0
1012,1638,2020-03-19 20:44:00,0,2716.0,2068.0,0.762,12.991,209,60,25,35,149,94,55,22,0.0,0.0
1012,1639,2020-03-19 20:47:00,0,2188.0,1688.0,0.771,10.49,67,45,9,36,22,0,22,11,0.0,0.0
1012,1640,2020-03-19 20:50:00,0,2201.0,1638.0,0.744,10.483,38,33,3,30,5,0,5,3,0.0,0.0
1012,1641,2020-03-19 20:53:00,0,2354.0,1785.0,0.758,11.253,11,9,0,9,2,0,2,0,0.0,0.0
1012,1642,2020-03-19 20:56:00,0,2360.0,1754.0,0.743,11.242,12,11,0,11,1,0,1,0,0.0,0.0
1012,1643,2020-03-19 20:59:00,0,2370.0,1729.0,0.73,11.252,1,1,0,1,0,0,0,0,0.0,0.0
1012,1644,2020-03-19 21:02:00,0,2352.0,1734.0,0.738,11.187,149,73,44,29,76,40,36,8,0.0,0.0
1012,1645,2020-03-19 21:05:00,0,2877.0,2269.0,0.789,13.846,350,178,123,55,172,110,62,61,0.0,0.0
1012,1646,2020-03-19 21:08:00,0,2848.0,2298.0,0.807,13.766,262,139,87,52,123,82,41,22,0.0,0.0
1012,1647,2020-03-19 21:11:00,0,3100.0,2374.0,0.766,14.842,502,242,163,79,260,182,78,41,0.0,0.0
1012,1648,2020-03-19 21:14:00,0,3242.0,2550.0,0.786,15.599,578,291,205,86,287,205,82,27,0.0,0.0
1012,1649,2020-03-19 21:17:00,0,2577.0,1959.0,0.76,12.322,149,91,44,47,58,27,31,54,0.0,0.0
1012,1650,2020-03-19 21:20:00,0,2649.0,2032.0,0.767,12.688,424,186,131,55,238,166,72,82,0.0,0.0
1012,1651,2020-03-19 21:23:00,0,2580.0,1955.0,0.757,12.331,320,150,100,50,170,117,53,48,0.0,0.0
1012,1652,2020-03-19 21:26:00,0,3479.0,2659.0,0.764,16.651,360,166,120,46,194,146,48,58,0.0,0.0
1012,1653,2020-03-19 21:29:00,0,3109.0,2372.0,0.763,14.876,199,104,72,32,95,61,34,85,0.0,0.0
1012,1654,2020-03-19 21:32:00,0,3259.0,2462.0,0.755,15.567,467,200,140,60,267,195,72,50,0.0,0.0
1012,1655,2020-03-19 21:35:00,0,3635.0,2710.0,0.745,17.324,522,302,206,96,220,165,55,9,0.0,0.0
1012,1656,2020-03-19 21:38:00,0,3563.0,2711.0,0.761,17.041,260,165,102,63,95,45,50,2,0.0,0.0
1012,1657,2020-03-19 21:41:00,0,2889.0,2171.0,0.751,13.784,77,23,5,18,54,16,38,0,0.0,0.0
1012,1658,2020-03-19 21:44:00,0,3241.0,2535.0,0.782,15.575,347,97,57,40,250,180,70,26,0.0,0.0
1012,1659,2020-03-19 21:47:00,0,2870.0,2237.0,0.779,13.786,339,150,90,60,189,134,55,28,0.0,0.0
1012,1660,2020-03-19 21:50:00,0,3255.0,2514.0,0.772,15.607,502,238,173,65,264,197,67,41,0.0,0.0
1012,1661,2020-03-19 21:53:00,0,3502.0,2634.0,0.752,16.716,519,216,153,63,303,227,76,108,0.09,0.0
1012,1662,2020-03-19 21:56:00,0,2862.0,2196.0,0.767,13.709,267,124,76,48,143,105,38,33,0.0,0.0
1012,1663,2020-03-19 21:59:00,0,3090.0,2372.0,0.768,14.803,275,135,81,54,140,91,49,4,0.15,0.0
1012,1664,2020-03-19 22:02:00,0,2587.0,1883.0,0.728,12.277,162,113,68,45,49,29,20,17,0.0,0.0
1012,1665,2020-03-19 22:05:00,0,2868.0,2195.0,0.765,13.729,331,146,78,68,185,126,59,9,0.0,0.0
1012,1666,2020-03-19 22:08:00,0,2886.0,2132.0,0.739,13.733,191,80,48,32,111,68,43,7,0.0,0.0
1012,1667,2020-03-19 22:11:00,0,2945.0,2244.0,0.762,14.089,295,171,118,53,124,79,45,42,0.0,0.0
1012,1668,2020-03-19 22:14:00,0,2874.0,2262.0,0.787,13.829,138,100,56,44,38,7,31,5,0.0,0.0
1012,1669,2020-03-19 22:17:00,0,2886.0,2258.0,0.782,13.873,63,47,19,28,16,3,13,0,0.0,0.0
1012,1670,2020-03-19 22:20:00,0,2869.0,2184.0,0.761,13.723,24,19,10,9,5,0,5,0,0.0,0.0
1012,1671,2020-03-19 22:23:00,0,2730.0,2048.0,0.75,13.025,0,0,0,0,0,0,0,0,0.0,0.0
1012,1672,2020-03-19 22:26:00,0,2587.0,1877.0,0.726,12.269,0,0,0,0,0,0,0,0,0.0,0.0
1012,1673,2020-03-19 22:29:00,0,2360.0,1749.0,0.741,11.237,0,0,0,0,0,0,0,0,0.0,0.0
1012,1674,2020-03-19 22:32:00,0,2200.0,1649.0,0.749,10.492,9,0,0,0,9,0,9,0,0.0,0.0
1012,1675,2020-03-19 22:35:00,0,2054.0,1530.0,0.745,9.786,0,0,0,0,0,0,0,0,0.0,0.0
1012,1676,2020-03-19 22:38:00,0,1981.0,1459.0,0.736,9.423,0,0,0,0,0,0,0,0,0.0,0.0
1012,1677,2020-03-19 22:41:00,0,1996.0,1416.0,0.709,9.432,7,0,0,0,7,1,6,0,0.0,0.0
1012,1678,2020-03-19 22:44:00,0,1907.0,1389.0,0.728,9.053,5,1,0,1,4,0,4,0,0.0,0.0
1012,1679,2020-03-19 22:47:00,0,1821.0,1366.0,0.75,8.689,21,10,1,9,11,2,9,0,0.0,0.0
1012,1680,2020-03-19 22:50:00,0,1969.0,1468.0,0.746,9.383,1,0,0,0,1,0,1,0,0.0,0.0
1012,1681,2020-03-19 22:53:00,0,2142.0,1524.0,0.711,10.126,81,55,24,31,26,1,25,1,0.0,0.0
1012,1682,2020-03-19 22:56:00,0,2355.0,1781.0,0.756,11.253,424,213,149,64,211,137,74,45,0.0,0.0
1012,1683,2020-03-19 22:59:00,0,2720.0,2083.0,0.766,13.022,612,271,205,66,341,250,91,19,0.0,0.0
1012,1684,2020-03-19 23:02:00,0,2572.0,1968.0,0.765,12.312,377,160,113,47,217,154,63,35,0.0,0.0
1012,1685,2020-03-19 23:05:00,0,2360.0,1752.0,0.742,11.238,186,98,63,35,88,50,38,28,0.0,0.0
1012,1686,2020-03-19 23:08:00,0,2723.0,2047.0,0.752,12.994,92,81,37,44,11,4,7,0,0.0,0.0
1012,1687,2020-03-19 23:11:00,0,2586.0,1921.0,0.743,12.315,1,1,0,1,0,0,0,0,0.0,0.0
1012,1688,2020-03-19 23:14:00,0,2349.0,1797.0,0.765,11.244,1,1,0,1,0,0,0,0,0.0,0.0
1012,1689,2020-03-19 23:17:00,0,2374.0,1682.0,0.709,11.214,29,20,11,9,9,5,4,0,0.0,0.0
1012,1690,2020-03-19 23:20:00,0,2207.0,1617.0,0.733,10.487,5,4,0,4,1,1,0,0,0.0,0.0
1012,1691,2020-03-19 23:23:00,0,2094.0,1554.0,0.743,9.971,3,2,0,2,1,0,1,0,0.0,0.0
1012,1692,2020-03-19 23:26:00,0,1981.0,1491.0,0.753,9.455,51,44,21,23,7,0,7,0,0.0,0.0
1012,1693,2020-03-19 23:29:00,0,2206.0,1644.0,0.745,10.512,114,101,57,44,13,5,8,2,0.0,0.0
1012,1694,2020-03-19 23:32:00,0,2434.0,1863.0,0.765,11.652,354,172,120,52,182,131,51,10,0.0,0.0
1012,1695,2020-03-19 23:35:00,0,2589.0,1924.0,0.743,12.331,389,177,128,49,212,161,51,76,0.0,0.0
1012,1696,2020-03-19 23:38:00,0,2572.0,1956.0,0.761,12.298,222,81,42,39,141,85,56,27,0.0,0.0
1012,1697,2020-03-19 23:41:00,0,2735.0,2046.0,0.748,13.042,398,148,100,48,250,170,80,71,0.0,0.0
1012,1698,2020-03-19 23:44:00,0,2733.0,2050.0,0.75,13.038,592,187,144,43,405,318,87,102,0.02,0.0
1012,1699,2020-03-19 23:47:00,0,2905.0,2141.0,0.737,13.817,325,182,130,52,143,93,50,123,0.06,0.0
1012,1700,2020-03-19 23:50:00,0,2895.0,2097.0,0.724,13.726,306,149,102,47,157,111,46,18,0.0,0.0
1012,1701,2020-03-19 23:53:00,0,3100.0,2375.0,0.766,14.844,521,263,191,72,258,183,75,10,0.0,0.07
1012,1702,2020-03-19 23:56:00,0,3258.0,2447.0,0.751,15.546,454,247,177,70,207,144,63,13,0.0,0.0
1012,1703,2020-03-19 23:59:00,0,3414.0,2558.0,0.749,16.286,218,142,94,48,76,43,33,3,0.0,0.0
1012,1704,2020-03-20 00:02:00,0,3434.0,2522.0,0.734,16.324,352,233,153,80,119,81,38,8,0.0,0.0
1012,1705,2020-03-20 00:05:00,0,3107.0,2345.0,0.755,14.839,230,142,82,60,88,51,37,3,0.0,0.0
1012,1706,2020-03-20 00:08:00,0,2584.0,1904.0,0.737,12.288,275,79,48,31,196,124,72,14,0.0,0.0
1012,1707,2020-03-20 00:11:00,0,3194.0,2394.0,0.75,15.234,341,137,81,56,204,126,78,15,0.13,0.0
1012,1708,2020-03-20 00:14:00,0,2952.0,2222.0,0.753,14.089,407,127,80,47,280,207,73,66,0.0,0.0
1012,1709,2020-03-20 00:17:00,0,3507.0,2609.0,0.744,16.708,454,237,187,50,217,176,41,166,0.0,0.0
1012,1710,2020-03-20 00:20:00,0,2586.0,1913.0,0.74,12.306,229,54,33,21,175,102,73,5,0.0,0.0
1012,1711,2020-03-20 00:23:00,0,3118.0,2336.0,0.749,14.871,188,68,46,22,120,77,43,2,0.0,0.0
1012,1712,2020-03-20 00:26:00,0,3108.0,2377.0,0.765,14.878,333,160,111,49,173,124,49,59,0.0,0.0
1012,1713,2020-03-20 00:29:00,0,2604.0,1850.0,0.71,12.309,223,94,42,52,129,77,52,5,0.0,0.0
1012,1714,2020-03-20 00:32:00,0,2900.0,2153.0,0.742,13.811,329,108,54,54,221,142,79,8,0.0,0.0
1012,1715,2020-03-20 00:35:00,0,3042.0,2248.0,0.739,14.477,701,340,265,75,361,269,92,23,0.0,0.0
1012,1716,2020-03-20 00:38:00,0,2892.0,2135.0,0.738,13.759,196,98,60,38,98,54,44,11,0.0,0.0
1012,1717,2020-03-20 00:41:00,0,2801.0,2095.0,0.748,13.356,200,115,72,43,85,61,24,11,0.05,0.0
1012,1718,2020-03-20 00:44:00,0,2713.0,2074.0,0.765,12.987,505,210,142,68,295,214,81,10,0.0,0.0
1012,1719,2020-03-20 00:47:00,0,2573.0,1954.0,0.76,12.301,291,163,106,57,128,73,55,15,0.0,0.0
1012,1720,2020-03-20 00:50:00,0,2816.0,2065.0,0.733,13.383,40,22,3,19,18,2,16,0,0.0,0.0
1012,1721,2020-03-20 00:53:00,0,2738.0,2021.0,0.738,13.025,44,17,6,11,27,2,25,0,0.0,0.0
1012,1722,2020-03-20 00:56:00,0,2581.0,1940.0,0.752,12.316,0,0,0,0,0,0,0,0,0.0,0.0
1012,1723,2020-03-20 00:59:00,0,2343.0,1791.0,0.764,11.215,0,0,0,0,0,0,0,0,0.0,0.0
1012,1724,2020-03-20 01:02:00,0,2383.0,1690.0,0.709,11.261,15,15,1,14,0,0,0,0,0.0,0.0
1012,1725,2020-03-20 01:05:00,0,2208.0,1603.0,0.726,10.473,0,0,0,0,0,0,0,0,0.0,0.0
1012,1726,2020-03-20 01:08:00,0,2141.0,1526.0,0.713,10.126,4,4,1,3,0,0,0,0,0.0,0.0
1012,1727,2020-03-20 01:11:00,0,1979.0,1438.0,0.727,9.389,7,4,0,4,3,0,3,0,0.0,0.0
1012,1728,2020-03-20 01:14:00,0,1996.0,1396.0,0.699,9.41,8,5,0,5,3,1,2,0,0.0,0.0
1012,1729,2020-03-20 01:17:00,0,1990.0,1392.0,0.7,9.382,0,0,0,0,0,0,0,0,0.0,0.0
1012,1730,2020-03-20 01:20:00,0,2000.0,1408.0,0.704,9.44,6,6,0,6,0,0,0,0,0.0,0.0
1012,1731,2020-03-20 01:23:00,0,1824.0,1369.0,0.751,8.703,0,0,0,0,0,0,0,0,0.0,0.0
1012,1732,2020-03-20 01:26:00,0,1993.0,1409.0,0.707,9.411,7,6,3,3,1,1,0,0,0.0,0.0
1012,1733,2020-03-20 01:29:00,0,1907.0,1396.0,0.732,9.06,2,2,1,1,0,0,0,0,0.0,0.0
1012,1734,2020-03-20 01:32:00,0,1830.0,1373.0,0.75,8.731,20,20,1,19,0,0,0,0,0.0,0.0
1012,1735,2020-03-20 01:35:00,0,1982.0,1446.0,0.73,9.41,3,3,1,2,0,0,0,0,0.0,0.0
1012,1736,2020-03-20 01:38:00,0,2067.0,1501.0,0.726,9.806,25,17,9,8,8,4,4,0,0.0,0.0
1012,1737,2020-03-20 01:41:00,0,2208.0,1605.0,0.727,10.478,134,65,50,15,69,34,35,2,0.0,0.0
1012,1738,2020-03-20 01:44:00,0,2372.0,1685.0,0.71,11.213,126,52,23,29,74,29,45,5,0.0,0.0
1012,1739,2020-03-20 01:47:00,0,2588.0,1914.0,0.739,12.317,468,202,149,53,266,202,64,60,0.0,0.0
1012,1740,2020-03-20 01:50:00,0,2579.0,1976.0,0.766,12.35,434,217,163,54,217,166,51,122,0.0,0.0
1012,1741,2020-03-20 01:53:00,0,3129.0,2376.0,0.759,14.958,436,208,158,50,228,180,48,75,0.02,0.0
1012,1742,2020-03-20 01:56:00,0,2826.0,2083.0,0.737,13.44,303,87,66,21,216,147,69,25,0.0,0.0
1012,1743,2020-03-20 01:59:00,0,2574.0,1948.0,0.757,12.3,286,136,89,47,150,115,35,68,0.0,0.0
1012,1744,2020-03-20 02:02:00,0,2883.0,2116.0,0.734,13.704,199,89,51,38,110,72,38,50,0.0,0.0
1012,1745,2020-03-20 02:05:00,0,2723.0,2054.0,0.754,13.003,478,214,159,55,264,190,74,90,0.02,0.0
1012,1746,2020-03-20 02:08:00,0,2889.0,2140.0,0.741,13.753,436,147,106,41,289,229,60,80,0.03,0.0
1012,1747,2020-03-20 02:11:00,0,2342.0,1776.0,0.758,11.196,288,133,98,35,155,109,46,35,0.0,0.0
1012,1748,2020-03-20 02:14:00,0,3128.0,2264.0,0.724,14.833,426,279,194,85,147,97,50,12,0.0,0.0
1012,1749,2020-03-20 02:17:00,0,2893.0,2176.0,0.752,13.808,163,75,49,26,88,58,30,5,0.03,0.0
1012,1750,2020-03-20 02:20:00,0,2210.0,1635.0,0.74,10.518,53,38,10,28,15,1,14,7,0.01,0.0
1012,1751,2020-03-20 02:23:00,0,2474.5,1823.5,0.737,11.7685,41,34,19,15,7,5,2,4,0.01,0.0
1012,1752,2020-03-20 02:26:00,0,2739.0,2012.0,0.734,13.019,3,3,0,3,0,0,0,0,0.0,0.0
1012,1753,2020-03-20 02:29:00,0,2593.0,1903.0,0.734,12.321,3,3,0,3,0,0,0,0,0.0,0.0
1012,1754,2020-03-20 02:32:00,0,2350.0,1755.0,0.747,11.202,2,2,0,2,0,0,0,0,0.0,0.0
1012,1755,2020-03-20 02:35:00,0,2186.0,1629.0,0.745,10.418,4,4,0,4,0,0,0,0,0.0,0.0
1012,1756,2020-03-20 02:38:00,0,2224.0,1551.0,0.697,10.478,4,4,0,4,0,0,0,0,0.0,0.0
1012,1757,2020-03-20 02:41:00,0,1985.0,1471.0,0.741,9.45,0,0,0,0,0,0,0,0,0.0,0.0
1012,1758,2020-03-20 02:44:00,0,1999.0,1372.0,0.686,9.397,14,1,0,1,13,1,12,0,0.0,0.0
1012,1759,2020-03-20 02:47:00,0,1902.0,1376.0,0.723,9.016,0,0,0,0,0,0,0,0,0.0,0.0
1012,1760,2020-03-20 02:50:00,0,1997.0,1422.0,0.712,9.442,0,0,0,0,0,0,0,0,0.0,0.0
1012,1761,2020-03-20 02:53:00,0,1989.0,1403.0,0.705,9.391,29,24,18,6,5,2,3,0,0.0,0.0
1012,1762,2020-03-20 02:56:00,0,1997.0,1405.0,0.704,9.424,2,2,1,1,0,0,0,0,0.0,0.0
1012,1763,2020-03-20 02:59:00,0,1834.0,1327.0,0.724,8.695,18,18,5,13,0,0,0,0,0.0,0.0
1012,1764,2020-03-20 03:02:00,0,1914.0,1370.0,0.716,9.059,6,6,1,5,0,0,0,0,0.0,0.0
1012,1765,2020-03-20 03:05:00,0,1991.0,1426.0,0.716,9.423,8,8,1,7,0,0,0,0,0.0,0.0
1012,1766,2020-03-20 03:08:00,0,1994.0,1392.0,0.698,9.397,5,3,1,2,2,1,1,0,0.0,0.0
1012,1767,2020-03-20 03:11:00,0,1827.0,1346.0,0.737,8.686,2,2,1,1,0,0,0,0,0.0,0.0
1012,1768,2020-03-20 03:14:00,0,1830.0,1308.0,0.715,8.658,4,2,0,2,2,1,1,0,0.0,0.0
1012,1769,2020-03-20 03:17:00,0,1843.0,1298.0,0.704,8.699,12,7,0,7,5,0,5,0,0.0,0.0
1012,1770,2020-03-20 03:20:00,0,1824.0,1354.0,0.742,8.685,2,1,0,1,1,0,1,0,0.0,0.0
1012,1771,2020-03-20 03:23:00,0,1994.0,1425.0,0.715,9.436,100,67,34,33,33,4,29,2,0.0,0.0
1012,1772,2020-03-20 03:26:00,0,2367.0,1676.0,0.708,11.184,78,46,18,28,32,9,23,3,0.0,0.0
1012,1773,2020-03-20 03:29:00,0,2515.0,1868.0,0.743,11.978,208,129,78,51,79,43,36,22,0.0,0.0
1012,1774,2020-03-20 03:32:00,0,2885.0,2159.0,0.748,13.759,591,230,175,55,361,284,77,56,0.0,0.0
1012,1775,2020-03-20 03:35:00,0,2901.0,2143.0,0.739,13.802,429,172,131,41,257,199,58,162,0.0,0.0
1012,1776,2020-03-20 03:38:00,0,2660.0,1992.0,0.749,12.685,335,148,109,39,187,142,45,62,0.09,0.0
1012,1777,2020-03-20 03:41:00,0,2366.0,1693.0,0.716,11.195,199,76,47,29,123,88,35,5,0.04,0.0
1012,1778,2020-03-20 03:44:00,0,2594.0,1896.0,0.731,12.32,113,49,23,26,64,32,32,6,0.0,0.0
1012,1779,2020-03-20 03:47:00,0,2816.0,2093.0,0.743,13.411,436,229,178,51,207,149,58,19,0.0,0.0
1012,1780,2020-03-20 03:50:00,0,2756.0,2035.0,0.738,13.113,251,79,55,24,172,128,44,51,0.0,0.0
1012,1781,2020-03-20 03:53:00,0,2579.0,1968.0,0.763,12.34,308,108,77,31,200,142,58,50,0.0,0.0
1012,1782,2020-03-20 03:56:00,0,2578.0,1916.0,0.743,12.28,131,70,27,43,61,42,19,41,0.0,0.0
1012,1783,2020-03-20 03:59:00,0,2600.0,1874.0,0.721,12.318,40,10,4,6,30,5,25,35,0.0,0.0
1012,1784,2020-03-20 04:02:00,0,2365.0,1740.0,0.736,11.244,0,0,0,0,0,0,0,42,0.0,0.0
1012,1785,2020-03-20 04:05:00,0,2212.0,1616.0,0.731,10.506,1,1,1,0,0,0,0,34,0.0,0.0
1012,1786,2020-03-20 04:08:00,0,2139.0,1513.0,0.707,10.101,0,0,0,0,0,0,0,40,0.0,0.0
1012,1787,2020-03-20 04:11:00,0,1979.0,1428.0,0.722,9.379,0,0,0,0,0,0,0,37,0.0,0.0
1012,1788,2020-03-20 04:14:00,0,1819.0,1353.0,0.743,8.667,16,12,0,12,4,1,3,42,0.0,0.0
1012,1789,2020-03-20 04:17:00,0,1840.0,1332.0,0.724,8.725,38,12,4,8,26,6,20,26,0.0,0.0
1012,1790,2020-03-20 04:20:00,0,1914.0,1376.0,0.719,9.064,30,1,0,1,29,1,28,45,0.0,0.0
1012,1791,2020-03-20 04:23:00,0,1996.0,1382.0,0.693,9.395,7,4,0,4,3,0,3,54,0.0,0.0
1012,1792,2020-03-20 04:26:00,0,1915.0,1371.0,0.716,9.065,95,15,2,13,80,58,22,62,0.0,0.0
1012,1793,2020-03-20 04:29:00,0,2003.0,1392.0,0.695,9.431,6,0,0,0,6,0,6,64,0.0,0.0
1012,1794,2020-03-20 04:32:00,0,2007.0,1372.0,0.683,9.427,11,0,0,0,11,0,11,60,0.0,0.0
1012,1795,2020-03-20 04:35:00,0,1921.0,1372.0,0.714,9.088,2,2,0,2,0,0,0,73,0.0,0.0
1012,1796,2020-03-20 04:38:00,0,1980.0,1457.0,0.736,9.416,76,40,8,32,36,18,18,61,0.0,0.0
1012,1797,2020-03-20 04:41:00,0,2214.0,1631.0,0.737,10.528,222,106,62,44,116,63,53,47,0.0,0.0
1012,1798,2020-03-20 04:44:00,0,2287.0,1678.0,0.734,10.868,2,2,0,2,0,0,0,55,0.0,0.0
1012,1799,2020-03-20 04:47:00,0,2218.0,1598.0,0.72,10.509,0,0,0,0,0,0,0,51,0.0,0.0
1012,1800,2020-03-20 04:50:00,0,2056.0,1524.0,0.741,9.789,2,2,0,2,0,0,0,49,0.0,0.0
1012,1801,2020-03-20 04:53:00,0,1976.0,1469.0,0.744,9.411,4,1,0,1,3,2,1,51,0.0,0.0
1012,1802,2020-03-20 04:56:00,0,1986.0,1425.0,0.717,9.402,0,0,0,0,0,0,0,41,0.0,0.0
1012,1803,2020-03-20 04:59:00,0,1906.0,1395.0,0.732,9.056,8,6,4,2,2,1,1,35,0.0,0.0
1012,1804,2020-03-20 05:02:00,0,1821.0,1373.0,0.754,8.694,0,0,0,0,0,0,0,33,0.0,0.0
1012,1805,2020-03-20 05:05:00,0,1826.0,1350.0,0.739,8.691,18,13,5,8,5,1,4,50,0.0,0.0
1012,1806,2020-03-20 05:08:00,0,1986.0,1440.0,0.725,9.419,87,58,20,38,29,11,18,42,0.0,0.0
1012,1807,2020-03-20 05:11:00,0,2210.0,1600.0,0.724,10.481,132,71,40,31,61,21,40,41,0.0,0.0
1012,1808,2020-03-20 05:14:00,0,2342.0,1802.0,0.77,11.223,224,97,65,32,127,75,52,49,0.0,0.0
1012,1809,2020-03-20 05:17:00,0,2885.0,2169.0,0.752,13.769,600,250,173,77,350,266,84,105,0.06,0.0
1012,1810,2020-03-20 05:20:00,0,2887.0,2137.0,0.74,13.743,280,155,101,54,125,83,42,67,0.01,0.0
1012,1811,2020-03-20 05:23:00,0,3006.5,2218.5,0.738,14.304,350,142,93,49,208,143,65,38,0.0,0.0
1012,1812,2020-03-20 05:26:00,0,3126.0,2300.0,0.736,14.865,602,253,193,60,349,274,75,129,0.0,0.0
1012,1813,2020-03-20 05:29:00,0,2588.0,1907.0,0.737,12.31,221,112,64,48,109,72,37,44,0.0,0.0
1012,1814,2020-03-20 05:32:00,0,2597.0,1874.0,0.722,12.306,445,232,161,71,213,145,68,7,0.0,0.0
1012,1815,2020-03-20 05:35:00,0,2895.0,2130.0,0.736,13.766,501,160,111,49,341,264,77,6,0.02,0.0
1012,1816,2020-03-20 05:38:00,0,2731.0,2054.0,0.752,13.033,232,131,85,46,101,60,41,3,0.0,0.0
1012,1817,2020-03-20 05:41:00,0,2758.0,2005.0,0.727,13.086,753,215,144,71,538,440,98,3,0.01,0.0
1012,1818,2020-03-20 05:44:00,0,2591.0,1933.0,0.746,12.349,311,125,79,46,186,120,66,11,0.0,0.0
1012,1819,2020-03-20 05:47:00,0,2583.0,1895.0,0.734,12.274,67,24,6,18,43,12,31,0,0.0,0.0
1012,1820,2020-03-20 05:50:00,0,2589.0,1887.0,0.729,12.289,32,20,2,18,12,2,10,0,0.0,0.0
1012,1821,2020-03-20 05:53:00,0,2359.0,1762.0,0.747,11.245,5,5,0,5,0,0,0,0,0.0,0.0
1012,1822,2020-03-20 05:56:00,0,2229.0,1636.0,0.734,10.593,12,8,2,6,4,1,3,0,0.0,0.0
1012,1823,2020-03-20 05:59:00,0,2149.0,1531.0,0.712,10.162,37,26,7,19,11,0,11,0,0.0,0.0
1012,1824,2020-03-20 06:02:00,1,2041.0,1531.0,0.75,9.737,76,44,22,22,32,15,17,7,0.0,0.0
1012,1825,2020-03-20 06:05:00,1,3106.0,2311.0,0.744,14.794,131,50,27,23,81,51,30,8,0.0,0.0
1012,1826,2020-03-20 06:08:00,1,3465.0,2624.0,0.757,16.559,222,163,102,61,59,26,33,1,0.0,0.0
1012,1827,2020-03-20 06:11:00,1,3423.0,2583.0,0.755,16.347,198,126,73,53,72,33,39,11,0.0,0.0
1012,1828,2020-03-20 06:14:00,1,3263.0,2535.0,0.777,15.663,230,130,71,59,100,46,54,13,0.0,0.0
1012,1829,2020-03-20 06:17:00,1,3554.0,2721.0,0.766,17.014,249,126,65,61,123,65,58,10,0.0,0.0
1012,1830,2020-03-20 06:20:00,1,3484.0,2697.0,0.774,16.715,184,98,39,59,86,38,48,18,0.0,0.1
1012,1831,2020-03-20 06:23:00,1,3456.0,2729.0,0.79,16.638,130,52,25,27,78,52,26,14,0.26,0.06
1012,1832,2020-03-20 06:26:00,1,3728.0,3065.0,0.822,18.083,184,101,51,50,83,47,36,7,0.0,0.07
1012,1833,2020-03-20 06:29:00,1,3581.0,2924.0,0.816,17.347,223,78,48,30,145,109,36,26,0.22,0.03
1012,1834,2020-03-20 06:32:00,1,3586.0,2924.0,0.815,17.365,282,119,87,32,163,132,31,85,0.0,0.05
1012,1835,2020-03-20 06:35:00,1,3717.0,3168.0,0.852,18.153,314,133,77,56,181,124,57,25,0.0,0.0
1012,1836,2020-03-20 06:38:00,1,3793.0,3186.0,0.84,18.47,175,81,32,49,94,44,50,8,0.0,0.08
1012,1837,2020-03-20 06:41:00,1,3564.0,2957.0,0.83,17.315,72,28,7,21,44,25,19,0,0.2,0.03
1012,1838,2020-03-20 06:44:00,1,3710.0,3207.0,0.865,18.167,220,87,47,40,133,80,53,3,0.0,0.11
1012,1839,2020-03-20 06:47:00,1,3779.0,3317.0,0.878,18.561,273,94,49,45,179,132,47,2,0.03,0.05
1012,1840,2020-03-20 06:50:00,1,3338.0,2910.0,0.872,16.374,431,166,126,40,265,205,60,46,0.29,0.0
1012,1841,2020-03-20 06:53:00,1,3760.0,3346.0,0.89,18.517,170,61,33,28,109,73,36,13,0.0,0.09
1012,1842,2020-03-20 06:56:00,1,3157.0,2836.0,0.898,15.577,63,31,27,4,32,25,7,6,0.0,0.27
1012,1843,2020-03-20 06:59:00,1,3016.0,2656.0,0.881,14.823,120,29,18,11,91,61,30,3,0.0,0.01
1012,1844,2020-03-20 07:02:00,1,3003.0,2728.0,0.908,14.853,522,241,184,57,281,212,69,18,0.14,0.0
1012,1845,2020-03-20 07:05:00,1,2655.0,2347.0,0.884,13.059,427,214,156,58,213,152,61,10,0.0,0.01
1012,1846,2020-03-20 07:08:00,1,3010.0,2703.0,0.898,14.853,157,70,45,25,87,62,25,0,0.12,0.0
1012,1847,2020-03-20 07:11:00,1,2654.0,2369.0,0.893,13.081,51,28,6,22,23,3,20,1,0.0,0.0
1012,1848,2020-03-20 07:14:00,1,2488.0,2247.0,0.903,12.288,15,9,1,8,6,1,5,0,0.0,0.0
1012,1849,2020-03-20 07:17:00,1,2511.0,2207.0,0.879,12.338,1,1,0,1,0,0,0,0,0.0,0.0
1012,1850,2020-03-20 07:20:00,1,2439.0,2151.0,0.882,11.991,2,2,0,2,0,0,0,0,0.0,0.0
1012,1851,2020-03-20 07:23:00,1,2479.0,2304.0,0.929,12.319,1,1,0,1,0,0,0,0,0.0,0.0
1012,1852,2020-03-20 07:26:00,1,2768.0,2617.0,0.945,13.805,7,7,1,6,0,0,0,0,0.0,0.0
1012,1853,2020-03-20 07:29:00,1,2613.0,2478.0,0.948,13.038,0,0,0,0,0,0,0,0,0.0,0.0
1012,1854,2020-03-20 07:32:00,1,2626.0,2416.0,0.92,13.023,13,11,0,11,2,1,1,0,0.0,0.0
1012,1855,2020-03-20 07:35:00,1,2622.0,2477.0,0.945,13.071,9,2,0,2,7,1,6,0,0.0,0.0
1012,1856,2020-03-20 07:38:00,1,2634.0,2432.0,0.924,13.069,8,4,0,4,4,0,4,0,0.0,0.0
1012,1857,2020-03-20 07:41:00,1,2463.0,2347.0,0.953,12.302,160,51,36,15,109,83,26,0,0.24,0.0
1012,1858,2020-03-20 07:44:00,1,2618.0,2522.0,0.963,13.105,99,67,31,36,32,16,16,10,0.0,0.0
1012,1859,2020-03-20 07:47:00,1,2688.0,2542.0,0.946,13.405,130,76,34,42,54,24,30,8,0.0,0.0
1012,1860,2020-03-20 07:50:00,1,2762.0,2617.0,0.948,13.779,22,17,4,13,5,4,1,0,0.0,0.0
1012,1861,2020-03-20 07:53:00,1,2619.0,2550.0,0.974,13.144,3,1,0,1,2,1,1,0,0.0,0.0
1012,1862,2020-03-20 07:56:00,1,2467.0,2398.0,0.972,12.375,132,32,18,14,100,63,37,0,0.0,0.0
1012,1863,2020-03-20 07:59:00,1,2820.0,2755.0,0.977,14.161,189,76,46,30,113,80,33,10,0.0,0.02
1012,1864,2020-03-20 08:02:00,1,2240.0,2203.0,0.984,11.263,592,251,192,59,341,270,71,5,0.0,0.01
1012,1865,2020-03-20 08:05:00,1,2624.0,2478.0,0.945,13.081,420,142,94,48,278,207,71,18,0.0,0.01
1012,1866,2020-03-20 08:08:00,1,2751.0,2682.0,0.975,13.807,129,46,25,21,83,59,24,2,0.0,0.01
1012,1867,2020-03-20 08:11:00,1,2258.0,2118.0,0.938,11.242,50,38,9,29,12,3,9,0,0.0,0.0
1012,1868,2020-03-20 08:14:00,1,2651.0,2420.0,0.913,13.125,38,9,3,6,29,1,28,0,0.0,0.0
1012,1869,2020-03-20 08:17:00,1,2621.0,2482.0,0.947,13.075,15,2,1,1,13,1,12,0,0.0,0.0
1012,1870,2020-03-20 08:20:00,1,2620.0,2463.0,0.94,13.05,0,0,0,0,0,0,0,0,0.0,0.0
1012,1871,2020-03-20 08:23:00,1,2556.0,2384.0,0.9325,12.7105,1,1,0,1,0,0,0,0,0.0,0.0
1012,1872,2020-03-20 08:26:00,1,2492.0,2305.0,0.925,12.371,20,10,5,5,10,5,5,0,0.0,0.0
1012,1873,2020-03-20 08:29:00,1,2484.0,2269.0,0.913,12.299,8,4,3,1,4,1,3,0,0.0,0.0
1012,1874,2020-03-20 08:32:00,1,2409.0,2249.0,0.933,11.98,0,0,0,0,0,0,0,0,0.0,0.01
1012,1875,2020-03-20 08:35:00,1,2320.0,2241.0,0.966,11.62,1,1,0,1,0,0,0,0,0.0,0.0
1012,1876,2020-03-20 08:38:00,1,2239.0,2222.0,0.992,11.283,5,5,0,5,0,0,0,0,0.0,0.0
1012,1877,2020-03-20 08:41:00,1,2238.0,2204.0,0.985,11.256,1,1,1,0,0,0,0,0,0.0,0.0
1012,1878,2020-03-20 08:44:00,1,2249.0,2180.0,0.969,11.275,0,0,0,0,0,0,0,0,0.0,0.0
1012,1879,2020-03-20 08:47:00,1,2244.0,2129.0,0.949,11.2,3,3,1,2,0,0,0,0,0.0,0.0
1012,1880,2020-03-20 08:50:00,1,2261.0,2135.0,0.945,11.272,0,0,0,0,0,0,0,0,0.0,0.0
1012,1881,2020-03-20 08:53:00,1,2250.0,2116.0,0.94,11.207,0,0,0,0,0,0,0,0,0.0,0.0
1012,1882,2020-03-20 08:56:00,1,2266.0,2105.0,0.929,11.257,22,20,16,4,2,1,1,0,0.0,0.0
1012,1883,2020-03-20 08:59:00,1,2256.0,2139.0,0.948,11.254,0,0,0,0,0,0,0,0,0.0,0.0
1012,1884,2020-03-20 09:02:00,1,2248.0,2171.0,0.965,11.261,6,4,0,4,2,1,1,0,0.0,0.0
1012,1885,2020-03-20 09:05:00,1,2258.0,2133.0,0.945,11.26,12,12,0,12,0,0,0,0,0.0,0.0
1012,1886,2020-03-20 09:08:00,1,2251.0,2119.0,0.941,11.217,7,6,0,6,1,0,1,0,0.0,0.0
1012,1887,2020-03-20 09:11:00,1,2262.0,2110.0,0.933,11.25,7,6,0,6,1,0,1,0,0.0,0.0
1012,1888,2020-03-20 09:14:00,1,2604.0,2575.0,0.989,13.109,179,67,40,27,112,71,41,6,0.16,0.0
1012,1889,2020-03-20 09:17:00,1,2900.0,2824.0,0.974,14.553,132,73,37,36,59,34,25,9,0.0,0.0
1012,1890,2020-03-20 09:20:00,1,2597.0,2608.0,1.004,13.119,184,63,34,29,121,81,40,14,0.0,0.01
1012,1891,2020-03-20 09:23:00,1,2740.0,2707.0,0.988,13.793,131,57,26,31,74,38,36,35,0.0,0.0
1012,1892,2020-03-20 09:26:00,1,3028.0,2979.0,0.984,15.228,221,102,64,38,119,76,43,25,0.0,0.07
1012,1893,2020-03-20 09:29:00,1,2746.0,2705.0,0.985,13.814,178,69,46,23,109,61,48,31,0.0,0.08
1012,1894,2020-03-20 09:32:00,1,2685.0,2596.0,0.967,13.452,110,61,40,21,49,38,11,1,0.07,0.02
1012,1895,2020-03-20 09:35:00,1,2259.0,2113.0,0.936,11.238,77,57,11,46,20,7,13,0,0.0,0.0
1012,1896,2020-03-20 09:38:00,1,2102.0,2012.0,0.957,10.509,54,44,13,31,10,7,3,0,0.0,0.0
1012,1897,2020-03-20 09:41:00,1,2104.0,2004.0,0.952,10.51,19,15,1,14,4,2,2,0,0.0,0.0
1012,1898,2020-03-20 09:44:00,1,2332.0,2195.0,0.941,11.618,4,4,0,4,0,0,0,0,0.0,0.0
1012,1899,2020-03-20 09:47:00,1,2460.0,2382.0,0.968,12.33,5,5,0,5,0,0,0,0,0.0,0.0
1012,1900,2020-03-20 09:50:00,1,2607.0,2525.0,0.968,13.068,5,5,2,3,0,0,0,0,0.0,0.0
1012,1901,2020-03-20 09:53:00,1,2626.0,2483.0,0.945,13.096,2,2,0,2,0,0,0,0,0.0,0.0
1012,1902,2020-03-20 09:56:00,1,2609.0,2484.0,0.952,13.03,0,0,0,0,0,0,0,0,0.0,0.0
1012,1903,2020-03-20 09:59:00,1,2589.0,2563.0,0.99,13.038,10,8,6,2,2,1,1,0,0.0,0.0
1012,1904,2020-03-20 10:02:00,1,2673.0,2610.0,0.977,13.421,0,0,0,0,0,0,0,0,0.0,0.0
1012,1905,2020-03-20 10:05:00,1,2598.0,2558.0,0.985,13.068,11,11,0,11,0,0,0,0,0.0,0.0
1012,1906,2020-03-20 10:08:00,1,2615.0,2519.0,0.963,13.093,133,81,60,21,52,41,11,4,0.0,0.0
1012,1907,2020-03-20 10:11:00,1,2214.0,2267.0,1.024,11.234,3,3,0,3,0,0,0,0,0.0,0.0
1012,1908,2020-03-20 10:14:00,1,2448.0,2402.0,0.981,12.303,8,8,0,8,0,0,0,0,0.0,0.0
1012,1909,2020-03-20 10:17:00,1,2391.0,2320.0,0.97,11.989,1,1,0,1,0,0,0,0,0.0,0.0
1012,1910,2020-03-20 10:20:00,1,2235.0,2195.0,0.982,11.236,7,7,0,7,0,0,0,0,0.0,0.0
1012,1911,2020-03-20 10:23:00,1,2252.0,2158.0,0.958,11.262,1,1,0,1,0,0,0,0,0.0,0.0
1012,1912,2020-03-20 10:26:00,1,2182.0,2119.0,0.971,10.944,1,1,0,1,0,0,0,0,0.0,0.0
1012,1913,2020-03-20 10:29:00,1,2092.0,2088.0,0.998,10.553,2,2,0,2,0,0,0,0,0.0,0.0
1012,1914,2020-03-20 10:32:00,1,2094.0,2044.0,0.976,10.515,1,1,0,1,0,0,0,0,0.0,0.0
1012,1915,2020-03-20 10:35:00,1,2093.0,2028.0,0.969,10.491,41,23,15,8,18,11,7,1,0.0,0.0
1012,1916,2020-03-20 10:38:00,1,2235.0,2228.0,0.997,11.272,97,73,42,31,24,14,10,2,0.0,0.0
1012,1917,2020-03-20 10:41:00,1,2239.0,2215.0,0.99,11.272,5,5,0,5,0,0,0,0,0.0,0.0
1012,1918,2020-03-20 10:44:00,1,2170.0,2127.0,0.98,10.906,0,0,0,0,0,0,0,0,0.0,0.0
1012,1919,2020-03-20 10:47:00,1,2171.0,2119.0,0.976,10.901,2,2,0,2,0,0,0,0,0.0,0.0
1012,1920,2020-03-20 10:50:00,1,2093.0,2057.0,0.983,10.524,11,8,0,8,3,2,1,0,0.0,0.0
1012,1921,2020-03-20 10:53:00,1,2102.0,2035.0,0.968,10.533,5,0,0,0,5,1,4,0,0.0,0.0
1012,1922,2020-03-20 10:56:00,1,2115.0,1955.0,0.924,10.499,17,15,4,11,2,0,2,0,0.0,0.0
1012,1923,2020-03-20 10:59:00,1,2246.0,2157.0,0.96,11.238,63,53,6,47,10,2,8,1,0.0,0.0
1012,1924,2020-03-20 11:02:00,1,2469.0,2396.0,0.97,12.38,185,90,56,34,95,57,38,13,0.0,0.0
1012,1925,2020-03-20 11:05:00,1,2726.0,2772.0,1.017,13.81,180,66,34,32,114,61,53,59,0.0,0.0
1012,1926,2020-03-20 11:08:00,1,2940.0,2978.0,1.013,14.88,129,47,11,36,82,31,51,58,0.0,0.06
1012,1927,2020-03-20 11:11:00,1,2949.0,2915.0,0.989,14.845,101,32,10,22,69,30,39,56,0.0,0.06
1012,1928,2020-03-20 11:14:00,1,2797.0,2861.0,1.023,14.189,635,211,156,55,424,328,96,38,0.17,0.02
1012,1929,2020-03-20 11:17:00,1,2758.0,2715.0,0.984,13.873,319,138,87,51,181,119,62,35,0.0,0.0
1012,1930,2020-03-20 11:20:00,1,3090.0,3073.0,0.994,15.578,348,134,97,37,214,147,67,20,0.0,0.02
1012,1931,2020-03-20 11:23:00,1,2882.0,2815.5,0.9755,14.473,630,212,150,62,418,315,103,1,0.04,0.07
1012,1932,2020-03-20 11:26:00,1,2674.0,2558.0,0.957,13.368,502,181,117,64,321,245,76,11,0.0,0.0
1012,1933,2020-03-20 11:29:00,1,3463.0,3394.0,0.98,17.403,403,153,105,48,250,181,69,12,0.01,0.08
1012,1934,2020-03-20 11:32:00,1,2527.0,2438.0,0.965,12.655,604,205,146,59,399,300,99,17,0.0,0.0
1012,1935,2020-03-20 11:35:00,1,3328.0,3222.0,0.968,16.681,423,208,143,65,215,158,57,10,0.0,0.0
1012,1936,2020-03-20 11:38:00,1,2241.0,2170.0,0.968,11.231,202,97,43,54,105,52,53,4,0.0,0.0
1012,1937,2020-03-20 11:41:00,1,2472.0,2370.0,0.959,12.361,24,22,7,15,2,1,1,0,0.0,0.0
1012,1938,2020-03-20 11:44:00,1,2682.0,2584.0,0.964,13.429,1,1,0,1,0,0,0,0,0.0,0.0
1012,1939,2020-03-20 11:47:00,1,2767.0,2633.0,0.952,13.818,27,22,4,18,5,4,1,0,0.0,0.0
1012,1940,2020-03-20 11:50:00,1,2970.0,2879.0,0.969,14.887,55,21,9,12,34,17,17,0,0.0,0.0
1012,1941,2020-03-20 11:53:00,1,2728.0,2671.0,0.979,13.705,34,2,1,1,32,0,32,0,0.0,0.0
1012,1942,2020-03-20 11:56:00,1,2599.0,2557.0,0.984,13.07,14,5,1,4,9,0,9,0,0.0,0.0
1012,1943,2020-03-20 11:59:00,1,2606.0,2570.0,0.986,13.115,24,10,1,9,14,5,9,0,0.0,0.0
1012,1944,2020-03-20 12:02:00,1,2604.0,2532.0,0.972,13.063,10,2,0,2,8,4,4,0,0.0,0.0
1012,1945,2020-03-20 12:05:00,1,2596.0,2539.0,0.978,13.038,66,38,17,21,28,12,16,5,0.0,0.0
1012,1946,2020-03-20 12:08:00,1,2453.0,2404.0,0.98,12.324,5,0,0,0,5,1,4,0,0.0,0.0
1013,1,2020-03-16 10:53:00,1,4946.0,3702.0,0.748,23.588,717,367,280,87,350,262,88,28,0.0,0.0
1013,2,2020-03-16 10:56:00,1,5023.0,3811.0,0.759,24.011,650,342,274,68,308,217,91,17,0.0,0.31
1013,3,2020-03-16 10:59:00,1,5060.0,3814.0,0.754,24.162,236,145,101,44,91,52,39,1,0.0,0.0
1013,4,2020-03-16 11:02:00,1,4812.0,3643.0,0.757,22.993,92,35,18,17,57,12,45,0,0.0,0.0
1013,5,2020-03-16 11:05:00,1,4622.0,3447.0,0.746,22.027,159,68,45,23,91,39,52,1,0.0,0.0
1013,6,2020-03-16 11:08:00,1,4901.0,3663.0,0.747,23.364,599,341,257,84,258,189,69,20,0.01,0.0
1013,7,2020-03-16 11:11:00,1,4839.0,3633.0,0.751,23.088,253,149,108,41,104,63,41,12,0.0,0.0
1013,8,2020-03-16 11:14:00,1,4733.0,3561.0,0.752,22.592,143,80,60,20,63,26,37,2,0.0,0.0
1013,9,2020-03-16 11:17:00,1,4514.0,3364.0,0.745,21.512,31,4,2,2,27,12,15,0,0.0,0.0
1013,10,2020-03-16 11:20:00,1,4313.0,3226.0,0.748,20.567,29,24,8,16,5,2,3,0,0.0,0.0
1013,11,2020-03-16 11:23:00,1,4324.0,3148.0,0.728,20.522,43,5,4,1,38,11,27,0,0.0,0.0
1013,12,2020-03-16 11:26:00,1,4032.5,2958.5,0.734,19.164,34,0,0,0,34,6,28,0,0.0,0.0
1013,13,2020-03-16 11:29:00,1,3741.0,2769.0,0.74,17.806,66,2,2,0,64,27,37,0,0.0,0.0
1013,14,2020-03-16 11:32:00,1,3574.0,2598.0,0.727,16.959,47,2,1,1,45,10,35,0,0.01,0.0
1013,15,2020-03-16 11:35:00,1,3537.0,2572.0,0.727,16.782,20,1,0,1,19,0,19,0,0.0,0.0
1013,16,2020-03-16 11:38:00,1,3218.0,2336.0,0.726,15.266,237,149,109,40,88,46,42,4,0.0,0.0
1013,17,2020-03-16 11:41:00,1,3792.0,2870.0,0.757,18.117,96,70,45,25,26,13,13,2,0.0,0.0
1013,18,2020-03-16 11:44:00,1,4124.0,3059.0,0.742,19.637,150,80,34,46,70,33,37,5,0.01,0.0
1013,19,2020-03-16 11:47:00,1,4078.0,3101.0,0.76,19.502,389,220,166,54,169,104,65,14,0.0,0.0
1013,20,2020-03-16 11:50:00,1,4233.0,3288.0,0.777,20.319,536,312,240,72,224,164,60,10,0.0,0.0
1013,21,2020-03-16 11:53:00,1,4170.0,3206.0,0.769,19.978,204,132,98,34,72,41,31,1,0.0,0.0
1013,22,2020-03-16 11:56:00,1,4067.0,2943.0,0.724,19.285,60,15,11,4,45,23,22,0,0.01,0.0
1013,23,2020-03-16 11:59:00,1,3324.0,2455.0,0.739,15.817,22,5,2,3,17,1,16,0,0.0,0.0
1013,24,2020-03-16 12:02:00,1,3358.0,2437.0,0.726,15.93,37,4,0,4,33,2,31,0,0.0,0.0
1013,25,2020-03-16 12:05:00,1,3132.0,2293.0,0.732,14.877,30,0,0,0,30,0,30,0,0.0,0.0
1013,26,2020-03-16 12:08:00,1,3093.0,2250.0,0.727,14.68,46,8,1,7,38,4,34,0,0.01,0.0
1013,27,2020-03-16 12:11:00,1,2934.0,2119.0,0.722,13.906,69,30,12,18,39,2,37,0,0.0,0.0
1013,28,2020-03-16 12:14:00,1,2949.0,2122.0,0.72,13.968,16,8,0,8,8,0,8,0,0.0,0.0
1013,29,2020-03-16 12:17:00,1,2940.0,2160.0,0.735,13.975,35,23,4,19,12,2,10,0,0.0,0.0
1013,30,2020-03-16 12:20:00,1,2868.0,2128.0,0.742,13.654,66,31,9,22,35,0,35,0,0.0,0.0
1013,31,2020-03-16 12:23:00,1,2805.0,2125.0,0.757,13.405,64,27,2,25,37,0,37,0,0.0,0.0
1013,32,2020-03-16 12:26:00,1,2754.0,2088.0,0.758,13.163,25,0,0,0,25,0,25,0,0.0,0.0
1013,33,2020-03-16 12:29:00,1,2761.0,2117.0,0.767,13.221,25,0,0,0,25,0,25,0,0.0,0.0
1013,34,2020-03-16 12:32:00,1,2712.0,2058.0,0.759,12.962,296,267,248,19,29,0,29,0,0.0,0.0
1013,35,2020-03-16 12:35:00,1,2702.0,2080.0,0.77,12.948,484,434,403,31,50,0,50,0,0.0,0.0
1013,36,2020-03-16 12:38:00,1,2785.0,2154.0,0.774,13.357,368,333,274,59,35,0,35,0,0.01,0.0
1013,37,2020-03-16 12:41:00,1,2729.0,2060.0,0.755,13.035,93,66,57,9,27,0,27,0,0.0,0.0
1013,38,2020-03-16 12:44:00,1,3051.0,2293.0,0.751,14.56,487,387,370,17,100,56,44,9,0.0,0.0
1013,39,2020-03-16 12:47:00,1,2980.0,2236.0,0.75,14.216,322,242,222,20,80,41,39,0,0.0,0.0
1013,40,2020-03-16 12:50:00,1,3376.0,2536.0,0.751,16.11,484,356,335,21,128,76,52,16,0.0,0.0
1013,41,2020-03-16 12:53:00,1,3320.0,2532.0,0.763,15.884,387,294,255,39,93,55,38,1,0.0,0.0
1013,42,2020-03-16 12:56:00,1,3270.0,2482.0,0.759,15.633,482,354,339,15,128,74,54,11,0.0,0.0
1013,43,2020-03-16 12:59:00,1,3794.0,2933.0,0.773,18.195,329,240,221,19,89,58,31,4,0.0,0.0
1013,44,2020-03-16 13:02:00,1,3605.0,2706.0,0.751,17.199,98,59,55,4,39,10,29,1,0.0,0.0
1013,45,2020-03-16 13:05:00,1,3884.0,2927.0,0.754,18.545,407,368,344,24,39,14,25,0,0.0,0.0
1013,46,2020-03-16 13:08:00,1,3921.0,2971.0,0.758,18.737,290,203,154,49,87,47,40,2,0.01,0.0
1013,47,2020-03-16 13:11:00,1,3265.0,2411.0,0.738,15.533,35,0,0,0,35,8,27,0,0.0,0.0
1013,48,2020-03-16 13:14:00,1,3100.0,2331.0,0.752,14.797,23,0,0,0,23,0,23,0,0.0,0.0
1013,49,2020-03-16 13:17:00,1,3085.0,2276.0,0.738,14.674,70,41,20,21,29,6,23,0,0.0,0.0
1013,50,2020-03-16 13:20:00,1,2949.0,2164.0,0.734,14.014,439,414,342,72,25,0,25,0,0.0,0.0
1013,51,2020-03-16 13:23:00,1,2983.0,2168.0,0.727,14.154,424,401,365,36,23,0,23,0,0.02,0.0
1013,52,2020-03-16 13:26:00,1,2764.0,2032.0,0.735,13.141,259,235,216,19,24,0,24,0,0.0,0.0
1013,53,2020-03-16 13:29:00,1,2596.0,1948.0,0.751,12.386,61,41,39,2,20,0,20,0,0.0,0.0
1013,54,2020-03-16 13:32:00,1,2619.0,1988.0,0.759,12.519,65,37,33,4,28,0,28,0,0.0,0.0
1013,55,2020-03-16 13:35:00,1,2671.0,1969.0,0.737,12.706,40,2,2,0,38,4,34,0,0.0,0.0
1013,56,2020-03-16 13:38:00,1,2794.0,2033.0,0.728,13.26,40,0,0,0,40,0,40,0,0.0,0.0
1013,57,2020-03-16 13:41:00,1,2721.0,2040.0,0.75,12.978,34,0,0,0,34,0,34,0,0.0,0.0
1013,58,2020-03-16 13:44:00,1,2778.0,2101.0,0.756,13.273,36,0,0,0,36,0,36,0,0.0,0.0
1013,59,2020-03-16 13:47:00,1,2772.0,2091.0,0.754,13.237,204,163,149,14,41,2,39,0,0.01,0.0
1013,60,2020-03-16 13:50:00,1,2628.0,1923.0,0.732,12.482,80,55,50,5,25,2,23,0,0.0,0.0
1013,61,2020-03-16 13:53:00,1,2429.0,1829.0,0.753,11.594,15,0,0,0,15,0,15,0,0.0,0.0
1013,62,2020-03-16 13:56:00,1,2428.0,1816.0,0.748,11.576,21,0,0,0,21,0,21,0,0.0,0.0
1013,63,2020-03-16 13:59:00,1,2544.0,1881.0,0.739,12.106,243,220,206,14,23,0,23,0,0.0,0.0
1013,64,2020-03-16 14:02:00,1,2560.0,1900.0,0.742,12.19,27,1,1,0,26,2,24,0,0.0,0.0
1013,65,2020-03-16 14:05:00,1,2592.0,1953.0,0.753,12.374,80,50,47,3,30,9,21,0,0.0,0.0
1013,66,2020-03-16 14:08:00,1,2719.0,2020.0,0.743,12.951,58,16,14,2,42,22,20,0,0.0,0.0
1013,67,2020-03-16 14:11:00,1,2723.0,2023.0,0.743,12.969,456,431,407,24,25,16,9,0,0.0,0.0
1013,68,2020-03-16 14:14:00,1,2725.0,2083.0,0.765,13.043,457,436,416,20,21,0,21,0,0.0,0.0
1013,69,2020-03-16 14:17:00,1,2613.0,1905.0,0.729,12.404,520,477,459,18,43,12,31,0,0.0,0.0
1013,70,2020-03-16 14:20:00,1,2539.0,1882.0,0.741,12.086,45,11,10,1,34,12,22,0,0.0,0.0
1013,71,2020-03-16 14:23:00,1,2601.0,1937.0,0.745,12.392,63,35,33,2,28,4,24,0,0.0,0.0
1013,72,2020-03-16 14:26:00,1,2615.5,1930.5,0.738,12.443,73,41,37,4,32,8,24,0,0.0,0.0
1013,73,2020-03-16 14:29:00,1,2630.0,1924.0,0.731,12.494,43,15,14,1,28,6,22,0,0.0,0.0
1013,74,2020-03-16 14:32:00,1,2625.0,1935.0,0.737,12.486,21,0,0,0,21,4,17,0,0.0,0.0
1013,75,2020-03-16 14:35:00,1,2475.0,1831.0,0.74,11.777,53,26,23,3,27,4,23,0,0.0,0.0
1013,76,2020-03-16 14:38:00,1,2523.0,1807.0,0.716,11.94,389,365,345,20,24,4,20,0,0.0,0.0
1013,77,2020-03-16 14:41:00,1,2843.0,2150.0,0.756,13.581,498,453,423,30,45,8,37,2,0.0,0.0
1013,78,2020-03-16 14:44:00,1,3113.0,2229.0,0.716,14.734,468,400,368,32,68,38,30,6,0.0,0.0
1013,79,2020-03-16 14:47:00,1,3243.0,2360.0,0.728,15.391,395,322,297,25,73,48,25,6,0.0,0.0
1013,80,2020-03-16 14:50:00,1,3288.0,2423.0,0.737,15.638,59,30,28,2,29,7,22,0,0.01,0.0
1013,81,2020-03-16 14:53:00,1,2977.0,2203.0,0.74,14.171,254,209,189,20,45,0,45,0,0.0,0.0
1013,82,2020-03-16 14:56:00,1,2678.0,2012.0,0.751,12.78,179,125,117,8,54,0,54,0,0.0,0.0
1013,83,2020-03-16 14:59:00,1,2669.0,1957.0,0.733,12.683,47,9,8,1,38,0,38,0,0.0,0.0
1013,84,2020-03-16 15:02:00,1,2684.0,1938.0,0.722,12.719,148,109,100,9,39,16,23,0,0.0,0.0
1013,85,2020-03-16 15:05:00,1,2702.0,1919.0,0.71,12.769,124,39,36,3,85,25,60,0,0.0,0.0
1013,86,2020-03-16 15:08:00,1,2483.0,1842.0,0.742,11.824,62,0,0,0,62,2,60,0,0.0,0.0
1013,87,2020-03-16 15:11:00,1,2646.0,1926.0,0.728,12.56,80,32,7,25,48,8,40,0,0.0,0.0
1013,88,2020-03-16 15:14:00,1,2676.0,1899.0,0.71,12.645,79,40,10,30,39,2,37,0,0.01,0.0
1013,89,2020-03-16 15:17:00,1,2662.0,1928.0,0.724,12.624,106,65,63,2,41,13,28,0,0.0,0.0
1013,90,2020-03-16 15:20:00,1,2694.0,1907.0,0.708,12.725,104,53,50,3,51,12,39,0,0.0,0.0
1013,91,2020-03-16 15:23:00,1,2616.0,1902.0,0.727,12.411,353,297,260,37,56,21,35,0,0.0,0.0
1013,92,2020-03-16 15:26:00,1,2507.0,1858.0,0.741,11.936,23,0,0,0,23,0,23,0,0.0,0.0
1013,93,2020-03-16 15:29:00,1,2527.0,1851.0,0.732,12.007,29,1,1,0,28,0,28,0,0.0,0.0
1013,94,2020-03-16 15:32:00,1,2538.0,1847.0,0.728,12.046,100,75,69,6,25,2,23,0,0.0,0.0
1013,95,2020-03-16 15:35:00,1,2394.0,1773.0,0.741,11.394,53,20,18,2,33,5,28,0,0.0,0.0
1013,96,2020-03-16 15:38:00,1,2380.0,1738.0,0.73,11.304,49,0,0,0,49,0,49,0,0.0,0.0
1013,97,2020-03-16 15:41:00,1,2515.0,1802.0,0.716,11.903,56,2,2,0,54,0,54,0,0.0,0.0
1013,98,2020-03-16 15:44:00,1,2563.0,1824.0,0.711,12.118,52,14,13,1,38,0,38,0,0.0,0.0
1013,99,2020-03-16 15:47:00,1,2518.0,1844.0,0.732,11.962,36,2,2,0,34,8,26,0,0.01,0.0
1013,100,2020-03-16 15:50:00,1,2464.0,1817.0,0.737,11.722,43,4,4,0,39,6,33,0,0.0,0.0
1013,101,2020-03-16 15:53:00,1,2191.0,1640.0,0.749,10.45,49,6,6,0,43,6,37,0,0.0,0.0
1013,102,2020-03-16 15:56:00,1,2133.0,1612.0,0.756,10.187,36,0,0,0,36,4,32,0,0.0,0.0
1013,103,2020-03-16 15:59:00,1,2314.0,1647.0,0.712,10.942,53,2,2,0,51,12,39,0,0.0,0.0
1013,104,2020-03-16 16:02:00,1,2396.0,1771.0,0.739,11.401,388,271,250,21,117,73,44,0,0.0,0.0
1013,105,2020-03-16 16:05:00,1,2488.0,1876.0,0.754,11.88,279,224,214,10,55,6,49,0,0.0,0.0
1013,106,2020-03-16 16:08:00,1,2537.0,1909.0,0.752,12.11,7,4,4,0,3,1,2,0,0.0,0.0
1013,107,2020-03-16 16:11:00,1,2532.0,1914.0,0.756,12.094,15,15,14,1,0,0,0,0,0.0,0.0
1013,108,2020-03-16 16:14:00,1,2695.0,1943.0,0.721,12.77,19,16,15,1,3,0,3,0,0.0,0.0
1013,109,2020-03-16 16:17:00,1,2468.0,1849.0,0.749,11.771,110,98,89,9,12,0,12,0,0.0,0.0
1013,110,2020-03-16 16:20:00,1,2290.0,1757.0,0.767,10.968,26,2,2,0,24,2,22,0,0.0,0.0
1013,111,2020-03-16 16:23:00,1,2288.0,1698.0,0.742,10.895,37,7,5,2,30,8,22,0,0.0,0.0
1013,112,2020-03-16 16:26:00,1,2355.0,1747.0,0.742,11.215,207,179,167,12,28,2,26,0,0.0,0.0
1013,113,2020-03-16 16:29:00,1,2359.0,1751.0,0.742,11.235,441,410,392,18,31,0,31,0,0.0,0.0
1013,114,2020-03-16 16:32:00,1,2553.0,1834.0,0.718,12.091,149,89,85,4,60,34,26,0,0.01,0.0
1013,115,2020-03-16 16:35:00,1,2567.0,1846.0,0.719,12.158,144,29,8,21,115,65,50,0,0.0,0.0
1013,116,2020-03-16 16:38:00,1,2518.0,1806.0,0.717,11.919,120,45,9,36,75,31,44,0,0.0,0.0
1013,117,2020-03-16 16:41:00,1,2537.0,1838.0,0.725,12.033,186,101,30,71,85,44,41,0,0.0,0.0
1013,118,2020-03-16 16:44:00,1,2514.0,1884.0,0.749,11.993,114,79,0,79,35,9,26,0,0.0,0.0
1013,119,2020-03-16 16:47:00,1,2574.0,1919.0,0.746,12.265,127,83,18,65,44,18,26,0,0.0,0.0
1013,120,2020-03-16 16:50:00,1,2579.0,1847.0,0.716,12.208,128,92,15,77,36,15,21,0,0.0,0.0
1013,121,2020-03-16 16:53:00,1,2567.0,1842.0,0.717,12.156,100,75,4,71,25,0,25,0,0.0,0.0
1013,122,2020-03-16 16:56:00,1,2478.0,1856.0,0.749,11.82,293,273,218,55,20,2,18,0,0.0,0.0
1013,123,2020-03-16 16:59:00,1,2279.0,1690.0,0.742,10.849,227,116,33,83,111,76,35,0,0.0,0.0
1013,124,2020-03-16 17:02:00,1,2338.0,1758.0,0.752,11.159,339,195,119,76,144,89,55,3,0.0,0.0
1013,125,2020-03-16 17:05:00,1,3153.0,2406.0,0.763,15.088,346,229,184,45,117,65,52,3,0.0,0.0
1013,126,2020-03-16 17:08:00,1,3399.0,2645.0,0.778,16.319,295,193,119,74,102,56,46,3,0.0,0.0
1013,127,2020-03-16 17:11:00,1,3640.0,2853.0,0.784,17.499,351,271,224,47,80,50,30,11,0.0,0.0
1013,128,2020-03-16 17:14:00,1,3638.0,2756.0,0.757,17.387,529,373,313,60,156,109,47,14,0.0,0.0
1013,129,2020-03-16 17:17:00,1,3963.0,2991.0,0.755,18.924,516,403,379,24,113,79,34,19,0.0,0.0
1013,130,2020-03-16 17:20:00,1,3918.0,2932.0,0.748,18.685,415,302,291,11,113,65,48,5,0.0,0.0
1013,131,2020-03-16 17:23:00,1,3677.0,2746.0,0.747,17.527,304,246,233,13,58,36,22,0,0.0,0.0
1013,132,2020-03-16 17:26:00,1,3700.0,2701.5,0.7305,17.5685,424,280,262,18,144,102,42,0,0.0,0.0
1013,133,2020-03-16 17:29:00,1,3723.0,2657.0,0.714,17.61,427,335,322,13,92,56,36,11,0.01,0.0
1013,134,2020-03-16 17:32:00,1,3688.0,2638.0,0.715,17.451,503,352,333,19,151,103,48,19,0.0,0.0
1013,135,2020-03-16 17:35:00,1,3719.0,2661.0,0.716,17.601,447,314,279,35,133,93,40,17,0.0,0.0
1013,136,2020-03-16 17:38:00,1,3702.0,2647.0,0.715,17.516,370,195,147,48,175,117,58,7,0.0,0.0
1013,137,2020-03-16 17:41:00,1,3519.0,2588.0,0.735,16.732,68,40,21,19,28,4,24,0,0.0,0.0
1013,138,2020-03-16 17:44:00,1,3461.0,2541.0,0.734,16.45,104,71,37,34,33,0,33,0,0.0,0.0
1013,139,2020-03-16 17:47:00,1,3342.0,2485.0,0.743,15.92,11,9,1,8,2,0,2,4,0.0,0.0
1013,140,2020-03-16 17:50:00,1,3121.0,2224.0,0.713,14.758,0,0,0,0,0,0,0,0,0.0,0.0
1013,141,2020-03-16 17:53:00,1,2816.0,1981.0,0.703,13.29,0,0,0,0,0,0,0,0,0.0,0.0
1013,142,2020-03-16 17:56:00,1,2754.0,1960.0,0.712,13.021,5,5,3,2,0,0,0,0,0.0,0.0
1013,143,2020-03-16 17:59:00,1,2664.0,1849.0,0.694,12.544,0,0,0,0,0,0,0,0,0.0,0.0
1013,144,2020-03-16 18:02:00,0,2513.0,1783.0,0.709,11.877,1,1,1,0,0,0,0,0,0.01,0.0
1013,145,2020-03-16 18:05:00,0,2481.0,1787.0,0.72,11.753,0,0,0,0,0,0,0,0,0.0,0.0
1013,146,2020-03-16 18:08:00,0,2396.0,1708.0,0.713,11.33,0,0,0,0,0,0,0,0,0.0,0.0
1013,147,2020-03-16 18:11:00,0,2435.0,1714.0,0.704,11.494,5,5,0,5,0,0,0,0,0.0,0.0
1013,148,2020-03-16 18:14:00,0,2372.0,1598.0,0.674,11.115,1,1,0,1,0,0,0,0,0.0,0.0
1013,149,2020-03-16 18:17:00,0,2649.0,1813.0,0.685,12.445,10,9,1,8,1,0,1,0,0.0,0.0
1013,150,2020-03-16 18:20:00,0,2400.0,1751.0,0.73,11.394,4,2,0,2,2,0,2,0,0.0,0.0
1013,151,2020-03-16 18:23:00,0,2393.0,1701.0,0.711,11.312,223,150,116,34,73,54,19,21,0.0,0.0
1013,152,2020-03-16 18:26:00,0,3159.0,2381.0,0.754,15.085,201,126,93,33,75,54,21,25,0.0,0.0
1013,153,2020-03-16 18:29:00,0,3098.0,2278.0,0.735,14.727,51,44,13,31,7,1,6,5,0.0,0.0
1013,154,2020-03-16 18:32:00,0,3165.0,2326.0,0.735,15.046,123,79,37,42,44,25,19,7,0.0,0.0
1013,155,2020-03-16 18:35:00,0,3169.0,2362.0,0.745,15.103,137,113,72,41,24,0,24,13,0.0,0.0
1013,156,2020-03-16 18:38:00,0,3288.0,2409.0,0.733,15.622,157,108,77,31,49,29,20,10,0.0,0.0
1013,157,2020-03-16 18:41:00,0,2961.0,2194.0,0.741,14.095,1,0,0,0,1,0,1,0,0.0,0.0
1013,158,2020-03-16 18:44:00,0,2805.0,2054.0,0.732,13.325,17,9,3,6,8,2,6,3,0.0,0.0
1013,159,2020-03-16 18:47:00,0,2785.0,2010.0,0.722,13.198,4,1,0,1,3,0,3,0,0.0,0.0
1013,160,2020-03-16 18:50:00,0,2602.0,1897.0,0.729,12.354,9,6,0,6,3,0,3,0,0.0,0.0
1013,161,2020-03-16 18:53:00,0,2589.0,1820.0,0.703,12.216,13,9,1,8,4,0,4,0,0.0,0.0
1013,162,2020-03-16 18:56:00,0,2760.0,2019.0,0.731,13.111,1,1,0,1,0,0,0,0,0.0,0.0
1013,163,2020-03-16 18:59:00,0,2757.0,2010.0,0.729,13.088,65,41,14,27,24,4,20,4,0.0,0.0
1013,164,2020-03-16 19:02:00,0,3104.0,2328.0,0.75,14.808,445,240,178,62,205,148,57,40,0.0,0.0
1013,165,2020-03-16 19:05:00,0,3535.0,2577.0,0.729,16.781,166,134,93,41,32,10,22,28,0.0,0.0
1013,166,2020-03-16 19:08:00,0,3131.0,2332.0,0.745,14.919,201,32,10,22,169,132,37,5,0.0,0.0
1013,167,2020-03-16 19:11:00,0,3372.0,2432.0,0.721,15.978,224,89,48,41,135,97,38,1,0.0,0.0
1013,168,2020-03-16 19:14:00,0,3320.0,2398.0,0.722,15.735,97,35,13,22,62,27,35,0,0.0,0.0
1013,169,2020-03-16 19:17:00,0,3336.0,2491.0,0.747,15.901,266,152,110,42,114,72,42,38,0.0,0.0
1013,170,2020-03-16 19:20:00,0,3591.0,2658.0,0.74,17.092,525,327,267,60,198,136,62,55,0.0,0.0
1013,171,2020-03-16 19:23:00,0,3686.0,2658.0,0.721,17.467,468,290,236,54,178,133,45,39,0.0,0.0
1013,172,2020-03-16 19:26:00,0,3565.0,2614.0,0.733,16.941,384,234,172,62,150,106,44,51,0.0,0.0
1013,173,2020-03-16 19:29:00,0,3438.0,2471.0,0.719,16.282,236,123,83,40,113,71,42,7,0.0,0.0
1013,174,2020-03-16 19:32:00,0,3295.0,2401.0,0.729,15.642,262,127,89,38,135,94,41,19,0.0,0.0
1013,175,2020-03-16 19:35:00,0,3146.0,2281.0,0.725,14.922,162,0,0,0,162,119,43,0,0.0,0.0
1013,176,2020-03-16 19:38:00,0,2880.0,2080.0,0.722,13.649,23,0,0,0,23,11,12,0,0.0,0.0
1013,177,2020-03-16 19:41:00,0,2585.0,1874.0,0.725,12.259,83,17,6,11,66,30,36,5,0.0,0.0
1013,178,2020-03-16 19:44:00,0,2755.0,1980.0,0.719,13.048,512,274,203,71,238,176,62,38,0.0,0.0
1013,179,2020-03-16 19:47:00,0,2852.0,2140.0,0.75,13.605,47,3,2,1,44,24,20,2,0.0,0.0
1013,180,2020-03-16 19:50:00,0,2824.0,2029.0,0.719,13.371,10,0,0,0,10,1,9,0,0.0,0.0
1013,181,2020-03-16 19:53:00,0,2727.0,1940.0,0.712,12.893,8,0,0,0,8,4,4,0,0.0,0.0
1013,182,2020-03-16 19:56:00,0,2555.0,1813.0,0.71,12.073,14,0,0,0,14,8,6,0,0.0,0.0
1013,183,2020-03-16 19:59:00,0,2349.0,1694.0,0.721,11.13,126,40,24,16,86,49,37,1,0.0,0.0
1013,184,2020-03-16 20:02:00,0,2709.0,1967.0,0.726,12.851,385,244,196,48,141,112,29,24,0.0,0.0
1013,185,2020-03-16 20:05:00,0,2886.0,2147.0,0.744,13.748,296,141,94,47,155,109,46,34,0.0,0.0
1013,186,2020-03-16 20:08:00,0,3040.0,2209.0,0.727,14.425,96,67,48,19,29,16,13,2,0.0,0.0
1013,187,2020-03-16 20:11:00,0,2918.0,2078.0,0.712,13.797,3,0,0,0,3,1,2,0,0.0,0.0
1013,188,2020-03-16 20:14:00,0,2802.0,1945.0,0.694,13.194,185,120,87,33,65,45,20,21,0.0,0.0
1013,189,2020-03-16 20:17:00,0,2796.0,1939.0,0.694,13.165,164,53,20,33,111,56,55,1,0.0,0.0
1013,190,2020-03-16 20:20:00,0,2895.0,2113.0,0.73,13.745,253,147,101,46,106,67,39,30,0.0,0.0
1013,191,2020-03-16 20:23:00,0,2945.0,2230.0,0.757,14.071,153,104,67,37,49,24,25,17,0.0,0.0
1013,192,2020-03-16 20:26:00,0,2826.0,2085.0,0.737,13.443,16,8,3,5,8,3,5,0,0.0,0.0
1013,193,2020-03-16 20:29:00,0,2707.0,1940.0,0.717,12.815,46,21,4,17,25,5,20,0,0.0,0.0
1013,194,2020-03-16 20:32:00,0,2659.0,1864.0,0.701,12.542,26,16,6,10,10,0,10,0,0.0,0.0
1013,195,2020-03-16 20:35:00,0,2384.0,1748.0,0.733,11.329,11,5,5,0,6,2,4,0,0.0,0.0
1013,196,2020-03-16 20:38:00,0,2307.0,1650.0,0.715,10.918,16,6,1,5,10,4,6,0,0.0,0.0
1013,197,2020-03-16 20:41:00,0,2209.0,1581.0,0.716,10.453,124,80,50,30,44,16,28,2,0.0,0.0
1013,198,2020-03-16 20:44:00,0,2577.0,1900.0,0.737,12.256,321,177,109,68,144,107,37,46,0.0,0.0
1013,199,2020-03-16 20:47:00,0,2979.0,2217.0,0.744,14.192,363,233,180,53,130,88,42,55,0.0,0.0
1013,200,2020-03-16 20:50:00,0,3131.0,2261.0,0.722,14.841,78,59,41,18,19,12,7,2,0.0,0.0
1013,201,2020-03-16 20:53:00,0,2914.0,2151.0,0.738,13.863,10,1,0,1,9,2,7,0,0.0,0.0
1013,202,2020-03-16 20:56:00,0,2786.0,2021.0,0.726,13.216,62,17,7,10,45,36,9,0,0.0,0.0
1013,203,2020-03-16 20:59:00,0,2605.0,1939.0,0.744,12.41,88,62,40,22,26,16,10,0,0.0,0.0
1013,204,2020-03-16 21:02:00,0,2593.0,1855.0,0.715,12.27,47,17,5,12,30,11,19,0,0.0,0.0
1013,205,2020-03-16 21:05:00,0,2463.0,1789.0,0.726,11.687,14,4,1,3,10,4,6,0,0.01,0.0
1013,206,2020-03-16 21:08:00,0,2377.0,1718.0,0.723,11.268,77,26,11,15,51,25,26,2,0.0,0.0
1013,207,2020-03-16 21:11:00,0,2636.0,1890.0,0.717,12.479,167,79,28,51,88,43,45,4,0.0,0.0
1013,208,2020-03-16 21:14:00,0,2918.0,2148.0,0.736,13.874,330,190,131,59,140,97,43,11,0.0,0.0
1013,209,2020-03-16 21:17:00,0,3146.0,2354.0,0.748,15.003,329,180,140,40,149,109,40,29,0.0,0.0
1013,210,2020-03-16 21:20:00,0,3329.0,2427.0,0.729,15.805,288,141,105,36,147,95,52,25,0.0,0.0
1013,211,2020-03-16 21:23:00,0,3312.0,2436.0,0.735,15.749,296,178,127,51,118,83,35,28,0.0,0.0
1013,212,2020-03-16 21:26:00,0,3308.0,2415.0,0.73,15.709,393,215,168,47,178,137,41,56,0.0,0.0
1013,213,2020-03-16 21:29:00,0,3333.0,2410.0,0.723,15.8,245,138,107,31,107,73,34,32,0.0,0.0
1013,214,2020-03-16 21:32:00,0,3353.0,2427.0,0.724,15.899,322,133,90,43,189,145,44,32,0.0,0.0
1013,215,2020-03-16 21:35:00,0,3188.0,2370.0,0.743,15.187,48,26,16,10,22,7,15,0,0.0,0.0
1013,216,2020-03-16 21:38:00,0,2928.0,2131.0,0.728,13.896,31,21,12,9,10,0,10,0,0.0,0.0
1013,217,2020-03-16 21:41:00,0,2827.0,2026.0,0.717,13.381,58,22,7,15,36,9,27,0,0.0,0.0
1013,218,2020-03-16 21:44:00,0,2637.0,1833.0,0.695,12.419,4,3,0,3,1,0,1,0,0.0,0.0
1013,219,2020-03-16 21:47:00,0,2353.0,1662.0,0.706,11.112,27,9,5,4,18,6,12,0,0.0,0.0
1013,220,2020-03-16 21:50:00,0,2241.0,1608.0,0.718,10.611,54,23,11,12,31,6,25,0,0.0,0.0
1013,221,2020-03-16 21:53:00,0,2215.0,1587.0,0.716,10.482,40,12,4,8,28,0,28,0,0.0,0.0
1013,222,2020-03-16 21:56:00,0,2204.0,1553.0,0.705,10.402,40,18,6,12,22,1,21,0,0.0,0.0
1013,223,2020-03-16 21:59:00,0,2150.0,1543.0,0.718,10.178,22,21,3,18,1,0,1,0,0.0,0.0
1013,224,2020-03-16 22:02:00,0,2229.0,1592.0,0.714,10.545,11,11,3,8,0,0,0,0,0.0,0.0
1013,225,2020-03-16 22:05:00,0,2224.0,1604.0,0.721,10.538,27,24,7,17,3,2,1,0,0.0,0.0
1013,226,2020-03-16 22:08:00,0,2300.0,1658.0,0.721,10.897,283,160,113,47,123,87,36,23,0.0,0.0
1013,227,2020-03-16 22:11:00,0,2798.0,2060.0,0.736,13.307,375,216,160,56,159,119,40,28,0.01,0.0
1013,228,2020-03-16 22:14:00,0,3095.0,2229.0,0.72,14.665,255,127,87,40,128,82,46,30,0.0,0.0
1013,229,2020-03-16 22:17:00,0,3149.0,2236.0,0.71,14.884,167,97,74,23,70,39,31,11,0.0,0.0
1013,230,2020-03-16 22:20:00,0,3197.0,2308.0,0.722,15.152,330,179,144,35,151,113,38,44,0.0,0.0
1013,231,2020-03-16 22:23:00,0,3365.0,2425.0,0.721,15.942,353,243,183,60,110,77,33,26,0.0,0.0
1013,232,2020-03-16 22:26:00,0,3143.0,2312.0,0.736,14.941,265,156,118,38,109,76,33,30,0.0,0.0
1013,233,2020-03-16 22:29:00,0,2857.0,2147.0,0.752,13.635,55,24,4,20,31,17,14,0,0.0,0.0
1013,234,2020-03-16 22:32:00,0,2945.0,2173.0,0.738,14.01,179,71,28,43,108,64,44,4,0.0,0.0
1013,235,2020-03-16 22:35:00,0,2939.0,2203.0,0.75,14.017,161,38,14,24,123,66,57,3,0.0,0.0
1013,236,2020-03-16 22:38:00,0,2996.0,2198.0,0.734,14.237,86,38,20,18,48,33,15,9,0.0,0.0
1013,237,2020-03-16 22:41:00,0,2717.0,2013.0,0.741,12.933,24,0,0,0,24,2,22,0,0.0,0.0
1013,238,2020-03-16 22:44:00,0,2575.0,1871.0,0.727,12.216,10,1,1,0,9,0,9,0,0.0,0.0
1013,239,2020-03-16 22:47:00,0,2452.0,1759.0,0.718,11.609,285,153,125,28,132,100,32,14,0.0,0.0
1013,240,2020-03-16 22:50:00,0,2571.0,1918.0,0.746,12.254,248,187,142,45,61,41,20,25,0.0,0.0
1013,241,2020-03-16 22:53:00,0,2810.0,1999.0,0.711,13.285,81,48,35,13,33,18,15,2,0.0,0.0
1013,242,2020-03-16 22:56:00,0,2477.0,1831.0,0.739,11.788,2,1,0,1,1,0,1,0,0.0,0.0
1013,243,2020-03-16 22:59:00,0,2340.0,1667.0,0.712,11.067,3,0,0,0,3,2,1,0,0.0,0.0
1013,244,2020-03-16 23:02:00,0,2176.0,1593.0,0.732,10.336,10,1,1,0,9,0,9,0,0.0,0.0
1013,245,2020-03-16 23:05:00,0,2187.0,1520.0,0.695,10.299,20,11,7,4,9,5,4,0,0.0,0.0
1013,246,2020-03-16 23:08:00,0,2063.0,1492.0,0.723,9.779,20,3,0,3,17,6,11,0,0.0,0.0
1013,247,2020-03-16 23:11:00,0,2077.0,1425.0,0.686,9.764,18,11,1,10,7,3,4,0,0.0,0.0
1013,248,2020-03-16 23:14:00,0,1947.0,1376.0,0.707,9.193,183,50,16,34,133,83,50,2,0.0,0.0
1013,249,2020-03-16 23:17:00,0,2466.0,1832.0,0.743,11.743,172,94,59,35,78,48,30,13,0.0,0.0
1013,250,2020-03-16 23:20:00,0,2460.0,1812.0,0.737,11.7,125,35,7,28,90,52,38,2,0.0,0.0
1013,251,2020-03-16 23:23:00,0,2614.0,1907.0,0.729,12.412,171,75,20,55,96,45,51,14,0.0,0.0
1013,252,2020-03-16 23:26:00,0,2781.5,2049.5,0.736,13.23,326,191,139,52,135,98,37,31,0.0,0.0
1013,253,2020-03-16 23:29:00,0,2949.0,2192.0,0.743,14.048,230,169,131,38,61,42,19,30,0.0,0.0
1013,254,2020-03-16 23:32:00,0,3163.0,2254.0,0.713,14.959,416,202,157,45,214,160,54,24,0.0,0.0
1013,255,2020-03-16 23:35:00,0,3167.0,2361.0,0.745,15.093,198,150,107,43,48,32,16,39,0.0,0.0
1013,256,2020-03-16 23:38:00,0,3179.0,2362.0,0.743,15.14,364,234,177,57,130,92,38,58,0.0,0.0
1013,257,2020-03-16 23:41:00,0,3343.0,2418.0,0.723,15.85,359,192,150,42,167,111,56,51,0.0,0.0
1013,258,2020-03-16 23:44:00,0,3199.0,2356.0,0.737,15.211,191,132,93,39,59,39,20,15,0.0,0.0
1013,259,2020-03-16 23:47:00,0,3122.0,2280.0,0.73,14.827,146,81,51,30,65,47,18,8,0.0,0.0
1013,260,2020-03-16 23:50:00,0,2907.0,2148.0,0.739,13.831,31,18,6,12,13,8,5,0,0.01,0.0
1013,261,2020-03-16 23:53:00,0,2782.0,1998.0,0.718,13.173,118,57,38,19,61,38,23,15,0.0,0.0
1013,262,2020-03-16 23:56:00,0,2804.0,1987.0,0.709,13.248,251,110,76,34,141,107,34,18,0.0,0.0
1013,263,2020-03-16 23:59:00,0,2607.0,1902.0,0.73,12.376,8,1,1,0,7,0,7,0,0.0,0.0
1013,264,2020-03-17 00:02:00,0,2456.0,1786.0,0.727,11.653,22,9,4,5,13,1,12,0,0.0,0.0
1013,265,2020-03-17 00:05:00,0,2354.0,1662.0,0.706,11.115,13,2,1,1,11,0,11,0,0.0,0.0
1013,266,2020-03-17 00:08:00,0,2254.0,1619.0,0.719,10.673,5,4,1,3,1,0,1,0,0.0,0.0
1013,267,2020-03-17 00:11:00,0,2035.0,1499.0,0.737,9.676,11,6,0,6,5,0,5,0,0.0,0.0
1013,268,2020-03-17 00:14:00,0,2073.0,1445.0,0.697,9.77,28,20,2,18,8,2,6,0,0.0,0.0
1013,269,2020-03-17 00:17:00,0,1801.0,1340.0,0.744,8.581,87,32,6,26,55,31,24,10,0.0,0.0
1013,270,2020-03-17 00:20:00,0,2140.0,1541.0,0.72,10.138,281,162,107,55,119,82,37,34,0.0,0.0
1013,271,2020-03-17 00:23:00,0,2619.0,1891.0,0.722,12.412,232,166,103,63,66,40,26,40,0.0,0.0
1013,272,2020-03-17 00:26:00,0,2805.0,2047.0,0.73,13.319,258,158,123,35,100,68,32,25,0.0,0.0
1013,273,2020-03-17 00:29:00,0,2894.0,2053.0,0.709,13.676,116,104,62,42,12,4,8,23,0.0,0.0
1013,274,2020-03-17 00:32:00,0,2937.0,2164.0,0.737,13.969,268,127,89,38,141,100,41,38,0.0,0.0
1013,275,2020-03-17 00:35:00,0,3146.0,2275.0,0.723,14.914,416,242,193,49,174,127,47,59,0.0,0.0
1013,276,2020-03-17 00:38:00,0,3370.0,2396.0,0.711,15.931,209,121,87,34,88,62,26,24,0.06,0.0
1013,277,2020-03-17 00:41:00,0,3340.0,2467.0,0.739,15.89,230,109,71,38,121,70,51,11,0.68,0.0
1013,278,2020-03-17 00:44:00,0,3541.0,2511.0,0.709,16.733,443,231,182,49,212,143,69,46,0.08,0.0
1013,279,2020-03-17 00:47:00,0,3293.0,2377.0,0.722,15.605,308,194,155,39,114,76,38,44,0.0,0.0
1013,280,2020-03-17 00:50:00,0,3312.0,2470.0,0.746,15.784,226,90,67,23,136,85,51,7,0.06,0.0
1013,281,2020-03-17 00:53:00,0,2976.0,2149.0,0.722,14.105,173,60,40,20,113,68,45,28,0.33,0.0
1013,282,2020-03-17 00:56:00,0,3265.0,2406.0,0.737,15.53,516,265,205,60,251,176,75,39,0.03,0.0
1013,283,2020-03-17 00:59:00,0,3289.0,2436.0,0.741,15.656,446,248,197,51,198,156,42,41,0.0,0.0
1013,284,2020-03-17 01:02:00,0,3135.0,2300.0,0.734,14.899,498,252,191,61,246,175,71,72,0.0,0.0
1013,285,2020-03-17 01:05:00,0,3292.0,2406.0,0.731,15.634,299,167,112,55,132,95,37,46,0.0,0.0
1013,286,2020-03-17 01:08:00,0,3532.0,2542.0,0.72,16.73,235,105,71,34,130,74,56,16,0.23,0.0
1013,287,2020-03-17 01:11:00,0,3141.0,2347.0,0.747,14.974,394,231,186,45,163,120,43,56,0.01,0.0
1013,288,2020-03-17 01:14:00,0,3163.0,2354.0,0.744,15.07,675,320,249,71,355,267,88,52,0.0,0.0
1013,289,2020-03-17 01:17:00,0,3176.0,2343.0,0.738,15.109,216,139,103,36,77,48,29,65,0.0,0.0
1013,290,2020-03-17 01:20:00,0,3122.0,2309.0,0.74,14.857,422,157,111,46,265,188,77,38,0.02,0.0
1013,291,2020-03-17 01:23:00,0,3168.0,2302.0,0.727,15.03,306,134,105,29,172,122,50,38,0.27,0.0
1013,292,2020-03-17 01:26:00,0,3109.0,2346.0,0.754,14.849,109,50,17,33,59,13,46,0,0.2,0.0
1013,293,2020-03-17 01:29:00,0,3121.0,2363.0,0.757,14.913,426,206,155,51,220,164,56,31,0.23,0.0
1013,294,2020-03-17 01:32:00,0,2884.0,2224.0,0.771,13.827,507,227,178,49,280,201,79,27,0.03,0.0
1013,295,2020-03-17 01:35:00,0,3155.0,2387.0,0.757,15.076,210,97,50,47,113,79,34,26,0.14,0.0
1013,296,2020-03-17 01:38:00,0,3051.0,2326.0,0.762,14.598,231,91,48,43,140,81,59,10,0.2,0.0
1013,297,2020-03-17 01:41:00,0,2875.0,2227.0,0.775,13.792,476,265,195,70,211,146,65,54,0.0,0.0
1013,298,2020-03-17 01:44:00,0,2899.0,2225.0,0.767,13.885,236,112,86,26,124,84,40,23,0.0,0.0
1013,299,2020-03-17 01:47:00,0,2864.0,2266.0,0.791,13.795,288,178,119,59,110,68,42,51,0.0,0.0
1013,300,2020-03-17 01:50:00,0,2858.0,2284.0,0.799,13.79,132,60,35,25,72,39,33,16,0.0,0.0
1013,301,2020-03-17 01:53:00,0,2782.0,2193.0,0.788,13.389,274,158,112,46,116,73,43,36,0.19,0.0
1013,302,2020-03-17 01:56:00,0,2735.0,2125.0,0.777,13.128,334,122,92,30,212,156,56,30,0.17,0.0
1013,303,2020-03-17 01:59:00,0,2643.0,2072.0,0.784,12.709,159,100,55,45,59,34,25,20,0.0,0.0
1013,304,2020-03-17 02:02:00,0,2707.0,2139.0,0.79,13.035,60,40,10,30,20,3,17,0,0.0,0.0
1013,305,2020-03-17 02:05:00,0,2576.0,2051.0,0.796,12.419,4,4,0,4,0,0,0,0,0.0,0.0
1013,306,2020-03-17 02:08:00,0,2391.0,1872.0,0.783,11.495,4,4,0,4,0,0,0,0,0.0,0.0
1013,307,2020-03-17 02:11:00,0,2376.0,1778.0,0.748,11.33,24,17,9,8,7,4,3,0,0.0,0.0
1013,308,2020-03-17 02:14:00,0,2183.0,1677.0,0.768,10.46,159,99,71,28,60,44,16,0,0.0,0.0
1013,309,2020-03-17 02:17:00,0,2201.0,1701.0,0.773,10.555,271,136,107,29,135,96,39,29,0.08,0.0
1013,310,2020-03-17 02:20:00,0,2265.0,1729.0,0.763,10.839,4,2,1,1,2,1,1,0,0.0,0.0
1013,311,2020-03-17 02:23:00,0,2194.0,1614.0,0.736,10.431,7,5,2,3,2,0,2,0,0.0,0.0
1013,312,2020-03-17 02:26:00,0,2075.5,1527.5,0.7365,9.8685,3,1,0,1,2,1,1,0,0.0,0.0
1013,313,2020-03-17 02:29:00,0,1957.0,1441.0,0.737,9.306,2,1,0,1,1,0,1,0,0.0,0.0
1013,314,2020-03-17 02:32:00,0,1797.0,1366.0,0.76,8.594,0,0,0,0,0,0,0,0,0.0,0.0
1013,315,2020-03-17 02:35:00,0,1839.0,1337.0,0.727,8.726,0,0,0,0,0,0,0,0,0.0,0.0
1013,316,2020-03-17 02:38:00,0,1653.0,1290.0,0.78,7.942,0,0,0,0,0,0,0,0,0.0,0.0
1013,317,2020-03-17 02:41:00,0,1639.0,1250.0,0.763,7.84,52,28,12,16,24,7,17,8,0.0,0.0
1013,318,2020-03-17 02:44:00,0,1781.0,1397.0,0.784,8.566,327,154,106,48,173,125,48,60,0.1,0.0
1013,319,2020-03-17 02:47:00,0,2602.0,1894.0,0.728,12.35,385,186,140,46,199,144,55,39,0.0,0.0
1013,320,2020-03-17 02:50:00,0,3196.0,2308.0,0.722,15.148,362,144,86,58,218,151,67,37,0.13,0.0
1013,321,2020-03-17 02:53:00,0,2910.0,2193.0,0.754,13.894,253,115,61,54,138,99,39,39,0.0,0.0
1013,322,2020-03-17 02:56:00,0,3229.0,2427.0,0.752,15.41,227,174,127,47,53,40,13,80,0.0,0.0
1013,323,2020-03-17 02:59:00,0,3458.0,2581.0,0.746,16.481,864,466,389,77,398,333,65,128,0.0,0.0
1013,324,2020-03-17 03:02:00,0,3461.0,2627.0,0.759,16.545,574,330,256,74,244,188,56,86,0.0,0.0
1013,325,2020-03-17 03:05:00,0,3618.0,2761.0,0.763,17.311,510,335,274,61,175,144,31,76,0.0,0.0
1013,326,2020-03-17 03:08:00,0,3610.0,2884.0,0.799,17.416,461,360,274,86,101,59,42,116,0.0,0.0
1013,327,2020-03-17 03:11:00,0,3820.0,3118.0,0.816,18.504,259,230,159,71,29,2,27,96,0.0,0.0
1013,328,2020-03-17 03:14:00,0,3706.0,3113.0,0.84,18.047,313,206,145,61,107,64,43,78,0.0,0.0
1013,329,2020-03-17 03:17:00,0,3390.0,2806.0,0.828,16.463,521,243,180,63,278,210,68,73,0.0,0.0
1013,330,2020-03-17 03:20:00,0,3387.0,2799.0,0.826,16.445,300,147,103,44,153,104,49,45,0.37,0.0
1013,331,2020-03-17 03:23:00,0,3702.0,3189.0,0.861,18.117,653,323,249,74,330,251,79,69,0.0,0.0
1013,332,2020-03-17 03:26:00,0,3615.0,3138.0,0.868,17.716,878,559,445,114,319,249,70,90,0.0,0.0
1013,333,2020-03-17 03:29:00,0,3595.0,3207.0,0.892,17.713,673,389,304,85,284,212,72,71,0.0,1.56
1013,334,2020-03-17 03:32:00,0,3591.0,3179.0,0.885,17.667,833,513,427,86,320,243,77,68,0.0,0.06
1013,335,2020-03-17 03:35:00,0,3681.0,3233.0,0.878,18.083,286,231,170,61,55,44,11,70,0.0,0.0
1013,336,2020-03-17 03:38:00,0,3655.0,3285.0,0.899,18.035,467,272,213,59,195,144,51,46,0.27,0.0
1013,337,2020-03-17 03:41:00,0,3591.0,3127.0,0.871,17.611,677,250,187,63,427,327,100,12,0.04,0.0
1013,338,2020-03-17 03:44:00,0,3589.0,3256.0,0.907,17.746,762,433,342,91,329,242,87,33,0.0,0.0
1013,339,2020-03-17 03:47:00,0,3584.0,3193.0,0.891,17.655,691,361,272,89,330,245,85,14,0.0,0.0
1013,340,2020-03-17 03:50:00,0,3591.0,3138.0,0.874,17.623,272,217,152,65,55,33,22,83,0.0,0.0
1013,341,2020-03-17 03:53:00,0,3544.0,3211.0,0.906,17.52,198,159,105,54,39,24,15,71,0.0,0.0
1013,342,2020-03-17 03:56:00,0,2999.0,2745.0,0.915,14.855,426,241,186,55,185,123,62,68,0.04,0.0
1013,343,2020-03-17 03:59:00,0,3594.0,3190.0,0.888,17.692,408,263,203,60,145,105,40,53,0.0,0.0
1013,344,2020-03-17 04:02:00,0,3775.0,3398.0,0.9,18.636,159,138,106,32,21,17,4,81,0.0,0.0
1013,345,2020-03-17 04:05:00,0,3521.0,3142.0,0.892,17.351,267,158,115,43,109,79,30,13,0.06,0.0
1013,346,2020-03-17 04:08:00,0,2763.0,2496.0,0.903,13.649,84,59,35,24,25,4,21,3,0.0,0.0
1013,347,2020-03-17 04:11:00,0,3572.0,3262.0,0.913,17.684,355,148,99,49,207,134,73,6,0.0,0.0
1013,348,2020-03-17 04:14:00,0,3792.0,3454.0,0.911,18.766,859,569,464,105,290,202,88,4,0.0,0.0
1013,349,2020-03-17 04:17:00,0,3640.0,3324.0,0.913,18.021,861,587,491,96,274,198,76,16,0.05,0.0
1013,350,2020-03-17 04:20:00,0,3721.0,3361.0,0.903,18.382,761,436,344,92,325,242,83,14,0.0,0.0
1013,351,2020-03-17 04:23:00,0,3618.0,3286.0,0.908,17.892,263,105,66,39,158,96,62,22,0.0,0.0
1013,352,2020-03-17 04:26:00,0,3567.0,3275.0,0.918,17.682,270,89,37,52,181,103,78,2,0.0,0.0
1013,353,2020-03-17 04:29:00,0,3578.0,3188.0,0.891,17.625,213,82,45,37,131,69,62,0,0.0,0.0
1013,354,2020-03-17 04:32:00,0,3157.0,2944.0,0.933,15.7,16,6,2,4,10,5,5,0,0.0,0.0
1013,355,2020-03-17 04:35:00,0,2641.0,2456.0,0.93,13.124,17,6,3,3,11,4,7,0,0.0,0.0
1013,356,2020-03-17 04:38:00,0,2556.0,2326.0,0.91,12.646,0,0,0,0,0,0,0,0,0.0,0.0
1013,357,2020-03-17 04:41:00,0,2793.0,2560.0,0.917,13.839,10,0,0,0,10,4,6,0,0.0,0.0
1013,358,2020-03-17 04:44:00,0,2852.0,2672.0,0.937,14.193,21,1,1,0,20,7,13,0,0.0,0.0
1013,359,2020-03-17 04:47:00,0,2778.0,2632.0,0.948,13.857,315,158,111,47,157,109,48,21,0.21,0.0
1013,360,2020-03-17 04:50:00,0,3007.0,2789.0,0.928,14.935,6,2,1,1,4,0,4,0,0.0,0.0
1013,361,2020-03-17 04:53:00,0,2958.0,2701.0,0.913,14.647,14,3,1,2,11,2,9,0,0.0,0.0
1013,362,2020-03-17 04:56:00,0,2801.0,2597.0,0.927,13.91,19,4,0,4,15,0,15,0,0.0,0.0
1013,363,2020-03-17 04:59:00,0,2734.0,2549.0,0.932,13.595,14,9,5,4,5,1,4,0,0.0,0.0
1013,364,2020-03-17 05:02:00,0,2659.0,2497.0,0.939,13.242,4,4,2,2,0,0,0,0,0.0,0.0
1013,365,2020-03-17 05:05:00,0,2533.0,2364.0,0.933,12.598,212,144,106,38,68,49,19,26,0.0,0.0
1013,366,2020-03-17 05:08:00,0,3155.0,2907.0,0.921,15.647,328,200,150,50,128,89,39,69,0.18,0.0
1013,367,2020-03-17 05:11:00,0,3066.0,2873.0,0.937,15.259,354,157,122,35,197,133,64,26,0.0,0.0
1013,368,2020-03-17 05:14:00,0,2877.0,2758.0,0.958,14.389,14,11,7,4,3,3,0,0,0.0,0.0
1013,369,2020-03-17 05:17:00,0,2795.0,2622.0,0.938,13.915,11,11,6,5,0,0,0,0,0.0,0.0
1013,370,2020-03-17 05:20:00,0,2871.0,2711.0,0.944,14.312,57,43,25,18,14,3,11,0,0.0,0.0
1013,371,2020-03-17 05:23:00,0,2839.0,2688.0,0.947,14.161,16,6,2,4,10,3,7,0,0.0,0.0
1013,372,2020-03-17 05:26:00,0,2926.0,2741.5,0.9375,14.563,121,74,48,26,47,21,26,12,0.0,0.0
1013,373,2020-03-17 05:29:00,0,3013.0,2795.0,0.928,14.965,153,134,81,53,19,14,5,49,0.0,0.0
1013,374,2020-03-17 05:32:00,0,2686.0,2494.0,0.929,13.343,215,100,59,41,115,75,40,38,0.0,0.0
1013,375,2020-03-17 05:35:00,0,3245.0,3008.0,0.927,16.115,390,221,181,40,169,121,48,35,0.0,0.0
1013,376,2020-03-17 05:38:00,0,3111.0,2949.0,0.948,15.521,194,99,73,26,95,65,30,11,0.0,0.0
1013,377,2020-03-17 05:41:00,0,3065.0,2903.0,0.947,15.289,6,0,0,0,6,1,5,0,0.0,0.0
1013,378,2020-03-17 05:44:00,0,2818.0,2659.0,0.944,14.046,13,9,1,8,4,0,4,0,0.0,0.0
1013,379,2020-03-17 05:47:00,0,2810.0,2575.0,0.916,13.922,23,10,1,9,13,0,13,0,0.0,0.0
1013,380,2020-03-17 05:50:00,0,2618.0,2468.0,0.943,13.045,16,6,2,4,10,1,9,0,0.0,0.0
1013,381,2020-03-17 05:53:00,0,2559.0,2383.0,0.931,12.722,16,5,1,4,11,3,8,0,0.0,0.0
1013,382,2020-03-17 05:56:00,0,2503.0,2343.0,0.936,12.455,12,5,1,4,7,0,7,0,0.0,0.0
1013,383,2020-03-17 05:59:00,0,2516.0,2274.0,0.904,12.43,7,2,1,1,5,2,3,0,0.0,0.0
1013,384,2020-03-17 06:02:00,1,2595.0,2442.0,0.941,12.927,282,169,120,49,113,74,39,39,0.0,0.0
1013,385,2020-03-17 06:05:00,1,2885.0,2740.0,0.95,14.401,184,113,67,46,71,49,22,30,0.0,0.0
1013,386,2020-03-17 06:08:00,1,2990.0,2894.0,0.968,14.983,157,48,27,21,109,55,54,13,0.0,0.0
1013,387,2020-03-17 06:11:00,1,3235.0,3071.0,0.949,16.147,273,124,73,51,149,93,56,14,0.0,0.0
1013,388,2020-03-17 06:14:00,1,3305.0,3230.0,0.977,16.598,281,206,154,52,75,52,23,70,0.0,0.0
1013,389,2020-03-17 06:17:00,1,3519.0,3351.0,0.952,17.574,118,114,65,49,4,0,4,74,0.0,0.0
1013,390,2020-03-17 06:20:00,1,3644.0,3460.0,0.95,18.187,119,98,67,31,21,8,13,32,0.0,0.0
1013,391,2020-03-17 06:23:00,1,3018.0,2907.0,0.963,15.108,259,119,77,42,140,88,52,26,0.09,0.0
1013,392,2020-03-17 06:26:00,1,3677.0,3486.0,0.948,18.347,510,301,237,64,209,150,59,26,0.05,0.0
1013,393,2020-03-17 06:29:00,1,3663.0,3445.0,0.941,18.245,503,286,223,63,217,157,60,17,0.05,0.0
1013,394,2020-03-17 06:32:00,1,3588.0,3406.0,0.949,17.908,405,136,94,42,269,188,81,9,0.0,0.0
1013,395,2020-03-17 06:35:00,1,3491.0,3367.0,0.965,17.48,381,277,205,72,104,73,31,34,0.0,0.0
1013,396,2020-03-17 06:38:00,1,3653.0,3458.0,0.947,18.22,229,153,101,52,76,55,21,43,0.0,0.0
1013,397,2020-03-17 06:41:00,1,3047.0,2801.0,0.919,15.105,195,101,59,42,94,39,55,2,0.0,0.0
1013,398,2020-03-17 06:44:00,1,3644.0,3451.0,0.947,18.177,170,110,55,55,60,17,43,6,0.0,0.0
1013,399,2020-03-17 06:47:00,1,3549.0,3403.0,0.959,17.752,64,42,14,28,22,8,14,0,0.0,0.0
1013,400,2020-03-17 06:50:00,1,3297.0,3059.0,0.928,16.376,6,3,1,2,3,2,1,0,0.0,0.0
1013,401,2020-03-17 06:53:00,1,3150.0,2980.0,0.946,15.709,18,11,6,5,7,4,3,0,0.0,0.0
1013,402,2020-03-17 06:56:00,1,3040.0,2896.0,0.953,15.183,12,6,5,1,6,4,2,0,0.0,0.0
1013,403,2020-03-17 06:59:00,1,2915.0,2768.0,0.949,14.551,5,1,0,1,4,1,3,0,0.0,0.0
1013,404,2020-03-17 07:02:00,1,2759.0,2682.0,0.972,13.839,6,0,0,0,6,0,6,0,0.0,0.0
1013,405,2020-03-17 07:05:00,1,2783.0,2603.0,0.935,13.846,15,10,4,6,5,3,2,0,0.0,0.0
1013,406,2020-03-17 07:08:00,1,2795.0,2635.0,0.943,13.931,2,0,0,0,2,1,1,0,0.0,0.0
1013,407,2020-03-17 07:11:00,1,2637.0,2580.0,0.978,13.246,3,0,0,0,3,2,1,0,0.0,0.0
1013,408,2020-03-17 07:14:00,1,2556.0,2450.0,0.959,12.782,0,0,0,0,0,0,0,0,0.0,0.0
1013,409,2020-03-17 07:17:00,1,2654.0,2487.0,0.937,13.211,0,0,0,0,0,0,0,0,0.0,0.0
1013,410,2020-03-17 07:20:00,1,2683.0,2483.0,0.926,13.321,187,98,55,43,89,43,46,3,0.0,0.0
1013,411,2020-03-17 07:23:00,1,2848.0,2799.0,0.983,14.319,49,25,16,9,24,15,9,0,0.0,0.0
1013,412,2020-03-17 07:26:00,1,2817.0,2709.0,0.962,14.096,0,0,0,0,0,0,0,0,0.0,0.0
1013,413,2020-03-17 07:29:00,1,2659.0,2545.0,0.957,13.292,2,0,0,0,2,1,1,0,0.0,0.0
1013,414,2020-03-17 07:32:00,1,2566.0,2462.0,0.96,12.834,111,70,49,21,41,26,15,7,0.0,0.0
1013,415,2020-03-17 07:35:00,1,3068.0,2960.0,0.965,15.364,165,120,75,45,45,24,21,44,0.02,0.0
1013,416,2020-03-17 07:38:00,1,3124.0,3061.0,0.98,15.699,144,72,36,36,72,36,36,2,0.26,0.0
1013,417,2020-03-17 07:41:00,1,3140.0,3035.0,0.967,15.729,247,117,73,44,130,81,49,11,0.0,0.0
1013,418,2020-03-17 07:44:00,1,3197.0,3087.0,0.966,16.012,53,26,0,26,27,3,24,1,0.0,0.0
1013,419,2020-03-17 07:47:00,1,3274.0,3171.0,0.969,16.41,141,60,16,44,81,36,45,1,0.0,0.0
1013,420,2020-03-17 07:50:00,1,3384.0,3276.0,0.968,16.958,136,102,65,37,34,27,7,13,0.0,0.0
1013,421,2020-03-17 07:53:00,1,3301.0,3187.0,0.966,16.533,534,298,238,60,236,162,74,9,0.0,0.0
1013,422,2020-03-17 07:56:00,1,3470.0,3312.0,0.955,17.34,178,102,67,35,76,54,22,2,0.0,0.0
1013,423,2020-03-17 07:59:00,1,3350.0,3241.0,0.967,16.788,9,9,1,8,0,0,0,0,0.0,0.0
1013,424,2020-03-17 08:02:00,1,3126.0,3027.0,0.968,15.667,15,5,1,4,10,3,7,0,0.0,0.0
1013,425,2020-03-17 08:05:00,1,2994.0,2865.0,0.957,14.968,4,1,0,1,3,2,1,0,0.0,0.0
1013,426,2020-03-17 08:08:00,1,2768.0,2750.0,0.994,13.951,49,1,0,1,48,23,25,0,0.0,0.0
1013,427,2020-03-17 08:11:00,1,2796.0,2648.0,0.947,13.948,0,0,0,0,0,0,0,0,0.0,0.0
1013,428,2020-03-17 08:14:00,1,2643.0,2507.0,0.948,13.191,18,1,0,1,17,0,17,0,0.0,0.0
1013,429,2020-03-17 08:17:00,1,2673.0,2556.0,0.956,13.36,25,8,3,5,17,1,16,0,0.0,0.0
1013,430,2020-03-17 08:20:00,1,2633.0,2558.0,0.972,13.205,192,97,66,31,95,62,33,5,0.0,0.0
1013,431,2020-03-17 08:23:00,1,2942.0,2822.0,0.959,14.713,211,124,90,34,87,56,31,0,0.08,0.0
1013,432,2020-03-17 08:26:00,1,2891.5,2788.5,0.9645,14.4785,48,47,6,41,1,0,1,0,0.0,0.0
1013,433,2020-03-17 08:29:00,1,2841.0,2755.0,0.97,14.244,125,70,29,41,55,14,41,2,0.0,0.0
1013,434,2020-03-17 08:32:00,1,2949.0,2826.0,0.958,14.747,122,50,16,34,72,24,48,0,0.0,0.0
1013,435,2020-03-17 08:35:00,1,2829.0,2743.0,0.97,14.182,29,15,5,10,14,3,11,0,0.0,0.0
1013,436,2020-03-17 08:38:00,1,2921.0,2696.0,0.923,14.493,14,8,4,4,6,1,5,0,0.0,0.0
1013,437,2020-03-17 08:41:00,1,2908.0,2698.0,0.928,14.446,0,0,0,0,0,0,0,0,0.0,0.0
1013,438,2020-03-17 08:44:00,1,2931.0,2633.0,0.898,14.463,12,0,0,0,12,3,9,0,0.0,0.0
1013,439,2020-03-17 08:47:00,1,2877.0,2588.0,0.899,14.203,1,0,0,0,1,0,1,0,0.0,0.0
1013,440,2020-03-17 08:50:00,1,2718.0,2558.0,0.941,13.539,1,0,0,0,1,0,1,0,0.0,0.0
1013,441,2020-03-17 08:53:00,1,2714.0,2530.0,0.932,13.493,0,0,0,0,0,0,0,0,0.0,0.0
1013,442,2020-03-17 08:56:00,1,2610.0,2306.0,0.884,12.837,7,4,1,3,3,1,2,0,0.0,0.0
1013,443,2020-03-17 08:59:00,1,2583.0,2326.0,0.901,12.751,44,23,10,13,21,9,12,2,0.0,0.0
1013,444,2020-03-17 09:02:00,1,2894.0,2623.0,0.906,14.307,8,4,0,4,4,2,2,0,0.0,0.0
1013,445,2020-03-17 09:05:00,1,2706.0,2487.0,0.919,13.413,12,4,2,2,8,2,6,0,0.0,0.0
1013,446,2020-03-17 09:08:00,1,2598.0,2337.0,0.9,12.822,7,2,0,2,5,0,5,0,0.0,0.0
1013,447,2020-03-17 09:11:00,1,2604.0,2276.0,0.874,12.78,6,3,1,2,3,1,2,0,0.0,0.0
1013,448,2020-03-17 09:14:00,1,2582.0,2262.0,0.876,12.678,3,2,0,2,1,0,1,0,0.0,0.0
1013,449,2020-03-17 09:17:00,1,2306.0,2207.0,0.957,11.529,25,4,1,3,21,5,16,0,0.0,0.0
1013,450,2020-03-17 09:20:00,1,2586.0,2297.0,0.888,12.731,70,31,16,15,39,17,22,3,0.0,0.0
1013,451,2020-03-17 09:23:00,1,2727.0,2567.0,0.941,13.588,209,93,48,45,116,70,46,25,0.0,0.0
1013,452,2020-03-17 09:26:00,1,2983.0,2812.0,0.943,14.866,196,113,74,39,83,48,35,9,0.0,0.0
1013,453,2020-03-17 09:29:00,1,3032.0,2839.0,0.936,15.087,164,68,36,32,96,47,49,13,0.0,0.0
1013,454,2020-03-17 09:32:00,1,2780.0,2653.0,0.954,13.889,519,300,241,59,219,178,41,79,0.0,0.0
1013,455,2020-03-17 09:35:00,1,2754.0,2564.0,0.931,13.69,504,285,226,59,219,158,61,91,0.0,0.0
1013,456,2020-03-17 09:38:00,1,3290.0,2953.0,0.898,16.233,403,215,154,61,188,139,49,44,0.0,0.0
1013,457,2020-03-17 09:41:00,1,3062.0,2850.0,0.931,15.218,62,21,10,11,41,19,22,0,0.0,0.0
1013,458,2020-03-17 09:44:00,1,3123.0,2716.0,0.87,15.312,101,77,32,45,24,4,20,2,0.0,0.0
1013,459,2020-03-17 09:47:00,1,2969.0,2687.0,0.905,14.673,4,3,3,0,1,0,1,0,0.0,0.0
1013,460,2020-03-17 09:50:00,1,2914.0,2595.0,0.89,14.355,2,2,1,1,0,0,0,0,0.0,0.0
1013,461,2020-03-17 09:53:00,1,2931.0,2522.0,0.861,14.339,10,10,3,7,0,0,0,0,0.0,0.0
1013,462,2020-03-17 09:56:00,1,2888.0,2516.0,0.871,14.165,0,0,0,0,0,0,0,0,0.0,0.0
1013,463,2020-03-17 09:59:00,1,2755.0,2480.0,0.9,13.6,3,3,0,3,0,0,0,0,0.0,0.0
1013,464,2020-03-17 10:02:00,1,2720.0,2411.0,0.886,13.387,0,0,0,0,0,0,0,0,0.0,0.0
1013,465,2020-03-17 10:05:00,1,2756.0,2472.0,0.897,13.595,0,0,0,0,0,0,0,0,0.0,0.0
1013,466,2020-03-17 10:08:00,1,2828.0,2489.0,0.88,13.898,205,113,68,45,92,52,40,20,0.0,0.0
1013,467,2020-03-17 10:11:00,1,3151.0,2742.0,0.87,15.452,164,53,16,37,111,55,56,18,0.0,0.0
1013,468,2020-03-17 10:14:00,1,3149.0,2916.0,0.926,15.634,148,82,48,34,66,45,21,23,0.0,0.0
1013,469,2020-03-17 10:17:00,1,3258.0,2908.0,0.892,16.057,236,114,74,40,122,85,37,9,0.0,0.0
1013,470,2020-03-17 10:20:00,1,3276.0,2916.0,0.89,16.137,402,226,164,62,176,121,55,12,0.0,0.0
1013,471,2020-03-17 10:23:00,1,3269.0,2952.0,0.903,16.15,211,176,119,57,35,17,18,6,0.0,0.0
1013,472,2020-03-17 10:26:00,1,3207.0,2838.0,0.885,15.778,228,114,71,43,114,70,44,15,0.0,0.0
1013,473,2020-03-17 10:29:00,1,3222.0,2896.0,0.899,15.901,92,58,22,36,34,2,32,1,0.0,0.0
1013,474,2020-03-17 10:32:00,1,3135.0,2877.0,0.918,15.536,127,63,24,39,64,23,41,8,0.0,0.0
1013,475,2020-03-17 10:35:00,1,3126.0,2709.0,0.867,15.315,25,23,2,21,2,0,2,0,0.0,0.0
1013,476,2020-03-17 10:38:00,1,2899.0,2549.0,0.879,14.244,1,1,0,1,0,0,0,0,0.0,0.0
1013,477,2020-03-17 10:41:00,1,2701.0,2380.0,0.881,13.275,4,4,0,4,0,0,0,0,0.0,0.0
1013,478,2020-03-17 10:44:00,1,2641.0,2267.0,0.858,12.915,18,18,2,16,0,0,0,0,0.0,0.0
1013,479,2020-03-17 10:47:00,1,2524.0,2184.0,0.865,12.36,1,1,1,0,0,0,0,0,0.0,0.0
1013,480,2020-03-17 10:50:00,1,2342.0,2109.0,0.9,11.563,9,9,1,8,0,0,0,0,0.0,0.0
1013,481,2020-03-17 10:53:00,1,2336.0,2067.0,0.885,11.492,9,9,2,7,0,0,0,0,0.0,0.0
1013,482,2020-03-17 10:56:00,1,2385.0,2034.0,0.853,11.649,24,21,2,19,3,1,2,0,0.0,0.0
1013,483,2020-03-17 10:59:00,1,2390.0,2102.0,0.879,11.744,1,0,0,0,1,0,1,0,0.0,0.0
1013,484,2020-03-17 11:02:00,1,2372.0,2114.0,0.891,11.687,1,1,1,0,0,0,0,0,0.0,0.0
1013,485,2020-03-17 11:05:00,1,2358.0,2145.0,0.91,11.664,2,2,0,2,0,0,0,0,0.0,0.0
1013,486,2020-03-17 11:08:00,1,2526.0,2170.0,0.859,12.356,1,1,1,0,0,0,0,0,0.0,0.0
1013,487,2020-03-17 11:11:00,1,2430.0,2140.0,0.881,11.943,1,1,0,1,0,0,0,0,0.0,0.0
1013,488,2020-03-17 11:14:00,1,2514.0,2127.0,0.846,12.259,0,0,0,0,0,0,0,0,0.0,0.0
1013,489,2020-03-17 11:17:00,1,2535.0,2154.0,0.85,12.372,0,0,0,0,0,0,0,0,0.0,0.0
1013,490,2020-03-17 11:20:00,1,2593.0,2147.0,0.828,12.594,184,117,67,50,67,27,40,29,0.0,0.0
1013,491,2020-03-17 11:23:00,1,2735.0,2420.0,0.885,13.455,170,79,61,18,91,50,41,37,0.0,0.0
1013,492,2020-03-17 11:26:00,1,2773.5,2451.0,0.884,13.641,198,122,97,25,76,42,34,0,0.15,0.0
1013,493,2020-03-17 11:29:00,1,2812.0,2482.0,0.883,13.827,2,1,0,1,1,0,1,0,0.0,0.0
1013,494,2020-03-17 11:32:00,1,2661.0,2294.0,0.862,13.026,1,1,0,1,0,0,0,0,0.0,0.0
1013,495,2020-03-17 11:35:00,1,2534.0,2220.0,0.876,12.443,0,0,0,0,0,0,0,0,0.0,0.0
1013,496,2020-03-17 11:38:00,1,2434.0,2133.0,0.876,11.952,1,1,1,0,0,0,0,0,0.0,0.0
1013,497,2020-03-17 11:41:00,1,2364.0,2076.0,0.878,11.612,3,3,1,2,0,0,0,0,0.0,0.0
1013,498,2020-03-17 11:44:00,1,2329.0,2113.0,0.907,11.515,0,0,0,0,0,0,0,0,0.0,0.0
1013,499,2020-03-17 11:47:00,1,2348.0,2068.0,0.881,11.542,0,0,0,0,0,0,0,0,0.0,0.0
1013,500,2020-03-17 11:50:00,1,2331.0,2041.0,0.876,11.443,75,48,24,24,27,7,20,2,0.0,0.0
1013,501,2020-03-17 11:53:00,1,2691.0,2271.0,0.844,13.118,317,174,120,54,143,87,56,30,0.0,0.0
1013,502,2020-03-17 11:56:00,1,2822.0,2568.0,0.91,13.962,727,474,397,77,253,186,67,17,0.1,0.0
1013,503,2020-03-17 11:59:00,1,2787.0,2555.0,0.917,13.81,291,167,129,38,124,93,31,16,0.0,0.0
1013,504,2020-03-17 12:02:00,1,2622.0,2355.0,0.898,12.937,27,21,5,16,6,0,6,0,0.0,0.0
1013,505,2020-03-17 12:05:00,1,2526.0,2240.0,0.887,12.431,6,5,0,5,1,0,1,0,0.0,0.0
1013,506,2020-03-17 12:08:00,1,2459.0,2099.0,0.854,12.014,2,2,0,2,0,0,0,0,0.0,0.0
1013,507,2020-03-17 12:11:00,1,2336.0,2056.0,0.88,11.479,0,0,0,0,0,0,0,0,0.0,0.0
1013,508,2020-03-17 12:14:00,1,2307.0,1985.0,0.861,11.286,10,9,1,8,1,0,1,0,0.0,0.0
1013,509,2020-03-17 12:17:00,1,2296.0,1992.0,0.868,11.253,2,2,0,2,0,0,0,0,0.0,0.0
1013,510,2020-03-17 12:20:00,1,2325.0,1950.0,0.839,11.32,3,3,0,3,0,0,0,0,0.0,0.0
1013,511,2020-03-17 12:23:00,1,2343.0,1968.0,0.84,11.409,20,20,0,20,0,0,0,0,0.0,0.0
1013,512,2020-03-17 12:26:00,1,2329.0,1945.0,0.835,11.328,2,2,0,2,0,0,0,0,0.0,0.0
1013,513,2020-03-17 12:29:00,1,2327.0,1967.0,0.845,11.346,1,1,0,1,0,0,0,0,0.0,0.0
1013,514,2020-03-17 12:32:00,1,2311.0,1909.0,0.826,11.22,6,3,1,2,3,0,3,0,0.0,0.0
1013,515,2020-03-17 12:35:00,1,2333.0,1937.0,0.83,11.337,36,25,12,13,11,6,5,2,0.0,0.0
1013,516,2020-03-17 12:38:00,1,2314.0,1911.0,0.826,11.234,133,110,76,34,23,7,16,6,0.0,0.0
1013,517,2020-03-17 12:41:00,1,2310.0,2014.0,0.872,11.33,240,139,103,36,101,49,52,22,0.0,0.0
1013,518,2020-03-17 12:44:00,1,2696.0,2319.0,0.86,13.191,505,300,230,70,205,144,61,18,0.0,0.0
1013,519,2020-03-17 12:47:00,1,3140.0,2612.0,0.832,15.263,524,294,230,64,230,173,57,23,0.07,0.0
1013,520,2020-03-17 12:50:00,1,3089.0,2570.0,0.832,15.017,1003,570,460,110,433,325,108,48,0.0,0.0
1013,521,2020-03-17 12:53:00,1,3067.0,2610.0,0.851,14.974,671,445,355,90,226,163,63,29,0.0,0.0
1013,522,2020-03-17 12:56:00,1,3123.0,2689.0,0.861,15.283,694,362,277,85,332,242,90,25,0.0,0.0
1013,523,2020-03-17 12:59:00,1,3071.0,2545.0,0.829,14.92,227,134,79,55,93,51,42,7,0.0,0.0
1013,524,2020-03-17 13:02:00,1,3099.0,2569.0,0.829,15.055,702,367,294,73,335,246,89,15,0.0,0.0
1013,525,2020-03-17 13:05:00,1,2828.0,2445.0,0.864,13.85,426,239,197,42,187,132,55,9,0.0,0.0
1013,526,2020-03-17 13:08:00,1,2869.0,2403.0,0.838,13.963,142,72,28,44,70,27,43,3,0.0,0.0
1013,527,2020-03-17 13:11:00,1,2857.0,2366.0,0.828,13.877,135,45,24,21,90,40,50,0,0.0,0.0
1013,528,2020-03-17 13:14:00,1,2845.0,2355.0,0.828,13.817,136,55,17,38,81,29,52,17,0.0,0.0
1013,529,2020-03-17 13:17:00,1,2728.0,2324.0,0.852,13.321,96,33,6,27,63,5,58,1,0.0,0.0
1013,530,2020-03-17 13:20:00,1,2759.0,2260.0,0.819,13.374,147,55,25,30,92,42,50,6,0.0,0.0
1013,531,2020-03-17 13:23:00,1,2734.0,2249.0,0.823,13.262,30,1,1,0,29,0,29,0,0.0,0.0
1013,532,2020-03-17 13:26:00,1,2535.0,2070.0,0.816,12.279,35,20,0,20,15,0,15,0,0.0,0.0
1013,533,2020-03-17 13:29:00,1,2324.0,1902.0,0.818,11.261,43,9,2,7,34,3,31,0,0.0,0.0
1013,534,2020-03-17 13:32:00,1,2345.0,1893.0,0.807,11.336,26,3,3,0,23,8,15,0,0.0,0.0
1013,535,2020-03-17 13:35:00,1,2343.0,1916.0,0.818,11.353,14,3,2,1,11,2,9,0,0.0,0.0
1013,536,2020-03-17 13:38:00,1,2314.0,1871.0,0.808,11.19,192,105,76,29,87,57,30,8,0.0,0.0
1013,537,2020-03-17 13:41:00,1,2759.0,2177.0,0.789,13.282,635,393,325,68,242,191,51,51,0.19,0.0
1013,538,2020-03-17 13:44:00,1,2879.0,2297.0,0.798,13.888,266,181,139,42,85,52,33,14,0.12,0.0
1013,539,2020-03-17 13:47:00,1,3050.0,2457.0,0.806,14.74,1013,567,482,85,446,339,107,50,0.08,0.0
1013,540,2020-03-17 13:50:00,1,3104.0,2451.0,0.79,14.943,1071,622,529,93,449,343,106,50,0.0,0.0
1013,541,2020-03-17 13:53:00,1,3017.0,2442.0,0.809,14.591,660,303,254,49,357,263,94,42,0.0,0.0
1013,542,2020-03-17 13:56:00,1,2947.0,2442.0,0.829,14.314,510,225,155,70,285,202,83,2,0.0,0.0
1013,543,2020-03-17 13:59:00,1,2927.0,2442.0,0.834,14.238,741,357,277,80,384,288,96,41,0.0,0.0
1013,544,2020-03-17 14:02:00,1,2950.0,2447.0,0.829,14.333,727,315,238,77,412,321,91,48,0.0,0.0
1013,545,2020-03-17 14:05:00,1,2876.0,2445.0,0.85,14.04,1003,542,445,97,461,352,109,52,0.0,0.0
1013,546,2020-03-17 14:08:00,1,2852.0,2355.0,0.826,13.843,1081,553,464,89,528,407,121,37,0.0,0.0
1013,547,2020-03-17 14:11:00,1,2885.0,2419.0,0.838,14.043,671,362,303,59,309,245,64,43,0.13,0.0
1013,548,2020-03-17 14:14:00,1,2921.0,2423.0,0.829,14.19,276,130,87,43,146,91,55,26,0.0,0.0
1013,549,2020-03-17 14:17:00,1,2852.0,2405.0,0.843,13.902,113,52,32,20,61,15,46,18,0.0,0.0
1013,550,2020-03-17 14:20:00,1,2863.0,2330.0,0.814,13.859,166,47,28,19,119,65,54,10,0.0,0.0
1013,551,2020-03-17 14:23:00,1,2712.0,2294.0,0.846,13.224,142,47,24,23,95,57,38,6,0.0,0.0
1013,552,2020-03-17 14:26:00,1,2590.0,2127.0,0.82,12.56,12,5,1,4,7,6,1,0,0.0,0.0
1013,553,2020-03-17 14:29:00,1,2468.0,1960.0,0.794,11.896,22,8,4,4,14,6,8,0,0.0,0.0
1013,554,2020-03-17 14:32:00,1,2327.0,1842.0,0.791,11.209,2,2,0,2,0,0,0,0,0.0,0.0
1013,555,2020-03-17 14:35:00,1,2268.0,1709.0,0.754,10.83,14,12,0,12,2,1,1,0,0.0,0.0
1013,556,2020-03-17 14:38:00,1,2117.0,1667.0,0.788,10.185,29,12,3,9,17,8,9,0,0.0,0.0
1013,557,2020-03-17 14:41:00,1,2101.0,1661.0,0.791,10.118,4,3,1,2,1,0,1,0,0.0,0.0
1013,558,2020-03-17 14:44:00,1,2296.0,1695.0,0.738,10.923,8,8,1,7,0,0,0,0,0.0,0.0
1013,559,2020-03-17 14:47:00,1,2252.0,1669.0,0.741,10.721,5,4,0,4,1,0,1,0,0.0,0.0
1013,560,2020-03-17 14:50:00,1,2313.0,1706.0,0.738,11.002,24,15,7,8,9,3,6,0,0.0,0.0
1013,561,2020-03-17 14:53:00,1,2293.0,1750.0,0.763,10.972,0,0,0,0,0,0,0,0,0.0,0.0
1013,562,2020-03-17 14:56:00,1,2275.0,1712.0,0.752,10.86,0,0,0,0,0,0,0,0,0.0,0.0
1013,563,2020-03-17 14:59:00,1,2304.0,1722.0,0.747,10.986,4,2,1,1,2,1,1,0,0.0,0.0
1013,564,2020-03-17 15:02:00,1,2251.0,1734.0,0.77,10.791,7,0,0,0,7,0,7,0,0.0,0.0
1013,565,2020-03-17 15:05:00,1,2304.0,1741.0,0.756,11.006,14,2,2,0,12,0,12,0,0.0,0.0
1013,566,2020-03-17 15:08:00,1,2290.0,1713.0,0.748,10.918,38,25,15,10,13,9,4,2,0.0,0.0
1013,567,2020-03-17 15:11:00,1,2280.0,1727.0,0.757,10.895,0,0,0,0,0,0,0,0,0.0,0.0
1013,568,2020-03-17 15:14:00,1,2279.0,1715.0,0.752,10.88,2,2,0,2,0,0,0,0,0.0,0.0
1013,569,2020-03-17 15:17:00,1,2295.0,1728.0,0.753,10.956,1,1,0,1,0,0,0,0,0.0,0.0
1013,570,2020-03-17 15:20:00,1,2252.0,1677.0,0.745,10.73,16,10,4,6,6,3,3,1,0.0,0.0
1013,571,2020-03-17 15:23:00,1,2375.0,1825.0,0.768,11.379,133,72,41,31,61,28,33,9,0.0,0.0
1013,572,2020-03-17 15:26:00,1,2675.0,2029.0,0.758,12.788,221,89,58,31,132,67,65,52,0.0,0.0
1013,573,2020-03-17 15:29:00,1,2772.0,2182.0,0.787,13.337,274,154,106,48,120,79,41,42,0.0,0.0
1013,574,2020-03-17 15:32:00,1,2927.0,2322.0,0.793,14.102,594,361,302,59,233,177,56,21,0.0,0.0
1013,575,2020-03-17 15:35:00,1,3040.0,2383.0,0.784,14.617,6,0,0,0,6,0,6,0,0.0,0.0
1013,576,2020-03-17 15:38:00,1,2640.0,2109.0,0.799,12.738,8,1,0,1,7,2,5,0,0.0,0.0
1013,577,2020-03-17 15:41:00,1,2457.0,1976.0,0.804,11.87,15,7,3,4,8,2,6,0,0.0,0.0
1013,578,2020-03-17 15:44:00,1,2381.0,1790.0,0.752,11.361,33,32,1,31,1,0,1,0,0.0,0.0
1013,579,2020-03-17 15:47:00,1,2278.0,1768.0,0.776,10.933,6,4,0,4,2,0,2,0,0.0,0.0
1013,580,2020-03-17 15:50:00,1,2258.0,1747.0,0.774,10.83,5,2,0,2,3,0,3,0,0.0,0.0
1013,581,2020-03-17 15:53:00,1,2255.0,1766.0,0.783,10.842,33,26,18,8,7,5,2,2,0.0,0.0
1013,582,2020-03-17 15:56:00,1,2293.0,1789.0,0.78,11.014,20,20,0,20,0,0,0,0,0.0,0.0
1013,583,2020-03-17 15:59:00,1,2248.0,1779.0,0.791,10.828,6,6,2,4,0,0,0,0,0.0,0.0
1013,584,2020-03-17 16:02:00,1,2224.0,1733.0,0.779,10.68,0,0,0,0,0,0,0,0,0.0,0.0
1013,585,2020-03-17 16:05:00,1,2243.0,1712.0,0.763,10.734,0,0,0,0,0,0,0,0,0.0,0.0
1013,586,2020-03-17 16:08:00,1,2308.0,1729.0,0.749,11.01,0,0,0,0,0,0,0,0,0.0,0.0
1013,587,2020-03-17 16:11:00,1,2303.0,1691.0,0.734,10.948,0,0,0,0,0,0,0,0,0.0,0.0
1013,588,2020-03-17 16:14:00,1,2273.0,1680.0,0.739,10.817,43,21,4,17,22,10,12,4,0.0,0.0
1013,589,2020-03-17 16:17:00,1,2283.0,1728.0,0.757,10.908,2,2,0,2,0,0,0,0,0.0,0.0
1013,590,2020-03-17 16:20:00,1,2247.0,1655.0,0.737,10.684,4,3,0,3,1,0,1,0,0.0,0.0
1013,591,2020-03-17 16:23:00,1,2197.0,1676.0,0.763,10.514,5,5,2,3,0,0,0,0,0.0,0.0
1013,592,2020-03-17 16:26:00,1,2094.0,1553.0,0.741,9.97,2,1,0,1,1,0,1,0,0.0,0.0
1013,593,2020-03-17 16:29:00,1,2278.0,1693.0,0.743,10.851,159,61,27,34,98,50,48,35,0.0,0.0
1013,594,2020-03-17 16:32:00,1,2679.0,2038.0,0.761,12.814,149,49,21,28,100,60,40,33,0.0,0.0
1013,595,2020-03-17 16:35:00,1,2835.0,2243.0,0.791,13.652,380,208,144,64,172,117,55,40,0.0,0.0
1013,596,2020-03-17 16:38:00,1,3219.0,2574.0,0.8,15.531,450,235,184,51,215,158,57,30,0.0,0.0
1013,597,2020-03-17 16:41:00,1,3092.0,2461.0,0.796,14.908,51,16,8,8,35,0,35,0,0.0,0.0
1013,598,2020-03-17 16:44:00,1,3198.0,2528.0,0.79,15.399,395,231,176,55,164,107,57,29,0.29,0.0
1013,599,2020-03-17 16:47:00,1,2892.0,2362.0,0.817,14.009,509,284,223,61,225,165,60,20,0.0,0.0
1013,600,2020-03-17 16:50:00,1,2936.0,2416.0,0.823,14.243,627,433,357,76,194,150,44,42,0.0,0.0
1013,601,2020-03-17 16:53:00,1,2975.0,2396.0,0.805,14.373,317,218,154,64,99,52,47,0,0.0,0.0
1013,602,2020-03-17 16:56:00,1,2955.0,2314.0,0.783,14.206,835,498,407,91,337,249,88,4,0.0,0.0
1013,603,2020-03-17 16:59:00,1,2939.0,2377.0,0.809,14.212,671,365,302,63,306,231,75,27,0.0,0.0
1013,604,2020-03-17 17:02:00,1,2947.0,2350.0,0.798,14.211,199,104,75,29,95,48,47,9,0.13,0.0
1013,605,2020-03-17 17:05:00,1,3015.0,2375.0,0.788,14.509,69,25,6,19,44,14,30,5,0.0,0.0
1013,606,2020-03-17 17:08:00,1,2966.0,2394.0,0.807,14.337,305,164,111,53,141,89,52,8,0.0,0.0
1013,607,2020-03-17 17:11:00,1,2943.0,2371.0,0.806,14.222,566,316,272,44,250,187,63,16,0.0,0.0
1013,608,2020-03-17 17:14:00,1,2942.0,2414.0,0.82,14.264,184,94,62,32,90,52,38,9,0.19,0.0
1013,609,2020-03-17 17:17:00,1,2943.0,2360.0,0.802,14.209,123,88,46,42,35,11,24,7,0.0,0.0
1013,610,2020-03-17 17:20:00,1,2786.0,2231.0,0.801,13.448,7,7,1,6,0,0,0,0,0.0,0.0
1013,611,2020-03-17 17:23:00,1,2650.0,2052.0,0.774,12.711,15,11,3,8,4,1,3,0,0.0,0.0
1013,612,2020-03-17 17:26:00,1,2496.0,1938.0,0.7765,11.9785,0,0,0,0,0,0,0,0,0.0,0.0
1013,613,2020-03-17 17:29:00,1,2342.0,1824.0,0.779,11.246,5,0,0,0,5,0,5,0,0.0,0.0
1013,614,2020-03-17 17:32:00,1,2258.0,1783.0,0.79,10.87,21,14,6,8,7,0,7,0,0.0,0.0
1013,615,2020-03-17 17:35:00,1,2242.0,1733.0,0.773,10.753,4,2,0,2,2,0,2,0,0.0,0.0
1013,616,2020-03-17 17:38:00,1,2255.0,1716.0,0.761,10.785,29,27,6,21,2,0,2,0,0.0,0.0
1013,617,2020-03-17 17:41:00,1,2290.0,1778.0,0.777,10.99,2,2,0,2,0,0,0,0,0.0,0.0
1013,618,2020-03-17 17:44:00,1,2276.0,1730.0,0.76,10.883,13,13,6,7,0,0,0,0,0.0,0.0
1013,619,2020-03-17 17:47:00,1,2244.0,1696.0,0.756,10.722,2,2,1,1,0,0,0,0,0.0,0.0
1013,620,2020-03-17 17:50:00,1,2317.0,1760.0,0.759,11.077,5,5,1,4,0,0,0,0,0.0,0.0
1013,621,2020-03-17 17:53:00,1,2278.0,1683.0,0.739,10.837,34,23,13,10,11,2,9,0,0.0,0.0
1013,622,2020-03-17 17:56:00,1,2303.0,1762.0,0.765,11.027,19,11,2,9,8,0,8,0,0.0,0.0
1013,623,2020-03-17 17:59:00,1,2308.0,1774.0,0.768,11.059,32,24,14,10,8,3,5,1,0.0,0.0
1013,624,2020-03-17 18:02:00,0,2262.0,1759.0,0.778,10.861,11,5,1,4,6,2,4,0,0.0,0.0
1013,625,2020-03-17 18:05:00,0,2305.0,1743.0,0.756,11.012,10,7,4,3,3,2,1,0,0.0,0.0
1013,626,2020-03-17 18:08:00,0,2268.0,1756.0,0.774,10.879,7,7,0,7,0,0,0,0,0.0,0.0
1013,627,2020-03-17 18:11:00,0,2400.0,1832.0,0.763,11.485,81,40,19,21,41,13,28,5,0.0,0.0
1013,628,2020-03-17 18:14:00,0,2667.0,2078.0,0.779,12.808,482,231,168,63,251,175,76,62,0.31,0.0
1013,629,2020-03-17 18:17:00,0,3272.0,2560.0,0.783,15.726,499,260,196,64,239,170,69,96,0.0,0.0
1013,630,2020-03-17 18:20:00,0,3545.0,2757.0,0.778,17.02,396,240,187,53,156,111,45,86,0.0,0.0
1013,631,2020-03-17 18:23:00,0,3313.0,2647.0,0.799,15.985,364,198,143,55,166,108,58,101,0.0,0.0
1013,632,2020-03-17 18:26:00,0,3499.0,2821.0,0.806,16.908,254,158,91,67,96,44,52,92,0.0,0.0
1013,633,2020-03-17 18:29:00,0,3687.0,2832.0,0.768,17.663,371,202,142,60,169,95,74,118,0.0,0.0
1013,634,2020-03-17 18:32:00,0,3757.0,2997.0,0.798,18.119,338,184,129,55,154,90,64,129,0.0,0.0
1013,635,2020-03-17 18:35:00,0,3220.0,2583.0,0.802,15.547,354,178,137,41,176,136,40,80,0.04,0.0
1013,636,2020-03-17 18:38:00,0,3505.0,2989.0,0.853,17.12,740,435,353,82,305,231,74,122,0.0,0.0
1013,637,2020-03-17 18:41:00,0,3528.0,3057.0,0.867,17.284,555,293,221,72,262,203,59,61,0.0,0.0
1013,638,2020-03-17 18:44:00,0,3596.0,3143.0,0.874,17.65,472,250,200,50,222,162,60,68,0.0,0.0
1013,639,2020-03-17 18:47:00,0,3767.0,3316.0,0.88,18.511,322,204,155,49,118,60,58,139,0.0,0.0
1013,640,2020-03-17 18:50:00,0,3815.0,3356.0,0.88,18.747,289,202,135,67,87,35,52,94,0.0,0.0
1013,641,2020-03-17 18:53:00,0,3814.0,3460.0,0.907,18.857,123,77,35,42,46,4,42,80,0.0,0.0
1013,642,2020-03-17 18:56:00,0,3716.0,3322.0,0.894,18.319,250,137,94,43,113,50,63,92,0.0,0.0
1013,643,2020-03-17 18:59:00,0,3347.0,3030.0,0.905,16.541,212,115,84,31,97,76,21,54,0.25,0.0
1013,644,2020-03-17 19:02:00,0,3887.0,3605.0,0.927,19.308,504,274,214,60,230,176,54,54,0.04,0.0
1013,645,2020-03-17 19:05:00,0,2980.0,2713.0,0.91,14.747,453,193,148,45,260,185,75,22,0.0,0.0
1013,646,2020-03-17 19:08:00,0,3008.0,2712.0,0.901,14.855,263,95,49,46,168,110,58,29,0.0,0.0
1013,647,2020-03-17 19:11:00,0,3488.0,3158.0,0.906,17.237,201,66,16,50,135,76,59,19,0.0,0.0
1013,648,2020-03-17 19:14:00,0,3722.0,3351.0,0.9,18.376,263,136,99,37,127,87,40,43,0.0,0.0
1013,649,2020-03-17 19:17:00,0,4106.0,3697.0,0.9,20.269,267,183,130,53,84,31,53,111,0.0,0.0
1013,650,2020-03-17 19:20:00,0,4254.0,3814.0,0.896,20.985,243,149,90,59,94,32,62,99,0.0,0.0
1013,651,2020-03-17 19:23:00,0,2921.0,2658.0,0.91,14.453,210,55,42,13,155,112,43,13,0.0,0.0
1013,652,2020-03-17 19:26:00,0,2708.0,2424.0,0.895,13.353,252,91,43,48,161,92,69,14,0.0,0.0
1013,653,2020-03-17 19:29:00,0,3183.0,2767.0,0.869,15.602,116,67,27,40,49,33,16,13,0.0,0.0
1013,654,2020-03-17 19:32:00,0,3060.0,2717.0,0.888,15.064,8,7,0,7,1,0,1,0,0.0,0.0
1013,655,2020-03-17 19:35:00,0,3127.0,2833.0,0.906,15.455,0,0,0,0,0,0,0,0,0.0,0.0
1013,656,2020-03-17 19:38:00,0,2965.0,2719.0,0.917,14.691,28,12,6,6,16,9,7,0,0.0,0.0
1013,657,2020-03-17 19:41:00,0,2705.0,2430.0,0.898,13.348,292,165,134,31,127,99,28,40,0.0,0.0
1013,658,2020-03-17 19:44:00,0,3759.0,3385.0,0.9,18.559,272,148,105,43,124,48,76,87,0.0,0.0
1013,659,2020-03-17 19:47:00,0,4203.0,3727.0,0.887,20.686,361,200,158,42,161,104,57,107,0.29,0.0
1013,660,2020-03-17 19:50:00,0,2717.0,2453.0,0.903,13.42,309,174,119,55,135,88,47,48,0.0,0.0
1013,661,2020-03-17 19:53:00,0,3728.0,3384.0,0.908,18.434,334,209,150,59,125,69,56,102,0.0,0.0
1013,662,2020-03-17 19:56:00,0,3285.0,2960.0,0.901,16.221,267,142,87,55,125,72,53,24,0.0,0.0
1013,663,2020-03-17 19:59:00,0,2879.0,2569.0,0.892,14.185,213,100,43,57,113,57,56,8,0.0,0.0
1013,664,2020-03-17 20:02:00,0,3482.0,2994.0,0.86,17.034,186,118,56,62,68,18,50,5,0.0,0.0
1013,665,2020-03-17 20:05:00,0,3647.0,3316.0,0.909,18.038,386,199,156,43,187,129,58,39,0.03,0.0
1013,666,2020-03-17 20:08:00,0,3655.0,3276.0,0.896,18.029,153,115,76,39,38,24,14,2,0.0,0.0
1013,667,2020-03-17 20:11:00,0,3657.0,3160.0,0.864,17.907,47,17,10,7,30,13,17,0,0.0,0.0
1013,668,2020-03-17 20:14:00,0,3093.0,2671.0,0.863,15.145,5,2,0,2,3,1,2,0,0.0,0.0
1013,669,2020-03-17 20:17:00,0,2844.0,2419.0,0.851,13.882,3,3,0,3,0,0,0,0,0.0,0.0
1013,670,2020-03-17 20:20:00,0,2790.0,2376.0,0.851,13.625,7,6,4,2,1,0,1,0,0.0,0.0
1013,671,2020-03-17 20:23:00,0,2850.0,2371.0,0.832,13.852,0,0,0,0,0,0,0,0,0.0,0.0
1013,672,2020-03-17 20:26:00,0,2916.0,2386.0,0.8185,14.1295,6,6,1,5,0,0,0,0,0.0,0.0
1013,673,2020-03-17 20:29:00,0,2982.0,2401.0,0.805,14.407,8,5,1,4,3,1,2,0,0.0,0.0
1013,674,2020-03-17 20:32:00,0,2812.0,2291.0,0.815,13.617,129,59,36,23,70,34,36,8,0.0,0.0
1013,675,2020-03-17 20:35:00,0,2966.0,2437.0,0.822,14.383,175,42,7,35,133,73,60,9,0.0,0.0
1013,676,2020-03-17 20:38:00,0,3136.0,2519.0,0.803,15.144,257,105,63,42,152,94,58,28,0.0,0.0
1013,677,2020-03-17 20:41:00,0,3388.0,2691.0,0.794,16.33,358,226,172,54,132,90,42,55,0.0,0.0
1013,678,2020-03-17 20:44:00,0,3354.0,2659.0,0.793,16.159,481,270,212,58,211,151,60,92,0.0,0.0
1013,679,2020-03-17 20:47:00,0,3443.0,2734.0,0.794,16.593,399,202,163,39,197,128,69,74,0.02,0.0
1013,680,2020-03-17 20:50:00,0,2806.0,2239.0,0.798,13.534,99,48,27,21,51,21,30,2,0.0,0.0
1013,681,2020-03-17 20:53:00,0,2992.0,2373.0,0.793,14.415,7,5,4,1,2,0,2,0,0.0,0.0
1013,682,2020-03-17 20:56:00,0,2852.0,2229.0,0.782,13.707,11,4,1,3,7,0,7,0,0.0,0.0
1013,683,2020-03-17 20:59:00,0,2712.0,2117.0,0.781,13.029,1,0,0,0,1,0,1,0,0.0,0.0
1013,684,2020-03-17 21:02:00,0,2573.0,1987.0,0.772,12.338,6,5,1,4,1,0,1,0,0.0,0.0
1013,685,2020-03-17 21:05:00,0,2589.0,1965.0,0.759,12.376,4,3,0,3,1,0,1,0,0.0,0.0
1013,686,2020-03-17 21:08:00,0,2609.0,1959.0,0.751,12.448,22,12,1,11,10,1,9,0,0.0,0.0
1013,687,2020-03-17 21:11:00,0,2656.0,2005.0,0.755,12.686,19,9,6,3,10,4,6,0,0.0,0.0
1013,688,2020-03-17 21:14:00,0,2623.0,1944.0,0.741,12.488,6,0,0,0,6,2,4,0,0.0,0.0
1013,689,2020-03-17 21:17:00,0,2485.0,1901.0,0.765,11.896,201,135,96,39,66,34,32,20,0.0,0.0
1013,690,2020-03-17 21:20:00,0,2795.0,2074.0,0.742,13.31,326,147,94,53,179,117,62,31,0.0,0.0
1013,691,2020-03-17 21:23:00,0,2950.0,2248.0,0.762,14.111,400,202,148,54,198,141,57,65,0.0,0.0
1013,692,2020-03-17 21:26:00,0,3236.0,2533.0,0.783,15.555,291,187,129,58,104,30,74,90,0.0,0.0
1013,693,2020-03-17 21:29:00,0,3486.0,2659.0,0.763,16.68,205,112,61,51,93,40,53,64,0.0,0.0
1013,694,2020-03-17 21:32:00,0,3389.0,2551.0,0.753,16.177,341,189,137,52,152,111,41,37,0.35,0.0
1013,695,2020-03-17 21:35:00,0,3092.0,2392.0,0.774,14.833,491,254,192,62,237,174,63,65,0.0,0.0
1013,696,2020-03-17 21:38:00,0,3205.0,2427.0,0.757,15.315,300,132,91,41,168,108,60,37,0.0,0.0
1013,697,2020-03-17 21:41:00,0,3216.0,2462.0,0.766,15.396,106,23,1,22,83,46,37,4,0.0,0.0
1013,698,2020-03-17 21:44:00,0,3252.0,2427.0,0.746,15.499,109,54,23,31,55,11,44,2,0.0,0.0
1013,699,2020-03-17 21:47:00,0,3100.0,2409.0,0.777,14.879,61,37,16,21,24,6,18,0,0.0,0.0
1013,700,2020-03-17 21:50:00,0,2860.0,2245.0,0.785,13.754,11,8,3,5,3,1,2,0,0.0,0.0
1013,701,2020-03-17 21:53:00,0,2646.0,2027.0,0.766,12.67,29,15,3,12,14,1,13,0,0.0,0.0
1013,702,2020-03-17 21:56:00,0,2476.0,1900.0,0.768,11.859,47,15,7,8,32,15,17,0,0.0,0.0
1013,703,2020-03-17 21:59:00,0,2400.0,1819.0,0.758,11.47,38,9,5,4,29,10,19,0,0.0,0.0
1013,704,2020-03-17 22:02:00,0,2414.0,1823.0,0.755,11.531,17,10,5,5,7,1,6,0,0.0,0.0
1013,705,2020-03-17 22:05:00,0,2450.0,1884.0,0.769,11.74,28,11,3,8,17,4,13,0,0.0,0.0
1013,706,2020-03-17 22:08:00,0,2424.0,1843.0,0.76,11.593,20,13,0,13,7,3,4,2,0.0,0.0
1013,707,2020-03-17 22:11:00,0,2884.0,2091.0,0.725,13.677,460,223,167,56,237,171,66,40,0.07,0.0
1013,708,2020-03-17 22:14:00,0,3020.0,2279.0,0.755,14.421,271,140,93,47,131,89,42,44,0.0,0.0
1013,709,2020-03-17 22:17:00,0,3030.0,2259.0,0.746,14.439,71,17,9,8,54,7,47,1,0.0,0.0
1013,710,2020-03-17 22:20:00,0,2876.0,2107.0,0.733,13.664,28,0,0,0,28,0,28,0,0.0,0.0
1013,711,2020-03-17 22:23:00,0,2603.0,1939.0,0.745,12.402,8,1,0,1,7,0,7,0,0.0,0.0
1013,712,2020-03-17 22:26:00,0,2437.0,1847.0,0.758,11.646,14,0,0,0,14,5,9,0,0.0,0.0
1013,713,2020-03-17 22:29:00,0,2322.0,1731.0,0.746,11.064,27,0,0,0,27,3,24,0,0.0,0.0
1013,714,2020-03-17 22:32:00,0,2302.0,1699.0,0.738,10.95,10,3,1,2,7,4,3,0,0.0,0.0
1013,715,2020-03-17 22:35:00,0,2492.0,1776.0,0.713,11.784,6,4,1,3,2,0,2,0,0.0,0.0
1013,716,2020-03-17 22:38:00,0,2279.0,1700.0,0.746,10.863,41,5,1,4,36,9,27,0,0.0,0.0
1013,717,2020-03-17 22:41:00,0,2463.0,1754.0,0.712,11.645,190,30,14,16,160,94,66,12,0.0,0.0
1013,718,2020-03-17 22:44:00,0,2703.0,1953.0,0.723,12.812,148,69,25,44,79,40,39,1,0.0,0.0
1013,719,2020-03-17 22:47:00,0,2803.0,2100.0,0.749,13.367,456,228,175,53,228,167,61,48,0.18,0.0
1013,720,2020-03-17 22:50:00,0,3003.0,2291.0,0.763,14.37,86,58,35,23,28,19,9,3,0.0,0.0
1013,721,2020-03-17 22:53:00,0,2808.0,2122.0,0.756,13.415,16,8,3,5,8,1,7,0,0.0,0.0
1013,722,2020-03-17 22:56:00,0,2656.0,1973.0,0.743,12.65,10,3,2,1,7,0,7,0,0.0,0.0
1013,723,2020-03-17 22:59:00,0,2690.0,1995.0,0.742,12.808,417,218,168,50,199,142,57,17,0.0,0.0
1013,724,2020-03-17 23:02:00,0,2653.0,2013.0,0.759,12.681,474,259,206,53,215,157,58,90,0.0,0.0
1013,725,2020-03-17 23:05:00,0,3174.0,2386.0,0.752,15.148,257,136,90,46,121,52,69,89,0.0,0.0
1013,726,2020-03-17 23:08:00,0,3531.0,2612.0,0.74,16.805,182,103,43,60,79,4,75,75,0.0,0.0
1013,727,2020-03-17 23:11:00,0,3590.0,2700.0,0.752,17.136,183,110,56,54,73,12,61,74,0.0,0.0
1013,728,2020-03-17 23:14:00,0,3591.0,2700.0,0.752,17.14,195,143,81,62,52,0,52,58,0.0,0.0
1013,729,2020-03-17 23:17:00,0,3024.0,2283.0,0.755,14.441,265,130,89,41,135,98,37,32,0.0,0.0
1013,730,2020-03-17 23:20:00,0,3719.0,2939.0,0.79,17.909,406,186,134,52,220,158,62,59,0.23,0.0
1013,731,2020-03-17 23:23:00,0,3446.0,2770.0,0.804,16.645,481,271,216,55,210,161,49,45,0.01,0.0
1013,732,2020-03-17 23:26:00,0,3449.0,2848.5,0.826,16.743,515,293,227,66,222,158,64,54,0.38,0.0
1013,733,2020-03-17 23:29:00,0,3452.0,2927.0,0.848,16.841,286,142,98,44,144,97,47,21,0.0,0.0
1013,734,2020-03-17 23:32:00,0,3399.0,2877.0,0.846,16.577,370,211,154,57,159,125,34,24,0.0,0.0
1013,735,2020-03-17 23:35:00,0,3335.0,2748.0,0.824,16.184,473,243,191,52,230,156,74,15,0.0,0.0
1013,736,2020-03-17 23:38:00,0,3293.0,2801.0,0.851,16.076,587,331,257,74,256,179,77,52,0.0,0.0
1013,737,2020-03-17 23:41:00,0,2977.0,2403.0,0.807,14.39,197,105,57,48,92,43,49,31,0.0,0.0
1013,738,2020-03-17 23:44:00,0,3560.0,2910.0,0.817,17.247,348,195,129,66,153,74,79,75,0.0,0.0
1013,739,2020-03-17 23:47:00,0,3475.0,2899.0,0.834,16.903,193,118,56,62,75,4,71,59,0.0,0.0
1013,740,2020-03-17 23:50:00,0,3647.0,2934.0,0.804,17.616,271,165,103,62,106,49,57,101,0.0,0.0
1013,741,2020-03-17 23:53:00,0,3174.0,2615.0,0.824,15.403,539,282,214,68,257,185,72,63,0.0,0.0
1013,742,2020-03-17 23:56:00,0,3265.0,2641.0,0.809,15.79,503,258,210,48,245,188,57,14,0.29,0.0
1013,743,2020-03-17 23:59:00,0,3234.0,2545.0,0.787,15.561,894,461,377,84,433,322,111,23,0.0,0.0
1013,744,2020-03-18 00:02:00,0,3489.0,2801.0,0.803,16.85,383,218,161,57,165,120,45,44,0.0,0.0
1013,745,2020-03-18 00:05:00,0,2668.0,2162.0,0.81,12.906,185,57,20,37,128,62,66,34,0.0,0.0
1013,746,2020-03-18 00:08:00,0,2822.0,2255.0,0.799,13.614,127,48,28,20,79,41,38,13,0.0,0.0
1013,747,2020-03-18 00:11:00,0,3203.0,2603.0,0.813,15.501,613,309,233,76,304,242,62,36,0.0,0.0
1013,748,2020-03-18 00:14:00,0,3303.0,2648.0,0.802,15.948,813,355,266,89,458,353,105,12,0.0,0.0
1013,749,2020-03-18 00:17:00,0,3173.0,2504.0,0.789,15.274,613,349,279,70,264,201,63,31,0.02,0.0
1013,750,2020-03-18 00:20:00,0,3209.0,2503.0,0.78,15.414,256,89,62,27,167,110,57,15,0.0,0.0
1013,751,2020-03-18 00:23:00,0,3146.0,2538.0,0.807,15.205,191,46,21,25,145,84,61,15,0.0,0.0
1013,752,2020-03-18 00:26:00,0,3142.0,2552.0,0.812,15.204,252,128,59,69,124,63,61,5,0.0,0.0
1013,753,2020-03-18 00:29:00,0,3205.0,2477.0,0.773,15.371,98,56,23,33,42,19,23,0,0.0,0.0
1013,754,2020-03-18 00:32:00,0,2974.0,2331.0,0.784,14.3,12,0,0,0,12,4,8,0,0.0,0.0
1013,755,2020-03-18 00:35:00,0,2658.0,2111.0,0.794,12.811,0,0,0,0,0,0,0,0,0.0,0.0
1013,756,2020-03-18 00:38:00,0,2432.0,1935.0,0.796,11.724,14,8,1,7,6,2,4,0,0.0,0.0
1013,757,2020-03-18 00:41:00,0,2239.0,1735.0,0.775,10.743,1,0,0,0,1,0,1,0,0.0,0.0
1013,758,2020-03-18 00:44:00,0,2276.0,1685.0,0.74,10.834,189,91,60,31,98,57,41,12,0.0,0.0
1013,759,2020-03-18 00:47:00,0,2672.0,2041.0,0.764,12.788,360,177,128,49,183,117,66,73,0.0,0.0
1013,760,2020-03-18 00:50:00,0,3189.0,2397.0,0.752,15.217,238,135,66,69,103,13,90,110,0.0,0.0
1013,761,2020-03-18 00:53:00,0,3380.0,2585.0,0.765,16.179,252,166,86,80,86,2,84,106,0.0,0.0
1013,762,2020-03-18 00:56:00,0,3345.0,2572.0,0.769,16.027,200,57,35,22,143,88,55,26,0.18,0.0
1013,763,2020-03-18 00:59:00,0,3004.0,2284.0,0.76,14.365,490,262,207,55,228,164,64,85,0.07,0.0
1013,764,2020-03-18 01:02:00,0,3409.0,2624.0,0.77,16.338,299,173,110,63,126,51,75,110,0.04,0.0
1013,765,2020-03-18 01:05:00,0,2946.0,2360.0,0.801,14.219,354,166,131,35,188,142,46,31,0.0,0.0
1013,766,2020-03-18 01:08:00,0,3209.0,2529.0,0.788,15.442,541,211,160,51,330,263,67,16,0.1,0.0
1013,767,2020-03-18 01:11:00,0,2900.0,2334.0,0.805,14.012,521,236,182,54,285,212,73,10,0.0,0.0
1013,768,2020-03-18 01:14:00,0,3173.0,2475.0,0.78,15.241,486,266,203,63,220,158,62,56,0.09,0.0
1013,769,2020-03-18 01:17:00,0,2921.0,2406.0,0.824,14.173,826,468,376,92,358,272,86,24,0.24,0.0
1013,770,2020-03-18 01:20:00,0,3000.0,2477.0,0.826,14.564,270,115,80,35,155,106,49,32,0.0,0.0
1013,771,2020-03-18 01:23:00,0,3178.0,2483.0,0.781,15.273,309,100,64,36,209,150,59,6,0.0,0.0
1013,772,2020-03-18 01:26:00,0,2989.0,2426.0,0.812,14.462,789,443,358,85,346,263,83,29,0.03,0.0
1013,773,2020-03-18 01:29:00,0,2932.0,2399.0,0.818,14.206,934,559,471,88,375,292,83,40,0.12,0.0
1013,774,2020-03-18 01:32:00,0,3065.0,2458.0,0.802,14.797,605,317,264,53,288,215,73,44,0.34,0.0
1013,775,2020-03-18 01:35:00,0,2977.0,2374.0,0.798,14.356,700,373,314,59,327,255,72,79,0.0,0.0
1013,776,2020-03-18 01:38:00,0,3012.0,2497.0,0.829,14.632,826,491,414,77,335,255,80,58,0.05,0.0
1013,777,2020-03-18 01:41:00,0,2808.0,2285.0,0.814,13.594,200,93,53,40,107,62,45,17,0.05,0.0
1013,778,2020-03-18 01:44:00,0,2295.0,1785.0,0.778,11.019,141,82,39,43,59,26,33,8,0.0,0.0
1013,779,2020-03-18 01:47:00,0,2619.0,2053.0,0.784,12.594,8,3,1,2,5,2,3,0,0.0,0.0
1013,780,2020-03-18 01:50:00,0,2725.0,2167.0,0.795,13.135,36,2,0,2,34,2,32,0,0.0,0.0
1013,781,2020-03-18 01:53:00,0,2592.0,2046.0,0.789,12.478,17,0,0,0,17,9,8,0,0.0,0.0
1013,782,2020-03-18 01:56:00,0,2421.0,1890.0,0.781,11.631,7,0,0,0,7,1,6,0,0.0,0.0
1013,783,2020-03-18 01:59:00,0,2222.0,1725.0,0.776,10.666,7,0,0,0,7,2,5,0,0.0,0.0
1013,784,2020-03-18 02:02:00,0,2271.0,1693.0,0.745,10.823,7,0,0,0,7,3,4,0,0.0,0.0
1013,785,2020-03-18 02:05:00,0,2288.0,1708.0,0.747,10.906,11,1,0,1,10,5,5,0,0.0,0.0
1013,786,2020-03-18 02:08:00,0,2255.0,1673.0,0.742,10.74,4,1,0,1,3,2,1,0,0.0,0.0
1013,787,2020-03-18 02:11:00,0,2329.0,1704.0,0.732,11.062,22,7,2,5,15,9,6,0,0.0,0.0
1013,788,2020-03-18 02:14:00,0,2294.0,1649.0,0.719,10.863,8,1,0,1,7,0,7,0,0.0,0.0
1013,789,2020-03-18 02:17:00,0,2130.0,1588.0,0.745,10.15,11,0,0,0,11,3,8,0,0.0,0.0
1013,790,2020-03-18 02:20:00,0,2144.0,1562.0,0.729,10.178,4,0,0,0,4,0,4,0,0.0,0.0
1013,791,2020-03-18 02:23:00,0,2122.0,1566.0,0.738,10.097,5,0,0,0,5,2,3,0,0.0,0.0
1013,792,2020-03-18 02:26:00,0,2121.5,1578.5,0.744,10.1075,14,0,0,0,14,0,14,0,0.0,0.0
1013,793,2020-03-18 02:29:00,0,2121.0,1591.0,0.75,10.118,15,0,0,0,15,0,15,0,0.0,0.0
1013,794,2020-03-18 02:32:00,0,2140.0,1497.0,0.699,10.091,12,0,0,0,12,1,11,0,0.0,0.0
1013,795,2020-03-18 02:35:00,0,2069.0,1470.0,0.71,9.78,185,38,15,23,147,95,52,33,0.0,0.0
1013,796,2020-03-18 02:38:00,0,2428.0,1825.0,0.752,11.589,219,72,32,40,147,86,61,11,0.0,0.0
1013,797,2020-03-18 02:41:00,0,2680.0,2021.0,0.754,12.797,159,50,22,28,109,59,50,9,0.0,0.0
1013,798,2020-03-18 02:44:00,0,3130.0,2391.0,0.764,14.979,314,144,106,38,170,110,60,54,0.2,0.0
1013,799,2020-03-18 02:47:00,0,2976.0,2295.0,0.771,14.265,277,133,102,31,144,86,58,32,0.2,0.0
1013,800,2020-03-18 02:50:00,0,3176.0,2522.0,0.794,15.307,599,321,261,60,278,209,69,126,0.05,0.0
1013,801,2020-03-18 02:53:00,0,3218.0,2440.0,0.758,15.379,501,245,194,51,256,184,72,46,0.22,0.0
1013,802,2020-03-18 02:56:00,0,2955.0,2360.0,0.799,14.257,593,250,210,40,343,262,81,38,0.12,0.0
1013,803,2020-03-18 02:59:00,0,2966.0,2337.0,0.788,14.273,665,311,232,79,354,265,89,12,0.0,0.0
1013,804,2020-03-18 03:02:00,0,2972.0,2287.0,0.769,14.243,532,281,223,58,251,192,59,40,0.08,0.0
1013,805,2020-03-18 03:05:00,0,2935.0,2314.0,0.788,14.125,440,261,209,52,179,127,52,44,0.22,0.0
1013,806,2020-03-18 03:08:00,0,2987.0,2372.0,0.794,14.395,341,199,135,64,142,95,47,8,0.0,0.0
1013,807,2020-03-18 03:11:00,0,2980.0,2392.0,0.803,14.388,222,127,102,25,95,61,34,13,0.04,0.0
1013,808,2020-03-18 03:14:00,0,2828.0,2277.0,0.805,13.662,142,83,42,41,59,33,26,4,0.0,0.0
1013,809,2020-03-18 03:17:00,0,2690.0,2140.0,0.795,12.967,25,16,3,13,9,4,5,0,0.0,0.0
1013,810,2020-03-18 03:20:00,0,2614.0,2035.0,0.779,12.553,3,1,0,1,2,1,1,0,0.0,0.0
1013,811,2020-03-18 03:23:00,0,2447.0,1854.0,0.758,11.696,14,6,2,4,8,1,7,0,0.0,0.0
1013,812,2020-03-18 03:26:00,0,2177.0,1677.0,0.77,10.432,1,0,0,0,1,0,1,0,0.0,0.0
1013,813,2020-03-18 03:29:00,0,2017.0,1556.0,0.771,9.671,117,48,36,12,69,47,22,0,0.0,0.0
1013,814,2020-03-18 03:32:00,0,2130.0,1589.0,0.746,10.154,3,1,0,1,2,1,1,0,0.0,0.0
1013,815,2020-03-18 03:35:00,0,2145.0,1607.0,0.749,10.23,31,4,3,1,27,16,11,0,0.0,0.0
1013,816,2020-03-18 03:38:00,0,2140.0,1556.0,0.727,10.154,7,2,1,1,5,2,3,0,0.0,0.0
1013,817,2020-03-18 03:41:00,0,2099.0,1551.0,0.739,9.986,0,0,0,0,0,0,0,0,0.0,0.0
1013,818,2020-03-18 03:44:00,0,2096.0,1524.0,0.727,9.946,1,0,0,0,1,1,0,0,0.0,0.0
1013,819,2020-03-18 03:47:00,0,2137.0,1538.0,0.72,10.123,2,1,0,1,1,0,1,0,0.0,0.0
1013,820,2020-03-18 03:50:00,0,2126.0,1534.0,0.721,10.074,95,37,17,20,58,34,24,0,0.0,0.0
1013,821,2020-03-18 03:53:00,0,2128.0,1580.0,0.743,10.133,31,29,13,16,2,1,1,0,0.0,0.0
1013,822,2020-03-18 03:56:00,0,2130.0,1533.0,0.72,10.089,8,8,1,7,0,0,0,0,0.0,0.0
1013,823,2020-03-18 03:59:00,0,2157.0,1527.0,0.708,10.188,14,7,3,4,7,1,6,0,0.0,0.0
1013,824,2020-03-18 04:02:00,0,1971.0,1462.0,0.742,9.384,6,3,0,3,3,0,3,0,0.0,0.0
1013,825,2020-03-18 04:05:00,0,2040.0,1455.0,0.713,9.65,6,2,0,2,4,3,1,0,0.0,0.0
1013,826,2020-03-18 04:08:00,0,2158.0,1568.0,0.727,10.239,250,149,123,26,101,71,30,9,0.09,0.0
1013,827,2020-03-18 04:11:00,0,2703.0,1968.0,0.728,12.831,274,153,110,43,121,80,41,49,0.1,0.0
1013,828,2020-03-18 04:14:00,0,2876.0,2097.0,0.729,13.654,131,53,12,41,78,39,39,19,0.0,0.0
1013,829,2020-03-18 04:17:00,0,2917.0,2173.0,0.745,13.9,132,73,30,43,59,25,34,9,0.0,0.0
1013,830,2020-03-18 04:20:00,0,2941.0,2303.0,0.783,14.139,284,156,116,40,128,61,67,89,0.23,0.0
1013,831,2020-03-18 04:23:00,0,3124.0,2363.0,0.756,14.926,218,109,73,36,109,57,52,41,0.15,0.0
1013,832,2020-03-18 04:26:00,0,3059.0,2359.0,0.771,14.666,406,210,175,35,196,140,56,86,0.22,0.0
1013,833,2020-03-18 04:29:00,0,3109.0,2393.0,0.77,14.898,714,365,301,64,349,266,83,29,0.12,0.0
1013,834,2020-03-18 04:32:00,0,2956.0,2320.0,0.785,14.214,712,375,312,63,337,260,77,40,0.09,0.0
1013,835,2020-03-18 04:35:00,0,2985.0,2299.0,0.77,14.305,676,367,290,77,309,229,80,54,0.01,0.0
1013,836,2020-03-18 04:38:00,0,2992.0,2305.0,0.77,14.339,859,438,344,94,421,314,107,18,0.0,0.0
1013,837,2020-03-18 04:41:00,0,2889.0,2255.0,0.781,13.879,712,350,258,92,362,276,86,23,0.0,0.0
1013,838,2020-03-18 04:44:00,0,2846.0,2255.0,0.792,13.708,701,424,333,91,277,211,66,72,0.13,0.0
1013,839,2020-03-18 04:47:00,0,2984.0,2309.0,0.774,14.314,612,328,279,49,284,216,68,37,0.06,0.0
1013,840,2020-03-18 04:50:00,0,2962.0,2265.0,0.765,14.177,440,287,227,60,153,99,54,22,0.2,0.0
1013,841,2020-03-18 04:53:00,0,2953.0,2376.0,0.805,14.266,117,54,30,24,63,25,38,9,0.23,0.0
1013,842,2020-03-18 04:56:00,0,2825.0,2178.0,0.771,13.542,111,60,16,44,51,18,33,3,0.0,0.0
1013,843,2020-03-18 04:59:00,0,2855.0,2191.0,0.767,13.676,7,0,0,0,7,0,7,0,0.0,0.0
1013,844,2020-03-18 05:02:00,0,2466.0,1973.0,0.8,11.9,5,0,0,0,5,0,5,0,0.0,0.0
1013,845,2020-03-18 05:05:00,0,2335.0,1828.0,0.783,11.225,6,0,0,0,6,0,6,0,0.0,0.0
1013,846,2020-03-18 05:08:00,0,2214.0,1739.0,0.785,10.65,15,0,0,0,15,5,10,0,0.0,0.0
1013,847,2020-03-18 05:11:00,0,2120.0,1658.0,0.782,10.187,2,0,0,0,2,0,2,0,0.0,0.0
1013,848,2020-03-18 05:14:00,0,2033.0,1569.0,0.772,9.746,0,0,0,0,0,0,0,0,0.0,0.0
1013,849,2020-03-18 05:17:00,0,1862.0,1472.0,0.79,8.967,18,0,0,0,18,2,16,0,0.0,0.0
1013,850,2020-03-18 05:20:00,0,2020.0,1515.0,0.75,9.638,19,0,0,0,19,5,14,0,0.0,0.0
1013,851,2020-03-18 05:23:00,0,1961.0,1489.0,0.759,9.376,30,7,4,3,23,7,16,0,0.0,0.0
1013,852,2020-03-18 05:26:00,0,1931.5,1468.5,0.76,9.2365,6,2,1,1,4,0,4,0,0.0,0.0
1013,853,2020-03-18 05:29:00,0,1902.0,1448.0,0.761,9.097,10,1,0,1,9,2,7,0,0.0,0.0
1013,854,2020-03-18 05:32:00,0,1866.0,1417.0,0.76,8.92,42,12,5,7,30,2,28,0,0.0,0.0
1013,855,2020-03-18 05:35:00,0,1949.0,1454.0,0.746,9.288,23,10,3,7,13,1,12,0,0.0,0.0
1013,856,2020-03-18 05:38:00,0,1960.0,1431.0,0.73,9.308,171,82,58,24,89,59,30,7,0.0,0.0
1013,857,2020-03-18 05:41:00,0,2302.0,1690.0,0.734,10.94,164,69,38,31,95,43,52,33,0.02,0.0
1013,858,2020-03-18 05:44:00,0,2667.0,1969.0,0.738,12.689,195,95,60,35,100,61,39,43,0.53,0.0
1013,859,2020-03-18 05:47:00,0,2992.0,2339.0,0.782,14.378,500,267,213,54,233,157,76,95,0.02,0.0
1013,860,2020-03-18 05:50:00,0,2994.0,2307.0,0.771,14.35,283,141,85,56,142,91,51,13,0.14,0.0
1013,861,2020-03-18 05:53:00,0,2979.0,2238.0,0.751,14.215,203,87,47,40,116,64,52,13,0.0,0.0
1013,862,2020-03-18 05:56:00,0,2934.0,2256.0,0.769,14.06,203,106,63,43,97,48,49,28,0.0,0.0
1013,863,2020-03-18 05:59:00,0,2990.0,2327.0,0.778,14.357,94,28,9,19,66,28,38,1,0.0,0.0
1013,864,2020-03-18 06:02:00,1,2854.0,2231.0,0.782,13.715,381,179,153,26,202,142,60,26,0.15,0.0
1013,865,2020-03-18 06:05:00,1,3184.0,2458.0,0.772,15.266,599,340,283,57,259,188,71,38,0.0,0.0
1013,866,2020-03-18 06:08:00,1,3195.0,2473.0,0.774,15.327,236,125,94,31,111,60,51,9,0.19,0.0
1013,867,2020-03-18 06:11:00,1,3220.0,2469.0,0.767,15.422,226,108,68,40,118,68,50,12,0.34,0.0
1013,868,2020-03-18 06:14:00,1,2851.0,2171.0,0.761,13.635,188,115,76,39,73,42,31,1,0.0,0.0
1013,869,2020-03-18 06:17:00,1,2679.0,2098.0,0.783,12.88,81,20,12,8,61,10,51,0,0.0,0.0
1013,870,2020-03-18 06:20:00,1,2808.0,2185.0,0.778,13.482,25,13,3,10,12,0,12,0,0.0,0.0
1013,871,2020-03-18 06:23:00,1,2585.0,2016.0,0.78,12.418,19,19,4,15,0,0,0,0,0.0,0.0
1013,872,2020-03-18 06:26:00,1,2466.0,1877.0,0.761,11.793,8,8,0,8,0,0,0,0,0.0,0.0
1013,873,2020-03-18 06:29:00,1,2272.0,1699.0,0.748,10.835,0,0,0,0,0,0,0,0,0.0,0.0
1013,874,2020-03-18 06:32:00,1,2128.0,1573.0,0.739,10.126,37,24,15,9,13,1,12,0,0.0,0.0
1013,875,2020-03-18 06:35:00,1,1864.0,1503.0,0.806,9.01,2,1,0,1,1,0,1,0,0.0,0.0
1013,876,2020-03-18 06:38:00,1,1914.0,1409.0,0.737,9.1,15,10,5,5,5,1,4,0,0.0,0.0
1013,877,2020-03-18 06:41:00,1,1737.0,1319.0,0.76,8.304,9,0,0,0,9,2,7,0,0.0,0.0
1013,878,2020-03-18 06:44:00,1,1664.0,1258.0,0.756,7.949,30,5,4,1,25,4,21,0,0.0,0.0
1013,879,2020-03-18 06:47:00,1,1575.0,1193.0,0.757,7.527,4,2,1,1,2,0,2,0,0.0,0.0
1013,880,2020-03-18 06:50:00,1,1589.0,1191.0,0.75,7.579,1,0,0,0,1,0,1,0,0.0,0.0
1013,881,2020-03-18 06:53:00,1,1546.0,1197.0,0.774,7.419,21,0,0,0,21,0,21,0,0.0,0.0
1013,882,2020-03-18 06:56:00,1,1667.0,1241.0,0.745,7.942,38,13,4,9,25,12,13,0,0.0,0.0
1013,883,2020-03-18 06:59:00,1,1579.0,1219.0,0.772,7.571,4,0,0,0,4,0,4,0,0.0,0.0
1013,884,2020-03-18 07:02:00,1,1570.0,1176.0,0.749,7.488,19,15,0,15,4,0,4,0,0.0,0.0
1013,885,2020-03-18 07:05:00,1,1561.0,1139.0,0.73,7.413,7,2,0,2,5,0,5,0,0.0,0.0
1013,886,2020-03-18 07:08:00,1,1552.0,1116.0,0.719,7.351,38,11,1,10,27,0,27,0,0.0,0.0
1013,887,2020-03-18 07:11:00,1,1582.0,1123.0,0.71,7.475,23,5,0,5,18,0,18,0,0.0,0.0
1013,888,2020-03-18 07:14:00,1,1585.0,1113.0,0.702,7.477,36,16,5,11,20,4,16,0,0.0,0.0
1013,889,2020-03-18 07:17:00,1,1726.0,1257.0,0.728,8.191,15,4,0,4,11,4,7,0,0.0,0.0
1013,890,2020-03-18 07:20:00,1,1847.0,1332.0,0.721,8.753,10,2,2,0,8,7,1,0,0.0,0.0
1013,891,2020-03-18 07:23:00,1,1873.0,1338.0,0.714,8.862,0,0,0,0,0,0,0,0,0.0,0.0
1013,892,2020-03-18 07:26:00,1,1914.0,1344.0,0.702,9.03,1,0,0,0,1,1,0,0,0.0,0.0
1013,893,2020-03-18 07:29:00,1,1884.0,1381.0,0.733,8.953,0,0,0,0,0,0,0,0,0.0,0.0
1013,894,2020-03-18 07:32:00,1,2006.0,1438.0,0.717,9.496,1,0,0,0,1,0,1,0,0.0,0.0
1013,895,2020-03-18 07:35:00,1,2089.0,1480.0,0.708,9.869,9,0,0,0,9,0,9,0,0.0,0.0
1013,896,2020-03-18 07:38:00,1,2151.0,1523.0,0.708,10.163,179,90,62,28,89,55,34,3,0.31,0.0
1013,897,2020-03-18 07:41:00,1,2950.0,2146.0,0.727,13.998,60,23,5,18,37,14,23,0,0.24,0.0
1013,898,2020-03-18 07:44:00,1,3392.0,2516.0,0.742,16.151,197,80,49,31,117,72,45,22,0.03,0.0
1013,899,2020-03-18 07:47:00,1,3258.0,2414.0,0.741,15.508,240,132,91,41,108,70,38,27,0.0,0.0
1013,900,2020-03-18 07:50:00,1,2796.0,2128.0,0.761,13.373,236,120,79,41,116,63,53,21,0.0,0.0
1013,901,2020-03-18 07:53:00,1,3159.0,2402.0,0.76,15.107,477,213,172,41,264,193,71,33,0.16,0.0
1013,902,2020-03-18 07:56:00,1,3072.0,2377.0,0.774,14.736,34,20,11,9,14,9,5,0,0.0,0.0
1013,903,2020-03-18 07:59:00,1,2813.0,2150.0,0.764,13.463,0,0,0,0,0,0,0,0,0.0,0.0
1013,904,2020-03-18 08:02:00,1,2606.0,1962.0,0.753,12.44,239,116,96,20,123,92,31,0,0.16,0.0
1013,905,2020-03-18 08:05:00,1,2474.0,1934.0,0.782,11.889,274,165,118,47,109,70,39,1,0.08,0.0
1013,906,2020-03-18 08:08:00,1,2037.0,1550.0,0.761,9.744,34,24,4,20,10,1,9,0,0.0,0.0
1013,907,2020-03-18 08:11:00,1,2112.0,1579.0,0.748,10.072,119,68,47,21,51,31,20,2,0.01,0.0
1013,908,2020-03-18 08:14:00,1,2331.0,1844.0,0.791,11.227,319,178,129,49,141,95,46,28,0.12,0.0
1013,909,2020-03-18 08:17:00,1,2251.0,1825.0,0.811,10.89,180,89,44,45,91,43,48,1,0.0,0.0
1013,910,2020-03-18 08:20:00,1,2614.0,2055.0,0.786,12.574,667,336,269,67,331,233,98,16,0.16,0.0
1013,911,2020-03-18 08:23:00,1,2682.0,2119.0,0.79,12.914,382,197,151,46,185,143,42,19,0.26,0.0
1013,912,2020-03-18 08:26:00,1,3181.0,2488.5,0.7835,15.29,379,256,179,77,123,81,42,3,0.01,0.03
1013,913,2020-03-18 08:29:00,1,3680.0,2858.0,0.777,17.666,227,163,105,58,64,28,36,75,0.0,0.16
1013,914,2020-03-18 08:32:00,1,3916.0,3181.0,0.812,18.95,273,162,107,55,111,65,46,63,0.04,0.13
1013,915,2020-03-18 08:35:00,1,3749.0,3025.0,0.807,18.121,200,120,75,45,80,32,48,96,0.0,0.07
1013,916,2020-03-18 08:38:00,1,3223.0,2699.0,0.837,15.687,480,259,196,63,221,162,59,33,0.0,0.01
1013,917,2020-03-18 08:41:00,1,3444.0,2908.0,0.844,16.79,160,68,26,42,92,35,57,0,0.0,0.01
1013,918,2020-03-18 08:44:00,1,3456.0,2968.0,0.859,16.904,180,95,43,52,85,32,53,0,0.0,0.0
1013,919,2020-03-18 08:47:00,1,3225.0,2789.0,0.865,15.794,8,7,1,6,1,0,1,0,0.0,0.0
1013,920,2020-03-18 08:50:00,1,3043.0,2649.0,0.871,14.922,14,10,7,3,4,2,2,0,0.0,0.0
1013,921,2020-03-18 08:53:00,1,2822.0,2583.0,0.915,13.977,7,2,1,1,5,1,4,0,0.0,0.0
1013,922,2020-03-18 08:56:00,1,2838.0,2549.0,0.898,14.003,29,12,4,8,17,7,10,0,0.0,0.0
1013,923,2020-03-18 08:59:00,1,2661.0,2444.0,0.918,13.191,0,0,0,0,0,0,0,0,0.0,0.0
1013,924,2020-03-18 09:02:00,1,2604.0,2372.0,0.911,12.886,8,0,0,0,8,4,4,0,0.0,0.0
1013,925,2020-03-18 09:05:00,1,2227.0,2145.0,0.963,11.15,3,0,0,0,3,2,1,0,0.0,0.0
1013,926,2020-03-18 09:08:00,1,2272.0,2106.0,0.927,11.281,53,30,22,8,23,10,13,2,0.0,0.0
1013,927,2020-03-18 09:11:00,1,2606.0,2430.0,0.932,12.96,553,331,251,80,222,159,63,22,0.14,0.0
1013,928,2020-03-18 09:14:00,1,2698.0,2501.0,0.927,13.397,16,5,2,3,11,3,8,0,0.0,0.0
1013,929,2020-03-18 09:17:00,1,2601.0,2406.0,0.925,12.912,14,0,0,0,14,0,14,0,0.0,0.0
1013,930,2020-03-18 09:20:00,1,2518.0,2238.0,0.889,12.399,10,5,3,2,5,3,2,0,0.0,0.0
1013,931,2020-03-18 09:23:00,1,2266.0,2088.0,0.921,11.24,8,5,0,5,3,0,3,0,0.0,0.0
1013,932,2020-03-18 09:26:00,1,2114.0,1994.0,0.943,10.538,5,1,0,1,4,0,4,0,0.0,0.0
1013,933,2020-03-18 09:29:00,1,2095.0,1913.0,0.913,10.373,16,5,0,5,11,2,9,0,0.0,0.0
1013,934,2020-03-18 09:32:00,1,1915.0,1813.0,0.947,9.551,17,12,6,6,5,1,4,0,0.0,0.0
1013,935,2020-03-18 09:35:00,1,1975.0,1826.0,0.924,9.803,1,1,0,1,0,0,0,0,0.0,0.0
1013,936,2020-03-18 09:38:00,1,1959.0,1755.0,0.896,9.66,3,3,1,2,0,0,0,0,0.0,0.0
1013,937,2020-03-18 09:41:00,1,1979.0,1794.0,0.907,9.782,1,1,0,1,0,0,0,0,0.0,0.0
1013,938,2020-03-18 09:44:00,1,1985.0,1759.0,0.886,9.767,24,11,7,4,13,3,10,0,0.0,0.0
1013,939,2020-03-18 09:47:00,1,1934.0,1730.0,0.895,9.534,6,3,1,2,3,0,3,0,0.0,0.0
1013,940,2020-03-18 09:50:00,1,1996.0,1726.0,0.865,9.776,82,60,29,31,22,4,18,0,0.0,0.0
1013,941,2020-03-18 09:53:00,1,2135.0,1941.0,0.909,10.563,176,120,66,54,56,12,44,1,0.0,0.0
1013,942,2020-03-18 09:56:00,1,2389.0,2182.0,0.913,11.826,96,76,34,42,20,8,12,0,0.0,0.0
1013,943,2020-03-18 09:59:00,1,2526.0,2314.0,0.916,12.514,182,133,81,52,49,26,23,15,0.0,0.0
1013,944,2020-03-18 10:02:00,1,2580.0,2319.0,0.899,12.731,3,3,0,3,0,0,0,0,0.0,0.0
1013,945,2020-03-18 10:05:00,1,2383.0,2127.0,0.893,11.744,19,17,11,6,2,0,2,0,0.0,0.0
1013,946,2020-03-18 10:08:00,1,2301.0,1967.0,0.855,11.245,38,11,2,9,27,0,27,0,0.0,0.0
1013,947,2020-03-18 10:11:00,1,2139.0,1893.0,0.885,10.521,51,6,2,4,45,0,45,0,0.0,0.0
1013,948,2020-03-18 10:14:00,1,2169.0,1797.0,0.829,10.535,100,57,20,37,43,17,26,0,0.0,0.0
1013,949,2020-03-18 10:17:00,1,2295.0,1984.0,0.865,11.241,43,28,9,19,15,0,15,0,0.0,0.0
1013,950,2020-03-18 10:20:00,1,2309.0,2105.0,0.912,11.428,34,23,0,23,11,0,11,0,0.0,0.0
1013,951,2020-03-18 10:23:00,1,2290.0,1960.0,0.856,11.193,6,1,1,0,5,2,3,0,0.0,0.0
1013,952,2020-03-18 10:26:00,1,2129.0,1894.0,0.89,10.486,4,1,0,1,3,1,2,0,0.0,0.0
1013,953,2020-03-18 10:29:00,1,2148.0,1833.0,0.854,10.493,9,0,0,0,9,3,6,0,0.0,0.0
1013,954,2020-03-18 10:32:00,1,2024.0,1747.0,0.863,9.909,3,3,1,2,0,0,0,0,0.0,0.0
1013,955,2020-03-18 10:35:00,1,1980.0,1757.0,0.887,9.745,5,3,2,1,2,0,2,0,0.0,0.0
1013,956,2020-03-18 10:38:00,1,1989.0,1708.0,0.858,9.729,16,6,4,2,10,2,8,0,0.0,0.0
1013,957,2020-03-18 10:41:00,1,2137.0,1756.0,0.822,10.366,9,0,0,0,9,0,9,0,0.0,0.0
1013,958,2020-03-18 10:44:00,1,2154.0,1926.0,0.894,10.617,121,61,50,11,60,47,13,4,0.0,0.0
1013,959,2020-03-18 10:47:00,1,2092.0,1868.0,0.893,10.312,0,0,0,0,0,0,0,0,0.0,0.0
1013,960,2020-03-18 10:50:00,1,2152.0,1832.0,0.851,10.509,4,2,0,2,2,1,1,0,0.0,0.0
1013,961,2020-03-18 10:53:00,1,2180.0,1817.0,0.834,10.601,1,0,0,0,1,0,1,0,0.0,0.0
1013,962,2020-03-18 10:56:00,1,2080.0,1769.0,0.85,10.152,3,1,0,1,2,1,1,0,0.0,0.0
1013,963,2020-03-18 10:59:00,1,1947.0,1724.0,0.885,9.578,7,4,0,4,3,1,2,0,0.0,0.0
1013,964,2020-03-18 11:02:00,1,1973.0,1728.0,0.876,9.685,5,5,0,5,0,0,0,0,0.0,0.0
1013,965,2020-03-18 11:05:00,1,1966.0,1703.0,0.866,9.633,11,11,0,11,0,0,0,0,0.0,0.0
1013,966,2020-03-18 11:08:00,1,2207.0,1821.0,0.825,10.711,134,51,23,28,83,43,40,15,0.0,0.0
1013,967,2020-03-18 11:11:00,1,2560.0,2123.0,0.829,12.439,148,56,32,24,92,53,39,5,0.0,0.0
1013,968,2020-03-18 11:14:00,1,2539.0,2140.0,0.843,12.373,112,71,32,39,41,17,24,4,0.0,0.0
1013,969,2020-03-18 11:17:00,1,3024.0,2550.0,0.843,14.737,336,159,113,46,177,125,52,36,0.38,0.0
1013,970,2020-03-18 11:20:00,1,2970.0,2487.0,0.837,14.456,330,175,134,41,155,111,44,68,0.0,0.04
1013,971,2020-03-18 11:23:00,1,3077.0,2580.0,0.838,14.978,201,116,66,50,85,29,56,114,0.0,0.13
1013,972,2020-03-18 11:26:00,1,3069.0,2646.5,0.8625,15.0205,159,121,71,50,38,3,35,91,0.0,0.2
1013,973,2020-03-18 11:29:00,1,3061.0,2713.0,0.887,15.063,445,220,162,58,225,149,76,23,0.0,0.01
1013,974,2020-03-18 11:32:00,1,3018.0,2688.0,0.891,14.868,610,271,205,66,339,252,87,15,0.02,0.0
1013,975,2020-03-18 11:35:00,1,3315.0,2912.0,0.879,16.285,672,399,321,78,273,194,79,23,0.0,0.0
1013,976,2020-03-18 11:38:00,1,3189.0,2917.0,0.915,15.793,888,426,335,91,462,340,122,16,0.0,0.0
1013,977,2020-03-18 11:41:00,1,3187.0,2893.0,0.908,15.758,674,421,318,103,253,168,85,26,0.0,0.0
1013,978,2020-03-18 11:44:00,1,3218.0,2903.0,0.902,15.894,881,482,389,93,399,306,93,65,0.0,0.0
1013,979,2020-03-18 11:47:00,1,2983.0,2785.0,0.934,14.834,68,40,6,34,28,2,26,1,0.0,0.0
1013,980,2020-03-18 11:50:00,1,2981.0,2769.0,0.929,14.81,153,81,31,50,72,31,41,49,0.0,0.0
1013,981,2020-03-18 11:53:00,1,3070.0,2776.0,0.904,15.171,375,230,150,80,145,84,61,30,0.0,0.0
1013,982,2020-03-18 11:56:00,1,2881.0,2665.0,0.925,14.302,838,449,358,91,389,294,95,82,0.0,0.0
1013,983,2020-03-18 11:59:00,1,2870.0,2644.0,0.921,14.234,1016,578,449,129,438,343,95,164,0.0,0.0
1013,984,2020-03-18 12:02:00,1,2804.0,2625.0,0.936,13.952,980,510,404,106,470,357,113,147,0.0,0.0
1013,985,2020-03-18 12:05:00,1,2837.0,2651.0,0.934,14.112,858,561,432,129,297,215,82,94,0.0,0.0
1013,986,2020-03-18 12:08:00,1,2834.0,2630.0,0.928,14.079,819,495,383,112,324,230,94,123,0.0,0.0
1013,987,2020-03-18 12:11:00,1,3179.0,2846.0,0.895,15.677,138,73,45,28,65,20,45,84,0.0,0.52
1013,988,2020-03-18 12:14:00,1,2508.0,2300.0,0.917,12.428,90,11,4,7,79,27,52,0,0.0,0.0
1013,989,2020-03-18 12:17:00,1,3087.0,2756.0,0.893,15.214,98,52,25,27,46,10,36,25,0.0,0.01
1013,990,2020-03-18 12:20:00,1,2994.0,2812.0,0.939,14.909,12,5,1,4,7,2,5,0,0.0,0.0
1013,991,2020-03-18 12:23:00,1,2992.0,2735.0,0.914,14.818,3,2,1,1,1,0,1,0,0.0,0.0
1013,992,2020-03-18 12:26:00,1,2749.0,2622.0,0.954,13.735,5,3,2,1,2,0,2,0,0.0,0.0
1013,993,2020-03-18 12:29:00,1,2627.0,2501.0,0.952,13.119,7,5,3,2,2,0,2,0,0.0,0.0
1013,994,2020-03-18 12:32:00,1,2472.0,2397.0,0.97,12.394,7,5,4,1,2,0,2,0,0.0,0.0
1013,995,2020-03-18 12:35:00,1,2501.0,2321.0,0.928,12.425,7,5,4,1,2,0,2,0,0.0,0.0
1013,996,2020-03-18 12:38:00,1,2278.0,2247.0,0.987,11.462,14,5,2,3,9,3,6,0,0.0,0.0
1013,997,2020-03-18 12:41:00,1,2255.0,2234.0,0.991,11.36,15,1,1,0,14,1,13,0,0.0,0.0
1013,998,2020-03-18 12:44:00,1,2263.0,2217.0,0.979,11.37,0,0,0,0,0,0,0,0,0.0,0.0
1013,999,2020-03-18 12:47:00,1,2238.0,2175.0,0.972,11.226,0,0,0,0,0,0,0,0,0.0,0.0
1013,1000,2020-03-18 12:50:00,1,2270.0,2215.0,0.975,11.397,1,0,0,0,1,1,0,0,0.0,0.01
1013,1001,2020-03-18 12:53:00,1,2249.0,2210.0,0.983,11.309,351,158,110,48,193,116,77,31,0.31,0.0
1013,1002,2020-03-18 12:56:00,1,2495.0,2342.0,0.939,12.423,200,107,85,22,93,66,27,14,0.0,0.0
1013,1003,2020-03-18 12:59:00,1,2210.0,2194.0,0.992,11.137,0,0,0,0,0,0,0,0,0.0,0.0
1013,1004,2020-03-18 13:02:00,1,2277.0,2133.0,0.937,11.334,1,1,0,1,0,0,0,0,0.0,0.0
1013,1005,2020-03-18 13:05:00,1,2193.0,2108.0,0.962,10.973,0,0,0,0,0,0,0,0,0.0,0.0
1013,1006,2020-03-18 13:08:00,1,2169.0,2059.0,0.949,10.827,43,22,14,8,21,13,8,2,0.0,0.0
1013,1007,2020-03-18 13:11:00,1,2321.0,2226.0,0.959,11.607,27,15,9,6,12,9,3,3,0.0,0.0
1013,1008,2020-03-18 13:14:00,1,2399.0,2254.0,0.94,11.948,1,1,0,1,0,0,0,0,0.0,0.0
1013,1009,2020-03-18 13:17:00,1,2226.0,2202.0,0.989,11.207,24,13,1,12,11,6,5,0,0.0,0.0
1013,1010,2020-03-18 13:20:00,1,2553.0,2389.0,0.936,12.704,144,83,47,36,61,27,34,57,0.0,0.0
1013,1011,2020-03-18 13:23:00,1,2649.0,2510.0,0.948,13.216,194,100,46,54,94,43,51,46,0.0,0.0
1013,1012,2020-03-18 13:26:00,1,2590.0,2592.0,1.001,13.073,663,402,332,70,261,190,71,63,0.22,0.0
1013,1013,2020-03-18 13:29:00,1,2797.0,2676.0,0.957,13.984,949,583,483,100,366,273,93,97,0.0,0.0
1013,1014,2020-03-18 13:32:00,1,2974.0,2885.0,0.97,14.911,565,377,283,94,188,136,52,64,0.0,0.0
1013,1015,2020-03-18 13:35:00,1,2881.0,2731.0,0.948,14.374,1081,624,490,134,457,348,109,75,0.0,0.0
1013,1016,2020-03-18 13:38:00,1,2856.0,2754.0,0.964,14.302,813,556,447,109,257,176,81,97,0.01,0.0
1013,1017,2020-03-18 13:41:00,1,2871.0,2756.0,0.96,14.364,745,360,265,95,385,313,72,57,0.0,0.0
1013,1018,2020-03-18 13:44:00,1,2779.0,2733.0,0.983,13.975,843,463,370,93,380,281,99,79,0.14,0.0
1013,1019,2020-03-18 13:47:00,1,2782.0,2661.0,0.956,13.906,154,113,43,70,41,4,37,15,0.0,0.0
1013,1020,2020-03-18 13:50:00,1,2767.0,2706.0,0.978,13.896,102,52,10,42,50,21,29,34,0.0,0.0
1013,1021,2020-03-18 13:53:00,1,2802.0,2695.0,0.962,14.022,181,74,37,37,107,59,48,0,0.0,0.0
1013,1022,2020-03-18 13:56:00,1,2813.0,2652.0,0.943,14.018,55,13,4,9,42,19,23,3,0.0,0.0
1013,1023,2020-03-18 13:59:00,1,2627.0,2481.0,0.945,13.097,9,4,2,2,5,2,3,0,0.0,0.0
1013,1024,2020-03-18 14:02:00,1,2528.0,2323.0,0.919,12.532,0,0,0,0,0,0,0,0,0.0,0.0
1013,1025,2020-03-18 14:05:00,1,2247.0,2141.0,0.953,11.222,0,0,0,0,0,0,0,0,0.0,0.0
1013,1026,2020-03-18 14:08:00,1,2244.0,2052.0,0.914,11.114,7,5,3,2,2,2,0,0,0.0,0.0
1013,1027,2020-03-18 14:11:00,1,2191.0,2030.0,0.927,10.879,5,2,1,1,3,0,3,0,0.0,0.0
1013,1028,2020-03-18 14:14:00,1,2099.0,1989.0,0.948,10.471,4,3,1,2,1,0,1,0,0.0,0.0
1013,1029,2020-03-18 14:17:00,1,2129.0,1955.0,0.918,10.552,3,3,0,3,0,0,0,0,0.0,0.0
1013,1030,2020-03-18 14:20:00,1,1924.0,1864.0,0.968,9.645,11,6,1,5,5,2,3,0,0.0,0.0
1013,1031,2020-03-18 14:23:00,1,2110.0,1943.0,0.921,10.466,35,20,10,10,15,9,6,0,0.0,0.0
1013,1032,2020-03-18 14:26:00,1,2197.0,2009.5,0.915,10.881,4,4,0,4,0,0,0,0,0.0,0.0
1013,1033,2020-03-18 14:29:00,1,2284.0,2076.0,0.909,11.296,61,61,0,61,0,0,0,0,0.0,0.0
1013,1034,2020-03-18 14:32:00,1,2394.0,2109.0,0.881,11.768,5,4,0,4,1,1,0,0,0.0,0.0
1013,1035,2020-03-18 14:35:00,1,2354.0,2108.0,0.895,11.608,29,15,1,14,14,4,10,0,0.0,0.0
1013,1036,2020-03-18 14:38:00,1,2377.0,2181.0,0.918,11.78,15,13,0,13,2,0,2,0,0.0,0.0
1013,1037,2020-03-18 14:41:00,1,2291.0,2073.0,0.905,11.323,50,37,0,37,13,2,11,0,0.0,0.0
1013,1038,2020-03-18 14:44:00,1,2207.0,2056.0,0.932,10.972,2,1,0,1,1,0,1,0,0.0,0.0
1013,1039,2020-03-18 14:47:00,1,2246.0,2043.0,0.91,11.111,4,4,2,2,0,0,0,0,0.0,0.0
1013,1040,2020-03-18 14:50:00,1,2173.0,1985.0,0.914,10.759,171,75,31,44,96,38,58,6,0.0,0.0
1013,1041,2020-03-18 14:53:00,1,2368.0,2156.0,0.91,11.718,132,48,22,26,84,38,46,4,0.0,0.0
1013,1042,2020-03-18 14:56:00,1,2561.0,2315.0,0.904,12.654,201,121,77,44,80,42,38,10,0.0,0.0
1013,1043,2020-03-18 14:59:00,1,2587.0,2313.0,0.894,12.755,5,3,2,1,2,0,2,0,0.0,0.0
1013,1044,2020-03-18 15:02:00,1,2344.0,2153.0,0.918,11.62,14,10,3,7,4,0,4,0,0.0,0.0
1013,1045,2020-03-18 15:05:00,1,2185.0,2028.0,0.928,10.854,15,12,1,11,3,0,3,0,0.0,0.0
1013,1046,2020-03-18 15:08:00,1,2193.0,1947.0,0.888,10.795,24,15,7,8,9,3,6,0,0.0,0.0
1013,1047,2020-03-18 15:11:00,1,2088.0,1925.0,0.922,10.357,0,0,0,0,0,0,0,0,0.0,0.0
1013,1048,2020-03-18 15:14:00,1,2142.0,1926.0,0.899,10.57,0,0,0,0,0,0,0,0,0.0,0.0
1013,1049,2020-03-18 15:17:00,1,2300.0,2079.0,0.904,11.364,26,12,8,4,14,8,6,0,0.0,0.0
1013,1050,2020-03-18 15:20:00,1,2374.0,2115.0,0.891,11.697,6,1,0,1,5,0,5,0,0.0,0.0
1013,1051,2020-03-18 15:23:00,1,2411.0,2122.0,0.88,11.848,4,0,0,0,4,0,4,0,0.0,0.0
1013,1052,2020-03-18 15:26:00,1,2420.0,2147.0,0.887,11.91,135,102,65,37,33,14,19,7,0.0,0.0
1013,1053,2020-03-18 15:29:00,1,2791.0,2622.0,0.939,13.899,157,79,63,16,78,56,22,6,0.28,0.0
1013,1054,2020-03-18 15:32:00,1,2577.0,2328.0,0.903,12.733,3,2,1,1,1,1,0,0,0.0,0.0
1013,1055,2020-03-18 15:35:00,1,2452.0,2293.0,0.935,12.201,0,0,0,0,0,0,0,0,0.0,0.0
1013,1056,2020-03-18 15:38:00,1,2377.0,2195.0,0.923,11.797,1,1,1,0,0,0,0,0,0.0,0.0
1013,1057,2020-03-18 15:41:00,1,2357.0,2108.0,0.894,11.62,11,3,1,2,8,3,5,0,0.0,0.0
1013,1058,2020-03-18 15:44:00,1,2313.0,2169.0,0.938,11.513,0,0,0,0,0,0,0,0,0.0,0.0
1013,1059,2020-03-18 15:47:00,1,2373.0,2159.0,0.91,11.741,70,48,28,20,22,13,9,0,0.0,0.0
1013,1060,2020-03-18 15:50:00,1,2567.0,2382.0,0.928,12.75,369,240,177,63,129,79,50,53,0.0,0.0
1013,1061,2020-03-18 15:53:00,1,3117.0,2849.0,0.914,15.436,167,111,48,63,56,6,50,88,0.0,0.1
1013,1062,2020-03-18 15:56:00,1,3503.0,3223.0,0.92,17.371,176,119,64,55,57,3,54,114,0.0,0.16
1013,1063,2020-03-18 15:59:00,1,3091.0,2846.0,0.921,15.329,303,204,142,62,99,70,29,33,0.0,0.0
1013,1064,2020-03-18 16:02:00,1,3245.0,3070.0,0.946,16.186,509,296,219,77,213,149,64,48,0.0,0.0
1013,1065,2020-03-18 16:05:00,1,3224.0,3051.0,0.946,16.081,800,476,390,86,324,239,85,107,0.0,0.0
1013,1066,2020-03-18 16:08:00,1,3397.0,3205.0,0.943,16.931,755,433,329,104,322,241,81,92,0.0,0.0
1013,1067,2020-03-18 16:11:00,1,3538.0,3267.0,0.923,17.555,197,147,87,60,50,1,49,85,0.0,0.11
1013,1068,2020-03-18 16:14:00,1,3740.0,3492.0,0.934,18.602,164,96,66,30,68,24,44,85,0.0,0.13
1013,1069,2020-03-18 16:17:00,1,3260.0,2960.0,0.908,16.12,680,392,299,93,288,198,90,68,0.0,0.0
1013,1070,2020-03-18 16:20:00,1,3606.0,3348.0,0.928,17.914,1158,753,607,146,405,303,102,156,0.2,0.0
1013,1071,2020-03-18 16:23:00,1,3566.0,3321.0,0.931,17.727,677,401,289,112,276,196,80,32,0.0,0.0
1013,1072,2020-03-18 16:26:00,1,3672.0,3380.0,0.92,18.21,273,92,33,59,181,108,73,14,0.0,0.0
1013,1073,2020-03-18 16:29:00,1,3622.0,3380.0,0.933,18.014,113,19,6,13,94,48,46,1,0.0,0.0
1013,1074,2020-03-18 16:32:00,1,3439.0,3170.0,0.922,17.061,67,30,0,30,37,3,34,0,0.0,0.0
1013,1075,2020-03-18 16:35:00,1,3204.0,3029.0,0.945,15.977,81,35,0,35,46,7,39,0,0.0,0.0
1013,1076,2020-03-18 16:38:00,1,2977.0,2818.0,0.946,14.85,12,5,0,5,7,4,3,0,0.0,0.0
1013,1077,2020-03-18 16:41:00,1,2901.0,2731.0,0.941,14.452,2,0,0,0,2,0,2,0,0.0,0.0
1013,1078,2020-03-18 16:44:00,1,2684.0,2594.0,0.967,13.446,1,0,0,0,1,0,1,0,0.0,0.0
1013,1079,2020-03-18 16:47:00,1,2720.0,2555.0,0.939,13.546,23,5,1,4,18,0,18,0,0.0,0.0
1013,1080,2020-03-18 16:50:00,1,2725.0,2505.0,0.919,13.51,48,43,3,40,5,0,5,0,0.0,0.0
1013,1081,2020-03-18 16:53:00,1,2731.0,2504.0,0.917,13.534,2,2,1,1,0,0,0,0,0.0,0.0
1013,1082,2020-03-18 16:56:00,1,2559.0,2442.0,0.954,12.785,28,27,18,9,1,0,1,0,0.0,0.0
1013,1083,2020-03-18 16:59:00,1,2583.0,2445.0,0.947,12.884,6,5,2,3,1,0,1,0,0.0,0.0
1013,1084,2020-03-18 17:02:00,1,2563.0,2432.0,0.949,12.791,53,42,25,17,11,3,8,0,0.0,0.0
1013,1085,2020-03-18 17:05:00,1,2548.0,2328.0,0.914,12.619,35,33,13,20,2,1,1,0,0.0,0.0
1013,1086,2020-03-18 17:08:00,1,2502.0,2297.0,0.918,12.401,94,94,26,68,0,0,0,0,0.0,0.0
1013,1087,2020-03-18 17:11:00,1,2385.0,2246.0,0.942,11.882,201,201,118,83,0,0,0,0,0.0,0.0
1013,1088,2020-03-18 17:14:00,1,2587.0,2361.0,0.913,12.808,49,43,24,19,6,2,4,0,0.0,0.0
1013,1089,2020-03-18 17:17:00,1,2513.0,2432.0,0.968,12.594,28,0,0,0,28,6,22,0,0.0,0.0
1013,1090,2020-03-18 17:20:00,1,2586.0,2450.0,0.947,12.903,100,28,21,7,72,36,36,0,0.0,0.0
1013,1091,2020-03-18 17:23:00,1,2786.0,2610.0,0.937,13.867,314,136,83,53,178,109,69,22,0.0,0.0
1013,1092,2020-03-18 17:26:00,1,2972.5,2745.0,0.9245,14.752,291,94,61,33,197,126,71,19,0.29,0.0
1013,1093,2020-03-18 17:29:00,1,3159.0,2880.0,0.912,15.637,157,82,56,26,75,49,26,6,0.0,0.0
1013,1094,2020-03-18 17:32:00,1,2785.0,2597.0,0.933,13.849,5,5,0,5,0,0,0,0,0.0,0.0
1013,1095,2020-03-18 17:35:00,1,2760.0,2478.0,0.898,13.617,33,30,4,26,3,1,2,0,0.0,0.0
1013,1096,2020-03-18 17:38:00,1,2659.0,2408.0,0.905,13.143,68,68,26,42,0,0,0,0,0.0,0.0
1013,1097,2020-03-18 17:41:00,1,2657.0,2393.0,0.901,13.118,54,43,18,25,11,4,7,20,0.0,0.0
1013,1098,2020-03-18 17:44:00,1,2805.0,2463.0,0.878,13.778,188,112,58,54,76,24,52,27,0.0,0.0
1013,1099,2020-03-18 17:47:00,1,2782.0,2577.0,0.926,13.815,130,99,46,53,31,4,27,26,0.0,0.0
1013,1100,2020-03-18 17:50:00,1,2970.0,2672.0,0.899,14.66,92,42,6,36,50,11,39,6,0.0,0.0
1013,1101,2020-03-18 17:53:00,1,2831.0,2539.0,0.897,13.966,116,113,59,54,3,0,3,0,0.0,0.0
1013,1102,2020-03-18 17:56:00,1,2671.0,2339.0,0.876,13.113,155,131,79,52,24,10,14,23,0.0,0.05
1013,1103,2020-03-18 17:59:00,1,3153.0,2870.0,0.91,15.602,283,226,152,74,57,18,39,76,0.0,0.08
1013,1104,2020-03-18 18:02:00,0,3718.0,3328.0,0.895,18.333,600,355,270,85,245,179,66,105,0.12,0.05
1013,1105,2020-03-18 18:05:00,0,3462.0,3164.0,0.914,17.143,786,456,359,97,330,249,81,161,0.0,0.0
1013,1106,2020-03-18 18:08:00,0,3679.0,3309.0,0.899,18.159,230,165,108,57,65,26,39,105,0.0,0.14
1013,1107,2020-03-18 18:11:00,0,3839.0,3514.0,0.915,19.016,149,87,56,31,62,37,25,54,0.0,0.32
1013,1108,2020-03-18 18:14:00,0,3562.0,3198.0,0.898,17.576,156,28,9,19,128,88,40,20,0.0,0.0
1013,1109,2020-03-18 18:17:00,0,3872.0,3517.0,0.908,19.151,57,27,11,16,30,9,21,0,0.0,0.0
1013,1110,2020-03-18 18:20:00,0,3497.0,3279.0,0.938,17.407,36,23,3,20,13,0,13,0,0.0,0.0
1013,1111,2020-03-18 18:23:00,0,3517.0,3159.0,0.898,17.355,50,7,2,5,43,0,43,0,0.0,0.01
1013,1112,2020-03-18 18:26:00,0,3409.0,3095.0,0.908,16.858,43,7,3,4,36,14,22,0,0.0,0.0
1013,1113,2020-03-18 18:29:00,0,3261.0,3015.0,0.924,16.188,53,27,8,19,26,9,17,3,0.0,0.0
1013,1114,2020-03-18 18:32:00,0,3207.0,2985.0,0.931,15.939,50,20,12,8,30,12,18,0,0.0,0.0
1013,1115,2020-03-18 18:35:00,0,3250.0,2979.0,0.917,16.102,34,12,6,6,22,7,15,0,0.0,0.0
1013,1116,2020-03-18 18:38:00,0,3349.0,3021.0,0.902,16.539,19,8,0,8,11,7,4,0,0.0,0.0
1013,1117,2020-03-18 18:41:00,0,3138.0,2912.0,0.928,15.588,92,39,24,15,53,29,24,3,0.23,0.0
1013,1118,2020-03-18 18:44:00,0,3336.0,3092.0,0.927,16.569,277,140,80,60,137,74,63,97,0.0,0.0
1013,1119,2020-03-18 18:47:00,0,3443.0,3264.0,0.948,17.178,262,85,34,51,177,108,69,42,0.0,0.0
1013,1120,2020-03-18 18:50:00,0,3842.0,3545.0,0.923,19.06,454,221,163,58,233,186,47,52,0.0,0.01
1013,1121,2020-03-18 18:53:00,0,3695.0,3396.0,0.919,18.317,497,276,198,78,221,162,59,39,0.0,0.0
1013,1122,2020-03-18 18:56:00,0,3735.0,3426.0,0.917,18.51,245,138,106,32,107,79,28,26,0.0,0.0
1013,1123,2020-03-18 18:59:00,0,3509.0,3314.0,0.944,17.494,69,53,31,22,16,10,6,11,0.0,0.0
1013,1124,2020-03-18 19:02:00,0,3335.0,3071.0,0.921,16.54,3,3,0,3,0,0,0,0,0.0,0.0
1013,1125,2020-03-18 19:05:00,0,3340.0,3131.0,0.937,16.628,3,2,0,2,1,0,1,0,0.0,0.0
1013,1126,2020-03-18 19:08:00,0,3351.0,3068.0,0.916,16.601,23,5,0,5,18,7,11,0,0.0,0.0
1013,1127,2020-03-18 19:11:00,0,3183.0,2987.0,0.939,15.847,17,6,2,4,11,5,6,0,0.0,0.0
1013,1128,2020-03-18 19:14:00,0,3210.0,2942.0,0.916,15.904,15,11,4,7,4,2,2,0,0.0,0.0
1013,1129,2020-03-18 19:17:00,0,3246.0,2978.0,0.917,16.088,13,9,3,6,4,1,3,0,0.0,0.0
1013,1130,2020-03-18 19:20:00,0,3184.0,2923.0,0.918,15.78,35,26,16,10,9,4,5,0,0.0,0.0
1013,1131,2020-03-18 19:23:00,0,3031.0,2825.0,0.932,15.07,67,54,42,12,13,10,3,8,0.0,0.0
1013,1132,2020-03-18 19:26:00,0,3479.0,3255.0,0.936,17.309,166,113,63,50,53,9,44,82,0.0,0.15
1013,1133,2020-03-18 19:29:00,0,3367.0,3098.0,0.92,16.695,174,93,69,24,81,40,41,62,0.0,0.22
1013,1134,2020-03-18 19:32:00,0,3934.0,3756.0,0.955,19.659,539,261,202,59,278,210,68,70,0.41,0.0
1013,1135,2020-03-18 19:35:00,0,4316.0,4217.0,0.977,21.674,275,143,96,47,132,94,38,22,0.0,0.0
1013,1136,2020-03-18 19:38:00,0,3640.0,3402.0,0.935,18.106,566,294,218,76,272,198,74,70,0.0,0.0
1013,1137,2020-03-18 19:41:00,0,3873.0,3563.0,0.92,19.206,703,412,320,92,291,211,80,62,0.0,0.0
1013,1138,2020-03-18 19:44:00,0,4052.0,3765.0,0.929,20.133,926,533,424,109,393,288,105,76,0.0,0.0
1013,1139,2020-03-18 19:47:00,0,3901.0,3659.0,0.938,19.42,613,334,273,61,279,211,68,65,0.04,0.01
1013,1140,2020-03-18 19:50:00,0,3860.0,3533.0,0.915,19.12,313,180,123,57,133,88,45,19,0.0,0.0
1013,1141,2020-03-18 19:53:00,0,3868.0,3474.0,0.898,19.086,72,31,15,16,41,20,21,7,0.0,0.0
1013,1142,2020-03-18 19:56:00,0,3842.0,3639.0,0.947,19.168,96,68,33,35,28,9,19,16,0.0,0.0
1013,1143,2020-03-18 19:59:00,0,3860.0,3647.0,0.945,19.244,116,41,19,22,75,38,37,4,0.0,0.0
1013,1144,2020-03-18 20:02:00,0,3708.0,3493.0,0.942,18.476,4,2,1,1,2,1,1,0,0.0,0.0
1013,1145,2020-03-18 20:05:00,0,3562.0,3314.0,0.93,17.703,12,3,2,1,9,1,8,0,0.0,0.0
1013,1146,2020-03-18 20:08:00,0,3436.0,3210.0,0.934,17.091,4,2,0,2,2,0,2,0,0.0,0.0
1013,1147,2020-03-18 20:11:00,0,3479.0,3270.0,0.94,17.326,19,3,1,2,16,2,14,0,0.0,0.0
1013,1148,2020-03-18 20:14:00,0,3593.0,3302.0,0.919,17.81,97,55,34,21,42,23,19,4,0.0,0.0
1013,1149,2020-03-18 20:17:00,0,3723.0,3338.0,0.897,18.363,9,5,3,2,4,4,0,0,0.0,0.0
1013,1150,2020-03-18 20:20:00,0,3407.0,3193.0,0.937,16.958,29,26,5,21,3,3,0,0,0.0,0.0
1013,1151,2020-03-18 20:23:00,0,3844.0,3492.0,0.908,19.014,173,99,71,28,74,47,27,2,0.3,0.0
1013,1152,2020-03-18 20:26:00,0,3797.5,3487.0,0.918,18.823,92,44,7,37,48,12,36,11,0.0,0.0
1013,1153,2020-03-18 20:29:00,0,3751.0,3482.0,0.928,18.632,81,35,16,19,46,20,26,22,0.0,0.0
1013,1154,2020-03-18 20:32:00,0,3852.0,3485.0,0.905,19.035,139,43,17,26,96,46,50,1,0.0,0.0
1013,1155,2020-03-18 20:35:00,0,3795.0,3492.0,0.92,18.82,41,23,7,16,18,10,8,0,0.0,0.0
1013,1156,2020-03-18 20:38:00,0,3656.0,3327.0,0.91,18.088,30,6,1,5,24,1,23,0,0.0,0.0
1013,1157,2020-03-18 20:41:00,0,3490.0,3216.0,0.921,17.312,46,15,0,15,31,2,29,0,0.0,0.0
1013,1158,2020-03-18 20:44:00,0,3488.0,3268.0,0.937,17.361,30,11,6,5,19,14,5,0,0.0,0.0
1013,1159,2020-03-18 20:47:00,0,3426.0,3176.0,0.927,17.017,23,4,3,1,19,9,10,0,0.0,0.0
1013,1160,2020-03-18 20:50:00,0,3472.0,3136.0,0.903,17.15,7,2,1,1,5,1,4,0,0.0,0.0
1013,1161,2020-03-18 20:53:00,0,3480.0,3248.0,0.933,17.306,276,126,97,29,150,106,44,18,0.22,0.0
1013,1162,2020-03-18 20:56:00,0,3542.0,3257.0,0.919,17.561,447,164,111,53,283,209,74,43,0.06,0.0
1013,1163,2020-03-18 20:59:00,0,3602.0,3327.0,0.924,17.877,203,116,75,41,87,64,23,18,0.03,0.0
1013,1164,2020-03-18 21:02:00,0,3720.0,3364.0,0.904,18.381,141,78,37,41,63,29,34,5,0.0,0.0
1013,1165,2020-03-18 21:05:00,0,3747.0,3384.0,0.903,18.509,159,66,27,39,93,51,42,27,0.0,0.0
1013,1166,2020-03-18 21:08:00,0,3709.0,3366.0,0.907,18.341,480,240,190,50,240,175,65,61,0.11,0.0
1013,1167,2020-03-18 21:11:00,0,3481.0,3252.0,0.934,17.314,804,459,375,84,345,251,94,91,0.0,0.0
1013,1168,2020-03-18 21:14:00,0,3697.0,3460.0,0.936,18.397,569,339,272,67,230,177,53,98,0.09,0.0
1013,1169,2020-03-18 21:17:00,0,3484.0,3177.0,0.912,17.243,183,87,52,35,96,58,38,31,0.0,0.0
1013,1170,2020-03-18 21:20:00,0,3486.0,3262.0,0.936,17.346,85,47,29,18,38,22,16,2,0.0,0.0
1013,1171,2020-03-18 21:23:00,0,3474.0,3149.0,0.906,17.173,9,6,1,5,3,2,1,0,0.0,0.0
1013,1172,2020-03-18 21:26:00,0,3221.0,3008.0,0.934,16.02,39,28,16,12,11,5,6,0,0.0,0.0
1013,1173,2020-03-18 21:29:00,0,3168.0,2842.0,0.897,15.627,14,5,0,5,9,5,4,0,0.0,0.0
1013,1174,2020-03-18 21:32:00,0,2936.0,2778.0,0.946,14.644,19,0,0,0,19,4,15,0,0.0,0.0
1013,1175,2020-03-18 21:35:00,0,3073.0,2785.0,0.906,15.192,41,19,8,11,22,12,10,0,0.0,0.0
1013,1176,2020-03-18 21:38:00,0,2931.0,2760.0,0.942,14.604,0,0,0,0,0,0,0,0,0.0,0.0
1013,1177,2020-03-18 21:41:00,0,3161.0,2876.0,0.91,15.636,29,18,4,14,11,4,7,0,0.0,0.0
1013,1178,2020-03-18 21:44:00,0,3191.0,2954.0,0.926,15.844,249,117,86,31,132,82,50,12,0.26,0.0
1013,1179,2020-03-18 21:47:00,0,3369.0,3086.0,0.916,16.691,198,127,59,68,71,16,55,21,0.0,0.0
1013,1180,2020-03-18 21:50:00,0,3287.0,3042.0,0.925,16.32,147,51,25,26,96,46,50,6,0.0,0.0
1013,1181,2020-03-18 21:53:00,0,3230.0,2974.0,0.921,16.02,2,1,0,1,1,1,0,0,0.0,0.0
1013,1182,2020-03-18 21:56:00,0,3183.0,2891.0,0.908,15.741,6,6,0,6,0,0,0,0,0.0,0.0
1013,1183,2020-03-18 21:59:00,0,3281.0,3001.0,0.914,16.251,221,141,71,70,80,50,30,21,0.0,0.0
1013,1184,2020-03-18 22:02:00,0,3481.0,3180.0,0.914,17.235,223,109,72,37,114,71,43,22,0.17,0.0
1013,1185,2020-03-18 22:05:00,0,3364.0,3114.0,0.926,16.7,221,97,73,24,124,89,35,20,0.0,0.0
1013,1186,2020-03-18 22:08:00,0,3119.0,2930.0,0.939,15.532,5,5,1,4,0,0,0,0,0.0,0.0
1013,1187,2020-03-18 22:11:00,0,3127.0,2862.0,0.915,15.488,25,21,7,14,4,2,2,0,0.0,0.0
1013,1188,2020-03-18 22:14:00,0,3136.0,2916.0,0.93,15.584,104,66,39,27,38,14,24,48,0.0,0.0
1013,1189,2020-03-18 22:17:00,0,3701.0,3327.0,0.899,18.265,312,204,140,64,108,46,62,114,0.0,0.08
1013,1190,2020-03-18 22:20:00,0,3634.0,3399.0,0.935,18.081,357,180,141,39,177,115,62,82,0.24,0.07
1013,1191,2020-03-18 22:23:00,0,3669.0,3385.0,0.923,18.203,287,141,102,39,146,101,45,31,0.0,0.0
1013,1192,2020-03-18 22:26:00,0,3852.0,3697.0,0.96,19.27,169,98,70,28,71,51,20,24,0.0,0.0
1013,1193,2020-03-18 22:29:00,0,3195.0,2984.0,0.934,15.893,561,349,262,87,212,146,66,34,0.0,0.0
1013,1194,2020-03-18 22:32:00,0,3739.0,3509.0,0.938,18.616,627,338,261,77,289,220,69,61,0.0,0.0
1013,1195,2020-03-18 22:35:00,0,3911.0,3663.0,0.937,19.463,519,315,237,78,204,135,69,24,0.0,0.0
1013,1196,2020-03-18 22:38:00,0,3830.0,3513.0,0.917,18.977,392,299,228,71,93,56,37,48,0.0,0.13
1013,1197,2020-03-18 22:41:00,0,3865.0,3597.0,0.931,19.211,173,99,60,39,74,40,34,23,0.0,0.0
1013,1198,2020-03-18 22:44:00,0,3742.0,3520.0,0.941,18.64,543,236,179,57,307,234,73,34,0.0,0.0
1013,1199,2020-03-18 22:47:00,0,3737.0,3457.0,0.925,18.55,714,281,203,78,433,330,103,29,0.0,0.0
1013,1200,2020-03-18 22:50:00,0,3791.0,3547.0,0.936,18.862,406,286,219,67,120,80,40,68,0.36,0.04
1013,1201,2020-03-18 22:53:00,0,3867.0,3573.0,0.924,19.191,464,263,202,61,201,136,65,27,0.0,0.0
1013,1202,2020-03-18 22:56:00,0,3763.0,3528.0,0.938,18.733,380,177,140,37,203,139,64,35,0.0,0.0
1013,1203,2020-03-18 22:59:00,0,3717.0,3450.0,0.928,18.466,145,67,41,26,78,34,44,10,0.0,0.0
1013,1204,2020-03-18 23:02:00,0,3729.0,3498.0,0.938,18.565,235,118,52,66,117,75,42,39,0.0,0.0
1013,1205,2020-03-18 23:05:00,0,3730.0,3448.0,0.925,18.512,115,75,38,37,40,20,20,9,0.0,0.0
1013,1206,2020-03-18 23:08:00,0,3445.0,3157.0,0.916,17.069,5,3,2,1,2,0,2,0,0.0,0.0
1013,1207,2020-03-18 23:11:00,0,3245.0,2994.0,0.923,16.099,11,2,0,2,9,0,9,0,0.0,0.0
1013,1208,2020-03-18 23:14:00,0,3160.0,2853.0,0.903,15.609,0,0,0,0,0,0,0,0,0.0,0.0
1013,1209,2020-03-18 23:17:00,0,2982.0,2779.0,0.932,14.826,11,6,5,1,5,0,5,0,0.0,0.0
1013,1210,2020-03-18 23:20:00,0,2948.0,2795.0,0.948,14.709,0,0,0,0,0,0,0,0,0.0,0.0
1013,1211,2020-03-18 23:23:00,0,2949.0,2769.0,0.939,14.687,37,0,0,0,37,26,11,0,0.0,0.0
1013,1212,2020-03-18 23:26:00,0,2891.0,2773.5,0.9595,14.463,82,23,14,9,59,24,35,0,0.0,0.0
1013,1213,2020-03-18 23:29:00,0,2833.0,2778.0,0.98,14.239,20,14,8,6,6,5,1,0,0.0,0.0
1013,1214,2020-03-18 23:32:00,0,2790.0,2683.0,0.962,13.964,14,14,2,12,0,0,0,0,0.0,0.0
1013,1215,2020-03-18 23:35:00,0,2890.0,2735.0,0.947,14.414,12,9,6,3,3,0,3,0,0.0,0.0
1013,1216,2020-03-18 23:38:00,0,2867.0,2725.0,0.951,14.312,9,8,2,6,1,0,1,0,0.0,0.0
1013,1217,2020-03-18 23:41:00,0,2934.0,2779.0,0.947,14.635,16,15,3,12,1,0,1,0,0.0,0.0
1013,1218,2020-03-18 23:44:00,0,2951.0,2775.0,0.94,14.699,158,90,61,29,68,47,21,20,0.0,0.0
1013,1219,2020-03-18 23:47:00,0,3344.0,3185.0,0.952,16.702,209,149,100,49,60,31,29,87,0.0,0.1
1013,1220,2020-03-18 23:50:00,0,3405.0,3119.0,0.916,16.867,333,181,142,39,152,98,54,50,0.14,0.0
1013,1221,2020-03-18 23:53:00,0,3382.0,3147.0,0.931,16.81,199,124,82,42,75,31,44,61,0.0,0.0
1013,1222,2020-03-18 23:56:00,0,3660.0,3392.0,0.927,18.177,352,182,123,59,170,109,61,49,0.0,0.0
1013,1223,2020-03-18 23:59:00,0,3610.0,3448.0,0.955,18.039,206,119,85,34,87,62,25,25,0.0,0.0
1013,1224,2020-03-19 00:02:00,0,3475.0,3353.0,0.965,17.403,4,0,0,0,4,1,3,0,0.0,0.0
1013,1225,2020-03-19 00:05:00,0,3421.0,3180.0,0.929,16.999,9,4,2,2,5,2,3,0,0.0,0.0
1013,1226,2020-03-19 00:08:00,0,3230.0,3067.0,0.95,16.122,2,2,0,2,0,0,0,0,0.0,0.0
1013,1227,2020-03-19 00:11:00,0,3218.0,3063.0,0.952,16.068,12,10,0,10,2,0,2,0,0.0,0.0
1013,1228,2020-03-19 00:14:00,0,3226.0,3020.0,0.936,16.053,21,6,0,6,15,8,7,0,0.0,0.01
1013,1229,2020-03-19 00:17:00,0,3303.0,3107.0,0.941,16.454,119,69,47,22,50,32,18,9,0.0,0.0
1013,1230,2020-03-19 00:20:00,0,3321.0,3128.0,0.942,16.549,177,133,77,56,44,2,42,118,0.0,0.14
1013,1231,2020-03-19 00:23:00,0,3266.0,3051.0,0.934,16.246,315,180,130,50,135,83,52,50,0.23,0.02
1013,1232,2020-03-19 00:26:00,0,3913.0,3723.0,0.951,19.539,399,208,154,54,191,143,48,76,0.01,0.03
1013,1233,2020-03-19 00:29:00,0,3760.0,3553.0,0.945,18.746,618,374,275,99,244,171,73,34,0.0,0.0
1013,1234,2020-03-19 00:32:00,0,3758.0,3571.0,0.95,18.76,442,179,135,44,263,202,61,27,0.0,0.0
1013,1235,2020-03-19 00:35:00,0,3681.0,3527.0,0.958,18.407,242,136,96,40,106,66,40,23,0.02,0.03
1013,1236,2020-03-19 00:38:00,0,3624.0,3460.0,0.955,18.108,457,250,196,54,207,149,58,45,0.0,0.0
1013,1237,2020-03-19 00:41:00,0,3798.0,3569.0,0.94,18.917,484,215,150,65,269,192,77,66,0.0,0.0
1013,1238,2020-03-19 00:44:00,0,3659.0,3471.0,0.949,18.258,359,141,78,63,218,136,82,0,0.0,0.0
1013,1239,2020-03-19 00:47:00,0,3624.0,3445.0,0.951,18.093,293,143,87,56,150,92,58,9,0.0,0.0
1013,1240,2020-03-19 00:50:00,0,3626.0,3374.0,0.931,18.022,554,287,213,74,267,192,75,25,0.0,0.0
1013,1241,2020-03-19 00:53:00,0,3536.0,3295.0,0.932,17.579,902,358,261,97,544,435,109,9,0.0,0.0
1013,1242,2020-03-19 00:56:00,0,3615.0,3360.0,0.93,17.963,392,225,156,69,167,119,48,7,0.0,0.0
1013,1243,2020-03-19 00:59:00,0,3399.0,3215.0,0.946,16.953,593,310,243,67,283,216,67,58,0.11,0.0
1013,1244,2020-03-19 01:02:00,0,3426.0,3180.0,0.928,17.02,244,149,92,57,95,50,45,48,0.0,0.0
1013,1245,2020-03-19 01:05:00,0,3415.0,3207.0,0.939,17.007,283,138,75,63,145,79,66,55,0.0,0.0
1013,1246,2020-03-19 01:08:00,0,3464.0,3147.0,0.909,17.133,13,12,3,9,1,0,1,0,0.0,0.0
1013,1247,2020-03-19 01:11:00,0,3207.0,2966.0,0.925,15.918,48,15,0,15,33,1,32,0,0.0,0.0
1013,1248,2020-03-19 01:14:00,0,3153.0,2885.0,0.915,15.618,24,7,4,3,17,0,17,0,0.0,0.0
1013,1249,2020-03-19 01:17:00,0,2956.0,2741.0,0.927,14.683,44,25,2,23,19,1,18,0,0.0,0.0
1013,1250,2020-03-19 01:20:00,0,2834.0,2621.0,0.925,14.069,8,3,1,2,5,2,3,0,0.0,0.0
1013,1251,2020-03-19 01:23:00,0,2886.0,2665.0,0.923,14.323,6,0,0,0,6,1,5,0,0.0,0.0
1013,1252,2020-03-19 01:26:00,0,2904.0,2662.0,0.917,14.387,33,1,0,1,32,19,13,0,0.0,0.0
1013,1253,2020-03-19 01:29:00,0,2867.0,2644.0,0.922,14.224,25,3,2,1,22,13,9,0,0.0,0.0
1013,1254,2020-03-19 01:32:00,0,2875.0,2585.0,0.899,14.19,34,30,7,23,4,3,1,0,0.0,0.0
1013,1255,2020-03-19 01:35:00,0,2707.0,2508.0,0.927,13.442,132,51,14,37,81,45,36,28,0.0,0.0
1013,1256,2020-03-19 01:38:00,0,3126.0,2790.0,0.892,15.406,208,101,46,55,107,47,60,20,0.0,0.0
1013,1257,2020-03-19 01:41:00,0,3151.0,2870.0,0.911,15.592,432,222,161,61,210,142,68,48,0.26,0.0
1013,1258,2020-03-19 01:44:00,0,3090.0,2866.0,0.928,15.346,142,101,56,45,41,9,32,26,0.0,0.0
1013,1259,2020-03-19 01:47:00,0,3099.0,2901.0,0.936,15.422,192,51,19,32,141,90,51,10,0.0,0.0
1013,1260,2020-03-19 01:50:00,0,3300.0,3004.0,0.911,16.326,18,8,3,5,10,1,9,1,0.0,0.0
1013,1261,2020-03-19 01:53:00,0,3104.0,2745.0,0.884,15.271,0,0,0,0,0,0,0,0,0.0,0.0
1013,1262,2020-03-19 01:56:00,0,2859.0,2661.0,0.931,14.211,9,2,1,1,7,5,2,0,0.0,0.0
1013,1263,2020-03-19 01:59:00,0,2950.0,2696.0,0.914,14.607,8,7,1,6,1,0,1,0,0.0,0.0
1013,1264,2020-03-19 02:02:00,0,3092.0,2718.0,0.879,15.192,79,57,35,22,22,10,12,9,0.0,0.0
1013,1265,2020-03-19 02:05:00,0,3420.0,3008.0,0.88,16.806,140,102,64,38,38,5,33,87,0.0,0.14
1013,1266,2020-03-19 02:08:00,0,3490.0,3070.0,0.88,17.149,269,121,97,24,148,103,45,39,0.16,0.02
1013,1267,2020-03-19 02:11:00,0,3662.0,3235.0,0.883,18.01,271,122,93,29,149,97,52,30,0.03,0.0
1013,1268,2020-03-19 02:14:00,0,3432.0,3136.0,0.914,16.995,15,9,2,7,6,2,4,0,0.0,0.0
1013,1269,2020-03-19 02:17:00,0,3236.0,3039.0,0.939,16.114,29,12,9,3,17,12,5,0,0.0,0.0
1013,1270,2020-03-19 02:20:00,0,3122.0,2889.0,0.925,15.5,12,3,1,2,9,2,7,0,0.0,0.0
1013,1271,2020-03-19 02:23:00,0,3073.0,2829.0,0.921,15.239,0,0,0,0,0,0,0,0,0.0,0.0
1013,1272,2020-03-19 02:26:00,0,3226.0,2943.0,0.913,15.9675,22,8,5,3,14,7,7,0,0.0,0.0
1013,1273,2020-03-19 02:29:00,0,3379.0,3057.0,0.905,16.696,26,19,3,16,7,3,4,0,0.0,0.0
1013,1274,2020-03-19 02:32:00,0,3308.0,2967.0,0.897,16.32,7,3,1,2,4,2,2,0,0.0,0.0
1013,1275,2020-03-19 02:35:00,0,3333.0,3121.0,0.936,16.586,23,0,0,0,23,10,13,0,0.0,0.0
1013,1276,2020-03-19 02:38:00,0,3431.0,3142.0,0.916,16.995,153,103,65,38,50,26,24,27,0.0,0.0
1013,1277,2020-03-19 02:41:00,0,3797.0,3435.0,0.905,18.762,426,233,178,55,193,134,59,106,0.0,0.08
1013,1278,2020-03-19 02:44:00,0,3573.0,3283.0,0.919,17.711,242,120,92,28,122,87,35,37,0.23,0.0
1013,1279,2020-03-19 02:47:00,0,3624.0,3353.0,0.925,17.991,8,2,1,1,6,3,3,0,0.0,0.0
1013,1280,2020-03-19 02:50:00,0,3535.0,3251.0,0.92,17.528,4,1,0,1,3,1,2,3,0.0,0.01
1013,1281,2020-03-19 02:53:00,0,3289.0,3057.0,0.93,16.343,10,10,1,9,0,0,0,0,0.0,0.0
1013,1282,2020-03-19 02:56:00,0,3227.0,3013.0,0.934,16.049,36,17,6,11,19,11,8,0,0.0,0.0
1013,1283,2020-03-19 02:59:00,0,3135.0,2965.0,0.946,15.634,44,21,11,10,23,15,8,0,0.0,0.0
1013,1284,2020-03-19 03:02:00,0,3493.0,3195.0,0.915,17.299,232,159,110,49,73,34,39,56,0.0,0.04
1013,1285,2020-03-19 03:05:00,0,3823.0,3486.0,0.912,18.924,146,100,63,37,46,21,25,52,0.0,0.03
1013,1286,2020-03-19 03:08:00,0,3846.0,3533.0,0.919,19.065,377,237,169,68,140,82,58,84,0.42,0.0
1013,1287,2020-03-19 03:11:00,0,3892.0,3614.0,0.929,19.335,263,133,97,36,130,95,35,32,0.0,0.03
1013,1288,2020-03-19 03:14:00,0,3529.0,3224.0,0.913,17.474,449,226,167,59,223,152,71,41,0.0,0.0
1013,1289,2020-03-19 03:17:00,0,3690.0,3452.0,0.935,18.359,432,194,138,56,238,178,60,41,0.0,0.0
1013,1290,2020-03-19 03:20:00,0,3708.0,3396.0,0.916,18.369,457,173,120,53,284,206,78,18,0.0,0.0
1013,1291,2020-03-19 03:23:00,0,3706.0,3356.0,0.906,18.318,281,111,64,47,170,100,70,51,0.0,0.0
1013,1292,2020-03-19 03:26:00,0,3767.0,3365.0,0.893,18.569,264,100,52,48,164,102,62,10,0.0,0.0
1013,1293,2020-03-19 03:29:00,0,3500.0,3253.0,0.929,17.392,88,46,21,25,42,22,20,0,0.0,0.0
1013,1294,2020-03-19 03:32:00,0,3361.0,3029.0,0.901,16.595,20,11,2,9,9,0,9,0,0.0,0.0
1013,1295,2020-03-19 03:35:00,0,3174.0,2841.0,0.895,15.65,18,11,4,7,7,0,7,0,0.0,0.0
1013,1296,2020-03-19 03:38:00,0,2954.0,2693.0,0.912,14.62,10,7,0,7,3,0,3,0,0.0,0.0
1013,1297,2020-03-19 03:41:00,0,2989.0,2715.0,0.908,14.78,0,0,0,0,0,0,0,0,0.0,0.0
1013,1298,2020-03-19 03:44:00,0,2969.0,2693.0,0.907,14.678,39,20,12,8,19,14,5,0,0.0,0.0
1013,1299,2020-03-19 03:47:00,0,2946.0,2703.0,0.917,14.599,21,10,3,7,11,1,10,0,0.0,0.0
1013,1300,2020-03-19 03:50:00,0,3207.0,2822.0,0.88,15.76,145,39,15,24,106,58,48,9,0.0,0.0
1013,1301,2020-03-19 03:53:00,0,3272.0,2926.0,0.894,16.132,177,78,41,37,99,50,49,21,0.0,0.0
1013,1302,2020-03-19 03:56:00,0,3361.0,3035.0,0.903,16.604,293,153,109,44,140,93,47,49,0.0,0.0
1013,1303,2020-03-19 03:59:00,0,3330.0,2984.0,0.896,16.426,14,7,6,1,7,5,2,0,0.0,0.0
1013,1304,2020-03-19 04:02:00,0,3212.0,2850.0,0.887,15.811,21,6,2,4,15,8,7,0,0.0,0.0
1013,1305,2020-03-19 04:05:00,0,3246.0,2817.0,0.868,15.909,77,41,23,18,36,17,19,0,0.0,0.0
1013,1306,2020-03-19 04:08:00,0,3232.0,2893.0,0.895,15.936,108,67,56,11,41,30,11,13,0.0,0.0
1013,1307,2020-03-19 04:11:00,0,3390.0,2896.0,0.854,16.565,7,7,0,7,0,0,0,0,0.0,0.0
1013,1308,2020-03-19 04:14:00,0,3387.0,2907.0,0.858,16.565,42,16,10,6,26,21,5,0,0.0,0.0
1013,1309,2020-03-19 04:17:00,0,3378.0,2865.0,0.848,16.483,95,24,14,10,71,27,44,6,0.0,0.0
1013,1310,2020-03-19 04:20:00,0,3405.0,2893.0,0.85,16.62,101,27,12,15,74,38,36,14,0.0,0.0
1013,1311,2020-03-19 04:23:00,0,3474.0,3033.0,0.873,17.045,369,166,111,55,203,145,58,66,0.0,0.0
1013,1312,2020-03-19 04:26:00,0,3693.0,3202.0,0.867,18.097,591,350,293,57,241,183,58,179,0.05,0.0
1013,1313,2020-03-19 04:29:00,0,3742.0,3203.0,0.856,18.291,670,375,303,72,295,233,62,132,0.03,0.0
1013,1314,2020-03-19 04:32:00,0,3812.0,3204.0,0.84,18.566,446,169,119,50,277,207,70,82,0.0,0.0
1013,1315,2020-03-19 04:35:00,0,3236.0,2643.0,0.816,15.677,262,112,68,44,150,102,48,36,0.0,0.0
1013,1316,2020-03-19 04:38:00,0,3511.0,2995.0,0.853,17.15,219,86,53,33,133,75,58,0,0.0,0.0
1013,1317,2020-03-19 04:41:00,0,3479.0,2902.0,0.834,16.919,82,9,7,2,73,15,58,0,0.0,0.0
1013,1318,2020-03-19 04:44:00,0,3523.0,2919.0,0.829,17.111,92,26,15,11,66,21,45,1,0.0,0.0
1013,1319,2020-03-19 04:47:00,0,3278.0,2728.0,0.832,15.934,22,9,4,5,13,1,12,0,0.0,0.0
1013,1320,2020-03-19 04:50:00,0,3252.0,2646.0,0.814,15.743,3,1,0,1,2,0,2,0,0.0,0.0
1013,1321,2020-03-19 04:53:00,0,3352.0,2752.0,0.821,16.255,13,5,2,3,8,6,2,0,0.0,0.0
1013,1322,2020-03-19 04:56:00,0,3193.0,2681.0,0.839,15.55,108,27,13,14,81,43,38,13,0.0,0.0
1013,1323,2020-03-19 04:59:00,0,3394.0,2755.0,0.812,16.424,362,183,118,65,179,115,64,47,0.0,0.0
1013,1324,2020-03-19 05:02:00,0,3381.0,2771.0,0.82,16.39,160,93,62,31,67,39,28,21,0.23,0.0
1013,1325,2020-03-19 05:05:00,0,3204.0,2570.0,0.802,15.467,192,65,37,28,127,74,53,10,0.0,0.0
1013,1326,2020-03-19 05:08:00,0,3413.0,2838.0,0.832,16.588,23,10,2,8,13,4,9,0,0.0,0.0
1013,1327,2020-03-19 05:11:00,0,3263.0,2627.0,0.805,15.765,26,11,4,7,15,4,11,0,0.0,0.0
1013,1328,2020-03-19 05:14:00,0,3064.0,2516.0,0.821,14.859,47,32,15,17,15,8,7,0,0.0,0.0
1013,1329,2020-03-19 05:17:00,0,3081.0,2511.0,0.815,14.919,12,7,5,2,5,4,1,0,0.0,0.0
1013,1330,2020-03-19 05:20:00,0,3124.0,2552.0,0.817,15.135,214,97,64,33,117,68,49,5,0.0,0.0
1013,1331,2020-03-19 05:23:00,0,3038.0,2516.0,0.828,14.756,27,4,0,4,23,12,11,0,0.0,0.0
1013,1332,2020-03-19 05:26:00,0,3243.5,2642.0,0.8155,15.7055,83,36,24,12,47,32,15,7,0.0,0.0
1013,1333,2020-03-19 05:29:00,0,3449.0,2768.0,0.803,16.655,199,140,90,50,59,25,34,104,0.0,0.1
1013,1334,2020-03-19 05:32:00,0,3467.0,2825.0,0.815,16.788,485,258,199,59,227,155,72,73,0.32,0.03
1013,1335,2020-03-19 05:35:00,0,3404.0,2781.0,0.817,16.491,432,155,108,47,277,202,75,49,0.0,0.0
1013,1336,2020-03-19 05:38:00,0,3570.0,2942.0,0.824,17.325,722,321,256,65,401,303,98,56,0.0,0.0
1013,1337,2020-03-19 05:41:00,0,3570.0,2965.0,0.831,17.347,426,240,177,63,186,122,64,85,0.0,0.0
1013,1338,2020-03-19 05:44:00,0,3528.0,2999.0,0.85,17.223,260,106,73,33,154,104,50,10,0.0,0.0
1013,1339,2020-03-19 05:47:00,0,3597.0,3032.0,0.843,17.528,142,65,36,29,77,37,40,17,0.0,0.0
1013,1340,2020-03-19 05:50:00,0,3417.0,2975.0,0.871,16.756,100,73,37,36,27,11,16,0,0.0,0.0
1013,1341,2020-03-19 05:53:00,0,3219.0,2817.0,0.875,15.801,10,6,0,6,4,2,2,0,0.0,0.0
1013,1342,2020-03-19 05:56:00,0,2951.0,2648.0,0.897,14.558,10,9,5,4,1,1,0,0,0.0,0.0
1013,1343,2020-03-19 05:59:00,0,2934.0,2550.0,0.869,14.382,14,5,2,3,9,6,3,0,0.0,0.0
1013,1344,2020-03-19 06:02:00,1,2965.0,2658.0,0.896,14.624,312,133,102,31,179,117,62,13,0.0,0.0
1013,1345,2020-03-19 06:05:00,1,3172.0,2806.0,0.885,15.602,267,149,105,44,118,64,54,20,0.0,0.0
1013,1346,2020-03-19 06:08:00,1,3354.0,2911.0,0.868,16.437,51,30,18,12,21,12,9,2,0.0,0.0
1013,1347,2020-03-19 06:11:00,1,3079.0,2672.0,0.868,15.09,1,1,1,0,0,0,0,0,0.0,0.0
1013,1348,2020-03-19 06:14:00,1,2992.0,2642.0,0.883,14.713,2,2,1,1,0,0,0,0,0.0,0.0
1013,1349,2020-03-19 06:17:00,1,3083.0,2611.0,0.847,15.039,6,4,2,2,2,0,2,0,0.0,0.0
1013,1350,2020-03-19 06:20:00,1,2971.0,2492.0,0.839,14.466,20,13,6,7,7,2,5,0,0.0,0.0
1013,1351,2020-03-19 06:23:00,1,2998.0,2533.0,0.845,14.617,38,7,4,3,31,7,24,0,0.0,0.0
1013,1352,2020-03-19 06:26:00,1,3008.0,2569.0,0.854,14.695,35,17,9,8,18,8,10,0,0.0,0.0
1013,1353,2020-03-19 06:29:00,1,3234.0,2611.0,0.807,15.631,259,94,50,44,165,98,67,13,0.0,0.0
1013,1354,2020-03-19 06:32:00,1,3350.0,2782.0,0.83,16.28,257,166,116,50,91,59,32,34,0.0,0.0
1013,1355,2020-03-19 06:35:00,1,3319.0,2743.0,0.827,16.114,92,58,37,21,34,20,14,0,0.0,0.0
1013,1356,2020-03-19 06:38:00,1,3131.0,2572.0,0.822,15.183,11,9,5,4,2,1,1,0,0.0,0.0
1013,1357,2020-03-19 06:41:00,1,3032.0,2474.0,0.816,14.684,18,13,5,8,5,4,1,0,0.0,0.0
1013,1358,2020-03-19 06:44:00,1,3017.0,2360.0,0.782,14.498,8,5,2,3,3,2,1,0,0.0,0.0
1013,1359,2020-03-19 06:47:00,1,3041.0,2398.0,0.789,14.636,119,64,56,8,55,40,15,12,0.0,0.0
1013,1360,2020-03-19 06:50:00,1,2975.0,2357.0,0.792,14.333,32,1,1,0,31,6,25,0,0.0,0.0
1013,1361,2020-03-19 06:53:00,1,2857.0,2271.0,0.795,13.77,31,5,1,4,26,8,18,0,0.0,0.0
1013,1362,2020-03-19 06:56:00,1,2900.0,2267.0,0.782,13.935,20,7,1,6,13,9,4,0,0.0,0.0
1013,1363,2020-03-19 06:59:00,1,2895.0,2243.0,0.775,13.889,28,14,6,8,14,10,4,0,0.0,0.0
1013,1364,2020-03-19 07:02:00,1,2912.0,2274.0,0.781,13.992,19,12,7,5,7,5,2,0,0.0,0.0
1013,1365,2020-03-19 07:05:00,1,2979.0,2270.0,0.762,14.252,40,10,4,6,30,22,8,0,0.0,0.0
1013,1366,2020-03-19 07:08:00,1,3045.0,2289.0,0.752,14.532,124,11,5,6,113,66,47,11,0.0,0.0
1013,1367,2020-03-19 07:11:00,1,3013.0,2399.0,0.796,14.527,284,134,81,53,150,94,56,38,0.0,0.0
1013,1368,2020-03-19 07:14:00,1,3385.0,2651.0,0.783,16.271,361,201,146,55,160,120,40,18,0.18,0.0
1013,1369,2020-03-19 07:17:00,1,3285.0,2624.0,0.799,15.846,272,122,66,56,150,101,49,52,0.0,0.0
1013,1370,2020-03-19 07:20:00,1,3327.0,2525.0,0.759,15.905,413,229,160,69,184,114,70,4,0.0,0.0
1013,1371,2020-03-19 07:23:00,1,2995.0,2392.0,0.799,14.451,297,178,124,54,119,82,37,6,0.0,0.0
1013,1372,2020-03-19 07:26:00,1,3140.0,2435.0,0.776,15.067,282,140,107,33,142,75,67,12,0.0,0.0
1013,1373,2020-03-19 07:29:00,1,3043.0,2376.0,0.781,14.62,59,13,0,13,46,2,44,0,0.0,0.0
1013,1374,2020-03-19 07:32:00,1,2988.0,2284.0,0.764,14.303,83,34,6,28,49,9,40,2,0.0,0.0
1013,1375,2020-03-19 07:35:00,1,2866.0,2215.0,0.773,13.745,7,6,0,6,1,0,1,0,0.0,0.0
1013,1376,2020-03-19 07:38:00,1,2790.0,2129.0,0.763,13.351,2,0,0,0,2,0,2,0,0.0,0.0
1013,1377,2020-03-19 07:41:00,1,2592.0,1958.0,0.755,12.382,4,0,0,0,4,0,4,0,0.0,0.0
1013,1378,2020-03-19 07:44:00,1,2533.0,1861.0,0.735,12.04,3,0,0,0,3,0,3,0,0.0,0.0
1013,1379,2020-03-19 07:47:00,1,2493.0,1884.0,0.756,11.907,6,3,0,3,3,0,3,0,0.0,0.0
1013,1380,2020-03-19 07:50:00,1,2666.0,1946.0,0.73,12.658,0,0,0,0,0,0,0,0,0.0,0.0
1013,1381,2020-03-19 07:53:00,1,2612.0,1924.0,0.736,12.421,9,7,0,7,2,0,2,0,0.0,0.0
1013,1382,2020-03-19 07:56:00,1,2596.0,1936.0,0.746,12.371,4,4,0,4,0,0,0,0,0.0,0.0
1013,1383,2020-03-19 07:59:00,1,2444.0,1836.0,0.751,11.664,2,1,0,1,1,0,1,0,0.0,0.0
1013,1384,2020-03-19 08:02:00,1,2545.0,1813.0,0.713,12.035,113,40,21,19,73,41,32,4,0.0,0.0
1013,1385,2020-03-19 08:05:00,1,2773.0,2051.0,0.74,13.196,154,31,12,19,123,63,60,10,0.0,0.0
1013,1386,2020-03-19 08:08:00,1,2746.0,2036.0,0.741,13.073,28,16,4,12,12,5,7,0,0.0,0.0
1013,1387,2020-03-19 08:11:00,1,2712.0,1969.0,0.726,12.864,14,3,3,0,11,5,6,0,0.0,0.0
1013,1388,2020-03-19 08:14:00,1,2784.0,1994.0,0.716,13.178,111,61,44,17,50,30,20,30,0.0,0.0
1013,1389,2020-03-19 08:17:00,1,3297.0,2484.0,0.753,15.741,277,94,51,43,183,148,35,48,0.14,0.11
1013,1390,2020-03-19 08:20:00,1,3133.0,2360.0,0.753,14.959,61,41,16,25,20,12,8,0,0.0,0.0
1013,1391,2020-03-19 08:23:00,1,3092.0,2295.0,0.742,14.723,35,16,9,7,19,5,14,0,0.0,0.0
1013,1392,2020-03-19 08:26:00,1,2896.5,2195.0,0.759,13.8425,18,13,3,10,5,1,4,0,0.0,0.0
1013,1393,2020-03-19 08:29:00,1,2701.0,2095.0,0.776,12.962,42,38,0,38,4,2,2,0,0.0,0.0
1013,1394,2020-03-19 08:32:00,1,2885.0,2366.0,0.82,13.986,10,5,0,5,5,2,3,0,0.0,0.0
1013,1395,2020-03-19 08:35:00,1,3040.0,2547.0,0.838,14.796,38,28,6,22,10,6,4,0,0.0,0.0
1013,1396,2020-03-19 08:38:00,1,3057.0,2635.0,0.862,14.96,49,38,24,14,11,6,5,0,0.0,0.0
1013,1397,2020-03-19 08:41:00,1,2986.0,2571.0,0.861,14.612,19,19,3,16,0,0,0,0,0.0,0.0
1013,1398,2020-03-19 08:44:00,1,3011.0,2563.0,0.851,14.7,49,23,10,13,26,18,8,0,0.0,0.0
1013,1399,2020-03-19 08:47:00,1,2867.0,2464.0,0.86,14.023,11,6,2,4,5,3,2,0,0.0,0.0
1013,1400,2020-03-19 08:50:00,1,2840.0,2398.0,0.845,13.845,18,6,2,4,12,7,5,0,0.0,0.0
1013,1401,2020-03-19 08:53:00,1,2990.0,2533.0,0.847,14.586,137,42,10,32,95,56,39,22,0.0,0.0
1013,1402,2020-03-19 08:56:00,1,3321.0,2722.0,0.82,16.096,257,181,135,46,76,44,32,56,0.0,0.01
1013,1403,2020-03-19 08:59:00,1,3467.0,2918.0,0.841,16.892,330,185,134,51,145,96,49,18,0.24,0.0
1013,1404,2020-03-19 09:02:00,1,3241.0,2789.0,0.861,15.857,265,149,89,60,116,64,52,10,0.0,0.0
1013,1405,2020-03-19 09:05:00,1,3281.0,2718.0,0.828,15.936,390,194,130,64,196,130,66,11,0.0,0.0
1013,1406,2020-03-19 09:08:00,1,3233.0,2698.0,0.834,15.725,439,218,173,45,221,160,61,15,0.0,0.0
1013,1407,2020-03-19 09:11:00,1,3003.0,2606.0,0.868,14.719,9,7,2,5,2,1,1,0,0.0,0.0
1013,1408,2020-03-19 09:14:00,1,2887.0,2429.0,0.841,14.063,15,12,0,12,3,2,1,0,0.0,0.0
1013,1409,2020-03-19 09:17:00,1,2854.0,2302.0,0.807,13.794,5,2,0,2,3,2,1,0,0.0,0.0
1013,1410,2020-03-19 09:20:00,1,2797.0,2281.0,0.816,13.544,34,13,9,4,21,8,13,0,0.0,0.0
1013,1411,2020-03-19 09:23:00,1,2658.0,2156.0,0.811,12.859,6,0,0,0,6,1,5,0,0.0,0.0
1013,1412,2020-03-19 09:26:00,1,2763.0,2214.0,0.801,13.336,6,3,3,0,3,0,3,0,0.0,0.0
1013,1413,2020-03-19 09:29:00,1,2699.0,2123.0,0.787,12.984,6,0,0,0,6,0,6,0,0.0,0.0
1013,1414,2020-03-19 09:32:00,1,2726.0,2093.0,0.768,13.056,5,4,1,3,1,0,1,0,0.0,0.0
1013,1415,2020-03-19 09:35:00,1,2750.0,2118.0,0.77,13.178,5,5,2,3,0,0,0,0,0.0,0.0
1013,1416,2020-03-19 09:38:00,1,2684.0,2053.0,0.765,12.846,35,20,12,8,15,8,7,0,0.0,0.01
1013,1417,2020-03-19 09:41:00,1,2713.0,2084.0,0.768,12.998,33,0,0,0,33,1,32,0,0.0,0.0
1013,1418,2020-03-19 09:44:00,1,2731.0,2075.0,0.76,13.059,157,49,23,26,108,46,62,21,0.0,0.0
1013,1419,2020-03-19 09:47:00,1,3113.0,2368.0,0.761,14.888,142,79,31,48,63,30,33,12,0.0,0.0
1013,1420,2020-03-19 09:50:00,1,3021.0,2421.0,0.801,14.583,258,167,115,52,91,53,38,22,0.0,0.0
1013,1421,2020-03-19 09:53:00,1,3030.0,2426.0,0.801,14.625,148,99,49,50,49,12,37,3,0.0,0.0
1013,1422,2020-03-19 09:56:00,1,3049.0,2382.0,0.781,14.65,146,18,8,10,128,76,52,1,0.0,0.0
1013,1423,2020-03-19 09:59:00,1,2891.0,2270.0,0.785,13.904,20,14,8,6,6,4,2,0,0.0,0.0
1013,1424,2020-03-19 10:02:00,1,2774.0,2112.0,0.761,13.27,9,9,3,6,0,0,0,0,0.0,0.0
1013,1425,2020-03-19 10:05:00,1,2507.0,1929.0,0.769,12.014,2,2,1,1,0,0,0,0,0.0,0.0
1013,1426,2020-03-19 10:08:00,1,2448.0,1872.0,0.765,11.72,14,14,0,14,0,0,0,0,0.0,0.0
1013,1427,2020-03-19 10:11:00,1,2475.0,1822.0,0.736,11.771,8,8,0,8,0,0,0,0,0.0,0.0
1013,1428,2020-03-19 10:14:00,1,2451.0,1827.0,0.745,11.682,23,23,0,23,0,0,0,0,0.0,0.0
1013,1429,2020-03-19 10:17:00,1,2358.0,1764.0,0.748,11.244,2,2,0,2,0,0,0,0,0.0,0.0
1013,1430,2020-03-19 10:20:00,1,2532.0,1962.0,0.775,12.147,42,20,12,8,22,12,10,0,0.0,0.0
1013,1431,2020-03-19 10:23:00,1,2773.0,2014.0,0.727,13.154,0,0,0,0,0,0,0,0,0.0,0.0
1013,1432,2020-03-19 10:26:00,1,2578.0,1988.0,0.771,12.361,0,0,0,0,0,0,0,0,0.0,0.0
1013,1433,2020-03-19 10:29:00,1,2473.0,1949.0,0.788,11.902,0,0,0,0,0,0,0,0,0.0,0.0
1013,1434,2020-03-19 10:32:00,1,2552.0,1968.0,0.771,12.234,42,18,7,11,24,14,10,0,0.0,0.0
1013,1435,2020-03-19 10:35:00,1,2771.0,2084.0,0.752,13.226,2,2,0,2,0,0,0,0,0.0,0.0
1013,1436,2020-03-19 10:38:00,1,2772.0,2062.0,0.744,13.204,88,60,38,22,28,10,18,26,0.0,0.0
1013,1437,2020-03-19 10:41:00,1,3317.0,2540.0,0.766,15.88,110,67,31,36,43,3,40,77,0.0,0.18
1013,1438,2020-03-19 10:44:00,1,3681.0,2905.0,0.789,17.719,356,148,113,35,208,156,52,35,0.19,0.01
1013,1439,2020-03-19 10:47:00,1,3275.0,2588.0,0.79,15.769,555,269,214,55,286,202,84,40,0.02,0.0
1013,1440,2020-03-19 10:50:00,1,3275.0,2645.0,0.808,15.834,619,375,308,67,244,180,64,21,0.0,0.0
1013,1441,2020-03-19 10:53:00,1,3269.0,2697.0,0.825,15.864,839,496,411,85,343,256,87,59,0.0,0.01
1013,1442,2020-03-19 10:56:00,1,3194.0,2746.0,0.86,15.623,414,151,100,51,263,192,71,10,0.0,0.0
1013,1443,2020-03-19 10:59:00,1,3222.0,2786.0,0.865,15.781,531,207,146,61,324,252,72,17,0.0,0.0
1013,1444,2020-03-19 11:02:00,1,3225.0,2759.0,0.855,15.76,379,177,121,56,202,143,59,32,0.23,0.0
1013,1445,2020-03-19 11:05:00,1,3244.0,2794.0,0.861,15.877,532,349,265,84,183,115,68,20,0.0,0.0
1013,1446,2020-03-19 11:08:00,1,3135.0,2775.0,0.885,15.424,144,91,43,48,53,20,33,6,0.0,0.0
1013,1447,2020-03-19 11:11:00,1,3188.0,2802.0,0.879,15.664,102,75,31,44,27,10,17,6,0.0,0.0
1013,1448,2020-03-19 11:14:00,1,3111.0,2804.0,0.901,15.361,115,68,30,38,47,12,35,0,0.0,0.0
1013,1449,2020-03-19 11:17:00,1,2909.0,2672.0,0.918,14.419,129,129,69,60,0,0,0,0,0.0,0.0
1013,1450,2020-03-19 11:20:00,1,2767.0,2542.0,0.918,13.717,54,53,28,25,1,0,1,0,0.0,0.0
1013,1451,2020-03-19 11:23:00,1,2736.0,2453.0,0.897,13.497,12,11,6,5,1,1,0,0,0.0,0.0
1013,1452,2020-03-19 11:26:00,1,2618.0,2357.0,0.901,12.925,9,4,2,2,5,0,5,0,0.0,0.0
1013,1453,2020-03-19 11:29:00,1,2500.0,2261.0,0.905,12.353,16,13,0,13,3,2,1,0,0.0,0.0
1013,1454,2020-03-19 11:32:00,1,2751.0,2414.0,0.877,13.51,5,2,0,2,3,0,3,0,0.0,0.0
1013,1455,2020-03-19 11:35:00,1,2519.0,2316.0,0.92,12.488,1,0,0,0,1,1,0,0,0.0,0.0
1013,1456,2020-03-19 11:38:00,1,2436.0,2300.0,0.944,12.143,2,1,1,0,1,0,1,0,0.0,0.0
1013,1457,2020-03-19 11:41:00,1,2462.0,2225.0,0.904,12.163,31,1,0,1,30,1,29,0,0.0,0.0
1013,1458,2020-03-19 11:44:00,1,2416.0,2165.0,0.896,11.914,20,1,1,0,19,1,18,0,0.0,0.0
1013,1459,2020-03-19 11:47:00,1,2482.0,2140.0,0.862,12.15,8,4,2,2,4,1,3,0,0.0,0.0
1013,1460,2020-03-19 11:50:00,1,2413.0,2137.0,0.885,11.872,32,6,1,5,26,2,24,0,0.0,0.0
1013,1461,2020-03-19 11:53:00,1,2427.0,2122.0,0.874,11.914,78,57,13,44,21,10,11,0,0.0,0.0
1013,1462,2020-03-19 11:56:00,1,2401.0,2099.0,0.874,11.785,61,59,0,59,2,0,2,0,0.0,0.0
1013,1463,2020-03-19 11:59:00,1,2448.0,2180.0,0.89,12.059,218,144,85,59,74,48,26,10,0.0,0.0
1013,1464,2020-03-19 12:02:00,1,2655.0,2320.0,0.874,13.028,155,51,15,36,104,72,32,0,0.0,0.01
1013,1465,2020-03-19 12:05:00,1,2920.0,2418.0,0.828,14.181,201,135,81,54,66,25,41,11,0.0,0.0
1013,1466,2020-03-19 12:08:00,1,2890.0,2381.0,0.824,14.024,129,35,4,31,94,31,63,3,0.0,0.0
1013,1467,2020-03-19 12:11:00,1,2853.0,2385.0,0.836,13.883,45,20,11,9,25,8,17,0,0.0,0.0
1013,1468,2020-03-19 12:14:00,1,2701.0,2208.0,0.817,13.089,2,2,1,1,0,0,0,0,0.0,0.0
1013,1469,2020-03-19 12:17:00,1,2670.0,2149.0,0.805,12.9,6,5,2,3,1,0,1,0,0.0,0.0
1013,1470,2020-03-19 12:20:00,1,2637.0,2073.0,0.786,12.685,6,3,0,3,3,0,3,0,0.0,0.0
1013,1471,2020-03-19 12:23:00,1,2600.0,2074.0,0.798,12.54,7,5,1,4,2,0,2,0,0.0,0.0
1013,1472,2020-03-19 12:26:00,1,2463.0,1984.0,0.805,11.902,2,2,1,1,0,0,0,0,0.0,0.0
1013,1473,2020-03-19 12:29:00,1,2495.0,1966.0,0.788,12.005,0,0,0,0,0,0,0,0,0.0,0.0
1013,1474,2020-03-19 12:32:00,1,2467.0,1932.0,0.783,11.86,12,11,0,11,1,0,1,0,0.0,0.0
1013,1475,2020-03-19 12:35:00,1,2458.0,1928.0,0.784,11.82,10,4,0,4,6,1,5,0,0.0,0.0
1013,1476,2020-03-19 12:38:00,1,2458.0,1935.0,0.787,11.828,8,4,1,3,4,1,3,0,0.0,0.0
1013,1477,2020-03-19 12:41:00,1,2511.0,1944.0,0.774,12.045,7,7,1,6,0,0,0,0,0.0,0.0
1013,1478,2020-03-19 12:44:00,1,2473.0,1984.0,0.802,11.941,23,15,7,8,8,7,1,0,0.0,0.0
1013,1479,2020-03-19 12:47:00,1,2488.0,1932.0,0.777,11.941,30,6,5,1,24,8,16,0,0.0,0.0
1013,1480,2020-03-19 12:50:00,1,2426.0,1892.0,0.78,11.654,68,17,4,13,51,10,41,0,0.0,0.0
1013,1481,2020-03-19 12:53:00,1,2505.0,1910.0,0.762,11.985,26,13,4,9,13,4,9,0,0.0,0.0
1013,1482,2020-03-19 12:56:00,1,2542.0,1948.0,0.766,12.174,164,61,33,28,103,53,50,9,0.0,0.0
1013,1483,2020-03-19 12:59:00,1,2890.0,2196.0,0.76,13.818,160,97,59,38,63,21,42,5,0.0,0.0
1013,1484,2020-03-19 13:02:00,1,2904.0,2338.0,0.805,14.029,173,85,48,37,88,45,43,6,0.0,0.0
1013,1485,2020-03-19 13:05:00,1,3003.0,2446.0,0.815,14.539,199,129,79,50,70,26,44,72,0.0,0.1
1013,1486,2020-03-19 13:08:00,1,3256.0,2658.0,0.816,15.773,367,213,159,54,154,109,45,50,0.03,0.06
1013,1487,2020-03-19 13:11:00,1,3418.0,2726.0,0.798,16.486,369,215,174,41,154,116,38,28,0.0,0.0
1013,1488,2020-03-19 13:14:00,1,3267.0,2574.0,0.788,15.724,879,518,449,69,361,282,79,65,0.0,0.03
1013,1489,2020-03-19 13:17:00,1,3307.0,2768.0,0.837,16.094,558,259,196,63,299,217,82,37,0.0,0.14
1013,1490,2020-03-19 13:20:00,1,3261.0,2753.0,0.844,15.898,458,265,194,71,193,119,74,1,0.0,0.0
1013,1491,2020-03-19 13:23:00,1,3203.0,2755.0,0.86,15.669,876,390,304,86,486,408,78,35,0.06,0.0
1013,1492,2020-03-19 13:26:00,1,3175.0,2784.0,0.877,15.59,442,242,172,70,200,156,44,43,0.0,0.0
1013,1493,2020-03-19 13:29:00,1,3275.0,2813.0,0.859,16.016,305,151,113,38,154,103,51,14,0.0,0.0
1013,1494,2020-03-19 13:32:00,1,3046.0,2711.0,0.89,15.003,19,15,0,15,4,0,4,0,0.0,0.0
1013,1495,2020-03-19 13:35:00,1,2966.0,2724.0,0.918,14.701,97,60,24,36,37,5,32,1,0.0,0.0
1013,1496,2020-03-19 13:38:00,1,2932.0,2666.0,0.909,14.505,4,2,0,2,2,0,2,0,0.0,0.0
1013,1497,2020-03-19 13:41:00,1,2885.0,2578.0,0.893,14.223,484,240,168,72,244,171,73,6,0.0,0.0
1013,1498,2020-03-19 13:44:00,1,2971.0,2619.0,0.882,14.606,265,108,65,43,157,103,54,0,0.0,0.0
1013,1499,2020-03-19 13:47:00,1,3026.0,2621.0,0.866,14.824,6,2,0,2,4,1,3,0,0.0,0.0
1013,1500,2020-03-19 13:50:00,1,2705.0,2438.0,0.901,13.355,0,0,0,0,0,0,0,0,0.0,0.0
1013,1501,2020-03-19 13:53:00,1,2660.0,2239.0,0.842,12.958,1,1,1,0,0,0,0,0,0.0,0.0
1013,1502,2020-03-19 13:56:00,1,2725.0,2262.0,0.83,13.241,7,3,0,3,4,2,2,0,0.0,0.0
1013,1503,2020-03-19 13:59:00,1,2540.0,2190.0,0.862,12.432,19,12,3,9,7,4,3,0,0.0,0.0
1013,1504,2020-03-19 14:02:00,1,2425.0,2096.0,0.864,11.877,19,1,0,1,18,1,17,0,0.0,0.0
1013,1505,2020-03-19 14:05:00,1,2446.0,2121.0,0.867,11.984,28,0,0,0,28,0,28,0,0.0,0.0
1013,1506,2020-03-19 14:08:00,1,2444.0,2113.0,0.865,11.969,34,0,0,0,34,0,34,0,0.0,0.0
1013,1507,2020-03-19 14:11:00,1,2501.0,2057.0,0.822,12.132,52,20,14,6,32,16,16,0,0.0,0.0
1013,1508,2020-03-19 14:14:00,1,2473.0,2105.0,0.851,12.073,1,0,0,0,1,0,1,0,0.0,0.0
1013,1509,2020-03-19 14:17:00,1,2432.0,2081.0,0.856,11.887,4,2,0,2,2,0,2,0,0.0,0.0
1013,1510,2020-03-19 14:20:00,1,2447.0,2105.0,0.86,11.971,217,105,70,35,112,62,50,8,0.03,0.0
1013,1511,2020-03-19 14:23:00,1,3221.0,2701.0,0.838,15.682,494,268,205,63,226,171,55,55,0.0,0.0
1013,1512,2020-03-19 14:26:00,1,3312.5,2684.5,0.811,16.024,263,119,74,45,144,100,44,37,0.0,0.0
1013,1513,2020-03-19 14:29:00,1,3404.0,2668.0,0.784,16.366,133,74,27,47,59,8,51,0,0.0,0.0
1013,1514,2020-03-19 14:32:00,1,3359.0,2644.0,0.787,16.164,94,48,11,37,46,3,43,0,0.0,0.0
1013,1515,2020-03-19 14:35:00,1,3280.0,2591.0,0.79,15.794,129,75,37,38,54,22,32,0,0.0,0.0
1013,1516,2020-03-19 14:38:00,1,3184.0,2463.0,0.774,15.272,59,6,1,5,53,29,24,0,0.0,0.0
1013,1517,2020-03-19 14:41:00,1,3078.0,2378.0,0.773,14.761,5,3,1,2,2,1,1,0,0.0,0.0
1013,1518,2020-03-19 14:44:00,1,3031.0,2263.0,0.747,14.448,19,3,0,3,16,6,10,0,0.0,0.0
1013,1519,2020-03-19 14:47:00,1,3085.0,2279.0,0.739,14.678,34,0,0,0,34,0,34,0,0.0,0.0
1013,1520,2020-03-19 14:50:00,1,2891.0,2185.0,0.756,13.808,31,11,6,5,20,9,11,0,0.0,0.0
1013,1521,2020-03-19 14:53:00,1,2908.0,2143.0,0.737,13.832,9,0,0,0,9,5,4,0,0.0,0.0
1013,1522,2020-03-19 14:56:00,1,2928.0,2198.0,0.751,13.97,26,0,0,0,26,5,21,0,0.0,0.0
1013,1523,2020-03-19 14:59:00,1,2863.0,2117.0,0.739,13.626,34,0,0,0,34,0,34,0,0.0,0.0
1013,1524,2020-03-19 15:02:00,1,3101.0,2254.0,0.727,14.715,26,4,1,3,22,0,22,0,0.0,0.0
1013,1525,2020-03-19 15:05:00,1,2924.0,2207.0,0.755,13.963,15,5,0,5,10,0,10,0,0.0,0.0
1013,1526,2020-03-19 15:08:00,1,3056.0,2239.0,0.732,14.52,53,26,14,12,27,14,13,0,0.0,0.0
1013,1527,2020-03-19 15:11:00,1,3234.0,2364.0,0.731,15.36,227,141,99,42,86,58,28,66,0.0,0.0
1013,1528,2020-03-19 15:14:00,1,3873.0,2818.0,0.728,18.38,169,95,61,34,74,52,22,41,0.0,0.0
1013,1529,2020-03-19 15:17:00,1,3417.0,2595.0,0.76,16.335,0,0,0,0,0,0,0,0,0.0,0.01
1013,1530,2020-03-19 15:20:00,1,3295.0,2474.0,0.751,15.722,0,0,0,0,0,0,0,0,0.0,0.0
1013,1531,2020-03-19 15:23:00,1,3065.0,2438.0,0.795,14.774,3,1,0,1,2,0,2,0,0.0,0.0
1013,1532,2020-03-19 15:26:00,1,3061.0,2433.0,0.795,14.755,18,1,0,1,17,11,6,0,0.0,0.0
1013,1533,2020-03-19 15:29:00,1,3052.0,2448.0,0.802,14.736,3,0,0,0,3,1,2,0,0.0,0.01
1013,1534,2020-03-19 15:32:00,1,2918.0,2442.0,0.837,14.201,8,4,2,2,4,2,2,0,0.0,0.0
1013,1535,2020-03-19 15:35:00,1,3008.0,2537.0,0.843,14.659,35,11,8,3,24,16,8,2,0.0,0.0
1013,1536,2020-03-19 15:38:00,1,2968.0,2523.0,0.85,14.488,0,0,0,0,0,0,0,0,0.0,0.0
1013,1537,2020-03-19 15:41:00,1,3258.0,2786.0,0.855,15.92,201,139,93,46,62,22,40,78,0.0,0.05
1013,1538,2020-03-19 15:44:00,1,3832.0,3381.0,0.882,18.842,178,89,64,25,89,51,38,21,0.25,0.12
1013,1539,2020-03-19 15:47:00,1,3430.0,3072.0,0.896,16.914,76,41,11,30,35,18,17,17,0.0,0.0
1013,1540,2020-03-19 15:50:00,1,3419.0,3126.0,0.915,16.93,342,154,116,38,188,131,57,26,0.0,0.0
1013,1541,2020-03-19 15:53:00,1,3504.0,3177.0,0.907,17.322,498,254,197,57,244,188,56,32,0.0,0.0
1013,1542,2020-03-19 15:56:00,1,3469.0,3144.0,0.906,17.147,526,233,147,86,293,218,75,13,0.0,0.0
1013,1543,2020-03-19 15:59:00,1,3413.0,3141.0,0.92,16.925,168,60,34,26,108,62,46,15,0.0,0.0
1013,1544,2020-03-19 16:02:00,1,3538.0,3202.0,0.905,17.486,117,24,4,20,93,36,57,0,0.0,0.0
1013,1545,2020-03-19 16:05:00,1,3495.0,3166.0,0.906,17.275,142,62,27,35,80,40,40,0,0.0,0.0
1013,1546,2020-03-19 16:08:00,1,3315.0,3069.0,0.926,16.46,76,41,25,16,35,19,16,1,0.0,0.0
1013,1547,2020-03-19 16:11:00,1,3145.0,2846.0,0.905,15.544,0,0,0,0,0,0,0,0,0.0,0.0
1013,1548,2020-03-19 16:14:00,1,2980.0,2680.0,0.899,14.706,3,1,1,0,2,0,2,0,0.0,0.0
1013,1549,2020-03-19 16:17:00,1,3001.0,2635.0,0.878,14.741,2,2,0,2,0,0,0,0,0.0,0.0
1013,1550,2020-03-19 16:20:00,1,2866.0,2507.0,0.875,14.069,0,0,0,0,0,0,0,0,0.0,0.0
1013,1551,2020-03-19 16:23:00,1,2624.0,2412.0,0.919,13.009,4,2,1,1,2,0,2,0,0.0,0.0
1013,1552,2020-03-19 16:26:00,1,2609.0,2369.0,0.908,12.904,29,3,0,3,26,8,18,0,0.0,0.0
1013,1553,2020-03-19 16:29:00,1,2641.0,2326.0,0.881,12.981,93,64,50,14,29,18,11,27,0.0,0.0
1013,1554,2020-03-19 16:32:00,1,3196.0,2828.0,0.885,15.724,116,92,43,49,24,5,19,58,0.0,0.21
1013,1555,2020-03-19 16:35:00,1,3236.0,2798.0,0.865,15.846,127,69,49,20,58,34,24,17,0.39,0.0
1013,1556,2020-03-19 16:38:00,1,2964.0,2660.0,0.897,14.623,10,5,3,2,5,1,4,0,0.0,0.0
1013,1557,2020-03-19 16:41:00,1,2976.0,2615.0,0.879,14.619,10,6,2,4,4,1,3,0,0.0,0.0
1013,1558,2020-03-19 16:44:00,1,3029.0,2675.0,0.883,14.896,16,6,3,3,10,5,5,0,0.0,0.0
1013,1559,2020-03-19 16:47:00,1,2965.0,2672.0,0.901,14.642,3,3,1,2,0,0,0,0,0.0,0.0
1013,1560,2020-03-19 16:50:00,1,2940.0,2743.0,0.933,14.619,43,23,13,10,20,12,8,0,0.0,0.0
1013,1561,2020-03-19 16:53:00,1,3031.0,2817.0,0.929,15.063,24,7,4,3,17,9,8,0,0.0,0.0
1013,1562,2020-03-19 16:56:00,1,2979.0,2763.0,0.927,14.797,0,0,0,0,0,0,0,0,0.0,0.0
1013,1563,2020-03-19 16:59:00,1,2871.0,2677.0,0.932,14.277,5,0,0,0,5,3,2,0,0.0,0.0
1013,1564,2020-03-19 17:02:00,1,2797.0,2655.0,0.949,13.96,46,18,11,7,28,14,14,0,0.0,0.0
1013,1565,2020-03-19 17:05:00,1,2949.0,2822.0,0.957,14.742,170,33,7,26,137,67,70,5,0.0,0.0
1013,1566,2020-03-19 17:08:00,1,3207.0,2950.0,0.92,15.9,195,91,54,37,104,66,38,10,0.0,0.33
1013,1567,2020-03-19 17:11:00,1,3271.0,3036.0,0.928,16.248,77,44,6,38,33,16,17,0,0.0,0.0
1013,1568,2020-03-19 17:14:00,1,3391.0,3155.0,0.931,16.852,32,0,0,0,32,2,30,10,0.0,0.0
1013,1569,2020-03-19 17:17:00,1,3360.0,3153.0,0.938,16.729,211,98,61,37,113,71,42,13,0.0,0.0
1013,1570,2020-03-19 17:20:00,1,3409.0,3200.0,0.939,16.973,463,259,209,50,204,145,59,44,0.0,0.02
1013,1571,2020-03-19 17:23:00,1,3479.0,3264.0,0.938,17.323,653,315,237,78,338,254,84,17,0.0,0.0
1013,1572,2020-03-19 17:26:00,1,3445.5,3224.5,0.936,17.1455,672,371,305,66,301,233,68,50,0.0,0.01
1013,1573,2020-03-19 17:29:00,1,3412.0,3185.0,0.934,16.968,248,128,83,45,120,69,51,13,0.0,0.0
1013,1574,2020-03-19 17:32:00,1,3461.0,3220.0,0.93,17.202,513,255,195,60,258,183,75,9,0.0,0.0
1013,1575,2020-03-19 17:35:00,1,3294.0,3112.0,0.945,16.422,170,56,19,37,114,68,46,3,0.0,0.0
1013,1576,2020-03-19 17:38:00,1,3346.0,3135.0,0.937,16.653,55,23,12,11,32,14,18,0,0.0,0.0
1013,1577,2020-03-19 17:41:00,1,3165.0,3039.0,0.96,15.836,25,25,1,24,0,0,0,0,0.0,0.0
1013,1578,2020-03-19 17:44:00,1,3040.0,2918.0,0.96,15.207,33,33,0,33,0,0,0,0,0.0,0.0
1013,1579,2020-03-19 17:47:00,1,3097.0,2892.0,0.934,15.403,8,7,3,4,1,0,1,0,0.0,0.0
1013,1580,2020-03-19 17:50:00,1,2913.0,2720.0,0.934,14.489,1,1,0,1,0,0,0,0,0.0,0.0
1013,1581,2020-03-19 17:53:00,1,2820.0,2723.0,0.966,14.126,3,3,0,3,0,0,0,0,0.0,0.0
1013,1582,2020-03-19 17:56:00,1,2872.0,2733.0,0.952,14.34,35,34,0,34,1,0,1,0,0.0,0.0
1013,1583,2020-03-19 17:59:00,1,2780.0,2686.0,0.966,13.927,2,2,0,2,0,0,0,0,0.0,0.0
1013,1584,2020-03-19 18:02:00,0,2932.0,2813.0,0.959,14.666,445,267,202,65,178,132,46,20,0.0,0.0
1013,1585,2020-03-19 18:05:00,0,3333.0,3165.0,0.95,16.635,517,276,210,66,241,179,62,49,0.0,0.04
1013,1586,2020-03-19 18:08:00,0,3431.0,3282.0,0.957,17.153,470,254,180,74,216,159,57,94,0.0,0.0
1013,1587,2020-03-19 18:11:00,0,3571.0,3289.0,0.921,17.709,199,60,25,35,139,91,48,18,0.0,0.0
1013,1588,2020-03-19 18:14:00,0,3384.0,3162.0,0.934,16.833,263,121,85,36,142,92,50,37,0.0,0.0
1013,1589,2020-03-19 18:17:00,0,3524.0,3201.0,0.908,17.428,9,9,0,9,0,0,0,0,0.0,0.0
1013,1590,2020-03-19 18:20:00,0,3147.0,2978.0,0.946,15.697,1,0,0,0,1,1,0,0,0.0,0.0
1013,1591,2020-03-19 18:23:00,0,3190.0,2872.0,0.9,15.75,15,13,0,13,2,1,1,0,0.0,0.0
1013,1592,2020-03-19 18:26:00,0,3178.0,2863.0,0.901,15.69,18,7,0,7,11,3,8,0,0.0,0.0
1013,1593,2020-03-19 18:29:00,0,3224.0,2951.0,0.915,15.968,160,79,35,44,81,40,41,10,0.0,0.0
1013,1594,2020-03-19 18:32:00,0,3157.0,2978.0,0.943,15.734,114,44,6,38,70,27,43,23,0.0,0.0
1013,1595,2020-03-19 18:35:00,0,3349.0,3080.0,0.92,16.605,234,37,7,30,197,125,72,25,0.0,0.0
1013,1596,2020-03-19 18:38:00,0,3233.0,3055.0,0.945,16.12,227,99,50,49,128,67,61,14,0.0,0.0
1013,1597,2020-03-19 18:41:00,0,3524.0,3254.0,0.923,17.485,303,158,99,59,145,91,54,35,0.0,0.0
1013,1598,2020-03-19 18:44:00,0,3549.0,3325.0,0.937,17.665,237,130,99,31,107,81,26,33,0.0,0.0
1013,1599,2020-03-19 18:47:00,0,3478.0,3193.0,0.918,17.237,30,12,6,6,18,14,4,0,0.0,0.0
1013,1600,2020-03-19 18:50:00,0,3363.0,3082.0,0.916,16.662,8,5,1,4,3,0,3,0,0.0,0.0
1013,1601,2020-03-19 18:53:00,0,3383.0,3034.0,0.897,16.687,85,25,14,11,60,23,37,0,0.0,0.0
1013,1602,2020-03-19 18:56:00,0,3193.0,2956.0,0.926,15.852,41,5,0,5,36,27,9,0,0.0,0.0
1013,1603,2020-03-19 18:59:00,0,3171.0,2893.0,0.912,15.699,239,129,90,39,110,65,45,13,0.0,0.0
1013,1604,2020-03-19 19:02:00,0,3527.0,3125.0,0.886,17.357,420,219,167,52,201,146,55,51,0.01,0.0
1013,1605,2020-03-19 19:05:00,0,3594.0,3195.0,0.889,17.696,188,97,42,55,91,25,66,16,0.0,0.0
1013,1606,2020-03-19 19:08:00,0,3538.0,3211.0,0.907,17.495,181,60,31,29,121,70,51,18,0.0,0.0
1013,1607,2020-03-19 19:11:00,0,3698.0,3313.0,0.896,18.237,430,215,159,56,215,158,57,75,0.08,0.0
1013,1608,2020-03-19 19:14:00,0,3704.0,3251.0,0.878,18.193,304,195,149,46,109,81,28,38,0.0,0.0
1013,1609,2020-03-19 19:17:00,0,3484.0,3171.0,0.91,17.237,295,172,127,45,123,82,41,69,0.0,0.0
1013,1610,2020-03-19 19:20:00,0,3527.0,3127.0,0.887,17.357,488,383,314,69,105,71,34,53,0.12,0.0
1013,1611,2020-03-19 19:23:00,0,3527.0,3083.0,0.874,17.309,361,216,152,64,145,100,45,48,0.0,0.0
1013,1612,2020-03-19 19:26:00,0,3532.0,2994.0,0.848,17.231,126,53,33,20,73,40,33,18,0.0,0.0
1013,1613,2020-03-19 19:29:00,0,3184.0,2757.0,0.866,15.599,1,1,0,1,0,0,0,0,0.0,0.0
1013,1614,2020-03-19 19:32:00,0,2958.0,2539.0,0.858,14.466,0,0,0,0,0,0,0,0,0.0,0.0
1013,1615,2020-03-19 19:35:00,0,2861.0,2413.0,0.844,13.944,3,1,0,1,2,0,2,0,0.0,0.0
1013,1616,2020-03-19 19:38:00,0,2876.0,2395.0,0.833,13.982,12,4,4,0,8,3,5,0,0.0,0.0
1013,1617,2020-03-19 19:41:00,0,2863.0,2309.0,0.807,13.835,239,151,128,23,88,69,19,28,0.0,0.0
1013,1618,2020-03-19 19:44:00,0,3054.0,2510.0,0.822,14.811,522,266,219,47,256,197,59,56,0.0,0.0
1013,1619,2020-03-19 19:47:00,0,3157.0,2544.0,0.806,15.254,332,159,96,63,173,102,71,46,0.02,0.0
1013,1620,2020-03-19 19:50:00,0,3241.0,2622.0,0.809,15.674,348,171,127,44,177,133,44,48,0.0,0.0
1013,1621,2020-03-19 19:53:00,0,3411.0,2747.0,0.805,16.481,531,262,205,57,269,225,44,63,0.0,0.0
1013,1622,2020-03-19 19:56:00,0,2955.0,2419.0,0.819,14.319,185,61,44,17,124,83,41,6,0.0,0.0
1013,1623,2020-03-19 19:59:00,0,3200.0,2505.0,0.783,15.384,97,35,11,24,62,32,30,6,0.0,0.0
1013,1624,2020-03-19 20:02:00,0,3260.0,2510.0,0.77,15.625,73,22,11,11,51,26,25,0,0.0,0.0
1013,1625,2020-03-19 20:05:00,0,2885.0,2282.0,0.791,13.895,16,10,6,4,6,3,3,0,0.0,0.0
1013,1626,2020-03-19 20:08:00,0,2771.0,2140.0,0.772,13.289,3,3,1,2,0,0,0,0,0.0,0.0
1013,1627,2020-03-19 20:11:00,0,2750.0,2126.0,0.773,13.189,16,8,5,3,8,3,5,0,0.0,0.0
1013,1628,2020-03-19 20:14:00,0,2839.0,2127.0,0.749,13.543,4,0,0,0,4,2,2,0,0.0,0.0
1013,1629,2020-03-19 20:17:00,0,2772.0,2102.0,0.758,13.249,1,1,1,0,0,0,0,0,0.0,0.0
1013,1630,2020-03-19 20:20:00,0,2865.0,2146.0,0.749,13.664,11,11,3,8,0,0,0,0,0.0,0.0
1013,1631,2020-03-19 20:23:00,0,2824.0,2116.0,0.749,13.47,205,92,40,52,113,61,52,19,0.0,0.0
1013,1632,2020-03-19 20:26:00,0,3114.5,2337.5,0.7505,14.8605,287,105,59,46,182,123,59,59,0.0,0.0
1013,1633,2020-03-19 20:29:00,0,3405.0,2559.0,0.752,16.251,501,275,216,59,226,163,63,83,0.0,0.0
1013,1634,2020-03-19 20:32:00,0,3411.0,2471.0,0.724,16.177,233,114,85,29,119,83,36,28,0.0,0.0
1013,1635,2020-03-19 20:35:00,0,3397.0,2550.0,0.751,16.207,506,267,199,68,239,186,53,20,0.0,0.04
1013,1636,2020-03-19 20:38:00,0,3726.0,2710.0,0.727,17.681,610,294,236,58,316,237,79,33,0.0,0.04
1013,1637,2020-03-19 20:41:00,0,3162.0,2360.0,0.746,15.073,353,183,132,51,170,126,44,27,0.0,0.0
1013,1638,2020-03-19 20:44:00,0,3399.0,2529.0,0.744,16.192,479,218,169,49,261,194,67,32,0.03,0.0
1013,1639,2020-03-19 20:47:00,0,3591.0,2598.0,0.723,17.025,174,62,40,22,112,71,41,11,0.01,0.0
1013,1640,2020-03-19 20:50:00,0,2595.0,1826.0,0.703,12.247,5,3,3,0,2,1,1,0,0.0,0.0
1013,1641,2020-03-19 20:53:00,0,3178.0,2346.0,0.738,15.117,27,1,0,1,26,1,25,0,0.0,0.0
1013,1642,2020-03-19 20:56:00,0,3030.0,2180.0,0.719,14.351,21,0,0,0,21,4,17,0,0.0,0.0
1013,1643,2020-03-19 20:59:00,0,2847.0,2012.0,0.707,13.445,38,12,9,3,26,17,9,0,0.0,0.0
1013,1644,2020-03-19 21:02:00,0,2871.0,1988.0,0.692,13.513,3,1,0,1,2,0,2,0,0.0,0.0
1013,1645,2020-03-19 21:05:00,0,2690.0,1929.0,0.717,12.734,23,19,10,9,4,0,4,0,0.0,0.0
1013,1646,2020-03-19 21:08:00,0,2652.0,1932.0,0.728,12.589,5,4,2,2,1,0,1,0,0.0,0.0
1013,1647,2020-03-19 21:11:00,0,2807.0,1950.0,0.695,13.219,172,68,26,42,104,53,51,24,0.0,0.0
1013,1648,2020-03-19 21:14:00,0,3028.0,2159.0,0.713,14.321,442,259,202,57,183,124,59,36,0.0,0.0
1013,1649,2020-03-19 21:17:00,0,3418.0,2422.0,0.709,16.15,415,271,204,67,144,109,35,35,0.0,0.0
1013,1650,2020-03-19 21:20:00,0,2997.0,2158.0,0.72,14.197,76,43,12,31,33,14,19,2,0.0,0.0
1013,1651,2020-03-19 21:23:00,0,3164.0,2260.0,0.714,14.968,82,33,18,15,49,19,30,1,0.0,0.0
1013,1652,2020-03-19 21:26:00,0,3188.0,2260.0,0.709,15.063,112,26,8,18,86,35,51,57,0.0,0.0
1013,1653,2020-03-19 21:29:00,0,3007.0,2190.0,0.728,14.271,24,5,2,3,19,5,14,0,0.0,0.0
1013,1654,2020-03-19 21:32:00,0,2837.0,2022.0,0.713,13.416,7,0,0,0,7,0,7,0,0.0,0.0
1013,1655,2020-03-19 21:35:00,0,2626.0,1899.0,0.723,12.45,3,1,1,0,2,0,2,0,0.0,0.0
1013,1656,2020-03-19 21:38:00,0,2568.0,1775.0,0.691,12.085,0,0,0,0,0,0,0,0,0.0,0.0
1013,1657,2020-03-19 21:41:00,0,2458.0,1718.0,0.699,11.586,14,0,0,0,14,0,14,0,0.0,0.0
1013,1658,2020-03-19 21:44:00,0,2470.0,1735.0,0.703,11.655,17,4,0,4,13,8,5,0,0.0,0.0
1013,1659,2020-03-19 21:47:00,0,2787.0,1906.0,0.684,13.093,226,80,40,40,146,80,66,6,0.0,0.0
1013,1660,2020-03-19 21:50:00,0,3031.0,2078.0,0.686,14.243,133,57,23,34,76,31,45,8,0.0,0.0
1013,1661,2020-03-19 21:53:00,0,3058.0,2215.0,0.724,14.5,284,155,117,38,129,88,41,27,0.01,0.0
1013,1662,2020-03-19 21:56:00,0,2984.0,2164.0,0.725,14.153,87,58,48,10,29,18,11,5,0.0,0.0
1013,1663,2020-03-19 21:59:00,0,2843.0,2072.0,0.729,13.496,27,4,0,4,23,3,20,0,0.0,0.0
1013,1664,2020-03-19 22:02:00,0,2763.0,1946.0,0.704,13.043,27,10,5,5,17,11,6,0,0.0,0.0
1013,1665,2020-03-19 22:05:00,0,2592.0,1841.0,0.71,12.253,18,4,4,0,14,6,8,0,0.0,0.0
1013,1666,2020-03-19 22:08:00,0,2665.0,1891.0,0.71,12.593,24,21,1,20,3,1,2,0,0.0,0.0
1013,1667,2020-03-19 22:11:00,0,2679.0,1882.0,0.702,12.639,173,104,84,20,69,49,20,33,0.0,0.0
1013,1668,2020-03-19 22:14:00,0,2793.0,1949.0,0.698,13.164,155,74,46,28,81,51,30,24,0.0,0.0
1013,1669,2020-03-19 22:17:00,0,2887.0,2049.0,0.71,13.645,37,15,6,9,22,8,14,3,0.0,0.0
1013,1670,2020-03-19 22:20:00,0,2690.0,1906.0,0.709,12.708,54,28,9,19,26,8,18,0,0.0,0.0
1013,1671,2020-03-19 22:23:00,0,2609.0,1838.0,0.705,12.316,3,3,2,1,0,0,0,0,0.0,0.0
1013,1672,2020-03-19 22:26:00,0,2625.0,1798.0,0.685,12.333,228,144,105,39,84,64,20,37,0.03,0.0
1013,1673,2020-03-19 22:29:00,0,2987.0,2126.0,0.712,14.124,347,192,136,56,155,118,37,28,0.0,0.0
1013,1674,2020-03-19 22:32:00,0,3362.0,2383.0,0.709,15.886,542,258,212,46,284,210,74,75,0.24,0.01
1013,1675,2020-03-19 22:35:00,0,3263.0,2335.0,0.716,15.443,361,236,180,56,125,86,39,70,0.0,0.0
1013,1676,2020-03-19 22:38:00,0,3375.0,2409.0,0.714,15.965,235,84,62,22,151,107,44,19,0.0,0.0
1013,1677,2020-03-19 22:41:00,0,3403.0,2373.0,0.697,16.036,109,41,27,14,68,43,25,7,0.0,0.0
1013,1678,2020-03-19 22:44:00,0,3429.0,2447.0,0.714,16.222,337,221,168,53,116,73,43,113,0.0,0.0
1013,1679,2020-03-19 22:47:00,0,3183.0,2252.0,0.708,15.034,356,175,135,40,181,132,49,21,0.0,0.0
1013,1680,2020-03-19 22:50:00,0,3397.0,2406.0,0.708,16.05,660,302,218,84,358,270,88,19,0.0,0.0
1013,1681,2020-03-19 22:53:00,0,3509.0,2475.0,0.705,16.567,523,354,266,88,169,124,45,22,0.0,0.0
1013,1682,2020-03-19 22:56:00,0,3654.0,2574.0,0.704,17.248,392,279,211,68,113,84,29,22,0.0,0.03
1013,1683,2020-03-19 22:59:00,0,3360.0,2307.0,0.687,15.792,366,223,163,60,143,95,48,40,0.0,0.0
1013,1684,2020-03-19 23:02:00,0,3501.0,2447.0,0.699,16.504,230,137,84,53,93,60,33,16,0.08,0.0
1013,1685,2020-03-19 23:05:00,0,3457.0,2460.0,0.712,16.346,170,71,22,49,99,59,40,11,0.0,0.0
1013,1686,2020-03-19 23:08:00,0,3418.0,2361.0,0.691,16.083,175,91,46,45,84,47,37,1,0.0,0.0
1013,1687,2020-03-19 23:11:00,0,3154.0,2259.0,0.716,14.93,15,13,5,8,2,0,2,0,0.0,0.0
1013,1688,2020-03-19 23:14:00,0,3006.0,2062.0,0.686,14.125,4,3,1,2,1,0,1,0,0.0,0.0
1013,1689,2020-03-19 23:17:00,0,2790.0,1926.0,0.69,13.126,68,22,15,7,46,29,17,1,0.0,0.0
1013,1690,2020-03-19 23:20:00,0,2634.0,1872.0,0.711,12.452,3,0,0,0,3,0,3,0,0.0,0.0
1013,1691,2020-03-19 23:23:00,0,2677.0,1799.0,0.672,12.542,5,0,0,0,5,0,5,0,0.0,0.0
1013,1692,2020-03-19 23:26:00,0,2577.0,1718.5,0.6665,12.057,1,1,0,1,0,0,0,0,0.0,0.0
1013,1693,2020-03-19 23:29:00,0,2477.0,1638.0,0.661,11.572,0,0,0,0,0,0,0,0,0.0,0.0
1013,1694,2020-03-19 23:32:00,0,2384.0,1599.0,0.671,11.165,12,7,0,7,5,0,5,0,0.0,0.0
1013,1695,2020-03-19 23:35:00,0,2435.0,1673.0,0.687,11.445,10,6,2,4,4,0,4,0,0.0,0.0
1013,1696,2020-03-19 23:38:00,0,2490.0,1727.0,0.694,11.723,21,12,2,10,9,0,9,0,0.0,0.0
1013,1697,2020-03-19 23:41:00,0,2452.0,1703.0,0.694,11.548,10,2,2,0,8,0,8,0,0.0,0.0
1013,1698,2020-03-19 23:44:00,0,2685.0,1879.0,0.7,12.661,431,268,205,63,163,113,50,30,0.0,0.0
1013,1699,2020-03-19 23:47:00,0,3162.0,2252.0,0.712,14.95,467,334,245,89,133,96,37,30,0.0,0.0
1013,1700,2020-03-19 23:50:00,0,3345.0,2377.0,0.711,15.81,357,254,187,67,103,68,35,55,0.0,0.0
1013,1701,2020-03-19 23:53:00,0,3183.0,2298.0,0.722,15.087,210,106,76,30,104,79,25,46,0.07,0.0
1013,1702,2020-03-19 23:56:00,0,3218.0,2254.0,0.7,15.176,366,165,111,54,201,135,66,45,0.0,0.0
1013,1703,2020-03-19 23:59:00,0,3561.0,2479.0,0.696,16.776,233,81,55,26,152,106,46,33,0.1,0.0
1013,1704,2020-03-20 00:02:00,0,3046.0,2178.0,0.715,14.415,390,256,207,49,134,103,31,33,0.0,0.0
1013,1705,2020-03-20 00:05:00,0,3178.0,2195.0,0.691,14.952,370,178,120,58,192,136,56,29,0.0,0.0
1013,1706,2020-03-20 00:08:00,0,3488.0,2443.0,0.7,16.447,503,266,195,71,237,175,62,50,0.0,0.0
1013,1707,2020-03-20 00:11:00,0,3331.0,2341.0,0.703,15.715,135,118,78,40,17,5,12,9,0.0,0.0
1013,1708,2020-03-20 00:14:00,0,3189.0,2273.0,0.713,15.081,278,134,86,48,144,95,49,42,0.0,0.0
1013,1709,2020-03-20 00:17:00,0,3439.0,2388.0,0.695,16.193,417,183,140,43,234,175,59,35,0.0,0.0
1013,1710,2020-03-20 00:20:00,0,3167.0,2232.0,0.705,14.95,281,168,115,53,113,74,39,37,0.0,0.0
1013,1711,2020-03-20 00:23:00,0,3220.0,2207.0,0.685,15.132,105,80,35,45,25,8,17,2,0.0,0.0
1013,1712,2020-03-20 00:26:00,0,3207.0,2249.0,0.701,15.125,221,110,79,31,111,71,40,46,0.0,0.0
1013,1713,2020-03-20 00:29:00,0,3051.0,2081.0,0.682,14.326,224,171,128,43,53,40,13,35,0.0,0.0
1013,1714,2020-03-20 00:32:00,0,3335.0,2350.0,0.705,15.741,640,402,305,97,238,185,53,30,0.0,0.0
1013,1715,2020-03-20 00:35:00,0,3341.0,2350.0,0.703,15.768,567,345,264,81,222,167,55,26,0.0,0.0
1013,1716,2020-03-20 00:38:00,0,3504.0,2406.0,0.687,16.469,243,132,84,48,111,70,41,14,0.17,0.0
1013,1717,2020-03-20 00:41:00,0,2794.0,1921.0,0.687,13.137,189,79,43,36,110,75,35,3,0.0,0.0
1013,1718,2020-03-20 00:44:00,0,3205.0,2271.0,0.709,15.143,467,270,210,60,197,152,45,12,0.0,0.0
1013,1719,2020-03-20 00:47:00,0,3029.0,2127.0,0.702,14.291,307,171,122,49,136,88,48,13,0.0,0.0
1013,1720,2020-03-20 00:50:00,0,2860.0,1952.0,0.682,13.43,105,70,27,43,35,9,26,4,0.0,0.0
1013,1721,2020-03-20 00:53:00,0,3082.0,2162.0,0.702,14.536,205,97,61,36,108,66,42,24,0.0,0.0
1013,1722,2020-03-20 00:56:00,0,3166.0,2198.0,0.694,14.907,266,98,52,46,168,114,54,22,0.0,0.0
1013,1723,2020-03-20 00:59:00,0,3180.0,2208.0,0.694,14.972,293,136,73,63,157,89,68,60,0.0,0.0
1013,1724,2020-03-20 01:02:00,0,3116.0,2189.0,0.702,14.701,249,129,94,35,120,90,30,0,0.0,0.0
1013,1725,2020-03-20 01:05:00,0,2887.0,2062.0,0.714,13.66,1,1,1,0,0,0,0,0,0.0,0.0
1013,1726,2020-03-20 01:08:00,0,2655.0,1877.0,0.707,12.54,7,4,2,2,3,1,2,0,0.0,0.0
1013,1727,2020-03-20 01:11:00,0,2439.0,1707.0,0.7,11.499,2,1,0,1,1,0,1,0,0.0,0.0
1013,1728,2020-03-20 01:14:00,0,2283.0,1600.0,0.701,10.765,24,22,0,22,2,0,2,0,0.0,0.0
1013,1729,2020-03-20 01:17:00,0,2335.0,1527.0,0.654,10.892,7,4,0,4,3,0,3,0,0.0,0.0
1013,1730,2020-03-20 01:20:00,0,2187.0,1501.0,0.686,10.278,4,2,0,2,2,0,2,0,0.0,0.0
1013,1731,2020-03-20 01:23:00,0,2104.0,1433.0,0.681,9.879,4,2,0,2,2,0,2,0,0.0,0.0
1013,1732,2020-03-20 01:26:00,0,1895.0,1354.0,0.714,8.965,25,21,0,21,4,0,4,0,0.0,0.0
1013,1733,2020-03-20 01:29:00,0,1870.0,1276.0,0.682,8.783,20,8,4,4,12,0,12,0,0.0,0.0
1013,1734,2020-03-20 01:32:00,0,1948.0,1293.0,0.664,9.107,25,17,8,9,8,0,8,0,0.0,0.0
1013,1735,2020-03-20 01:35:00,0,1907.0,1340.0,0.703,8.997,102,85,50,35,17,9,8,4,0.0,0.0
1013,1736,2020-03-20 01:38:00,0,2106.0,1454.0,0.691,9.907,17,7,4,3,10,2,8,0,0.0,0.0
1013,1737,2020-03-20 01:41:00,0,2059.0,1409.0,0.684,9.674,19,18,2,16,1,1,0,0,0.0,0.0
1013,1738,2020-03-20 01:44:00,0,2062.0,1382.0,0.67,9.656,29,25,9,16,4,2,2,0,0.0,0.0
1013,1739,2020-03-20 01:47:00,0,2253.0,1524.0,0.677,10.564,16,13,6,7,3,1,2,0,0.0,0.0
1013,1740,2020-03-20 01:50:00,0,2336.0,1594.0,0.682,10.967,6,1,1,0,5,1,4,0,0.0,0.0
1013,1741,2020-03-20 01:53:00,0,2468.0,1658.0,0.672,11.561,247,130,85,45,117,79,38,32,0.0,0.0
1013,1742,2020-03-20 01:56:00,0,3040.0,2119.0,0.697,14.324,569,282,228,54,287,214,73,139,0.0,0.0
1013,1743,2020-03-20 01:59:00,0,3551.0,2564.0,0.722,16.831,542,319,245,74,223,171,52,42,0.0,0.0
1013,1744,2020-03-20 02:02:00,0,3415.0,2366.0,0.693,16.076,492,283,238,45,209,156,53,111,0.04,0.0
1013,1745,2020-03-20 02:05:00,0,3501.0,2505.0,0.715,16.57,553,283,209,74,270,205,65,26,0.0,0.0
1013,1746,2020-03-20 02:08:00,0,3359.0,2348.0,0.699,15.833,551,239,193,46,312,243,69,89,0.17,0.0
1013,1747,2020-03-20 02:11:00,0,3434.0,2347.0,0.684,16.128,122,56,25,31,66,39,27,2,0.0,0.0
1013,1748,2020-03-20 02:14:00,0,3241.0,2277.0,0.703,15.291,293,163,120,43,130,98,32,30,0.0,0.0
1013,1749,2020-03-20 02:17:00,0,3181.0,2241.0,0.704,15.014,125,72,43,29,53,33,20,46,0.0,0.0
1013,1750,2020-03-20 02:20:00,0,3203.0,2335.0,0.729,15.204,301,73,45,28,228,147,81,9,0.09,0.0
1013,1751,2020-03-20 02:23:00,0,3050.0,2100.0,0.688,14.345,81,36,28,8,45,21,24,4,0.01,0.0
1013,1752,2020-03-20 02:26:00,0,3194.0,2208.0,0.691,15.0315,73,58,21,37,15,7,8,3,0.0,0.0
1013,1753,2020-03-20 02:29:00,0,3338.0,2316.0,0.694,15.718,145,84,42,42,61,27,34,6,0.01,0.0
1013,1754,2020-03-20 02:32:00,0,3225.0,2256.0,0.699,15.205,268,159,111,48,109,72,37,4,0.0,0.0
1013,1755,2020-03-20 02:35:00,0,2998.0,2141.0,0.714,14.182,115,59,29,30,56,19,37,6,0.0,0.0
1013,1756,2020-03-20 02:38:00,0,3071.0,2085.0,0.679,14.407,21,11,1,10,10,1,9,0,0.0,0.0
1013,1757,2020-03-20 02:41:00,0,2782.0,1894.0,0.681,13.059,44,3,0,3,41,0,41,0,0.0,0.0
1013,1758,2020-03-20 02:44:00,0,2672.0,1796.0,0.672,12.515,0,0,0,0,0,0,0,0,0.0,0.0
1013,1759,2020-03-20 02:47:00,0,2534.0,1687.0,0.666,11.851,3,0,0,0,3,2,1,0,0.0,0.0
1013,1760,2020-03-20 02:50:00,0,2307.0,1535.0,0.665,10.791,0,0,0,0,0,0,0,0,0.0,0.0
1013,1761,2020-03-20 02:53:00,0,2032.0,1439.0,0.708,9.6,9,2,1,1,7,0,7,0,0.0,0.0
1013,1762,2020-03-20 02:56:00,0,2081.0,1390.0,0.668,9.736,27,9,5,4,18,5,13,1,0.01,0.0
1013,1763,2020-03-20 02:59:00,0,1996.0,1349.0,0.676,9.358,17,12,2,10,5,3,2,0,0.0,0.0
1013,1764,2020-03-20 03:02:00,0,1912.0,1252.0,0.655,8.919,39,31,6,25,8,0,8,0,0.0,0.0
1013,1765,2020-03-20 03:05:00,0,1925.0,1314.0,0.683,9.039,24,1,0,1,23,0,23,0,0.0,0.0
1013,1766,2020-03-20 03:08:00,0,1927.0,1319.0,0.685,9.053,4,2,1,1,2,0,2,0,0.01,0.0
1013,1767,2020-03-20 03:11:00,0,1905.0,1262.0,0.662,8.901,11,8,0,8,3,0,3,0,0.0,0.0
1013,1768,2020-03-20 03:14:00,0,2066.0,1412.0,0.684,9.702,156,71,43,28,85,47,38,25,0.0,0.0
1013,1769,2020-03-20 03:17:00,0,3018.0,2076.0,0.688,14.192,340,200,145,55,140,101,39,38,0.0,0.01
1013,1770,2020-03-20 03:20:00,0,3147.0,2212.0,0.703,14.85,353,235,164,71,118,80,38,31,0.02,0.0
1013,1771,2020-03-20 03:23:00,0,3418.0,2397.0,0.701,16.122,312,226,152,74,86,67,19,31,0.0,0.0
1013,1772,2020-03-20 03:26:00,0,3350.0,2382.0,0.711,15.837,334,269,180,89,65,46,19,17,0.0,0.0
1013,1773,2020-03-20 03:29:00,0,3439.0,2397.0,0.697,16.204,346,212,145,67,134,90,44,63,0.0,0.0
1013,1774,2020-03-20 03:32:00,0,3437.0,2418.0,0.704,16.218,407,126,87,39,281,214,67,45,0.02,0.0
1013,1775,2020-03-20 03:35:00,0,2615.0,1900.0,0.727,12.408,100,44,28,16,56,33,23,6,0.0,0.0
1013,1776,2020-03-20 03:38:00,0,3211.0,2266.0,0.706,15.162,212,81,33,48,131,74,57,46,0.0,0.0
1013,1777,2020-03-20 03:41:00,0,3464.0,2472.0,0.714,16.384,320,162,115,47,158,103,55,29,0.0,0.0
1013,1778,2020-03-20 03:44:00,0,3358.0,2432.0,0.724,15.923,272,130,97,33,142,102,40,69,0.0,0.0
1013,1779,2020-03-20 03:47:00,0,3178.0,2200.0,0.692,14.959,151,67,29,38,84,47,37,7,0.22,0.0
1013,1780,2020-03-20 03:50:00,0,2885.0,2015.0,0.698,13.598,128,87,36,51,41,14,27,5,0.0,0.0
1013,1781,2020-03-20 03:53:00,0,3135.0,2189.0,0.698,14.778,385,177,149,28,208,164,44,39,0.0,0.0
1013,1782,2020-03-20 03:56:00,0,2629.0,1875.0,0.713,12.437,98,42,16,26,56,28,28,2,0.0,0.0
1013,1783,2020-03-20 03:59:00,0,2986.0,2100.0,0.703,14.089,365,182,126,56,183,135,48,10,0.0,0.0
1013,1784,2020-03-20 04:02:00,0,3075.0,2161.0,0.703,14.508,334,226,168,58,108,83,25,54,0.0,0.0
1013,1785,2020-03-20 04:05:00,0,2581.0,1866.0,0.723,12.235,131,82,42,40,49,9,40,2,0.0,0.0
1013,1786,2020-03-20 04:08:00,0,2870.0,2019.0,0.704,13.545,48,30,17,13,18,4,14,0,0.0,0.0
1013,1787,2020-03-20 04:11:00,0,2559.0,1813.0,0.709,12.09,7,3,2,1,4,1,3,0,0.0,0.0
1013,1788,2020-03-20 04:14:00,0,2479.0,1704.0,0.688,11.653,0,0,0,0,0,0,0,0,0.0,0.0
1013,1789,2020-03-20 04:17:00,0,2318.0,1558.0,0.672,10.857,9,9,2,7,0,0,0,0,0.0,0.0
1013,1790,2020-03-20 04:20:00,0,2076.0,1461.0,0.704,9.796,16,16,0,16,0,0,0,0,0.0,0.0
1013,1791,2020-03-20 04:23:00,0,2071.0,1400.0,0.676,9.708,0,0,0,0,0,0,0,0,0.0,0.0
1013,1792,2020-03-20 04:26:00,0,1905.0,1340.0,0.704,8.99,5,4,1,3,1,0,1,0,0.0,0.0
1013,1793,2020-03-20 04:29:00,0,1941.0,1287.0,0.663,9.073,25,25,0,25,0,0,0,0,0.0,0.0
1013,1794,2020-03-20 04:32:00,0,1725.0,1201.0,0.696,8.128,9,9,2,7,0,0,0,0,0.0,0.0
1013,1795,2020-03-20 04:35:00,0,1753.0,1180.0,0.673,8.214,20,7,0,7,13,1,12,0,0.0,0.0
1013,1796,2020-03-20 04:38:00,0,1783.0,1139.0,0.639,8.285,121,36,18,18,85,48,37,7,0.0,0.0
1013,1797,2020-03-20 04:41:00,0,2293.0,1556.0,0.678,10.759,273,109,76,33,164,122,42,19,0.0,0.0
1013,1798,2020-03-20 04:44:00,0,2068.0,1469.0,0.71,9.775,16,8,0,8,8,3,5,1,0.0,0.0
1013,1799,2020-03-20 04:47:00,0,2251.0,1565.0,0.695,10.603,269,99,52,47,170,111,59,62,0.0,0.0
1013,1800,2020-03-20 04:50:00,0,2539.0,1787.0,0.704,11.983,139,65,44,21,74,47,27,14,0.0,0.0
1013,1801,2020-03-20 04:53:00,0,2458.0,1718.0,0.699,11.588,13,1,0,1,12,0,12,0,0.0,0.0
1013,1802,2020-03-20 04:56:00,0,2331.0,1630.0,0.699,10.988,0,0,0,0,0,0,0,0,0.0,0.0
1013,1803,2020-03-20 04:59:00,0,2038.0,1493.0,0.732,9.683,3,2,2,0,1,1,0,0,0.0,0.0
1013,1804,2020-03-20 05:02:00,0,2061.0,1427.0,0.692,9.703,0,0,0,0,0,0,0,0,0.0,0.0
1013,1805,2020-03-20 05:05:00,0,1895.0,1357.0,0.716,8.97,0,0,0,0,0,0,0,0,0.0,0.0
1013,1806,2020-03-20 05:08:00,0,1925.0,1297.0,0.674,9.022,0,0,0,0,0,0,0,0,0.0,0.0
1013,1807,2020-03-20 05:11:00,0,1912.0,1390.0,0.727,9.072,201,79,26,53,122,65,57,20,0.0,0.0
1013,1808,2020-03-20 05:14:00,0,2502.0,1687.0,0.674,11.728,142,73,24,49,69,35,34,18,0.0,0.0
1013,1809,2020-03-20 05:17:00,0,2695.0,1939.0,0.72,12.764,329,169,136,33,160,127,33,33,0.0,0.0
1013,1810,2020-03-20 05:20:00,0,2650.0,1913.0,0.722,12.561,463,257,210,47,206,154,52,35,0.0,0.0
1013,1811,2020-03-20 05:23:00,0,2830.0,1987.0,0.702,13.352,442,191,146,45,251,197,54,53,0.0,0.0
1013,1812,2020-03-20 05:26:00,0,2811.5,1965.0,0.699,13.2545,452,248,187,61,204,134,70,16,0.0,0.0
1013,1813,2020-03-20 05:29:00,0,2793.0,1943.0,0.696,13.157,442,195,141,54,247,180,67,39,0.08,0.0
1013,1814,2020-03-20 05:32:00,0,2466.0,1734.0,0.703,11.638,667,269,209,60,398,317,81,77,0.0,0.0
1013,1815,2020-03-20 05:35:00,0,2467.0,1791.0,0.726,11.704,306,136,86,50,170,113,57,21,0.0,0.0
1013,1816,2020-03-20 05:38:00,0,2637.0,1801.0,0.683,12.383,275,79,54,25,196,144,52,24,0.0,0.0
1013,1817,2020-03-20 05:41:00,0,2677.0,1856.0,0.693,12.601,524,243,195,48,281,214,67,58,0.0,0.0
1013,1818,2020-03-20 05:44:00,0,2568.0,1795.0,0.699,12.107,467,159,103,56,308,226,82,10,0.0,0.0
1013,1819,2020-03-20 05:47:00,0,2491.0,1772.0,0.711,11.775,403,139,89,50,264,191,73,30,0.0,0.0
1013,1820,2020-03-20 05:50:00,0,2442.0,1723.0,0.706,11.528,323,149,108,41,174,123,51,22,0.0,0.0
1013,1821,2020-03-20 05:53:00,0,2471.0,1745.0,0.706,11.67,404,192,148,44,212,148,64,16,0.0,0.0
1013,1822,2020-03-20 05:56:00,0,2454.0,1684.0,0.686,11.532,622,335,262,73,287,220,67,84,0.0,0.0
1013,1823,2020-03-20 05:59:00,0,2513.0,1689.0,0.672,11.77,156,80,59,21,76,53,23,19,0.0,0.0
1013,1824,2020-03-20 06:02:00,1,2402.0,1705.0,0.71,11.354,210,148,97,51,62,38,24,33,0.0,0.0
1013,1825,2020-03-20 06:05:00,1,3061.0,2163.0,0.707,14.454,364,238,181,57,126,80,46,104,0.0,0.0
1013,1826,2020-03-20 06:08:00,1,3521.0,2519.0,0.715,16.661,151,121,66,55,30,3,27,99,0.0,0.14
1013,1827,2020-03-20 06:11:00,1,3735.0,2680.0,0.718,17.682,297,158,98,60,139,94,45,84,0.0,0.12
1013,1828,2020-03-20 06:14:00,1,3814.0,2785.0,0.73,18.113,152,116,69,47,36,6,30,103,0.0,0.24
1013,1829,2020-03-20 06:17:00,1,3842.0,2950.0,0.768,18.406,393,230,170,60,163,120,43,140,0.0,0.18
1013,1830,2020-03-20 06:20:00,1,3874.0,3018.0,0.779,18.605,157,61,37,24,96,63,33,92,0.18,0.01
1013,1831,2020-03-20 06:23:00,1,3493.0,2744.0,0.785,16.801,284,182,124,58,102,71,31,55,0.0,0.02
1013,1832,2020-03-20 06:26:00,1,3908.0,3065.0,0.784,18.791,143,108,61,47,35,21,14,72,0.01,0.07
1013,1833,2020-03-20 06:29:00,1,3874.0,3125.0,0.807,18.724,308,120,85,35,188,144,44,57,0.4,0.04
1013,1834,2020-03-20 06:32:00,1,4010.0,3399.0,0.848,19.563,292,165,109,56,127,78,49,74,0.0,0.0
1013,1835,2020-03-20 06:35:00,1,3660.0,3027.0,0.827,17.774,185,139,77,62,46,2,44,128,0.0,0.02
1013,1836,2020-03-20 06:38:00,1,3653.0,2964.0,0.812,17.674,94,72,44,28,22,6,16,12,0.0,0.02
1013,1837,2020-03-20 06:41:00,1,3439.0,2896.0,0.842,16.756,267,142,100,42,125,92,33,19,0.0,0.05
1013,1838,2020-03-20 06:44:00,1,2901.0,2394.0,0.825,14.08,126,49,26,23,77,36,41,8,0.0,0.0
1013,1839,2020-03-20 06:47:00,1,2934.0,2371.0,0.808,14.184,218,98,66,32,120,67,53,6,0.1,0.0
1013,1840,2020-03-20 06:50:00,1,3476.0,2915.0,0.839,16.923,230,84,43,41,146,72,74,16,0.0,0.0
1013,1841,2020-03-20 06:53:00,1,3589.0,3039.0,0.847,17.504,439,269,198,71,170,95,75,25,0.0,0.0
1013,1842,2020-03-20 06:56:00,1,3643.0,3124.0,0.857,17.814,198,98,60,38,100,50,50,2,0.0,0.0
1013,1843,2020-03-20 06:59:00,1,3464.0,3027.0,0.874,16.999,138,70,55,15,68,52,16,0,0.0,0.0
1013,1844,2020-03-20 07:02:00,1,3284.0,2938.0,0.895,16.193,0,0,0,0,0,0,0,0,0.0,0.0
1013,1845,2020-03-20 07:05:00,1,2989.0,2712.0,0.907,14.781,6,3,2,1,3,1,2,0,0.0,0.0
1013,1846,2020-03-20 07:08:00,1,2899.0,2585.0,0.892,14.285,0,0,0,0,0,0,0,0,0.0,0.0
1013,1847,2020-03-20 07:11:00,1,2811.0,2421.0,0.861,13.756,1,1,1,0,0,0,0,0,0.0,0.0
1013,1848,2020-03-20 07:14:00,1,2499.0,2285.0,0.914,12.375,0,0,0,0,0,0,0,0,0.0,0.0
1013,1849,2020-03-20 07:17:00,1,2563.0,2304.0,0.899,12.649,153,90,60,30,63,36,27,58,0.0,0.0
1013,1850,2020-03-20 07:20:00,1,3458.0,2989.0,0.865,16.934,122,92,46,46,30,9,21,64,0.0,0.05
1013,1851,2020-03-20 07:23:00,1,3689.0,3293.0,0.893,18.179,104,75,25,50,29,6,23,76,0.0,0.13
1013,1852,2020-03-20 07:26:00,1,3604.0,3350.0,0.93,17.907,329,163,125,38,166,127,39,52,0.23,0.0
1013,1853,2020-03-20 07:29:00,1,2879.0,2538.0,0.882,14.152,88,33,18,15,55,33,22,0,0.0,0.0
1013,1854,2020-03-20 07:32:00,1,2314.0,1957.0,0.845,11.285,0,0,0,0,0,0,0,0,0.0,0.0
1013,1855,2020-03-20 07:35:00,1,2418.0,1980.0,0.819,11.718,4,1,1,0,3,1,2,0,0.0,0.0
1013,1856,2020-03-20 07:38:00,1,2496.0,2116.0,0.848,12.177,1,1,0,1,0,0,0,0,0.0,0.0
1013,1857,2020-03-20 07:41:00,1,3091.0,2865.0,0.927,15.349,2,2,0,2,0,0,0,0,0.0,0.0
1013,1858,2020-03-20 07:44:00,1,3012.0,2891.0,0.96,15.069,1,1,0,1,0,0,0,0,0.0,0.0
1013,1859,2020-03-20 07:47:00,1,3054.0,2773.0,0.908,15.103,6,6,4,2,0,0,0,0,0.0,0.0
1013,1860,2020-03-20 07:50:00,1,2854.0,2634.0,0.923,14.161,2,0,0,0,2,1,1,0,0.0,0.0
1013,1861,2020-03-20 07:53:00,1,2751.0,2542.0,0.924,13.653,82,54,36,18,28,16,12,0,0.0,0.0
1013,1862,2020-03-20 07:56:00,1,2704.0,2573.0,0.951,13.504,225,78,40,38,147,85,62,46,0.0,0.0
1013,1863,2020-03-20 07:59:00,1,3045.0,2820.0,0.926,15.12,183,124,68,56,59,45,14,90,0.0,0.06
1013,1864,2020-03-20 08:02:00,1,3203.0,3021.0,0.943,15.963,130,95,51,44,35,19,16,69,0.0,0.0
1013,1865,2020-03-20 08:05:00,1,3181.0,3036.0,0.954,15.896,189,86,60,26,103,66,37,59,0.0,0.0
1013,1866,2020-03-20 08:08:00,1,3218.0,2990.0,0.929,15.989,170,102,58,44,68,51,17,58,0.0,0.06
1013,1867,2020-03-20 08:11:00,1,3577.0,3215.0,0.899,17.652,103,88,46,42,15,6,9,44,0.0,0.06
1013,1868,2020-03-20 08:14:00,1,3178.0,2937.0,0.924,15.773,207,140,101,39,67,31,36,21,0.17,0.0
1013,1869,2020-03-20 08:17:00,1,2770.0,2438.0,0.88,13.615,132,48,22,26,84,46,38,5,0.0,0.0
1013,1870,2020-03-20 08:20:00,1,3445.0,3095.0,0.898,16.999,163,90,47,43,73,27,46,8,0.0,0.0
1013,1871,2020-03-20 08:23:00,1,3549.0,3186.0,0.898,17.51,74,26,9,17,48,17,31,1,0.0,0.0
1013,1872,2020-03-20 08:26:00,1,3402.0,3066.5,0.9015,16.798,24,8,0,8,16,7,9,0,0.0,0.0
1013,1873,2020-03-20 08:29:00,1,3255.0,2947.0,0.905,16.086,28,22,0,22,6,4,2,0,0.0,0.0
1013,1874,2020-03-20 08:32:00,1,3031.0,2835.0,0.936,15.079,17,11,1,10,6,3,3,0,0.0,0.0
1013,1875,2020-03-20 08:35:00,1,2882.0,2636.0,0.914,14.275,6,5,2,3,1,0,1,0,0.0,0.0
1013,1876,2020-03-20 08:38:00,1,2744.0,2485.0,0.906,13.561,12,3,0,3,9,2,7,0,0.0,0.0
1013,1877,2020-03-20 08:41:00,1,2726.0,2439.0,0.895,13.438,17,2,0,2,15,2,13,0,0.0,0.0
1013,1878,2020-03-20 08:44:00,1,2562.0,2240.0,0.875,12.573,12,0,0,0,12,0,12,0,0.0,0.0
1013,1879,2020-03-20 08:47:00,1,2353.0,2125.0,0.903,11.623,31,0,0,0,31,0,31,0,0.0,0.0
1013,1880,2020-03-20 08:50:00,1,2363.0,2066.0,0.874,11.596,151,83,61,22,68,38,30,25,0.0,0.0
1013,1881,2020-03-20 08:53:00,1,2898.0,2551.0,0.88,14.242,87,70,38,32,17,1,16,55,0.0,0.11
1013,1882,2020-03-20 08:56:00,1,3238.0,2934.0,0.906,16.005,119,100,56,44,19,7,12,65,0.0,0.09
1013,1883,2020-03-20 08:59:00,1,3284.0,3044.0,0.927,16.307,116,50,32,18,66,38,28,12,0.03,0.01
1013,1884,2020-03-20 09:02:00,1,2971.0,2701.0,0.909,14.695,77,40,19,21,37,9,28,11,0.0,0.01
1013,1885,2020-03-20 09:05:00,1,3324.0,3020.0,0.908,16.441,59,30,18,12,29,21,8,0,0.0,0.01
1013,1886,2020-03-20 09:08:00,1,3054.0,2912.0,0.953,15.258,6,5,1,4,1,0,1,0,0.0,0.0
1013,1887,2020-03-20 09:11:00,1,3059.0,2831.0,0.925,15.189,5,2,0,2,3,0,3,0,0.0,0.0
1013,1888,2020-03-20 09:14:00,1,2898.0,2694.0,0.93,14.402,6,5,1,4,1,0,1,0,0.0,0.0
1013,1889,2020-03-20 09:17:00,1,2678.0,2496.0,0.932,13.314,33,31,0,31,2,0,2,0,0.0,0.0
1013,1890,2020-03-20 09:20:00,1,2754.0,2500.0,0.908,13.621,40,11,2,9,29,15,14,0,0.0,0.0
1013,1891,2020-03-20 09:23:00,1,2671.0,2417.0,0.905,13.201,27,0,0,0,27,6,21,0,0.0,0.0
1013,1892,2020-03-20 09:26:00,1,2523.0,2350.0,0.931,12.544,68,38,20,18,30,16,14,0,0.0,0.0
1013,1893,2020-03-20 09:29:00,1,2504.0,2322.0,0.928,12.435,20,1,0,1,19,2,17,0,0.0,0.0
1013,1894,2020-03-20 09:32:00,1,2491.0,2267.0,0.91,12.326,19,1,0,1,18,0,18,0,0.0,0.0
1013,1895,2020-03-20 09:35:00,1,2517.0,2289.0,0.909,12.453,113,63,51,12,50,29,21,7,0.0,0.0
1013,1896,2020-03-20 09:38:00,1,2521.0,2293.0,0.909,12.473,10,2,1,1,8,3,5,0,0.0,0.0
1013,1897,2020-03-20 09:41:00,1,2396.0,2229.0,0.93,11.909,20,0,0,0,20,2,18,0,0.0,0.0
1013,1898,2020-03-20 09:44:00,1,2355.0,2244.0,0.953,11.764,1,0,0,0,1,0,1,0,0.0,0.0
1013,1899,2020-03-20 09:47:00,1,2317.0,2246.0,0.969,11.616,228,81,45,36,147,84,63,0,0.0,0.0
1013,1900,2020-03-20 09:50:00,1,2618.0,2483.0,0.949,13.062,162,47,29,18,115,58,57,53,0.0,0.0
1013,1901,2020-03-20 09:53:00,1,2729.0,2627.0,0.963,13.659,123,65,30,35,58,12,46,30,0.0,0.0
1013,1902,2020-03-20 09:56:00,1,2986.0,2876.0,0.963,14.949,162,102,64,38,60,19,41,99,0.0,0.01
1013,1903,2020-03-20 09:59:00,1,3343.0,3232.0,0.967,16.75,73,36,28,8,37,22,15,6,0.13,0.01
1013,1904,2020-03-20 10:02:00,1,3167.0,2980.0,0.941,15.778,37,12,10,2,25,5,20,0,0.0,0.0
1013,1905,2020-03-20 10:05:00,1,3008.0,2925.0,0.972,15.091,60,0,0,0,60,24,36,0,0.0,0.0
1013,1906,2020-03-20 10:08:00,1,3055.0,2829.0,0.926,15.168,35,0,0,0,35,15,20,0,0.0,0.0
1013,1907,2020-03-20 10:11:00,1,2862.0,2656.0,0.928,14.215,132,68,52,16,64,24,40,67,0.0,0.01
1013,1908,2020-03-20 10:14:00,1,3034.0,2962.0,0.976,15.231,189,121,74,47,68,32,36,89,0.0,0.1
1013,1909,2020-03-20 10:17:00,1,3379.0,3199.0,0.947,16.855,178,86,57,29,92,59,33,39,0.11,0.09
1013,1910,2020-03-20 10:20:00,1,3013.0,2928.0,0.972,15.111,263,94,64,30,169,121,48,19,0.0,0.0
1013,1911,2020-03-20 10:23:00,1,3394.0,3226.0,0.95,16.942,137,70,48,22,67,32,35,7,0.0,0.0
1013,1912,2020-03-20 10:26:00,1,2545.0,2388.0,0.938,12.673,203,92,39,53,111,76,35,26,0.0,0.0
1013,1913,2020-03-20 10:29:00,1,3371.0,3255.0,0.965,16.884,490,238,188,50,252,191,61,34,0.0,0.0
1013,1914,2020-03-20 10:32:00,1,3425.0,3301.0,0.964,17.147,895,434,343,91,461,351,110,69,0.0,0.0
1013,1915,2020-03-20 10:35:00,1,3353.0,3197.0,0.953,16.749,537,274,220,54,263,188,75,27,0.0,0.0
1013,1916,2020-03-20 10:38:00,1,3229.0,3060.0,0.948,16.111,306,167,128,39,139,93,46,11,0.0,0.0
1013,1917,2020-03-20 10:41:00,1,3227.0,3022.0,0.936,16.061,25,9,3,6,16,5,11,1,0.0,0.0
1013,1918,2020-03-20 10:44:00,1,3218.0,3007.0,0.935,16.007,137,69,28,41,68,24,44,3,0.0,0.0
1013,1919,2020-03-20 10:47:00,1,3012.0,2922.0,0.97,15.104,8,7,3,4,1,0,1,0,0.0,0.0
1013,1920,2020-03-20 10:50:00,1,2928.0,2677.0,0.914,14.5,3,3,1,2,0,0,0,0,0.0,0.0
1013,1921,2020-03-20 10:53:00,1,2723.0,2450.0,0.9,13.44,56,56,0,56,0,0,0,0,0.0,0.0
1013,1922,2020-03-20 10:56:00,1,2477.0,2352.0,0.95,12.362,24,1,1,0,23,3,20,0,0.0,0.0
1013,1923,2020-03-20 10:59:00,1,2495.0,2279.0,0.914,12.352,21,0,0,0,21,0,21,0,0.0,0.0
1013,1924,2020-03-20 11:02:00,1,2449.0,2250.0,0.919,12.139,0,0,0,0,0,0,0,0,0.0,0.0
1013,1925,2020-03-20 11:05:00,1,2328.0,2211.0,0.95,11.619,15,3,1,2,12,4,8,0,0.0,0.0
1013,1926,2020-03-20 11:08:00,1,2345.0,2217.0,0.946,11.694,1,0,0,0,1,0,1,0,0.0,0.0
1013,1927,2020-03-20 11:11:00,1,2321.0,2165.0,0.933,11.542,11,2,0,2,9,5,4,0,0.0,0.0
1013,1928,2020-03-20 11:14:00,1,2349.0,2182.0,0.929,11.67,1,0,0,0,1,0,1,0,0.0,0.0
1013,1929,2020-03-20 11:17:00,1,2359.0,2147.0,0.91,11.672,14,7,4,3,7,3,4,0,0.0,0.0
1013,1930,2020-03-20 11:20:00,1,2341.0,2218.0,0.948,11.679,3,0,0,0,3,0,3,0,0.0,0.0
1013,1931,2020-03-20 11:23:00,1,2339.0,2166.0,0.926,11.611,3,1,1,0,2,1,1,0,0.0,0.0
1013,1932,2020-03-20 11:26:00,1,2296.0,2133.0,0.929,11.406,2,1,0,1,1,0,1,0,0.0,0.0
1013,1933,2020-03-20 11:29:00,1,2253.0,2100.0,0.932,11.201,7,3,0,3,4,0,4,0,0.0,0.0
1013,1934,2020-03-20 11:32:00,1,2166.0,2081.0,0.961,10.838,6,3,0,3,3,0,3,0,0.0,0.0
1013,1935,2020-03-20 11:35:00,1,2218.0,2060.0,0.929,11.021,8,6,2,4,2,1,1,0,0.0,0.0
1013,1936,2020-03-20 11:38:00,1,2042.0,1937.0,0.949,10.19,4,2,0,2,2,1,1,0,0.0,0.0
1013,1937,2020-03-20 11:41:00,1,2121.0,1978.0,0.933,10.545,18,6,3,3,12,0,12,0,0.0,0.0
1013,1938,2020-03-20 11:44:00,1,2180.0,1967.0,0.902,10.766,2,0,0,0,2,0,2,0,0.0,0.0
1013,1939,2020-03-20 11:47:00,1,2090.0,1962.0,0.939,10.406,48,32,12,20,16,9,7,0,0.0,0.0
1013,1940,2020-03-20 11:50:00,1,2380.0,2189.0,0.92,11.799,48,20,15,5,28,13,15,0,0.0,0.0
1013,1941,2020-03-20 11:53:00,1,2365.0,2296.0,0.971,11.861,14,7,4,3,7,5,2,0,0.0,0.0
1013,1942,2020-03-20 11:56:00,1,2482.0,2295.0,0.924,12.321,197,133,81,52,64,23,41,87,0.0,0.0
1013,1943,2020-03-20 11:59:00,1,3031.0,2912.0,0.961,15.167,189,121,72,49,68,10,58,139,0.0,0.07
1013,1944,2020-03-20 12:02:00,1,3226.0,3096.0,0.96,16.139,129,89,47,42,40,0,40,91,0.0,0.07
1013,1945,2020-03-20 12:05:00,1,3508.0,3357.0,0.957,17.536,148,79,53,26,69,36,33,42,0.13,0.03
1013,1946,2020-03-20 12:08:00,1,3239.0,3178.0,0.981,16.279,240,103,72,31,137,95,42,26,0.0,0.0
1014,1,2020-03-16 10:53:00,1,4462.0,3154.0,0.707,21.072,1049,379,328,51,670,595,75,127,0.0,0.04
1014,2,2020-03-16 10:56:00,1,4552.0,3147.0,0.691,21.419,1074,377,298,79,697,599,98,71,0.0,0.0
1014,3,2020-03-16 10:59:00,1,4270.0,3076.0,0.72,20.231,754,261,201,60,493,417,76,93,0.0,0.0
1014,4,2020-03-16 11:02:00,1,4266.0,3121.0,0.732,20.266,765,261,197,64,504,398,106,85,0.0,0.0
1014,5,2020-03-16 11:05:00,1,4285.0,3060.0,0.714,20.271,736,286,219,67,450,347,103,85,0.0,0.0
1014,6,2020-03-16 11:08:00,1,4733.0,3339.0,0.705,22.344,934,375,299,76,559,450,109,75,0.0,0.0
1014,7,2020-03-16 11:11:00,1,4744.0,3331.0,0.702,22.379,611,243,189,54,368,281,87,123,0.03,0.0
1014,8,2020-03-16 11:14:00,1,4548.0,3210.0,0.706,21.472,482,180,136,44,302,233,69,62,0.01,0.0
1014,9,2020-03-16 11:17:00,1,4565.0,3148.0,0.69,21.474,415,130,82,48,285,200,85,44,0.0,0.0
1014,10,2020-03-16 11:20:00,1,4470.0,3131.0,0.7,21.078,500,177,118,59,323,232,91,22,0.0,0.0
1014,11,2020-03-16 11:23:00,1,4272.0,2992.0,0.7,20.145,453,164,124,40,289,207,82,11,0.0,0.0
1014,12,2020-03-16 11:26:00,1,4285.0,3009.0,0.702,20.215,515,159,122,37,356,270,86,16,0.0,0.05
1014,13,2020-03-16 11:29:00,1,4188.5,2919.5,0.697,19.735,193,58,38,20,135,72,63,29,0.0,0.0
1014,14,2020-03-16 11:32:00,1,4092.0,2830.0,0.692,19.255,500,195,151,44,305,232,73,39,0.01,0.0
1014,15,2020-03-16 11:35:00,1,3571.0,2487.0,0.696,16.826,378,70,39,31,308,212,96,14,0.0,0.0
1014,16,2020-03-16 11:38:00,1,3572.0,2549.0,0.714,16.898,289,32,16,16,257,163,94,7,0.0,0.0
1014,17,2020-03-16 11:41:00,1,3941.0,2775.0,0.704,18.601,413,169,139,30,244,171,73,92,0.0,0.0
1014,18,2020-03-16 11:44:00,1,3834.0,2723.0,0.71,18.121,594,179,140,39,415,307,108,49,0.0,0.0
1014,19,2020-03-16 11:47:00,1,3923.0,2754.0,0.702,18.508,546,194,149,45,352,252,100,51,0.0,0.0
1014,20,2020-03-16 11:50:00,1,3840.0,2743.0,0.714,18.166,550,173,126,47,377,286,91,66,0.0,0.0
1014,21,2020-03-16 11:53:00,1,3910.0,2767.0,0.708,18.468,279,104,74,30,175,113,62,47,0.0,0.0
1014,22,2020-03-16 11:56:00,1,3567.0,2567.0,0.72,16.896,307,49,22,27,258,181,77,4,0.01,0.0
1014,23,2020-03-16 11:59:00,1,3565.0,2588.0,0.726,16.91,326,53,25,28,273,204,69,3,0.0,0.0
1014,24,2020-03-16 12:02:00,1,3287.0,2371.0,0.721,15.574,141,45,12,33,96,31,65,0,0.0,0.0
1014,25,2020-03-16 12:05:00,1,3303.0,2327.0,0.704,15.59,105,26,0,26,79,21,58,0,0.01,0.0
1014,26,2020-03-16 12:08:00,1,3169.0,2079.0,0.656,14.79,73,16,6,10,57,8,49,0,0.0,0.0
1014,27,2020-03-16 12:11:00,1,2615.0,1746.0,0.668,12.237,68,2,0,2,66,0,66,0,0.0,0.0
1014,28,2020-03-16 12:14:00,1,3307.0,2249.0,0.68,15.52,366,153,109,44,213,133,80,28,0.0,0.0
1014,29,2020-03-16 12:17:00,1,3053.0,2044.0,0.67,14.291,178,41,29,12,137,60,77,3,0.0,0.0
1014,30,2020-03-16 12:20:00,1,2626.0,1651.0,0.629,12.177,122,7,4,3,115,34,81,0,0.0,0.0
1014,31,2020-03-16 12:23:00,1,2894.0,1872.0,0.647,13.476,186,4,1,3,182,101,81,0,0.01,0.0
1014,32,2020-03-16 12:26:00,1,2621.0,1712.0,0.653,12.222,77,1,0,1,76,0,76,0,0.0,0.0
1014,33,2020-03-16 12:29:00,1,2360.0,1452.0,0.615,10.906,73,0,0,0,73,0,73,0,0.0,0.0
1014,34,2020-03-16 12:32:00,1,2275.0,1434.0,0.63,10.549,85,15,4,11,70,0,70,0,0.0,0.0
1014,35,2020-03-16 12:35:00,1,2370.0,1476.0,0.623,10.972,79,11,6,5,68,0,68,0,0.0,0.0
1014,36,2020-03-16 12:38:00,1,2467.0,1484.0,0.602,11.362,128,6,4,2,122,42,80,0,0.0,0.0
1014,37,2020-03-16 12:41:00,1,2899.0,1885.0,0.65,13.509,122,0,0,0,122,46,76,0,0.0,0.0
1014,38,2020-03-16 12:44:00,1,2461.0,1505.0,0.612,11.364,99,22,7,15,77,6,71,0,0.0,0.0
1014,39,2020-03-16 12:47:00,1,2524.0,1663.0,0.659,11.784,81,5,4,1,76,0,76,0,0.0,0.0
1014,40,2020-03-16 12:50:00,1,2176.0,1377.0,0.633,10.101,66,0,0,0,66,0,66,0,0.0,0.0
1014,41,2020-03-16 12:53:00,1,1982.0,1296.0,0.654,9.246,83,0,0,0,83,2,81,0,0.0,0.0
1014,42,2020-03-16 12:56:00,1,1987.0,1296.0,0.652,9.263,99,19,11,8,80,2,78,0,0.0,0.0
1014,43,2020-03-16 12:59:00,1,2187.0,1356.0,0.62,10.119,132,52,24,28,80,4,76,0,0.0,0.0
1014,44,2020-03-16 13:02:00,1,2170.0,1393.0,0.642,10.092,77,0,0,0,77,0,77,0,0.0,0.0
1014,45,2020-03-16 13:05:00,1,2360.0,1502.0,0.636,10.963,88,12,9,3,76,2,74,0,0.0,0.0
1014,46,2020-03-16 13:08:00,1,2599.0,1772.0,0.682,12.203,222,0,0,0,222,117,105,0,0.0,0.0
1014,47,2020-03-16 13:11:00,1,2860.0,2029.0,0.709,13.513,218,8,5,3,210,107,103,0,0.0,0.0
1014,48,2020-03-16 13:14:00,1,2576.0,1847.0,0.717,12.193,80,10,5,5,70,6,64,0,0.0,0.0
1014,49,2020-03-16 13:17:00,1,2607.0,1744.0,0.669,12.205,76,11,4,7,65,0,65,0,0.0,0.0
1014,50,2020-03-16 13:20:00,1,2524.0,1676.0,0.664,11.801,118,14,7,7,104,29,75,0,0.0,0.0
1014,51,2020-03-16 13:23:00,1,2589.0,1827.0,0.706,12.222,172,1,0,1,171,84,87,0,0.0,0.0
1014,52,2020-03-16 13:26:00,1,2857.0,2016.0,0.706,13.488,85,18,12,6,67,9,58,0,0.0,0.0
1014,53,2020-03-16 13:29:00,1,2876.0,1956.0,0.68,13.498,67,0,0,0,67,0,67,0,0.0,0.0
1014,54,2020-03-16 13:32:00,1,2595.0,1834.0,0.707,12.256,67,0,0,0,67,0,67,0,0.0,0.0
1014,55,2020-03-16 13:35:00,1,2611.0,1750.0,0.67,12.227,68,0,0,0,68,0,68,0,0.0,0.0
1014,56,2020-03-16 13:38:00,1,2420.0,1657.0,0.685,11.369,75,3,3,0,72,0,72,0,0.0,0.0
1014,57,2020-03-16 13:41:00,1,2515.0,1677.0,0.667,11.767,67,1,0,1,66,3,63,0,0.0,0.0
1014,58,2020-03-16 13:44:00,1,2430.0,1634.0,0.673,11.384,76,0,0,0,76,0,76,0,0.0,0.0
1014,59,2020-03-16 13:47:00,1,2443.0,1572.0,0.643,11.366,142,0,0,0,142,58,84,0,0.0,0.0
1014,60,2020-03-16 13:50:00,1,2598.0,1759.0,0.677,12.185,79,12,6,6,67,0,67,0,0.0,0.0
1014,61,2020-03-16 13:53:00,1,2148.0,1511.0,0.704,10.135,88,16,10,6,72,0,72,0,0.0,0.0
1014,62,2020-03-16 13:56:00,1,2149.0,1488.0,0.693,10.115,70,0,0,0,70,0,70,0,0.0,0.0
1014,63,2020-03-16 13:59:00,1,2167.0,1439.0,0.664,10.132,86,6,4,2,80,0,80,0,0.0,0.0
1014,64,2020-03-16 14:02:00,1,2352.0,1520.0,0.646,10.951,110,34,1,33,76,4,72,0,0.0,0.0
1014,65,2020-03-16 14:05:00,1,2438.0,1595.0,0.654,11.371,76,1,0,1,75,0,75,0,0.0,0.0
1014,66,2020-03-16 14:08:00,1,2447.0,1578.0,0.645,11.389,77,8,0,8,69,0,69,0,0.0,0.0
1014,67,2020-03-16 14:11:00,1,2452.0,1558.0,0.635,11.387,129,17,0,17,112,33,79,0,0.0,0.0
1014,68,2020-03-16 14:14:00,1,2777.0,1908.0,0.687,13.054,130,3,0,3,127,40,87,0,0.0,0.0
1014,69,2020-03-16 14:17:00,1,2591.0,1814.0,0.7,12.219,329,134,98,36,195,108,87,1,0.0,0.0
1014,70,2020-03-16 14:20:00,1,3137.0,2142.0,0.683,14.731,175,39,27,12,136,54,82,0,0.0,0.0
1014,71,2020-03-16 14:23:00,1,3132.0,2180.0,0.696,14.754,220,37,2,35,183,96,87,1,0.0,0.0
1014,72,2020-03-16 14:26:00,1,3121.0,2198.0,0.704,14.731,366,146,113,33,220,138,82,53,0.0,0.0
1014,73,2020-03-16 14:29:00,1,3214.5,2265.0,0.7045,15.1725,288,70,60,10,218,125,93,9,0.0,0.0
1014,74,2020-03-16 14:32:00,1,3308.0,2332.0,0.705,15.614,280,88,32,56,192,94,98,2,0.0,0.0
1014,75,2020-03-16 14:35:00,1,3106.0,2251.0,0.725,14.732,265,92,56,36,173,91,82,15,0.0,0.0
1014,76,2020-03-16 14:38:00,1,3123.0,2215.0,0.709,14.757,195,27,15,12,168,78,90,0,0.0,0.0
1014,77,2020-03-16 14:41:00,1,3150.0,2163.0,0.686,14.808,390,115,90,25,275,182,93,15,0.0,0.0
1014,78,2020-03-16 14:44:00,1,2939.0,2087.0,0.71,13.892,383,60,37,23,323,204,119,0,0.0,0.0
1014,79,2020-03-16 14:47:00,1,2937.0,2106.0,0.717,13.905,127,4,1,3,123,43,80,0,0.0,0.0
1014,80,2020-03-16 14:50:00,1,2850.0,2080.0,0.73,13.533,294,22,4,18,272,164,108,0,0.0,0.0
1014,81,2020-03-16 14:53:00,1,2668.0,1919.0,0.719,12.638,70,1,0,1,69,0,69,0,0.0,0.0
1014,82,2020-03-16 14:56:00,1,2515.0,1730.0,0.688,11.825,62,0,0,0,62,0,62,0,0.0,0.0
1014,83,2020-03-16 14:59:00,1,2403.0,1685.0,0.701,11.335,133,2,0,2,131,44,87,0,0.0,0.0
1014,84,2020-03-16 15:02:00,1,2408.0,1685.0,0.7,11.353,122,5,0,5,117,33,84,0,0.0,0.0
1014,85,2020-03-16 15:05:00,1,2414.0,1664.0,0.689,11.354,69,0,0,0,69,0,69,0,0.0,0.0
1014,86,2020-03-16 15:08:00,1,2427.0,1611.0,0.664,11.348,79,3,0,3,76,0,76,0,0.0,0.0
1014,87,2020-03-16 15:11:00,1,2428.0,1646.0,0.678,11.388,76,0,0,0,76,0,76,0,0.0,0.0
1014,88,2020-03-16 15:14:00,1,2430.0,1629.0,0.67,11.376,244,77,61,16,167,82,85,4,0.0,0.0
1014,89,2020-03-16 15:17:00,1,2512.0,1744.0,0.694,11.83,106,0,0,0,106,31,75,0,0.0,0.0
1014,90,2020-03-16 15:20:00,1,2419.0,1672.0,0.691,11.381,115,2,0,2,113,28,85,0,0.0,0.0
1014,91,2020-03-16 15:23:00,1,2434.0,1625.0,0.668,11.392,79,1,0,1,78,6,72,0,0.0,0.0
1014,92,2020-03-16 15:26:00,1,2429.0,1608.0,0.662,11.352,78,3,0,3,75,4,71,0,0.0,0.0
1014,93,2020-03-16 15:29:00,1,2411.0,1708.0,0.708,11.391,92,8,0,8,84,0,84,0,0.0,0.0
1014,94,2020-03-16 15:32:00,1,2408.0,1664.0,0.691,11.33,70,0,0,0,70,0,70,0,0.0,0.0
1014,95,2020-03-16 15:35:00,1,2235.0,1581.0,0.707,10.555,80,4,1,3,76,0,76,0,0.0,0.0
1014,96,2020-03-16 15:38:00,1,2139.0,1558.0,0.728,10.151,74,4,0,4,70,0,70,0,0.0,0.0
1014,97,2020-03-16 15:41:00,1,2224.0,1570.0,0.706,10.5,78,1,0,1,77,0,77,0,0.0,0.0
1014,98,2020-03-16 15:44:00,1,2133.0,1551.0,0.727,10.12,90,6,1,5,84,0,84,0,0.0,0.0
1014,99,2020-03-16 15:47:00,1,2142.0,1513.0,0.706,10.116,75,1,0,1,74,0,74,0,0.0,0.0
1014,100,2020-03-16 15:50:00,1,2135.0,1541.0,0.722,10.12,85,4,2,2,81,0,81,0,0.0,0.0
1014,101,2020-03-16 15:53:00,1,2160.0,1469.0,0.68,10.137,85,5,1,4,80,0,80,0,0.0,0.0
1014,102,2020-03-16 15:56:00,1,2149.0,1496.0,0.696,10.125,68,0,0,0,68,0,68,0,0.0,0.0
1014,103,2020-03-16 15:59:00,1,2226.0,1582.0,0.711,10.523,90,12,8,4,78,0,78,0,0.0,0.0
1014,104,2020-03-16 16:02:00,1,2329.0,1609.0,0.691,10.958,92,6,2,4,86,0,86,0,0.0,0.0
1014,105,2020-03-16 16:05:00,1,2147.0,1508.0,0.702,10.131,100,27,7,20,73,2,71,0,0.0,0.0
1014,106,2020-03-16 16:08:00,1,2146.0,1507.0,0.702,10.122,83,0,0,0,83,0,83,0,0.0,0.0
1014,107,2020-03-16 16:11:00,1,2057.0,1433.0,0.697,9.693,80,4,1,3,76,0,76,0,0.0,0.0
1014,108,2020-03-16 16:14:00,1,2157.0,1470.0,0.682,10.125,88,11,0,11,77,0,77,0,0.0,0.0
1014,109,2020-03-16 16:17:00,1,2326.0,1611.0,0.693,10.947,72,5,3,2,67,0,67,0,0.0,0.0
1014,110,2020-03-16 16:20:00,1,2131.0,1563.0,0.733,10.125,121,0,0,0,121,48,73,0,0.0,0.0
1014,111,2020-03-16 16:23:00,1,2136.0,1546.0,0.724,10.128,86,1,1,0,85,8,77,0,0.0,0.0
1014,112,2020-03-16 16:26:00,1,2133.0,1556.0,0.729,10.129,77,1,1,0,76,8,68,0,0.0,0.0
1014,113,2020-03-16 16:29:00,1,2146.0,1494.0,0.696,10.108,176,68,50,18,108,33,75,0,0.0,0.0
1014,114,2020-03-16 16:32:00,1,2397.0,1739.0,0.726,11.369,109,38,2,36,71,0,71,0,0.0,0.0
1014,115,2020-03-16 16:35:00,1,2586.0,1803.0,0.697,12.187,144,21,5,16,123,42,81,0,0.0,0.0
1014,116,2020-03-16 16:38:00,1,2663.0,1940.0,0.729,12.641,256,128,93,35,128,56,72,22,0.0,0.0
1014,117,2020-03-16 16:41:00,1,2937.0,2122.0,0.722,13.922,291,97,63,34,194,104,90,20,0.0,0.0
1014,118,2020-03-16 16:44:00,1,2851.0,2030.0,0.712,13.48,100,0,0,0,100,30,70,0,0.0,0.0
1014,119,2020-03-16 16:47:00,1,2572.0,1868.0,0.726,12.202,70,4,3,1,66,0,66,0,0.0,0.0
1014,120,2020-03-16 16:50:00,1,2407.0,1698.0,0.705,11.363,80,7,4,3,73,2,71,0,0.0,0.0
1014,121,2020-03-16 16:53:00,1,2428.0,1637.0,0.674,11.379,92,0,0,0,92,16,76,0,0.0,0.0
1014,122,2020-03-16 16:56:00,1,2412.0,1680.0,0.697,11.363,82,0,0,0,82,9,73,0,0.0,0.0
1014,123,2020-03-16 16:59:00,1,2333.0,1594.0,0.683,10.955,65,0,0,0,65,0,65,0,0.0,0.0
1014,124,2020-03-16 17:02:00,1,2135.0,1522.0,0.713,10.1,98,29,1,28,69,0,69,0,0.0,0.0
1014,125,2020-03-16 17:05:00,1,2335.0,1585.0,0.679,10.956,73,0,0,0,73,0,73,0,0.0,0.0
1014,126,2020-03-16 17:08:00,1,2339.0,1580.0,0.675,10.966,67,0,0,0,67,0,67,0,0.0,0.0
1014,127,2020-03-16 17:11:00,1,2342.0,1577.0,0.673,10.975,87,0,0,0,87,0,87,0,0.0,0.0
1014,128,2020-03-16 17:14:00,1,2241.0,1549.0,0.691,10.544,77,1,0,1,76,0,76,0,0.0,0.0
1014,129,2020-03-16 17:17:00,1,2137.0,1518.0,0.71,10.099,80,2,1,1,78,0,78,0,0.0,0.0
1014,130,2020-03-16 17:20:00,1,2232.0,1557.0,0.698,10.52,104,3,0,3,101,23,78,0,0.0,0.0
1014,131,2020-03-16 17:23:00,1,2427.0,1620.0,0.668,11.355,155,47,14,33,108,29,79,0,0.0,0.0
1014,132,2020-03-16 17:26:00,1,2485.0,1776.0,0.715,11.756,172,11,0,11,161,77,84,0,0.0,0.0
1014,133,2020-03-16 17:29:00,1,2674.0,1904.0,0.7125,12.6435,350,150,100,50,200,113,87,17,0.0,0.0
1014,134,2020-03-16 17:32:00,1,2863.0,2032.0,0.71,13.531,452,127,94,33,325,231,94,18,0.0,0.0
1014,135,2020-03-16 17:35:00,1,2855.0,2026.0,0.71,13.493,253,57,35,22,196,114,82,9,0.0,0.04
1014,136,2020-03-16 17:38:00,1,2828.0,2129.0,0.753,13.502,497,107,80,27,390,299,91,8,0.0,0.0
1014,137,2020-03-16 17:41:00,1,2745.0,1989.0,0.725,13.018,195,47,14,33,148,70,78,0,0.0,0.0
1014,138,2020-03-16 17:44:00,1,2865.0,2010.0,0.702,13.514,87,12,1,11,75,0,75,0,0.0,0.0
1014,139,2020-03-16 17:47:00,1,2754.0,1991.0,0.723,13.057,145,39,9,30,106,27,79,0,0.0,0.0
1014,140,2020-03-16 17:50:00,1,2572.0,1900.0,0.739,12.238,137,1,1,0,136,51,85,0,0.0,0.0
1014,141,2020-03-16 17:53:00,1,2395.0,1758.0,0.734,11.382,75,0,0,0,75,0,75,0,0.0,0.0
1014,142,2020-03-16 17:56:00,1,2407.0,1670.0,0.694,11.333,74,0,0,0,74,0,74,0,0.0,0.0
1014,143,2020-03-16 17:59:00,1,2415.0,1672.0,0.692,11.367,72,0,0,0,72,0,72,0,0.0,0.0
1014,144,2020-03-16 18:02:00,0,2399.0,1715.0,0.715,11.35,142,1,1,0,141,56,85,0,0.0,0.0
1014,145,2020-03-16 18:05:00,0,2416.0,1705.0,0.706,11.408,92,17,1,16,75,0,75,0,0.0,0.0
1014,146,2020-03-16 18:08:00,0,2409.0,1719.0,0.714,11.394,82,4,1,3,78,0,78,0,0.0,0.0
1014,147,2020-03-16 18:11:00,0,2408.0,1728.0,0.718,11.399,73,0,0,0,73,0,73,0,0.0,0.0
1014,148,2020-03-16 18:14:00,0,2406.0,1690.0,0.703,11.351,110,0,0,0,110,30,80,0,0.0,0.0
1014,149,2020-03-16 18:17:00,0,2591.0,1796.0,0.693,12.196,93,20,9,11,73,0,73,0,0.0,0.0
1014,150,2020-03-16 18:20:00,0,2565.0,1882.0,0.734,12.189,68,2,2,0,66,0,66,0,0.0,0.0
1014,151,2020-03-16 18:23:00,0,2591.0,1847.0,0.713,12.255,72,1,0,1,71,0,71,0,0.0,0.0
1014,152,2020-03-16 18:26:00,0,2597.0,1786.0,0.688,12.211,117,8,2,6,109,33,76,0,0.0,0.0
1014,153,2020-03-16 18:29:00,0,2404.0,1732.0,0.72,11.39,83,11,1,10,72,0,72,0,0.0,0.0
1014,154,2020-03-16 18:32:00,0,2602.0,1779.0,0.683,12.223,271,150,112,38,121,58,63,28,0.0,0.0
1014,155,2020-03-16 18:35:00,0,2833.0,2082.0,0.735,13.469,495,192,148,44,303,227,76,91,0.0,0.0
1014,156,2020-03-16 18:38:00,0,3121.0,2245.0,0.72,14.782,313,112,67,45,201,117,84,46,0.0,0.0
1014,157,2020-03-16 18:41:00,0,3033.0,2143.0,0.707,14.323,530,228,179,49,302,228,74,99,0.0,0.0
1014,158,2020-03-16 18:44:00,0,3030.0,2176.0,0.718,14.347,493,186,145,41,307,227,80,76,0.28,0.0
1014,159,2020-03-16 18:47:00,0,3283.0,2393.0,0.729,15.584,328,120,78,42,208,132,76,37,0.07,0.0
1014,160,2020-03-16 18:50:00,0,2585.0,1852.0,0.717,12.234,394,163,114,49,231,141,90,57,0.0,0.0
1014,161,2020-03-16 18:53:00,0,3264.0,2489.0,0.763,15.615,498,192,134,58,306,220,86,62,0.0,0.0
1014,162,2020-03-16 18:56:00,0,2996.0,2278.0,0.76,14.327,682,315,255,60,367,275,92,118,0.0,0.0
1014,163,2020-03-16 18:59:00,0,2555.0,1997.0,0.782,12.277,696,264,197,67,432,333,99,28,0.0,0.0
1014,164,2020-03-16 19:02:00,0,3131.0,2557.0,0.817,15.166,629,232,180,52,397,302,95,63,0.0,0.0
1014,165,2020-03-16 19:05:00,0,2778.0,2320.0,0.835,13.514,419,145,100,45,274,190,84,26,0.0,0.0
1014,166,2020-03-16 19:08:00,0,3475.0,2922.0,0.841,16.925,520,205,148,57,315,231,84,68,0.0,0.0
1014,167,2020-03-16 19:11:00,0,3177.0,2815.0,0.886,15.634,664,271,206,65,393,302,91,84,0.0,0.01
1014,168,2020-03-16 19:14:00,0,3101.0,2681.0,0.865,15.185,602,318,257,61,284,214,70,109,0.0,0.0
1014,169,2020-03-16 19:17:00,0,3023.0,2587.0,0.856,14.775,684,245,188,57,439,386,53,128,0.0,0.0
1014,170,2020-03-16 19:20:00,0,2054.0,1826.0,0.889,10.116,232,76,40,36,156,133,23,25,0.0,0.0
1014,171,2020-03-16 19:23:00,0,2759.0,2383.0,0.864,13.511,261,84,44,40,177,152,25,38,0.0,0.0
1014,172,2020-03-16 19:26:00,0,3400.0,3143.0,0.924,16.875,533,186,135,51,347,306,41,76,0.0,0.0
1014,173,2020-03-16 19:29:00,0,3705.0,3233.0,0.873,18.179,483,201,148,53,282,243,39,27,0.0,0.0
1014,174,2020-03-16 19:32:00,0,3438.0,3007.0,0.875,16.875,465,156,105,51,309,281,28,76,0.0,0.0
1014,175,2020-03-16 19:35:00,0,1810.0,1587.0,0.877,8.889,463,168,121,47,295,252,43,40,0.0,0.0
1014,176,2020-03-16 19:38:00,0,3466.0,2953.0,0.852,16.927,310,129,73,56,181,172,9,106,0.0,0.0
1014,177,2020-03-16 19:41:00,0,2954.0,2518.0,0.852,14.426,228,112,64,48,116,111,5,48,0.0,0.08
1014,178,2020-03-16 19:44:00,0,1564.0,1293.0,0.827,7.594,54,36,16,20,18,18,0,0,0.0,0.0
1014,179,2020-03-16 19:47:00,0,2100.0,1690.0,0.805,10.145,202,71,27,44,131,116,15,3,0.0,0.0
1014,180,2020-03-16 19:50:00,0,3706.0,3228.0,0.871,18.177,573,247,191,56,326,286,40,83,0.0,0.0
1014,181,2020-03-16 19:53:00,0,2260.0,1853.0,0.82,10.954,496,164,124,40,332,283,49,25,0.0,0.0
1014,182,2020-03-16 19:56:00,0,3903.0,3414.0,0.875,19.159,587,162,97,65,425,387,38,64,0.0,0.01
1014,183,2020-03-16 19:59:00,0,3663.0,3334.0,0.91,18.124,454,170,117,53,284,219,65,28,0.07,0.0
1014,184,2020-03-16 20:02:00,0,3720.0,3212.0,0.863,18.213,235,113,76,37,122,55,67,35,0.01,0.0
1014,185,2020-03-16 20:05:00,0,3156.0,2911.0,0.922,15.658,567,210,157,53,357,270,87,42,0.0,0.0
1014,186,2020-03-16 20:08:00,0,3480.0,2933.0,0.843,16.959,268,115,78,37,153,93,60,25,0.0,0.0
1014,187,2020-03-16 20:11:00,0,2505.0,2091.0,0.835,12.183,303,121,69,52,182,106,76,74,0.0,0.0
1014,188,2020-03-16 20:14:00,0,3884.0,3310.0,0.852,18.968,377,134,75,59,243,154,89,77,0.0,0.11
1014,189,2020-03-16 20:17:00,0,2423.0,1983.0,0.818,11.744,326,115,80,35,211,139,72,43,0.02,0.0
1014,190,2020-03-16 20:20:00,0,2697.0,2234.0,0.829,13.098,536,247,204,43,289,217,72,108,0.0,0.0
1014,191,2020-03-16 20:23:00,0,3191.0,2745.0,0.86,15.61,511,258,204,54,253,191,62,122,0.01,0.0
1014,192,2020-03-16 20:26:00,0,2574.0,2291.0,0.89,12.679,469,239,183,56,230,171,59,28,0.03,0.01
1014,193,2020-03-16 20:29:00,0,2247.5,1918.0,0.847,10.98,239,139,90,49,100,61,39,15,0.0,0.0
1014,194,2020-03-16 20:32:00,0,1921.0,1545.0,0.804,9.281,219,81,32,49,138,77,61,8,0.0,0.0
1014,195,2020-03-16 20:35:00,0,2873.0,2344.0,0.816,13.915,67,23,10,13,44,28,16,5,0.0,0.0
1014,196,2020-03-16 20:38:00,0,3822.0,3177.0,0.831,18.576,277,109,63,46,168,109,59,64,0.0,0.0
1014,197,2020-03-16 20:41:00,0,3784.0,3284.0,0.868,18.546,414,173,130,43,241,184,57,105,0.0,0.06
1014,198,2020-03-16 20:44:00,0,3614.0,3174.0,0.878,17.755,469,200,155,45,269,193,76,42,0.06,0.0
1014,199,2020-03-16 20:47:00,0,2189.0,1746.0,0.797,10.56,426,200,135,65,226,139,87,3,0.01,0.0
1014,200,2020-03-16 20:50:00,0,2804.0,2265.0,0.808,13.557,537,232,185,47,305,223,82,20,0.0,0.0
1014,201,2020-03-16 20:53:00,0,2180.0,1742.0,0.799,10.517,125,62,32,30,63,39,24,4,0.0,0.0
1014,202,2020-03-16 20:56:00,0,3368.0,2884.0,0.856,16.463,307,72,33,39,235,166,69,6,0.0,0.0
1014,203,2020-03-16 20:59:00,0,3790.0,3347.0,0.883,18.637,312,98,48,50,214,138,76,22,0.01,0.0
1014,204,2020-03-16 21:02:00,0,3937.0,3483.0,0.885,19.37,383,146,90,56,237,154,83,57,0.0,0.0
1014,205,2020-03-16 21:05:00,0,2459.0,1938.0,0.788,11.835,206,108,66,42,98,59,39,0,0.0,0.0
1014,206,2020-03-16 21:08:00,0,1907.0,1587.0,0.832,9.271,50,2,1,1,48,0,48,0,0.0,0.0
1014,207,2020-03-16 21:11:00,0,3095.0,2688.0,0.869,15.169,469,212,150,62,257,167,90,69,0.0,0.02
1014,208,2020-03-16 21:14:00,0,4225.0,3730.0,0.883,20.775,343,122,66,56,221,147,74,46,0.42,0.02
1014,209,2020-03-16 21:17:00,0,3101.0,2739.0,0.883,15.248,285,112,76,36,173,115,58,27,0.0,0.0
1014,210,2020-03-16 21:20:00,0,1908.0,1597.0,0.837,9.287,142,0,0,0,142,70,72,0,0.0,0.0
1014,211,2020-03-16 21:23:00,0,1736.0,1451.0,0.836,8.446,102,7,4,3,95,28,67,0,0.0,0.0
1014,212,2020-03-16 21:26:00,0,1819.0,1541.0,0.847,8.872,98,10,3,7,88,35,53,0,0.0,0.0
1014,213,2020-03-16 21:29:00,0,1722.0,1472.0,0.855,8.416,110,42,33,9,68,16,52,4,0.0,0.0
1014,214,2020-03-16 21:32:00,0,3508.0,3142.0,0.896,17.298,385,186,126,60,199,125,74,70,0.14,0.01
1014,215,2020-03-16 21:35:00,0,4201.0,3761.0,0.895,20.718,291,112,81,31,179,118,61,46,0.0,0.0
1014,216,2020-03-16 21:38:00,0,3494.0,3142.0,0.899,17.246,385,189,138,51,196,133,63,63,0.0,0.04
1014,217,2020-03-16 21:41:00,0,2255.0,1910.0,0.847,10.998,608,251,187,64,357,270,87,19,0.0,0.0
1014,218,2020-03-16 21:44:00,0,3766.0,3329.0,0.884,18.523,979,373,294,79,606,482,124,33,0.0,0.01
1014,219,2020-03-16 21:47:00,0,2637.0,2407.0,0.913,13.056,110,44,25,19,66,18,48,21,0.0,0.0
1014,220,2020-03-16 21:50:00,0,3763.0,3455.0,0.918,18.651,334,152,89,63,182,118,64,62,0.0,0.01
1014,221,2020-03-16 21:53:00,0,3926.0,3639.0,0.927,19.496,255,91,60,31,164,103,61,18,0.0,0.01
1014,222,2020-03-16 21:56:00,0,2158.0,1854.0,0.859,10.554,82,28,2,26,54,2,52,0,0.0,0.0
1014,223,2020-03-16 21:59:00,0,1898.0,1647.0,0.868,9.301,70,13,7,6,57,4,53,0,0.0,0.0
1014,224,2020-03-16 22:02:00,0,2360.0,1877.0,0.795,11.378,69,8,4,4,61,14,47,0,0.0,0.0
1014,225,2020-03-16 22:05:00,0,2431.0,2009.0,0.826,11.804,49,1,0,1,48,0,48,0,0.0,0.0
1014,226,2020-03-16 22:08:00,0,2859.0,2385.0,0.834,13.906,53,2,0,2,51,0,51,0,0.0,0.0
1014,227,2020-03-16 22:11:00,0,3129.0,2585.0,0.826,15.192,44,1,0,1,43,0,43,0,0.0,0.0
1014,228,2020-03-16 22:14:00,0,3315.0,2684.0,0.809,16.034,276,141,110,31,135,88,47,27,0.0,0.0
1014,229,2020-03-16 22:17:00,0,3824.0,3199.0,0.837,18.61,351,145,91,54,206,137,69,43,0.0,0.01
1014,230,2020-03-16 22:20:00,0,2851.0,2446.0,0.858,13.942,31,6,3,3,25,0,25,1,0.0,0.0
1014,231,2020-03-16 22:23:00,0,3046.0,2470.0,0.811,14.735,212,43,20,23,169,119,50,1,0.0,0.0
1014,232,2020-03-16 22:26:00,0,3574.0,2962.0,0.829,17.362,301,13,4,9,288,206,82,3,0.0,0.0
1014,233,2020-03-16 22:29:00,0,3283.0,2839.0,0.865,16.076,265,103,67,36,162,96,66,47,0.0,0.04
1014,234,2020-03-16 22:32:00,0,3263.0,2871.0,0.88,16.036,470,258,198,60,212,149,63,47,0.0,0.0
1014,235,2020-03-16 22:35:00,0,3310.0,2718.0,0.821,16.05,349,161,115,46,188,128,60,59,0.06,0.0
1014,236,2020-03-16 22:38:00,0,2786.0,2291.0,0.822,13.512,180,93,65,28,87,44,43,4,0.0,0.0
1014,237,2020-03-16 22:41:00,0,2531.0,2050.0,0.81,12.241,93,55,24,31,38,0,38,0,0.0,0.0
1014,238,2020-03-16 22:44:00,0,2964.0,2404.0,0.811,14.341,48,3,1,2,45,0,45,0,0.0,0.0
1014,239,2020-03-16 22:47:00,0,3068.0,2462.0,0.803,14.813,46,0,0,0,46,0,46,0,0.0,0.0
1014,240,2020-03-16 22:50:00,0,2884.0,2336.0,0.81,13.948,43,10,3,7,33,0,33,0,0.0,0.0
1014,241,2020-03-16 22:53:00,0,2615.0,2174.0,0.831,12.71,45,11,5,6,34,0,34,0,0.0,0.0
1014,242,2020-03-16 22:56:00,0,2634.0,2051.0,0.779,12.647,30,0,0,0,30,0,30,0,0.0,0.0
1014,243,2020-03-16 22:59:00,0,2647.0,2007.0,0.758,12.651,37,0,0,0,37,0,37,0,0.0,0.0
1014,244,2020-03-16 23:02:00,0,2657.0,1972.0,0.742,12.652,30,0,0,0,30,0,30,0,0.0,0.0
1014,245,2020-03-16 23:05:00,0,2662.0,1981.0,0.744,12.683,38,9,4,5,29,0,29,0,0.0,0.0
1014,246,2020-03-16 23:08:00,0,2653.0,1991.0,0.75,12.658,42,14,5,9,28,2,26,0,0.0,0.0
1014,247,2020-03-16 23:11:00,0,2471.0,1872.0,0.757,11.809,34,6,2,4,28,0,28,0,0.0,0.0
1014,248,2020-03-16 23:14:00,0,2493.0,1784.0,0.716,11.797,36,6,3,3,30,0,30,0,0.0,0.0
1014,249,2020-03-16 23:17:00,0,2576.0,1889.0,0.733,12.242,29,1,0,1,28,0,28,0,0.0,0.0
1014,250,2020-03-16 23:20:00,0,2488.0,1849.0,0.743,11.852,44,2,0,2,42,7,35,0,0.0,0.0
1014,251,2020-03-16 23:23:00,0,2501.0,1770.0,0.708,11.815,47,7,1,6,40,1,39,0,0.0,0.0
1014,252,2020-03-16 23:26:00,0,2400.0,1760.0,0.733,11.406,48,14,0,14,34,0,34,0,0.0,0.0
1014,253,2020-03-16 23:29:00,0,2497.5,1765.0,0.7075,11.7955,187,96,70,26,91,54,37,15,0.0,0.0
1014,254,2020-03-16 23:32:00,0,2595.0,1770.0,0.682,12.185,55,25,9,16,30,4,26,0,0.0,0.0
1014,255,2020-03-16 23:35:00,0,2572.0,1849.0,0.719,12.181,237,128,87,41,109,59,50,46,0.0,0.0
1014,256,2020-03-16 23:38:00,0,2841.0,2027.0,0.714,13.44,334,163,117,46,171,114,57,35,0.0,0.0
1014,257,2020-03-16 23:41:00,0,2783.0,1895.0,0.681,13.062,286,124,84,40,162,98,64,16,0.0,0.0
1014,258,2020-03-16 23:44:00,0,3051.0,2137.0,0.7,14.388,141,62,29,33,79,40,39,0,0.0,0.0
1014,259,2020-03-16 23:47:00,0,2849.0,2059.0,0.723,13.504,252,151,91,60,101,67,34,15,0.0,0.0
1014,260,2020-03-16 23:50:00,0,2755.0,2034.0,0.738,13.106,183,99,49,50,84,50,34,24,0.0,0.0
1014,261,2020-03-16 23:53:00,0,3051.0,2105.0,0.69,14.352,110,67,25,42,43,8,35,0,0.0,0.0
1014,262,2020-03-16 23:56:00,0,2850.0,2066.0,0.725,13.517,107,33,10,23,74,31,43,0,0.0,0.0
1014,263,2020-03-16 23:59:00,0,2763.0,1940.0,0.702,13.036,40,7,1,6,33,4,29,0,0.0,0.0
1014,264,2020-03-17 00:02:00,0,2603.0,1796.0,0.69,12.244,33,0,0,0,33,0,33,0,0.0,0.0
1014,265,2020-03-17 00:05:00,0,2600.0,1781.0,0.685,12.217,42,0,0,0,42,0,42,0,0.0,0.0
1014,266,2020-03-17 00:08:00,0,2617.0,1726.0,0.66,12.221,43,7,2,5,36,0,36,0,0.0,0.0
1014,267,2020-03-17 00:11:00,0,2528.0,1679.0,0.664,11.82,39,0,0,0,39,0,39,0,0.0,0.0
1014,268,2020-03-17 00:14:00,0,2600.0,1751.0,0.673,12.183,47,11,2,9,36,2,34,0,0.0,0.0
1014,269,2020-03-17 00:17:00,0,2427.0,1644.0,0.677,11.384,49,0,0,0,49,2,47,0,0.0,0.0
1014,270,2020-03-17 00:20:00,0,2341.0,1567.0,0.669,10.956,47,5,1,4,42,0,42,0,0.0,0.0
1014,271,2020-03-17 00:23:00,0,2247.0,1528.0,0.68,10.544,44,5,0,5,39,3,36,0,0.0,0.0
1014,272,2020-03-17 00:26:00,0,2238.0,1514.0,0.676,10.496,36,3,1,2,33,2,31,0,0.0,0.0
1014,273,2020-03-17 00:29:00,0,2152.0,1474.0,0.685,10.11,39,2,0,2,37,4,33,0,0.0,0.0
1014,274,2020-03-17 00:32:00,0,2335.0,1586.0,0.679,10.955,34,2,0,2,32,2,30,0,0.0,0.0
1014,275,2020-03-17 00:35:00,0,2330.0,1605.0,0.689,10.959,35,6,0,6,29,0,29,0,0.0,0.0
1014,276,2020-03-17 00:38:00,0,2337.0,1594.0,0.682,10.972,48,0,0,0,48,4,44,0,0.0,0.0
1014,277,2020-03-17 00:41:00,0,2342.0,1570.0,0.67,10.966,61,1,0,1,60,13,47,0,0.0,0.0
1014,278,2020-03-17 00:44:00,0,2346.0,1528.0,0.651,10.934,43,3,1,2,40,4,36,0,0.0,0.0
1014,279,2020-03-17 00:47:00,0,2054.0,1439.0,0.7,9.687,31,0,0,0,31,0,31,0,0.0,0.0
1014,280,2020-03-17 00:50:00,0,2066.0,1379.0,0.667,9.668,55,9,0,9,46,2,44,0,0.0,0.0
1014,281,2020-03-17 00:53:00,0,2149.0,1518.0,0.706,10.149,57,19,11,8,38,9,29,0,0.0,0.0
1014,282,2020-03-17 00:56:00,0,2255.0,1525.0,0.676,10.575,34,0,0,0,34,0,34,0,0.0,0.0
1014,283,2020-03-17 00:59:00,0,2153.0,1476.0,0.686,10.118,48,4,1,3,44,0,44,0,0.0,0.0
1014,284,2020-03-17 01:02:00,0,2345.0,1513.0,0.645,10.916,42,1,0,1,41,0,41,0,0.0,0.0
1014,285,2020-03-17 01:05:00,0,2340.0,1554.0,0.664,10.942,36,2,1,1,34,0,34,0,0.0,0.0
1014,286,2020-03-17 01:08:00,0,2352.0,1539.0,0.654,10.972,50,6,1,5,44,0,44,0,0.0,0.0
1014,287,2020-03-17 01:11:00,0,2240.0,1507.0,0.673,10.494,38,5,1,4,33,0,33,0,0.0,0.0
1014,288,2020-03-17 01:14:00,0,2347.0,1550.0,0.661,10.964,86,40,23,17,46,2,44,2,0.0,0.0
1014,289,2020-03-17 01:17:00,0,2693.0,1868.0,0.694,12.678,198,99,73,26,99,56,43,23,0.0,0.0
1014,290,2020-03-17 01:20:00,0,2588.0,1796.0,0.694,12.187,145,69,15,54,76,25,51,0,0.0,0.0
1014,291,2020-03-17 01:23:00,0,2590.0,1844.0,0.712,12.248,142,53,14,39,89,35,54,2,0.0,0.0
1014,292,2020-03-17 01:26:00,0,2681.0,1881.0,0.702,12.645,187,86,56,30,101,63,38,17,0.0,0.0
1014,293,2020-03-17 01:29:00,0,2780.0,1932.0,0.695,13.095,219,89,50,39,130,77,53,43,0.0,0.0
1014,294,2020-03-17 01:32:00,0,2757.0,1966.0,0.713,13.04,537,193,138,55,344,251,93,26,0.3,0.0
1014,295,2020-03-17 01:35:00,0,3058.0,2072.0,0.678,14.346,71,34,27,7,37,11,26,10,0.0,0.0
1014,296,2020-03-17 01:38:00,0,3051.0,2070.0,0.679,14.312,109,70,36,34,39,10,29,3,0.0,0.0
1014,297,2020-03-17 01:41:00,0,2844.0,2024.0,0.712,13.448,43,8,2,6,35,0,35,0,0.0,0.0
1014,298,2020-03-17 01:44:00,0,2596.0,1834.0,0.706,12.261,44,10,0,10,34,0,34,0,0.0,0.0
1014,299,2020-03-17 01:47:00,0,2527.0,1663.0,0.658,11.799,52,8,0,8,44,1,43,0,0.0,0.0
1014,300,2020-03-17 01:50:00,0,2352.0,1550.0,0.659,10.984,290,110,78,32,180,114,66,0,0.0,0.0
1014,301,2020-03-17 01:53:00,0,2522.0,1708.0,0.677,11.828,810,323,251,72,487,376,111,12,0.0,0.0
1014,302,2020-03-17 01:56:00,0,2853.0,2016.0,0.707,13.473,350,164,118,46,186,140,46,38,0.0,0.0
1014,303,2020-03-17 01:59:00,0,2793.0,1872.0,0.67,13.079,254,90,51,39,164,100,64,29,0.0,0.0
1014,304,2020-03-17 02:02:00,0,1984.0,1315.0,0.663,9.272,372,160,111,49,212,151,61,0,0.0,0.0
1014,305,2020-03-17 02:05:00,0,2748.0,2042.0,0.743,13.089,306,143,83,60,163,120,43,26,0.0,0.0
1014,306,2020-03-17 02:08:00,0,3049.0,2123.0,0.696,14.365,329,164,119,45,165,110,55,91,0.0,0.0
1014,307,2020-03-17 02:11:00,0,3286.0,2348.0,0.715,15.547,209,68,27,41,141,84,57,41,0.0,0.07
1014,308,2020-03-17 02:14:00,0,3304.0,2260.0,0.684,15.523,302,94,58,36,208,139,69,74,0.0,0.0
1014,309,2020-03-17 02:17:00,0,3305.0,2348.0,0.711,15.621,384,160,108,52,224,152,72,56,0.0,0.01
1014,310,2020-03-17 02:20:00,0,2321.0,1683.0,0.725,11.007,184,46,32,14,138,78,60,2,0.0,0.0
1014,311,2020-03-17 02:23:00,0,3286.0,2424.0,0.738,15.631,574,273,224,49,301,224,77,10,0.0,0.0
1014,312,2020-03-17 02:26:00,0,3005.0,2234.0,0.743,14.314,206,89,60,29,117,77,40,14,0.0,0.0
1014,313,2020-03-17 02:29:00,0,2514.5,1897.5,0.757,12.0075,168,80,59,21,88,44,44,2,0.0,0.0
1014,314,2020-03-17 02:32:00,0,2024.0,1561.0,0.771,9.701,45,19,10,9,26,0,26,0,0.0,0.0
1014,315,2020-03-17 02:35:00,0,2022.0,1576.0,0.779,9.711,39,5,2,3,34,0,34,0,0.0,0.0
1014,316,2020-03-17 02:38:00,0,2303.0,1725.0,0.749,10.984,29,3,1,2,26,0,26,0,0.0,0.0
1014,317,2020-03-17 02:41:00,0,2572.0,1878.0,0.73,12.212,42,1,0,1,41,13,28,0,0.0,0.0
1014,318,2020-03-17 02:44:00,0,2570.0,1928.0,0.75,12.26,382,200,138,62,182,121,61,0,0.0,0.0
1014,319,2020-03-17 02:47:00,0,2760.0,1996.0,0.723,13.086,601,367,283,84,234,162,72,12,0.0,0.0
1014,320,2020-03-17 02:50:00,0,2747.0,2037.0,0.742,13.078,217,116,80,36,101,61,40,24,0.0,0.0
1014,321,2020-03-17 02:53:00,0,3037.0,2176.0,0.717,14.374,75,37,7,30,38,6,32,2,0.0,0.0
1014,322,2020-03-17 02:56:00,0,3011.0,2182.0,0.725,14.278,77,47,13,34,30,0,30,0,0.0,0.0
1014,323,2020-03-17 02:59:00,0,2945.0,2091.0,0.71,13.917,122,61,21,40,61,17,44,0,0.0,0.0
1014,324,2020-03-17 03:02:00,0,2745.0,2024.0,0.737,13.056,448,226,163,63,222,153,69,0,0.0,0.0
1014,325,2020-03-17 03:05:00,0,2748.0,2027.0,0.738,13.071,83,59,23,36,24,0,24,0,0.0,0.0
1014,326,2020-03-17 03:08:00,0,2751.0,2026.0,0.736,13.084,75,15,2,13,60,20,40,0,0.0,0.0
1014,327,2020-03-17 03:11:00,0,2759.0,1989.0,0.721,13.074,30,5,2,3,25,2,23,0,0.0,0.0
1014,328,2020-03-17 03:14:00,0,2595.0,1816.0,0.7,12.237,118,46,20,26,72,26,46,0,0.0,0.0
1014,329,2020-03-17 03:17:00,0,2529.0,1717.0,0.679,11.866,305,152,109,43,153,101,52,2,0.0,0.0
1014,330,2020-03-17 03:20:00,0,2516.0,1667.0,0.663,11.758,53,9,2,7,44,4,40,0,0.0,0.0
1014,331,2020-03-17 03:23:00,0,2335.0,1621.0,0.694,10.993,50,6,4,2,44,2,42,0,0.0,0.0
1014,332,2020-03-17 03:26:00,0,2330.0,1585.0,0.68,10.934,48,0,0,0,48,4,44,0,0.0,0.0
1014,333,2020-03-17 03:29:00,0,2345.0,1561.0,0.666,10.969,55,1,1,0,54,6,48,0,0.0,0.0
1014,334,2020-03-17 03:32:00,0,2340.0,1580.0,0.675,10.968,37,0,0,0,37,0,37,0,0.0,0.0
1014,335,2020-03-17 03:35:00,0,2322.0,1616.0,0.696,10.939,42,4,2,2,38,0,38,0,0.0,0.0
1014,336,2020-03-17 03:38:00,0,2340.0,1558.0,0.666,10.944,201,92,66,26,109,68,41,0,0.0,0.0
1014,337,2020-03-17 03:41:00,0,2244.0,1535.0,0.684,10.54,40,0,0,0,40,11,29,0,0.0,0.0
1014,338,2020-03-17 03:44:00,0,2043.0,1456.0,0.712,9.663,36,1,0,1,35,7,28,0,0.0,0.0
1014,339,2020-03-17 03:47:00,0,2046.0,1474.0,0.72,9.692,25,0,0,0,25,0,25,0,0.0,0.0
1014,340,2020-03-17 03:50:00,0,2061.0,1387.0,0.673,9.658,21,1,0,1,20,0,20,0,0.0,0.0
1014,341,2020-03-17 03:53:00,0,2063.0,1413.0,0.685,9.693,26,1,0,1,25,7,18,0,0.0,0.0
1014,342,2020-03-17 03:56:00,0,2061.0,1418.0,0.688,9.692,34,3,0,3,31,3,28,0,0.0,0.0
1014,343,2020-03-17 03:59:00,0,2356.0,1531.0,0.65,10.978,29,0,0,0,29,2,27,0,0.0,0.0
1014,344,2020-03-17 04:02:00,0,2353.0,1554.0,0.661,10.991,30,0,0,0,30,2,28,0,0.0,0.0
1014,345,2020-03-17 04:05:00,0,2052.0,1450.0,0.707,9.691,29,9,3,6,20,0,20,0,0.0,0.0
1014,346,2020-03-17 04:08:00,0,2047.0,1452.0,0.709,9.672,19,0,0,0,19,0,19,0,0.0,0.0
1014,347,2020-03-17 04:11:00,0,2056.0,1435.0,0.698,9.688,25,1,0,1,24,0,24,0,0.0,0.0
1014,348,2020-03-17 04:14:00,0,2345.0,1540.0,0.657,10.943,21,0,0,0,21,0,21,0,0.0,0.0
1014,349,2020-03-17 04:17:00,0,2045.0,1459.0,0.714,9.674,38,9,5,4,29,2,27,0,0.0,0.0
1014,350,2020-03-17 04:20:00,0,2067.0,1378.0,0.667,9.672,26,8,5,3,18,0,18,0,0.0,0.0
1014,351,2020-03-17 04:23:00,0,2055.0,1437.0,0.699,9.687,22,0,0,0,22,0,22,0,0.0,0.0
1014,352,2020-03-17 04:26:00,0,2042.0,1474.0,0.722,9.678,29,6,0,6,23,0,23,0,0.0,0.0
1014,353,2020-03-17 04:29:00,0,2345.0,1528.0,0.651,10.933,24,0,0,0,24,0,24,0,0.0,0.0
1014,354,2020-03-17 04:32:00,0,2050.0,1434.0,0.7,9.665,23,6,2,4,17,0,17,0,0.0,0.0
1014,355,2020-03-17 04:35:00,0,2072.0,1388.0,0.67,9.699,41,15,5,10,26,0,26,0,0.0,0.0
1014,356,2020-03-17 04:38:00,0,2071.0,1379.0,0.666,9.687,31,4,1,3,27,0,27,0,0.0,0.0
1014,357,2020-03-17 04:41:00,0,2073.0,1379.0,0.665,9.694,62,43,4,39,19,0,19,0,0.0,0.0
1014,358,2020-03-17 04:44:00,0,2246.0,1532.0,0.682,10.546,606,330,262,68,276,206,70,9,0.0,0.0
1014,359,2020-03-17 04:47:00,0,2333.0,1581.0,0.678,10.941,456,233,166,67,223,150,73,10,0.15,0.0
1014,360,2020-03-17 04:50:00,0,2512.0,1691.0,0.673,11.77,772,345,256,89,427,312,115,10,0.0,0.0
1014,361,2020-03-17 04:53:00,0,2609.0,1726.0,0.661,12.19,334,130,107,23,204,154,50,21,0.0,0.0
1014,362,2020-03-17 04:56:00,0,2949.0,2061.0,0.699,13.903,105,26,11,15,79,30,49,28,0.0,0.0
1014,363,2020-03-17 04:59:00,0,3060.0,2060.0,0.673,14.339,336,132,75,57,204,145,59,79,0.0,0.0
1014,364,2020-03-17 05:02:00,0,2046.0,1487.0,0.727,9.709,121,71,25,46,50,11,39,11,0.0,0.0
1014,365,2020-03-17 05:05:00,0,2955.0,2019.0,0.683,13.878,62,21,5,16,41,0,41,0,0.0,0.0
1014,366,2020-03-17 05:08:00,0,2754.0,1958.0,0.711,13.017,76,30,11,19,46,0,46,0,0.0,0.0
1014,367,2020-03-17 05:11:00,0,2759.0,1968.0,0.713,13.05,112,61,34,27,51,8,43,0,0.0,0.0
1014,368,2020-03-17 05:14:00,0,2685.0,1851.0,0.689,12.629,53,11,5,6,42,0,42,0,0.0,0.0
1014,369,2020-03-17 05:17:00,0,2518.0,1688.0,0.67,11.789,42,4,0,4,38,0,38,0,0.0,0.0
1014,370,2020-03-17 05:20:00,0,2242.0,1529.0,0.682,10.527,27,4,2,2,23,0,23,0,0.0,0.0
1014,371,2020-03-17 05:23:00,0,2153.0,1482.0,0.688,10.125,58,30,1,29,28,0,28,0,0.0,0.0
1014,372,2020-03-17 05:26:00,0,2356.0,1503.0,0.638,10.948,34,8,1,7,26,0,26,0,0.0,0.0
1014,373,2020-03-17 05:29:00,0,2352.0,1523.0,0.6475,10.955,33,1,0,1,32,0,32,0,0.0,0.0
1014,374,2020-03-17 05:32:00,0,2348.0,1543.0,0.657,10.962,47,1,0,1,46,4,42,0,0.0,0.0
1014,375,2020-03-17 05:35:00,0,2337.0,1590.0,0.68,10.967,43,0,0,0,43,6,37,0,0.0,0.0
1014,376,2020-03-17 05:38:00,0,2342.0,1566.0,0.669,10.961,35,6,2,4,29,2,27,0,0.0,0.0
1014,377,2020-03-17 05:41:00,0,2328.0,1607.0,0.69,10.953,240,110,77,33,130,88,42,2,0.0,0.0
1014,378,2020-03-17 05:44:00,0,2314.0,1644.0,0.71,10.939,186,94,58,36,92,57,35,8,0.0,0.0
1014,379,2020-03-17 05:47:00,0,2525.0,1697.0,0.672,11.827,53,22,7,15,31,0,31,0,0.0,0.0
1014,380,2020-03-17 05:50:00,0,2331.0,1608.0,0.69,10.965,41,7,3,4,34,0,34,0,0.0,0.0
1014,381,2020-03-17 05:53:00,0,2049.0,1478.0,0.722,9.709,31,0,0,0,31,2,29,0,0.0,0.0
1014,382,2020-03-17 05:56:00,0,1974.0,1349.0,0.683,9.272,47,6,3,3,41,4,37,0,0.0,0.0
1014,383,2020-03-17 05:59:00,0,1974.0,1344.0,0.681,9.265,37,0,0,0,37,0,37,0,0.0,0.0
1014,384,2020-03-17 06:02:00,1,1878.0,1314.0,0.699,8.855,43,3,1,2,40,0,40,0,0.0,0.0
1014,385,2020-03-17 06:05:00,1,2074.0,1392.0,0.671,9.715,36,3,0,3,33,0,33,0,0.0,0.0
1014,386,2020-03-17 06:08:00,1,2054.0,1446.0,0.704,9.696,44,4,0,4,40,0,40,0,0.0,0.0
1014,387,2020-03-17 06:11:00,1,2059.0,1434.0,0.697,9.699,34,5,0,5,29,0,29,0,0.0,0.0
1014,388,2020-03-17 06:14:00,1,2049.0,1435.0,0.7,9.66,30,0,0,0,30,0,30,0,0.0,0.0
1014,389,2020-03-17 06:17:00,1,2056.0,1421.0,0.691,9.676,28,4,0,4,24,0,24,0,0.0,0.0
1014,390,2020-03-17 06:20:00,1,2070.0,1394.0,0.674,9.699,31,4,0,4,27,0,27,0,0.0,0.0
1014,391,2020-03-17 06:23:00,1,2077.0,1337.0,0.644,9.664,33,0,0,0,33,0,33,0,0.0,0.0
1014,392,2020-03-17 06:26:00,1,1878.0,1300.0,0.692,8.84,28,1,0,1,27,0,27,0,0.0,0.0
1014,393,2020-03-17 06:29:00,1,1972.0,1335.0,0.677,9.249,45,0,0,0,45,6,39,0,0.0,0.0
1014,394,2020-03-17 06:32:00,1,2064.0,1400.0,0.678,9.684,42,0,0,0,42,0,42,0,0.0,0.0
1014,395,2020-03-17 06:35:00,1,2058.0,1432.0,0.696,9.695,75,10,5,5,65,0,65,0,0.0,0.0
1014,396,2020-03-17 06:38:00,1,2060.0,1423.0,0.691,9.693,73,1,1,0,72,0,72,0,0.0,0.0
1014,397,2020-03-17 06:41:00,1,2050.0,1465.0,0.715,9.701,55,0,0,0,55,0,55,0,0.0,0.0
1014,398,2020-03-17 06:44:00,1,2072.0,1397.0,0.674,9.711,73,5,1,4,68,0,68,0,0.0,0.0
1014,399,2020-03-17 06:47:00,1,2063.0,1397.0,0.677,9.677,57,8,4,4,49,0,49,0,0.0,0.0
1014,400,2020-03-17 06:50:00,1,2070.0,1380.0,0.667,9.682,89,28,2,26,61,0,61,0,0.0,0.0
1014,401,2020-03-17 06:53:00,1,1983.0,1344.0,0.678,9.3,80,12,1,11,68,0,68,0,0.0,0.0
1014,402,2020-03-17 06:56:00,1,2071.0,1364.0,0.659,9.669,54,2,0,2,52,0,52,0,0.0,0.0
1014,403,2020-03-17 06:59:00,1,2067.0,1407.0,0.681,9.703,56,3,0,3,53,0,53,0,0.0,0.0
1014,404,2020-03-17 07:02:00,1,2066.0,1397.0,0.676,9.686,60,3,2,1,57,0,57,0,0.0,0.0
1014,405,2020-03-17 07:05:00,1,2076.0,1368.0,0.659,9.693,64,11,4,7,53,0,53,0,0.0,0.0
1014,406,2020-03-17 07:08:00,1,2067.0,1416.0,0.685,9.711,62,2,0,2,60,0,60,0,0.0,0.0
1014,407,2020-03-17 07:11:00,1,2068.0,1429.0,0.691,9.731,116,41,20,21,75,16,59,1,0.0,0.0
1014,408,2020-03-17 07:14:00,1,2244.0,1520.0,0.677,10.525,95,25,9,16,70,5,65,0,0.0,0.0
1014,409,2020-03-17 07:17:00,1,2508.0,1693.0,0.675,11.755,257,116,76,40,141,78,63,3,0.0,0.0
1014,410,2020-03-17 07:20:00,1,2795.0,1922.0,0.688,13.139,401,163,113,50,238,171,67,88,0.0,0.0
1014,411,2020-03-17 07:23:00,1,2752.0,1965.0,0.714,13.021,251,87,65,22,164,102,62,41,0.0,0.0
1014,412,2020-03-17 07:26:00,1,2850.0,2019.0,0.709,13.463,99,49,26,23,50,6,44,2,0.0,0.0
1014,413,2020-03-17 07:29:00,1,2754.0,1985.0,0.721,13.051,76,18,13,5,58,4,54,0,0.0,0.0
1014,414,2020-03-17 07:32:00,1,2769.0,1960.0,0.708,13.082,147,57,27,30,90,35,55,0,0.0,0.0
1014,415,2020-03-17 07:35:00,1,2684.0,1866.0,0.695,12.641,309,143,88,55,166,112,54,87,0.0,0.0
1014,416,2020-03-17 07:38:00,1,3325.0,2253.0,0.678,15.593,350,190,137,53,160,113,47,74,0.0,0.0
1014,417,2020-03-17 07:41:00,1,2420.0,1661.0,0.686,11.376,287,151,103,48,136,88,48,61,0.0,0.0
1014,418,2020-03-17 07:44:00,1,3026.0,2183.0,0.722,14.34,364,183,120,63,181,110,71,91,0.0,0.01
1014,419,2020-03-17 07:47:00,1,3017.0,2193.0,0.727,14.315,409,165,114,51,244,173,71,77,0.0,0.0
1014,420,2020-03-17 07:50:00,1,2121.0,1581.0,0.746,10.107,544,227,169,58,317,244,73,54,0.01,0.0
1014,421,2020-03-17 07:53:00,1,2737.0,2029.0,0.741,13.032,349,176,147,29,173,130,43,148,0.0,0.09
1014,422,2020-03-17 07:56:00,1,2051.0,1459.0,0.711,9.696,446,186,129,57,260,195,65,2,0.0,0.0
1014,423,2020-03-17 07:59:00,1,3166.0,2447.0,0.773,15.186,369,178,120,58,191,127,64,10,0.0,0.0
1014,424,2020-03-17 08:02:00,1,2812.0,2188.0,0.778,13.5,136,33,17,16,103,34,69,1,0.0,0.0
1014,425,2020-03-17 08:05:00,1,2990.0,2306.0,0.771,14.335,135,50,16,34,85,12,73,0,0.0,0.0
1014,426,2020-03-17 08:08:00,1,3170.0,2421.0,0.764,15.171,112,26,3,23,86,23,63,0,0.0,0.0
1014,427,2020-03-17 08:11:00,1,2906.0,2255.0,0.776,13.947,124,38,22,16,86,23,63,0,0.0,0.0
1014,428,2020-03-17 08:14:00,1,2702.0,2171.0,0.803,13.049,556,261,201,60,295,207,88,11,0.0,0.0
1014,429,2020-03-17 08:17:00,1,2818.0,2159.0,0.766,13.492,183,69,42,27,114,63,51,6,0.18,0.0
1014,430,2020-03-17 08:20:00,1,2725.0,2106.0,0.773,13.068,73,12,0,12,61,0,61,1,0.0,0.0
1014,431,2020-03-17 08:23:00,1,2732.0,2103.0,0.77,13.091,111,32,2,30,79,22,57,0,0.0,0.0
1014,432,2020-03-17 08:26:00,1,2755.0,2015.0,0.731,13.084,115,2,0,2,113,62,51,0,0.0,0.0
1014,433,2020-03-17 08:29:00,1,2660.0,1948.5,0.7325,12.6365,198,0,0,0,198,128,70,0,0.0,0.0
1014,434,2020-03-17 08:32:00,1,2565.0,1882.0,0.734,12.189,137,1,0,1,136,70,66,0,0.0,0.0
1014,435,2020-03-17 08:35:00,1,2669.0,1931.0,0.724,12.652,144,80,47,33,64,0,64,0,0.0,0.0
1014,436,2020-03-17 08:38:00,1,2671.0,1917.0,0.718,12.646,121,58,30,28,63,4,59,0,0.0,0.0
1014,437,2020-03-17 08:41:00,1,2567.0,1887.0,0.735,12.203,76,10,4,6,66,0,66,0,0.0,0.0
1014,438,2020-03-17 08:44:00,1,2504.0,1745.0,0.697,11.798,72,14,1,13,58,0,58,0,0.0,0.0
1014,439,2020-03-17 08:47:00,1,2327.0,1606.0,0.69,10.946,69,9,0,9,60,0,60,0,0.0,0.0
1014,440,2020-03-17 08:50:00,1,2139.0,1526.0,0.713,10.117,90,5,3,2,85,16,69,0,0.0,0.0
1014,441,2020-03-17 08:53:00,1,2041.0,1488.0,0.729,9.691,72,5,2,3,67,2,65,0,0.0,0.0
1014,442,2020-03-17 08:56:00,1,2063.0,1396.0,0.677,9.673,68,0,0,0,68,0,68,0,0.0,0.0
1014,443,2020-03-17 08:59:00,1,2056.0,1459.0,0.71,9.717,63,2,1,1,61,0,61,0,0.0,0.0
1014,444,2020-03-17 09:02:00,1,2052.0,1463.0,0.713,9.706,69,3,1,2,66,2,64,0,0.0,0.0
1014,445,2020-03-17 09:05:00,1,2056.0,1458.0,0.709,9.715,236,3,0,3,233,145,88,0,0.0,0.0
1014,446,2020-03-17 09:08:00,1,2044.0,1461.0,0.715,9.671,69,6,0,6,63,0,63,0,0.0,0.0
1014,447,2020-03-17 09:11:00,1,2067.0,1391.0,0.673,9.684,113,47,0,47,66,0,66,0,0.0,0.0
1014,448,2020-03-17 09:14:00,1,2070.0,1371.0,0.662,9.675,173,48,16,32,125,54,71,0,0.0,0.0
1014,449,2020-03-17 09:17:00,1,2139.0,1543.0,0.722,10.137,117,54,7,47,63,2,61,0,0.0,0.0
1014,450,2020-03-17 09:20:00,1,2323.0,1639.0,0.706,10.969,137,72,29,43,65,2,63,2,0.0,0.0
1014,451,2020-03-17 09:23:00,1,2313.0,1686.0,0.729,10.981,97,20,3,17,77,0,77,0,0.0,0.0
1014,452,2020-03-17 09:26:00,1,2330.0,1595.0,0.685,10.946,81,4,0,4,77,0,77,0,0.0,0.0
1014,453,2020-03-17 09:29:00,1,2053.0,1480.0,0.721,9.726,76,2,1,1,74,0,74,0,0.0,0.0
1014,454,2020-03-17 09:32:00,1,2064.0,1398.0,0.677,9.679,71,0,0,0,71,8,63,0,0.0,0.0
1014,455,2020-03-17 09:35:00,1,2512.0,1748.0,0.696,11.832,348,153,111,42,195,119,76,19,0.0,0.0
1014,456,2020-03-17 09:38:00,1,2577.0,1868.0,0.725,12.221,59,1,1,0,58,0,58,0,0.0,0.0
1014,457,2020-03-17 09:41:00,1,2517.0,1710.0,0.679,11.811,69,8,3,5,61,0,61,0,0.0,0.0
1014,458,2020-03-17 09:44:00,1,2339.0,1575.0,0.673,10.958,62,2,0,2,60,0,60,0,0.0,0.0
1014,459,2020-03-17 09:47:00,1,2245.0,1528.0,0.681,10.539,67,1,0,1,66,0,66,0,0.0,0.0
1014,460,2020-03-17 09:50:00,1,2045.0,1462.0,0.715,9.677,71,0,0,0,71,0,71,0,0.0,0.0
1014,461,2020-03-17 09:53:00,1,2064.0,1429.0,0.692,9.714,66,3,0,3,63,2,61,0,0.0,0.0
1014,462,2020-03-17 09:56:00,1,2144.0,1484.0,0.692,10.089,73,6,0,6,67,0,67,0,0.0,0.0
1014,463,2020-03-17 09:59:00,1,2062.0,1417.0,0.687,9.691,82,5,0,5,77,0,77,0,0.0,0.0
1014,464,2020-03-17 10:02:00,1,2056.0,1416.0,0.689,9.671,72,0,0,0,72,0,72,0,0.0,0.0
1014,465,2020-03-17 10:05:00,1,2057.0,1453.0,0.706,9.714,104,18,7,11,86,2,84,0,0.0,0.0
1014,466,2020-03-17 10:08:00,1,2052.0,1437.0,0.7,9.675,78,0,0,0,78,0,78,0,0.0,0.0
1014,467,2020-03-17 10:11:00,1,1867.0,1336.0,0.716,8.836,82,0,0,0,82,10,72,0,0.0,0.0
1014,468,2020-03-17 10:14:00,1,1966.0,1375.0,0.699,9.268,116,28,25,3,88,8,80,2,0.0,0.0
1014,469,2020-03-17 10:17:00,1,2055.0,1414.0,0.688,9.663,171,85,51,34,86,46,40,14,0.0,0.0
1014,470,2020-03-17 10:20:00,1,2329.0,1617.0,0.694,10.967,295,117,89,28,178,103,75,5,0.0,0.0
1014,471,2020-03-17 10:23:00,1,2616.0,1751.0,0.669,12.245,111,35,8,27,76,2,74,1,0.0,0.0
1014,472,2020-03-17 10:26:00,1,2605.0,1790.0,0.687,12.245,90,22,6,16,68,0,68,0,0.0,0.0
1014,473,2020-03-17 10:29:00,1,2591.0,1778.0,0.686,12.179,110,19,0,19,91,18,73,0,0.0,0.0
1014,474,2020-03-17 10:32:00,1,2621.0,1747.0,0.666,12.263,77,11,2,9,66,2,64,0,0.0,0.0
1014,475,2020-03-17 10:35:00,1,2325.0,1612.0,0.693,10.948,80,6,3,3,74,8,66,0,0.0,0.0
1014,476,2020-03-17 10:38:00,1,2246.0,1537.0,0.684,10.551,78,11,2,9,67,0,67,0,0.0,0.0
1014,477,2020-03-17 10:41:00,1,2060.0,1414.0,0.686,9.683,101,30,19,11,71,1,70,0,0.0,0.0
1014,478,2020-03-17 10:44:00,1,2043.0,1472.0,0.72,9.678,364,152,96,56,212,134,78,8,0.0,0.0
1014,479,2020-03-17 10:47:00,1,2528.0,1682.0,0.665,11.825,526,188,143,45,338,260,78,32,0.0,0.0
1014,480,2020-03-17 10:50:00,1,2618.0,1763.0,0.673,12.268,134,44,30,14,90,44,46,1,0.0,0.0
1014,481,2020-03-17 10:53:00,1,2409.0,1695.0,0.703,11.369,56,0,0,0,56,0,56,0,0.0,0.0
1014,482,2020-03-17 10:56:00,1,2343.0,1572.0,0.671,10.973,43,2,1,1,41,0,41,0,0.0,0.0
1014,483,2020-03-17 10:59:00,1,2047.0,1461.0,0.714,9.682,56,8,6,2,48,0,48,0,0.0,0.0
1014,484,2020-03-17 11:02:00,1,2067.0,1382.0,0.669,9.674,54,0,0,0,54,0,54,0,0.0,0.0
1014,485,2020-03-17 11:05:00,1,2064.0,1410.0,0.683,9.692,63,0,0,0,63,0,63,0,0.0,0.0
1014,486,2020-03-17 11:08:00,1,2069.0,1409.0,0.681,9.714,50,0,0,0,50,2,48,0,0.0,0.0
1014,487,2020-03-17 11:11:00,1,2057.0,1377.0,0.669,9.628,53,0,0,0,53,0,53,0,0.0,0.0
1014,488,2020-03-17 11:14:00,1,2065.0,1359.0,0.658,9.643,59,6,2,4,53,3,50,0,0.0,0.0
1014,489,2020-03-17 11:17:00,1,2070.0,1397.0,0.675,9.703,66,2,1,1,64,0,64,0,0.0,0.0
1014,490,2020-03-17 11:20:00,1,2069.0,1423.0,0.688,9.728,72,17,2,15,55,0,55,0,0.0,0.0
1014,491,2020-03-17 11:23:00,1,2048.0,1450.0,0.708,9.675,86,21,9,12,65,6,59,0,0.0,0.0
1014,492,2020-03-17 11:26:00,1,2074.0,1367.0,0.659,9.685,56,1,0,1,55,0,55,0,0.0,0.0
1014,493,2020-03-17 11:29:00,1,1984.0,1321.5,0.6665,9.2805,63,10,3,7,53,0,53,0,0.0,0.0
1014,494,2020-03-17 11:32:00,1,1894.0,1276.0,0.674,8.876,58,3,0,3,55,0,55,0,0.0,0.0
1014,495,2020-03-17 11:35:00,1,1888.0,1286.0,0.681,8.864,62,7,3,4,55,0,55,0,0.0,0.0
1014,496,2020-03-17 11:38:00,1,1884.0,1269.0,0.674,8.83,49,0,0,0,49,0,49,0,0.0,0.0
1014,497,2020-03-17 11:41:00,1,1885.0,1263.0,0.67,8.827,52,0,0,0,52,2,50,0,0.0,0.0
1014,498,2020-03-17 11:44:00,1,1881.0,1272.0,0.676,8.821,51,0,0,0,51,0,51,0,0.0,0.0
1014,499,2020-03-17 11:47:00,1,1892.0,1259.0,0.666,8.848,60,0,0,0,60,0,60,0,0.0,0.0
1014,500,2020-03-17 11:50:00,1,1891.0,1274.0,0.674,8.861,55,0,0,0,55,0,55,0,0.0,0.0
1014,501,2020-03-17 11:53:00,1,1892.0,1240.0,0.655,8.828,100,19,0,19,81,0,81,0,0.0,0.0
1014,502,2020-03-17 11:56:00,1,1887.0,1251.0,0.663,8.82,72,14,3,11,58,0,58,0,0.0,0.0
1014,503,2020-03-17 11:59:00,1,1876.0,1316.0,0.701,8.85,64,14,9,5,50,2,48,0,0.0,0.0
1014,504,2020-03-17 12:02:00,1,1890.0,1277.0,0.676,8.862,57,1,0,1,56,0,56,0,0.0,0.0
1014,505,2020-03-17 12:05:00,1,1879.0,1296.0,0.69,8.837,61,0,0,0,61,0,61,0,0.0,0.0
1014,506,2020-03-17 12:08:00,1,1881.0,1288.0,0.684,8.838,53,0,0,0,53,0,53,0,0.0,0.0
1014,507,2020-03-17 12:11:00,1,1879.0,1331.0,0.708,8.879,52,0,0,0,52,0,52,0,0.0,0.0
1014,508,2020-03-17 12:14:00,1,1891.0,1282.0,0.678,8.869,49,2,1,1,47,2,45,0,0.0,0.0
1014,509,2020-03-17 12:17:00,1,1892.0,1252.0,0.662,8.841,53,0,0,0,53,0,53,0,0.0,0.0
1014,510,2020-03-17 12:20:00,1,2069.0,1357.0,0.656,9.656,67,13,2,11,54,6,48,0,0.0,0.0
1014,511,2020-03-17 12:23:00,1,2347.0,1572.0,0.67,10.988,96,20,3,17,76,16,60,0,0.0,0.0
1014,512,2020-03-17 12:26:00,1,2333.0,1612.0,0.691,10.977,197,51,35,16,146,84,62,20,0.0,0.0
1014,513,2020-03-17 12:29:00,1,2510.0,1744.0,0.695,11.822,241,99,65,34,142,78,64,9,0.23,0.0
1014,514,2020-03-17 12:32:00,1,2600.0,1826.0,0.703,12.265,257,134,81,53,123,57,66,0,0.0,0.0
1014,515,2020-03-17 12:35:00,1,2623.0,1762.0,0.672,12.286,894,381,311,70,513,389,124,6,0.0,0.0
1014,516,2020-03-17 12:38:00,1,2688.0,1845.0,0.687,12.633,317,133,83,50,184,115,69,44,0.0,0.0
1014,517,2020-03-17 12:41:00,1,2594.0,1785.0,0.688,12.198,808,406,309,97,402,289,113,32,0.0,0.0
1014,518,2020-03-17 12:44:00,1,2783.0,1913.0,0.687,13.085,1373,457,358,99,916,773,143,3,0.0,0.0
1014,519,2020-03-17 12:47:00,1,2762.0,1940.0,0.702,13.03,399,200,146,54,199,134,65,34,0.0,0.0
1014,520,2020-03-17 12:50:00,1,2965.0,2011.0,0.678,13.909,353,113,69,44,240,156,84,84,0.0,0.0
1014,521,2020-03-17 12:53:00,1,3060.0,2084.0,0.681,14.363,208,80,53,27,128,67,61,7,0.0,0.0
1014,522,2020-03-17 12:56:00,1,2052.0,1440.0,0.702,9.678,289,91,58,33,198,121,77,6,0.0,0.0
1014,523,2020-03-17 12:59:00,1,2768.0,1934.0,0.699,13.048,472,238,156,82,234,169,65,3,0.0,0.0
1014,524,2020-03-17 13:02:00,1,2788.0,1863.0,0.668,13.048,618,305,240,65,313,227,86,1,0.0,0.0
1014,525,2020-03-17 13:05:00,1,2602.0,1764.0,0.678,12.204,153,23,8,15,130,60,70,0,0.0,0.0
1014,526,2020-03-17 13:08:00,1,2606.0,1748.0,0.671,12.204,582,230,171,59,352,243,109,0,0.0,0.0
1014,527,2020-03-17 13:11:00,1,2599.0,1786.0,0.687,12.217,99,8,2,6,91,20,71,1,0.0,0.0
1014,528,2020-03-17 13:14:00,1,2624.0,1715.0,0.654,12.238,92,13,8,5,79,8,71,0,0.0,0.0
1014,529,2020-03-17 13:17:00,1,2515.0,1703.0,0.677,11.797,98,11,4,7,87,16,71,0,0.0,0.0
1014,530,2020-03-17 13:20:00,1,2510.0,1703.0,0.679,11.775,171,29,3,26,142,57,85,0,0.0,0.0
1014,531,2020-03-17 13:23:00,1,2617.0,1713.0,0.654,12.207,135,26,12,14,109,37,72,0,0.0,0.0
1014,532,2020-03-17 13:26:00,1,2625.0,1703.0,0.649,12.231,152,33,11,22,119,48,71,0,0.0,0.0
1014,533,2020-03-17 13:29:00,1,2309.0,1625.0,0.704,10.897,88,14,6,8,74,2,72,0,0.0,0.0
1014,534,2020-03-17 13:32:00,1,2253.0,1536.0,0.682,10.576,91,12,0,12,79,12,67,0,0.0,0.0
1014,535,2020-03-17 13:35:00,1,2058.0,1439.0,0.699,9.701,89,4,0,4,85,12,73,0,0.0,0.0
1014,536,2020-03-17 13:38:00,1,2061.0,1430.0,0.694,9.704,59,0,0,0,59,4,55,0,0.0,0.0
1014,537,2020-03-17 13:41:00,1,2047.0,1457.0,0.712,9.679,60,3,0,3,57,0,57,0,0.0,0.0
1014,538,2020-03-17 13:44:00,1,2062.0,1425.0,0.691,9.702,63,0,0,0,63,6,57,0,0.0,0.0
1014,539,2020-03-17 13:47:00,1,2055.0,1431.0,0.697,9.68,137,0,0,0,137,76,61,0,0.0,0.0
1014,540,2020-03-17 13:50:00,1,2059.0,1414.0,0.687,9.679,156,0,0,0,156,84,72,0,0.0,0.0
1014,541,2020-03-17 13:53:00,1,2069.0,1396.0,0.675,9.697,62,0,0,0,62,0,62,0,0.0,0.0
1014,542,2020-03-17 13:56:00,1,2051.0,1426.0,0.695,9.661,65,0,0,0,65,0,65,0,0.0,0.0
1014,543,2020-03-17 13:59:00,1,2076.0,1357.0,0.654,9.682,59,6,1,5,53,0,53,0,0.0,0.0
1014,544,2020-03-17 14:02:00,1,2075.0,1369.0,0.66,9.69,99,26,13,13,73,12,61,0,0.0,0.0
1014,545,2020-03-17 14:05:00,1,2077.0,1338.0,0.644,9.664,69,8,2,6,61,0,61,0,0.0,0.0
1014,546,2020-03-17 14:08:00,1,2071.0,1359.0,0.656,9.663,71,12,4,8,59,0,59,0,0.0,0.0
1014,547,2020-03-17 14:11:00,1,2069.0,1405.0,0.679,9.709,97,24,15,9,73,18,55,0,0.0,0.0
1014,548,2020-03-17 14:14:00,1,1986.0,1325.0,0.667,9.294,54,0,0,0,54,2,52,0,0.0,0.0
1014,549,2020-03-17 14:17:00,1,1879.0,1316.0,0.701,8.86,71,3,1,2,68,0,68,0,0.0,0.0
1014,550,2020-03-17 14:20:00,1,2081.0,1362.0,0.654,9.708,73,2,1,1,71,0,71,0,0.0,0.0
1014,551,2020-03-17 14:23:00,1,2067.0,1396.0,0.676,9.69,110,15,10,5,95,13,82,0,0.0,0.0
1014,552,2020-03-17 14:26:00,1,2044.0,1475.0,0.722,9.685,96,6,3,3,90,19,71,0,0.0,0.0
1014,553,2020-03-17 14:29:00,1,2062.0,1427.5,0.693,9.7045,77,6,0,6,71,4,67,0,0.0,0.0
1014,554,2020-03-17 14:32:00,1,2080.0,1380.0,0.664,9.724,93,8,5,3,85,6,79,0,0.0,0.0
1014,555,2020-03-17 14:35:00,1,1984.0,1343.0,0.677,9.305,387,155,113,42,232,140,92,3,0.0,0.0
1014,556,2020-03-17 14:38:00,1,2145.0,1495.0,0.697,10.108,572,264,210,54,308,220,88,19,0.05,0.0
1014,557,2020-03-17 14:41:00,1,2590.0,1744.0,0.673,12.135,387,173,132,41,214,137,77,5,0.0,0.0
1014,558,2020-03-17 14:44:00,1,2609.0,1754.0,0.672,12.224,80,7,0,7,73,0,73,0,0.0,0.0
1014,559,2020-03-17 14:47:00,1,2618.0,1742.0,0.665,12.245,180,59,10,49,121,44,77,0,0.0,0.0
1014,560,2020-03-17 14:50:00,1,2607.0,1780.0,0.683,12.243,121,24,4,20,97,22,75,0,0.0,0.0
1014,561,2020-03-17 14:53:00,1,2408.0,1667.0,0.692,11.335,85,4,1,3,81,13,68,0,0.0,0.0
1014,562,2020-03-17 14:56:00,1,2146.0,1523.0,0.71,10.141,109,21,8,13,88,16,72,0,0.0,0.0
1014,563,2020-03-17 14:59:00,1,2072.0,1406.0,0.679,9.719,55,0,0,0,55,0,55,0,0.0,0.0
1014,564,2020-03-17 15:02:00,1,2074.0,1386.0,0.668,9.706,113,15,7,8,98,32,66,0,0.0,0.0
1014,565,2020-03-17 15:05:00,1,2047.0,1444.0,0.706,9.662,71,0,0,0,71,19,52,0,0.0,0.0
1014,566,2020-03-17 15:08:00,1,2077.0,1384.0,0.666,9.716,65,8,6,2,57,2,55,0,0.0,0.0
1014,567,2020-03-17 15:11:00,1,2078.0,1338.0,0.644,9.672,57,1,0,1,56,2,54,0,0.0,0.0
1014,568,2020-03-17 15:14:00,1,2060.0,1420.0,0.689,9.687,99,22,12,10,77,18,59,0,0.0,0.0
1014,569,2020-03-17 15:17:00,1,2061.0,1408.0,0.683,9.679,95,14,4,10,81,20,61,0,0.0,0.0
1014,570,2020-03-17 15:20:00,1,2064.0,1400.0,0.678,9.681,72,14,7,7,58,7,51,0,0.0,0.0
1014,571,2020-03-17 15:23:00,1,2068.0,1396.0,0.675,9.694,63,0,0,0,63,3,60,0,0.0,0.0
1014,572,2020-03-17 15:26:00,1,2050.0,1449.0,0.707,9.683,68,1,1,0,67,6,61,0,0.0,0.0
1014,573,2020-03-17 15:29:00,1,2255.0,1539.0,0.683,10.589,67,5,3,2,62,4,58,0,0.0,0.0
1014,574,2020-03-17 15:32:00,1,2060.0,1421.0,0.69,9.691,77,20,0,20,57,0,57,0,0.0,0.0
1014,575,2020-03-17 15:35:00,1,2071.0,1359.0,0.656,9.663,75,2,0,2,73,17,56,0,0.0,0.0
1014,576,2020-03-17 15:38:00,1,1882.0,1307.0,0.694,8.864,86,1,0,1,85,17,68,0,0.0,0.0
1014,577,2020-03-17 15:41:00,1,1877.0,1321.0,0.704,8.857,72,11,5,6,61,8,53,0,0.0,0.0
1014,578,2020-03-17 15:44:00,1,1873.0,1336.0,0.713,8.857,77,11,5,6,66,2,64,0,0.0,0.0
1014,579,2020-03-17 15:47:00,1,1882.0,1288.0,0.684,8.843,84,14,4,10,70,2,68,0,0.0,0.0
1014,580,2020-03-17 15:50:00,1,1883.0,1292.0,0.686,8.849,131,39,8,31,92,33,59,0,0.0,0.0
1014,581,2020-03-17 15:53:00,1,2058.0,1423.0,0.691,9.686,183,121,65,56,62,18,44,0,0.0,0.0
1014,582,2020-03-17 15:56:00,1,2044.0,1509.0,0.738,9.726,118,51,15,36,67,16,51,0,0.0,0.0
1014,583,2020-03-17 15:59:00,1,2336.0,1609.0,0.689,10.988,186,82,36,46,104,57,47,29,0.0,0.0
1014,584,2020-03-17 16:02:00,1,2592.0,1813.0,0.699,12.22,281,145,88,57,136,76,60,94,0.0,0.0
1014,585,2020-03-17 16:05:00,1,2498.0,1735.0,0.695,11.765,330,162,124,38,168,125,43,43,0.0,0.0
1014,586,2020-03-17 16:08:00,1,2616.0,1763.0,0.674,12.262,558,252,195,57,306,239,67,44,0.0,0.0
1014,587,2020-03-17 16:11:00,1,2439.0,1668.0,0.684,11.456,132,36,9,27,96,33,63,0,0.0,0.0
1014,588,2020-03-17 16:14:00,1,2592.0,1851.0,0.714,12.263,132,32,3,29,100,36,64,0,0.0,0.0
1014,589,2020-03-17 16:17:00,1,2586.0,1815.0,0.702,12.197,98,35,9,26,63,16,47,0,0.0,0.0
1014,590,2020-03-17 16:20:00,1,2518.0,1725.0,0.685,11.83,53,6,4,2,47,4,43,0,0.0,0.0
1014,591,2020-03-17 16:23:00,1,2334.0,1587.0,0.68,10.954,56,0,0,0,56,0,56,0,0.0,0.0
1014,592,2020-03-17 16:26:00,1,2148.0,1505.0,0.701,10.131,44,2,0,2,42,2,40,0,0.0,0.0
1014,593,2020-03-17 16:29:00,1,2067.0,1437.0,0.696,9.734,45,0,0,0,45,0,45,0,0.0,0.0
1014,594,2020-03-17 16:32:00,1,2064.0,1371.0,0.664,9.652,35,0,0,0,35,0,35,0,0.0,0.0
1014,595,2020-03-17 16:35:00,1,2074.0,1408.0,0.679,9.73,36,0,0,0,36,0,36,0,0.0,0.0
1014,596,2020-03-17 16:38:00,1,2067.0,1421.0,0.688,9.718,36,0,0,0,36,0,36,0,0.0,0.0
1014,597,2020-03-17 16:41:00,1,2080.0,1359.0,0.653,9.701,44,2,0,2,42,0,42,0,0.0,0.0
1014,598,2020-03-17 16:44:00,1,2062.0,1407.0,0.682,9.684,50,5,1,4,45,0,45,0,0.0,0.0
1014,599,2020-03-17 16:47:00,1,2253.0,1496.0,0.664,10.534,71,12,2,10,59,14,45,0,0.0,0.0
1014,600,2020-03-17 16:50:00,1,2045.0,1468.0,0.718,9.682,66,14,0,14,52,0,52,0,0.0,0.0
1014,601,2020-03-17 16:53:00,1,2067.0,1386.0,0.67,9.678,42,5,0,5,37,0,37,0,0.0,0.0
1014,602,2020-03-17 16:56:00,1,2071.0,1366.0,0.659,9.671,65,15,0,15,50,2,48,0,0.0,0.0
1014,603,2020-03-17 16:59:00,1,2064.0,1396.0,0.677,9.678,55,4,0,4,51,0,51,0,0.0,0.0
1014,604,2020-03-17 17:02:00,1,2071.0,1396.0,0.674,9.707,51,1,0,1,50,2,48,0,0.0,0.0
1014,605,2020-03-17 17:05:00,1,2063.0,1391.0,0.674,9.669,81,15,7,8,66,19,47,0,0.0,0.0
1014,606,2020-03-17 17:08:00,1,2079.0,1375.0,0.662,9.714,55,9,5,4,46,3,43,0,0.0,0.0
1014,607,2020-03-17 17:11:00,1,2072.0,1378.0,0.665,9.69,45,0,0,0,45,0,45,0,0.0,0.0
1014,608,2020-03-17 17:14:00,1,1975.0,1340.0,0.678,9.265,54,0,0,0,54,4,50,0,0.0,0.0
1014,609,2020-03-17 17:17:00,1,2078.0,1376.0,0.662,9.712,59,12,2,10,47,0,47,0,0.0,0.0
1014,610,2020-03-17 17:20:00,1,2064.0,1430.0,0.693,9.718,92,25,7,18,67,20,47,0,0.0,0.0
1014,611,2020-03-17 17:23:00,1,2338.0,1589.0,0.68,10.97,183,35,20,15,148,71,77,0,0.0,0.0
1014,612,2020-03-17 17:26:00,1,2624.0,1712.0,0.652,12.237,262,91,54,37,171,96,75,49,0.05,0.0
1014,613,2020-03-17 17:29:00,1,2711.0,1782.5,0.657,12.657,459,178,135,43,281,197,84,44,0.0,0.0
1014,614,2020-03-17 17:32:00,1,2798.0,1853.0,0.662,13.077,315,110,75,35,205,139,66,61,0.0,0.0
1014,615,2020-03-17 17:35:00,1,2784.0,1878.0,0.675,13.05,315,138,111,27,177,122,55,37,0.0,0.0
1014,616,2020-03-17 17:38:00,1,1910.0,1208.0,0.633,8.862,90,19,5,14,71,24,47,0,0.0,0.0
1014,617,2020-03-17 17:41:00,1,2005.0,1231.0,0.614,9.263,88,22,11,11,66,18,48,0,0.0,0.0
1014,618,2020-03-17 17:44:00,1,2171.0,1421.0,0.655,10.127,73,19,1,18,54,0,54,0,0.0,0.0
1014,619,2020-03-17 17:47:00,1,2442.0,1540.0,0.631,11.327,52,2,0,2,50,4,46,0,0.0,0.0
1014,620,2020-03-17 17:50:00,1,2246.0,1513.0,0.674,10.524,72,14,4,10,58,11,47,0,0.0,0.0
1014,621,2020-03-17 17:53:00,1,2175.0,1391.0,0.64,10.109,44,3,1,2,41,4,37,0,0.0,0.0
1014,622,2020-03-17 17:56:00,1,2240.0,1496.0,0.668,10.484,53,1,0,1,52,8,44,0,0.0,0.0
1014,623,2020-03-17 17:59:00,1,2246.0,1519.0,0.676,10.531,49,5,2,3,44,2,42,0,0.0,0.0
1014,624,2020-03-17 18:02:00,0,2249.0,1518.0,0.675,10.541,99,26,15,11,73,26,47,0,0.0,0.0
1014,625,2020-03-17 18:05:00,0,2799.0,1819.0,0.65,13.045,334,157,106,51,177,118,59,63,0.06,0.0
1014,626,2020-03-17 18:08:00,0,3132.0,2179.0,0.696,14.752,429,188,138,50,241,177,64,57,0.09,0.0
1014,627,2020-03-17 18:11:00,0,3157.0,2044.0,0.647,14.702,284,109,51,58,175,103,72,81,0.0,0.0
1014,628,2020-03-17 18:14:00,0,3400.0,2310.0,0.679,15.956,405,178,112,66,227,157,70,81,0.0,0.0
1014,629,2020-03-17 18:17:00,0,3125.0,2163.0,0.692,14.706,374,122,90,32,252,182,70,42,0.07,0.0
1014,630,2020-03-17 18:20:00,0,3141.0,2157.0,0.687,14.763,459,234,190,44,225,160,65,114,0.0,0.0
1014,631,2020-03-17 18:23:00,0,2754.0,1967.0,0.714,13.028,420,176,127,49,244,174,70,67,0.0,0.0
1014,632,2020-03-17 18:26:00,0,2160.0,1432.0,0.663,10.097,263,109,73,36,154,98,56,24,0.0,0.0
1014,633,2020-03-17 18:29:00,0,2076.0,1405.0,0.677,9.734,359,264,170,94,95,39,56,2,0.0,0.0
1014,634,2020-03-17 18:32:00,0,2694.0,1797.0,0.667,12.606,222,134,71,63,88,39,49,14,0.0,0.0
1014,635,2020-03-17 18:35:00,0,2868.0,1982.0,0.691,13.494,104,38,3,35,66,23,43,1,0.0,0.0
1014,636,2020-03-17 18:38:00,0,3399.0,2379.0,0.7,16.028,382,142,89,53,240,164,76,81,0.0,0.0
1014,637,2020-03-17 18:41:00,0,3563.0,2472.0,0.694,16.774,306,82,49,33,224,147,77,42,0.08,0.0
1014,638,2020-03-17 18:44:00,0,3455.0,2522.0,0.73,16.404,469,200,155,45,269,188,81,35,0.05,0.0
1014,639,2020-03-17 18:47:00,0,2321.0,1635.0,0.705,10.956,519,174,129,45,345,255,90,41,0.0,0.0
1014,640,2020-03-17 18:50:00,0,2921.0,2189.0,0.75,13.932,354,166,129,37,188,142,46,93,0.0,0.0
1014,641,2020-03-17 18:53:00,0,2135.0,1547.0,0.725,10.125,280,56,21,35,224,152,72,11,0.0,0.0
1014,642,2020-03-17 18:56:00,0,2760.0,1942.0,0.703,13.026,335,125,68,57,210,130,80,10,0.0,0.0
1014,643,2020-03-17 18:59:00,0,3273.0,2451.0,0.749,15.609,93,16,10,6,77,18,59,2,0.0,0.0
1014,644,2020-03-17 19:02:00,0,2808.0,2208.0,0.786,13.509,55,1,1,0,54,4,50,0,0.0,0.0
1014,645,2020-03-17 19:05:00,0,2848.0,2090.0,0.734,13.534,64,0,0,0,64,2,62,0,0.0,0.0
1014,646,2020-03-17 19:08:00,0,2664.0,1967.0,0.738,12.672,68,7,2,5,61,2,59,0,0.0,0.0
1014,647,2020-03-17 19:11:00,0,2689.0,1859.0,0.691,12.653,80,7,0,7,73,12,61,0,0.0,0.0
1014,648,2020-03-17 19:14:00,0,2406.0,1716.0,0.713,11.378,73,21,8,13,52,4,48,4,0.0,0.0
1014,649,2020-03-17 19:17:00,0,2672.0,1904.0,0.713,12.634,295,120,72,48,175,111,64,60,0.0,0.0
1014,650,2020-03-17 19:20:00,0,3131.0,2158.0,0.689,14.725,306,117,69,48,189,114,75,94,0.0,0.0
1014,651,2020-03-17 19:23:00,0,3113.0,2296.0,0.738,14.808,360,116,88,28,244,173,71,46,0.2,0.0
1014,652,2020-03-17 19:26:00,0,2921.0,2182.0,0.747,13.926,495,206,150,56,289,220,69,75,0.04,0.0
1014,653,2020-03-17 19:29:00,0,2817.0,2159.0,0.766,13.489,367,131,92,39,236,163,73,34,0.09,0.0
1014,654,2020-03-17 19:32:00,0,2807.0,2222.0,0.792,13.519,502,230,176,54,272,209,63,122,0.0,0.0
1014,655,2020-03-17 19:35:00,0,3083.0,2370.0,0.769,14.771,346,163,120,43,183,131,52,113,0.02,0.0
1014,656,2020-03-17 19:38:00,0,4061.0,3038.0,0.748,19.365,476,230,163,67,246,189,57,103,0.0,0.0
1014,657,2020-03-17 19:41:00,0,2936.0,2092.0,0.713,13.885,747,325,241,84,422,326,96,104,0.0,0.0
1014,658,2020-03-17 19:44:00,0,2404.0,1712.0,0.712,11.367,550,214,165,49,336,251,85,73,0.17,0.0
1014,659,2020-03-17 19:47:00,0,3187.0,2327.0,0.73,15.133,345,135,76,59,210,135,75,85,0.0,0.0
1014,660,2020-03-17 19:50:00,0,3015.0,2225.0,0.738,14.343,391,137,104,33,254,183,71,28,0.35,0.0
1014,661,2020-03-17 19:53:00,0,3527.0,2722.0,0.772,16.909,323,149,100,49,174,119,55,62,0.0,0.04
1014,662,2020-03-17 19:56:00,0,3058.0,2430.0,0.795,14.738,421,208,160,48,213,152,61,90,0.14,0.0
1014,663,2020-03-17 19:59:00,0,3468.0,2863.0,0.825,16.834,411,167,100,67,244,159,85,91,0.0,0.0
1014,664,2020-03-17 20:02:00,0,2723.0,2141.0,0.787,13.098,488,256,183,73,232,166,66,60,0.0,0.0
1014,665,2020-03-17 20:05:00,0,3488.0,2845.0,0.815,16.894,459,239,175,64,220,156,64,87,0.0,0.0
1014,666,2020-03-17 20:08:00,0,3319.0,2719.0,0.819,16.089,361,145,99,46,216,156,60,17,0.12,0.0
1014,667,2020-03-17 20:11:00,0,3384.0,2824.0,0.834,16.459,648,332,266,66,316,235,81,77,0.03,0.05
1014,668,2020-03-17 20:14:00,0,3486.0,2825.0,0.81,16.865,396,162,118,44,234,164,70,61,0.01,0.0
1014,669,2020-03-17 20:17:00,0,3240.0,2596.0,0.801,15.641,149,52,23,29,97,64,33,14,0.12,0.0
1014,670,2020-03-17 20:20:00,0,3441.0,2980.0,0.866,16.859,382,179,108,71,203,130,73,120,0.0,0.0
1014,671,2020-03-17 20:23:00,0,2864.0,2393.0,0.836,13.932,424,211,143,68,213,148,65,55,0.0,0.02
1014,672,2020-03-17 20:26:00,0,2361.0,1854.0,0.785,11.355,155,31,14,17,124,82,42,0,0.05,0.0
1014,673,2020-03-17 20:29:00,0,2645.0,2190.0,0.824,12.846,202,78,57,21,124,72,52,23,0.0,0.0
1014,674,2020-03-17 20:32:00,0,2929.0,2526.0,0.863,14.337,460,224,170,54,236,176,60,43,0.14,0.0
1014,675,2020-03-17 20:35:00,0,3608.0,3194.0,0.885,17.751,468,206,146,60,262,182,80,109,0.0,0.0
1014,676,2020-03-17 20:38:00,0,3196.0,2725.0,0.853,15.608,416,217,161,56,199,144,55,32,0.0,0.0
1014,677,2020-03-17 20:41:00,0,3386.0,2859.0,0.844,16.507,436,245,188,57,191,148,43,91,0.08,0.0
1014,678,2020-03-17 20:44:00,0,3385.0,2824.0,0.834,16.464,294,122,87,35,172,118,54,18,0.01,0.0
1014,679,2020-03-17 20:47:00,0,3389.0,2827.0,0.834,16.483,218,107,74,33,111,86,25,17,0.0,0.0
1014,680,2020-03-17 20:50:00,0,3228.0,2586.0,0.801,15.583,47,12,1,11,35,13,22,0,0.0,0.0
1014,681,2020-03-17 20:53:00,0,2967.0,2374.0,0.8,14.317,85,9,0,9,76,35,41,4,0.0,0.0
1014,682,2020-03-17 20:56:00,0,3050.0,2468.0,0.809,14.748,326,131,89,42,195,136,59,81,0.02,0.0
1014,683,2020-03-17 20:59:00,0,3258.0,2495.0,0.766,15.6,500,230,152,78,270,195,75,135,0.0,0.0
1014,684,2020-03-17 21:02:00,0,3246.0,2556.0,0.788,15.618,525,244,180,64,281,197,84,94,0.0,0.07
1014,685,2020-03-17 21:05:00,0,2789.0,2269.0,0.813,13.5,543,210,155,55,333,250,83,28,0.05,0.03
1014,686,2020-03-17 21:08:00,0,2985.0,2304.0,0.772,14.311,419,169,114,55,250,162,88,74,0.02,0.0
1014,687,2020-03-17 21:11:00,0,2967.0,2440.0,0.822,14.391,431,200,141,59,231,158,73,73,0.06,0.0
1014,688,2020-03-17 21:14:00,0,3155.0,2485.0,0.788,15.181,445,186,130,56,259,172,87,100,0.26,0.0
1014,689,2020-03-17 21:17:00,0,3161.0,2476.0,0.783,15.197,457,173,112,61,284,199,85,49,0.0,0.0
1014,690,2020-03-17 21:20:00,0,2790.0,2283.0,0.818,13.521,405,164,123,41,241,169,72,14,0.09,0.0
1014,691,2020-03-17 21:23:00,0,3043.0,2495.0,0.82,14.752,376,174,119,55,202,139,63,80,0.0,0.0
1014,692,2020-03-17 21:26:00,0,3224.0,2658.0,0.824,15.646,481,216,157,59,265,196,69,17,0.0,0.0
1014,693,2020-03-17 21:29:00,0,2964.0,2401.0,0.81,14.338,326,158,122,36,168,116,52,76,0.0,0.09
1014,694,2020-03-17 21:32:00,0,3231.0,2612.0,0.808,15.622,482,215,153,62,267,189,78,105,0.0,0.0
1014,695,2020-03-17 21:35:00,0,3420.0,2744.0,0.802,16.514,551,255,183,72,296,221,75,94,0.04,0.0
1014,696,2020-03-17 21:38:00,0,2734.0,2086.0,0.763,13.082,236,92,54,38,144,102,42,0,0.1,0.0
1014,697,2020-03-17 21:41:00,0,3399.0,2716.0,0.799,16.401,341,111,75,36,230,163,67,4,0.23,0.0
1014,698,2020-03-17 21:44:00,0,3222.0,2688.0,0.834,15.67,459,225,154,71,234,163,71,125,0.0,0.0
1014,699,2020-03-17 21:47:00,0,3226.0,2669.0,0.827,15.665,260,125,74,51,135,86,49,89,0.0,0.0
1014,700,2020-03-17 21:50:00,0,3205.0,2663.0,0.831,15.575,313,141,99,42,172,112,60,9,0.11,0.0
1014,701,2020-03-17 21:53:00,0,3206.0,2680.0,0.836,15.601,346,176,123,53,170,104,66,90,0.1,0.0
1014,702,2020-03-17 21:56:00,0,3207.0,2729.0,0.851,15.656,402,178,131,47,224,156,68,29,0.42,0.0
1014,703,2020-03-17 21:59:00,0,3388.0,2855.0,0.843,16.508,280,83,56,27,197,135,62,6,0.0,0.0
1014,704,2020-03-17 22:02:00,0,3211.0,2656.0,0.827,15.593,366,195,135,60,171,113,58,112,0.0,0.0
1014,705,2020-03-17 22:05:00,0,3179.0,2795.0,0.879,15.621,387,171,124,47,216,151,65,43,0.02,0.0
1014,706,2020-03-17 22:08:00,0,2653.0,2374.0,0.895,13.082,457,242,179,63,215,159,56,29,0.0,0.0
1014,707,2020-03-17 22:11:00,0,3117.0,2627.0,0.843,15.191,394,184,138,46,210,151,59,85,0.06,0.0
1014,708,2020-03-17 22:14:00,0,2743.0,2412.0,0.879,13.478,467,240,178,62,227,157,70,69,0.09,0.0
1014,709,2020-03-17 22:17:00,0,3283.0,2808.0,0.855,16.044,352,123,71,52,229,137,92,102,0.0,0.0
1014,710,2020-03-17 22:20:00,0,3360.0,2974.0,0.885,16.532,183,63,30,33,120,53,67,64,0.0,0.0
1014,711,2020-03-17 22:23:00,0,3532.0,3022.0,0.856,17.262,218,77,42,35,141,75,66,68,0.0,0.0
1014,712,2020-03-17 22:26:00,0,3382.0,2858.0,0.845,16.491,231,109,70,39,122,64,58,49,0.35,0.0
1014,713,2020-03-17 22:29:00,0,3213.0,2654.0,0.826,15.598,146,58,27,31,88,39,49,36,0.0,0.0
1014,714,2020-03-17 22:32:00,0,2944.0,2508.0,0.852,14.376,228,115,65,50,113,61,52,9,0.03,0.0
1014,715,2020-03-17 22:35:00,0,2681.0,2295.0,0.856,13.102,229,71,42,29,158,96,62,47,0.0,0.0
1014,716,2020-03-17 22:38:00,0,3196.0,2787.0,0.872,15.679,323,110,63,47,213,138,75,50,0.06,0.0
1014,717,2020-03-17 22:41:00,0,3341.0,3003.0,0.899,16.487,263,103,72,31,160,97,63,66,0.07,0.0
1014,718,2020-03-17 22:44:00,0,3222.0,2610.0,0.81,15.585,275,102,65,37,173,110,63,92,0.0,0.0
1014,719,2020-03-17 22:47:00,0,3189.0,2780.0,0.872,15.643,333,131,95,36,202,131,71,79,0.18,0.0
1014,720,2020-03-17 22:50:00,0,2939.0,2586.0,0.88,14.445,436,168,122,46,268,187,81,32,0.15,0.0
1014,721,2020-03-17 22:53:00,0,3207.0,2666.0,0.831,15.587,76,15,7,8,61,18,43,7,0.0,0.0
1014,722,2020-03-17 22:56:00,0,3020.0,2583.0,0.855,14.759,379,153,100,53,226,160,66,27,0.0,0.14
1014,723,2020-03-17 22:59:00,0,3297.0,2800.0,0.849,16.088,383,123,71,52,260,178,82,73,0.14,0.0
1014,724,2020-03-17 23:02:00,0,2936.0,2490.0,0.848,14.323,488,226,183,43,262,182,80,72,0.0,0.0
1014,725,2020-03-17 23:05:00,0,3232.0,2637.0,0.816,15.654,360,143,90,53,217,143,74,81,0.0,0.0
1014,726,2020-03-17 23:08:00,0,2609.0,2177.0,0.834,12.692,251,75,37,38,176,106,70,5,0.33,0.0
1014,727,2020-03-17 23:11:00,0,2942.0,2472.0,0.84,14.329,356,132,100,32,224,152,72,46,0.0,0.0
1014,728,2020-03-17 23:14:00,0,2861.0,2395.0,0.837,13.923,403,177,135,42,226,157,69,28,0.0,0.0
1014,729,2020-03-17 23:17:00,0,3381.0,2875.0,0.85,16.502,364,124,68,56,240,180,60,86,0.0,0.0
1014,730,2020-03-17 23:20:00,0,3187.0,2795.0,0.877,15.652,436,156,103,53,280,188,92,65,0.03,0.0
1014,731,2020-03-17 23:23:00,0,3193.0,2765.0,0.866,15.642,393,174,130,44,219,156,63,104,0.17,0.0
1014,732,2020-03-17 23:26:00,0,3381.0,2877.0,0.851,16.507,346,123,82,41,223,149,74,47,0.0,0.0
1014,733,2020-03-17 23:29:00,0,3390.0,2834.5,0.8365,16.4945,364,162,107,55,202,143,59,40,0.09,0.0
1014,734,2020-03-17 23:32:00,0,3399.0,2792.0,0.822,16.482,437,162,108,54,275,203,72,90,0.0,0.0
1014,735,2020-03-17 23:35:00,0,3387.0,2846.0,0.84,16.495,480,176,118,58,304,217,87,46,0.18,0.0
1014,736,2020-03-17 23:38:00,0,3383.0,2792.0,0.825,16.421,342,133,75,58,209,134,75,36,0.13,0.0
1014,737,2020-03-17 23:41:00,0,3227.0,2630.0,0.815,15.624,451,174,120,54,277,188,89,66,0.06,0.0
1014,738,2020-03-17 23:44:00,0,2941.0,2498.0,0.85,14.352,434,185,122,63,249,174,75,101,0.04,0.0
1014,739,2020-03-17 23:47:00,0,3122.0,2573.0,0.824,15.148,361,164,109,55,197,135,62,61,0.0,0.0
1014,740,2020-03-17 23:50:00,0,2754.0,2396.0,0.87,13.503,167,71,47,24,96,54,42,1,0.04,0.0
1014,741,2020-03-17 23:53:00,0,2538.0,2022.0,0.797,12.237,62,21,3,18,41,4,37,0,0.0,0.0
1014,742,2020-03-17 23:56:00,0,2673.0,2309.0,0.864,13.088,79,35,14,21,44,9,35,2,0.0,0.0
1014,743,2020-03-17 23:59:00,0,2667.0,2336.0,0.876,13.096,37,5,4,1,32,2,30,0,0.0,0.0
1014,744,2020-03-18 00:02:00,0,2718.0,2137.0,0.786,13.076,51,12,5,7,39,9,30,0,0.0,0.0
1014,745,2020-03-18 00:05:00,0,2353.0,1896.0,0.806,11.371,40,5,1,4,35,2,33,0,0.0,0.0
1014,746,2020-03-18 00:08:00,0,2280.0,1769.0,0.776,10.943,53,13,1,12,40,0,40,0,0.0,0.0
1014,747,2020-03-18 00:11:00,0,2001.0,1651.0,0.825,9.713,48,8,0,8,40,0,40,0,0.0,0.0
1014,748,2020-03-18 00:14:00,0,2021.0,1552.0,0.768,9.683,51,3,0,3,48,0,48,0,0.0,0.0
1014,749,2020-03-18 00:17:00,0,2031.0,1529.0,0.753,9.697,116,44,13,31,72,23,49,0,0.0,0.0
1014,750,2020-03-18 00:20:00,0,2385.0,1790.0,0.75,11.378,343,151,102,49,192,131,61,68,0.05,0.01
1014,751,2020-03-18 00:23:00,0,2763.0,1972.0,0.714,13.07,363,154,103,51,209,139,70,57,0.23,0.0
1014,752,2020-03-18 00:26:00,0,2760.0,2025.0,0.734,13.117,450,192,140,52,258,167,91,67,0.03,0.0
1014,753,2020-03-18 00:29:00,0,2487.0,1824.0,0.733,11.819,259,129,82,47,130,84,46,15,0.0,0.02
1014,754,2020-03-18 00:32:00,0,2731.0,2137.0,0.783,13.127,46,12,2,10,34,0,34,0,0.0,0.0
1014,755,2020-03-18 00:35:00,0,2746.0,2068.0,0.753,13.11,41,7,1,6,34,0,34,0,0.0,0.0
1014,756,2020-03-18 00:38:00,0,2551.0,1953.0,0.766,12.216,94,2,0,2,92,51,41,0,0.02,0.0
1014,757,2020-03-18 00:41:00,0,2565.0,1930.0,0.753,12.242,268,90,67,23,178,130,48,9,0.07,0.0
1014,758,2020-03-18 00:44:00,0,2658.0,1968.0,0.74,12.65,47,4,1,3,43,2,41,0,0.01,0.0
1014,759,2020-03-18 00:47:00,0,2588.0,1868.0,0.722,12.267,45,7,0,7,38,0,38,0,0.0,0.0
1014,760,2020-03-18 00:50:00,0,2302.0,1706.0,0.741,10.96,99,34,23,11,65,25,40,0,0.08,0.0
1014,761,2020-03-18 00:53:00,0,2310.0,1679.0,0.727,10.961,368,155,100,55,213,146,67,82,0.23,0.0
1014,762,2020-03-18 00:56:00,0,2590.0,1877.0,0.725,12.283,253,93,55,38,160,104,56,60,0.04,0.0
1014,763,2020-03-18 00:59:00,0,2534.0,1994.0,0.787,12.192,269,123,90,33,146,98,48,27,0.11,0.0
1014,764,2020-03-18 01:02:00,0,2733.0,2084.0,0.763,13.076,279,96,45,51,183,131,52,55,0.15,0.0
1014,765,2020-03-18 01:05:00,0,2723.0,2097.0,0.77,13.049,358,175,148,27,183,123,60,53,0.06,0.0
1014,766,2020-03-18 01:08:00,0,2685.0,2208.0,0.822,13.022,282,103,55,48,179,121,58,62,0.0,0.0
1014,767,2020-03-18 01:11:00,0,2957.0,2424.0,0.82,14.334,322,112,68,44,210,127,83,71,0.0,0.0
1014,768,2020-03-18 01:14:00,0,2707.0,2207.0,0.815,13.11,332,166,115,51,166,111,55,40,0.25,0.0
1014,769,2020-03-18 01:17:00,0,3041.0,2520.0,0.828,14.772,303,116,57,59,187,118,69,80,0.06,0.0
1014,770,2020-03-18 01:20:00,0,2964.0,2415.0,0.815,14.353,333,179,121,58,154,102,52,52,0.0,0.01
1014,771,2020-03-18 01:23:00,0,2775.0,2329.0,0.839,13.513,251,94,58,36,157,94,63,105,0.0,0.0
1014,772,2020-03-18 01:26:00,0,2934.0,2536.0,0.865,14.368,414,185,131,54,229,160,69,40,0.12,0.0
1014,773,2020-03-18 01:29:00,0,2954.0,2453.0,0.831,14.354,291,98,51,47,193,134,59,40,0.07,0.28
1014,774,2020-03-18 01:32:00,0,2681.0,2266.0,0.845,13.07,455,216,155,61,239,169,70,41,0.16,0.0
1014,775,2020-03-18 01:35:00,0,2941.0,2508.0,0.853,14.364,336,117,69,48,219,136,83,70,0.0,0.0
1014,776,2020-03-18 01:38:00,0,3022.0,2588.0,0.856,14.772,389,175,130,45,214,133,81,23,0.08,0.0
1014,777,2020-03-18 01:41:00,0,2659.0,2356.0,0.886,13.084,243,88,49,39,155,75,80,46,0.0,0.0
1014,778,2020-03-18 01:44:00,0,2664.0,2324.0,0.872,13.069,330,133,76,57,197,118,79,55,0.05,0.0
1014,779,2020-03-18 01:47:00,0,2695.0,2242.0,0.832,13.1,130,31,20,11,99,27,72,1,0.0,0.0
1014,780,2020-03-18 01:50:00,0,2351.0,1937.0,0.824,11.41,60,0,0,0,60,0,60,0,0.0,0.0
1014,781,2020-03-18 01:53:00,0,2620.0,2161.0,0.825,12.713,65,2,0,2,63,9,54,0,0.0,0.0
1014,782,2020-03-18 01:56:00,0,2696.0,2217.0,0.822,13.077,68,6,0,6,62,12,50,0,0.0,0.0
1014,783,2020-03-18 01:59:00,0,2518.0,2112.0,0.839,12.261,55,2,0,2,53,0,53,0,0.0,0.0
1014,784,2020-03-18 02:02:00,0,2529.0,2017.0,0.798,12.196,50,7,3,4,43,0,43,0,0.0,0.0
1014,785,2020-03-18 02:05:00,0,2558.0,1962.0,0.767,12.251,108,56,17,39,52,1,51,2,0.0,0.0
1014,786,2020-03-18 02:08:00,0,2546.0,1928.0,0.757,12.167,57,4,1,3,53,3,50,0,0.0,0.0
1014,787,2020-03-18 02:11:00,0,2578.0,1870.0,0.725,12.229,64,1,0,1,63,14,49,0,0.0,0.0
1014,788,2020-03-18 02:14:00,0,2372.0,1783.0,0.752,11.322,144,34,23,11,110,51,59,0,0.0,0.0
1014,789,2020-03-18 02:17:00,0,2389.0,1770.0,0.741,11.371,717,374,287,87,343,256,87,7,0.05,0.0
1014,790,2020-03-18 02:20:00,0,2554.0,1916.0,0.75,12.184,505,256,206,50,249,188,61,51,0.05,0.0
1014,791,2020-03-18 02:23:00,0,2562.0,1948.0,0.76,12.251,79,38,13,25,41,3,38,0,0.0,0.0
1014,792,2020-03-18 02:26:00,0,2597.0,1801.0,0.693,12.225,47,0,0,0,47,0,47,0,0.0,0.0
1014,793,2020-03-18 02:29:00,0,2318.5,1645.0,0.7115,10.9555,35,0,0,0,35,0,35,0,0.0,0.0
1014,794,2020-03-18 02:32:00,0,2040.0,1489.0,0.73,9.686,30,0,0,0,30,0,30,0,0.0,0.0
1014,795,2020-03-18 02:35:00,0,1961.0,1411.0,0.719,9.288,43,0,0,0,43,1,42,0,0.0,0.0
1014,796,2020-03-18 02:38:00,0,2040.0,1490.0,0.73,9.688,394,174,129,45,220,150,70,4,0.16,0.0
1014,797,2020-03-18 02:41:00,0,2028.0,1543.0,0.761,9.698,185,104,80,24,81,35,46,18,0.0,0.0
1014,798,2020-03-18 02:44:00,0,2331.0,1648.0,0.707,11.009,286,251,197,54,35,2,33,6,0.0,0.0
1014,799,2020-03-18 02:47:00,0,2294.0,1689.0,0.736,10.907,120,62,46,16,58,26,32,13,0.06,0.0
1014,800,2020-03-18 02:50:00,0,2313.0,1656.0,0.716,10.947,32,0,0,0,32,0,32,0,0.0,0.0
1014,801,2020-03-18 02:53:00,0,2036.0,1530.0,0.751,9.717,45,2,0,2,43,8,35,0,0.0,0.0
1014,802,2020-03-18 02:56:00,0,2047.0,1464.0,0.715,9.686,29,1,0,1,28,0,28,0,0.0,0.0
1014,803,2020-03-18 02:59:00,0,2057.0,1412.0,0.687,9.668,26,4,0,4,22,0,22,0,0.0,0.0
1014,804,2020-03-18 03:02:00,0,1965.0,1384.0,0.704,9.275,32,1,0,1,31,0,31,0,0.0,0.0
1014,805,2020-03-18 03:05:00,0,2066.0,1394.0,0.675,9.685,59,14,6,8,45,5,40,0,0.0,0.0
1014,806,2020-03-18 03:08:00,0,2069.0,1408.0,0.68,9.713,52,20,2,18,32,0,32,0,0.0,0.0
1014,807,2020-03-18 03:11:00,0,2037.0,1509.0,0.741,9.695,59,1,0,1,58,6,52,0,0.0,0.0
1014,808,2020-03-18 03:14:00,0,2238.0,1541.0,0.688,10.524,66,17,2,15,49,4,45,0,0.0,0.0
1014,809,2020-03-18 03:17:00,0,2424.0,1679.0,0.693,11.412,199,106,67,39,93,43,50,4,0.02,0.0
1014,810,2020-03-18 03:20:00,0,2614.0,1764.0,0.675,12.253,257,112,85,27,145,79,66,20,0.1,0.0
1014,811,2020-03-18 03:23:00,0,2321.0,1694.0,0.73,11.022,36,0,0,0,36,2,34,0,0.0,0.0
1014,812,2020-03-18 03:26:00,0,2130.0,1548.0,0.727,10.105,32,0,0,0,32,5,27,0,0.0,0.0
1014,813,2020-03-18 03:29:00,0,2059.0,1432.0,0.696,9.699,27,2,2,0,25,2,23,0,0.0,0.0
1014,814,2020-03-18 03:32:00,0,2073.0,1366.0,0.659,9.68,27,1,0,1,26,0,26,0,0.0,0.0
1014,815,2020-03-18 03:35:00,0,2059.0,1444.0,0.701,9.711,22,0,0,0,22,0,22,0,0.0,0.0
1014,816,2020-03-18 03:38:00,0,2071.0,1390.0,0.671,9.698,34,2,1,1,32,0,32,0,0.0,0.0
1014,817,2020-03-18 03:41:00,0,1878.0,1351.0,0.719,8.895,28,2,1,1,26,0,26,0,0.0,0.0
1014,818,2020-03-18 03:44:00,0,1877.0,1298.0,0.691,8.832,47,10,0,10,37,0,37,0,0.0,0.0
1014,819,2020-03-18 03:47:00,0,1965.0,1374.0,0.699,9.264,46,12,3,9,34,3,31,0,0.0,0.0
1014,820,2020-03-18 03:50:00,0,2338.0,1615.0,0.691,11.0,224,96,65,31,128,86,42,16,0.27,0.0
1014,821,2020-03-18 03:53:00,0,2506.0,1709.0,0.682,11.769,117,80,28,52,37,2,35,4,0.0,0.0
1014,822,2020-03-18 03:56:00,0,2593.0,1805.0,0.696,12.216,92,38,18,20,54,20,34,0,0.0,0.0
1014,823,2020-03-18 03:59:00,0,2917.0,2185.0,0.749,13.911,226,101,72,29,125,79,46,27,0.1,0.0
1014,824,2020-03-18 04:02:00,0,2654.0,1940.0,0.731,12.603,29,7,0,7,22,0,22,0,0.0,0.0
1014,825,2020-03-18 04:05:00,0,2595.0,1812.0,0.698,12.231,30,1,0,1,29,0,29,0,0.0,0.0
1014,826,2020-03-18 04:08:00,0,2324.0,1641.0,0.706,10.972,31,3,1,2,28,0,28,0,0.0,0.0
1014,827,2020-03-18 04:11:00,0,2033.0,1503.0,0.739,9.676,34,0,0,0,34,0,34,0,0.0,0.0
1014,828,2020-03-18 04:14:00,0,2051.0,1481.0,0.722,9.722,32,0,0,0,32,0,32,0,0.0,0.0
1014,829,2020-03-18 04:17:00,0,2344.0,1547.0,0.66,10.949,160,71,51,20,89,49,40,2,0.11,0.0
1014,830,2020-03-18 04:20:00,0,2323.0,1660.0,0.714,10.991,40,19,4,15,21,0,21,0,0.0,0.0
1014,831,2020-03-18 04:23:00,0,2123.0,1571.0,0.74,10.103,33,13,0,13,20,0,20,0,0.0,0.0
1014,832,2020-03-18 04:26:00,0,2055.0,1457.0,0.709,9.71,32,2,0,2,30,7,23,0,0.0,0.0
1014,833,2020-03-18 04:29:00,0,2066.0,1421.0,0.688,9.714,25,0,0,0,25,1,24,0,0.0,0.0
1014,834,2020-03-18 04:32:00,0,2059.0,1465.0,0.711,9.733,25,2,0,2,23,0,23,0,0.0,0.0
1014,835,2020-03-18 04:35:00,0,2064.0,1425.0,0.69,9.71,144,62,49,13,82,42,40,1,0.05,0.0
1014,836,2020-03-18 04:38:00,0,2231.0,1567.0,0.702,10.527,50,2,1,1,48,14,34,0,0.03,0.0
1014,837,2020-03-18 04:41:00,0,2047.0,1467.0,0.717,9.691,40,0,0,0,40,0,40,0,0.0,0.0
1014,838,2020-03-18 04:44:00,0,1853.0,1378.0,0.743,8.827,56,9,1,8,47,0,47,0,0.0,0.0
1014,839,2020-03-18 04:47:00,0,1881.0,1305.0,0.694,8.855,50,3,0,3,47,0,47,0,0.0,0.0
1014,840,2020-03-18 04:50:00,0,1893.0,1276.0,0.674,8.871,37,0,0,0,37,0,37,0,0.0,0.0
1014,841,2020-03-18 04:53:00,0,1893.0,1255.0,0.663,8.848,161,87,58,29,74,40,34,2,0.14,0.0
1014,842,2020-03-18 04:56:00,0,2131.0,1534.0,0.72,10.095,166,123,59,64,43,9,34,0,0.0,0.0
1014,843,2020-03-18 04:59:00,0,2400.0,1717.0,0.716,11.357,248,120,83,37,128,82,46,57,0.12,0.0
1014,844,2020-03-18 05:02:00,0,2780.0,1928.0,0.694,13.087,257,111,83,28,146,104,42,59,0.04,0.0
1014,845,2020-03-18 05:05:00,0,2736.0,2087.0,0.763,13.091,223,83,53,30,140,92,48,19,0.29,0.0
1014,846,2020-03-18 05:08:00,0,2760.0,2036.0,0.738,13.128,486,192,142,50,294,224,70,77,0.13,0.0
1014,847,2020-03-18 05:11:00,0,2761.0,1986.0,0.719,13.078,420,208,160,48,212,163,49,81,0.32,0.0
1014,848,2020-03-18 05:14:00,0,2727.0,2126.0,0.78,13.097,111,39,25,14,72,42,30,2,0.0,0.0
1014,849,2020-03-18 05:17:00,0,2730.0,2109.0,0.772,13.091,31,2,1,1,29,6,23,0,0.0,0.0
1014,850,2020-03-18 05:20:00,0,2565.0,1928.0,0.752,12.242,30,3,0,3,27,8,19,0,0.0,0.0
1014,851,2020-03-18 05:23:00,0,2297.0,1742.0,0.758,10.98,33,4,2,2,29,0,29,0,0.0,0.0
1014,852,2020-03-18 05:26:00,0,2016.0,1589.0,0.788,9.704,24,2,0,2,22,8,14,0,0.0,0.0
1014,853,2020-03-18 05:29:00,0,1988.5,1497.0,0.7525,9.4935,42,7,6,1,35,6,29,0,0.0,0.0
1014,854,2020-03-18 05:32:00,0,1961.0,1405.0,0.717,9.283,32,3,0,3,29,0,29,0,0.0,0.0
1014,855,2020-03-18 05:35:00,0,1968.0,1342.0,0.682,9.239,42,17,0,17,25,2,23,0,0.0,0.0
1014,856,2020-03-18 05:38:00,0,2061.0,1430.0,0.694,9.705,39,2,0,2,37,0,37,0,0.0,0.0
1014,857,2020-03-18 05:41:00,0,1972.0,1355.0,0.687,9.272,26,6,0,6,20,0,20,0,0.0,0.0
1014,858,2020-03-18 05:44:00,0,2163.0,1427.0,0.66,10.103,24,1,0,1,23,0,23,0,0.0,0.0
1014,859,2020-03-18 05:47:00,0,1969.0,1407.0,0.714,9.317,21,5,0,5,16,0,16,0,0.0,0.0
1014,860,2020-03-18 05:50:00,0,2069.0,1348.0,0.652,9.645,48,23,2,21,25,0,25,0,0.0,0.0
1014,861,2020-03-18 05:53:00,0,2156.0,1448.0,0.671,10.099,38,5,3,2,33,7,26,0,0.0,0.0
1014,862,2020-03-18 05:56:00,0,1978.0,1366.0,0.691,9.305,43,19,11,8,24,0,24,0,0.0,0.0
1014,863,2020-03-18 05:59:00,0,1988.0,1257.0,0.632,9.227,16,2,0,2,14,0,14,0,0.0,0.0
1014,864,2020-03-18 06:02:00,1,1807.0,1196.0,0.662,8.444,33,10,0,10,23,0,23,0,0.0,0.0
1014,865,2020-03-18 06:05:00,1,1913.0,1192.0,0.623,8.86,29,0,0,0,29,0,29,0,0.0,0.0
1014,866,2020-03-18 06:08:00,1,2023.0,1182.0,0.584,9.279,40,4,2,2,36,0,36,0,0.0,0.0
1014,867,2020-03-18 06:11:00,1,2409.0,1725.0,0.716,11.401,226,102,69,33,124,69,55,6,0.07,0.0
1014,868,2020-03-18 06:14:00,1,2420.0,1721.0,0.711,11.441,424,161,124,37,263,183,80,10,0.06,0.0
1014,869,2020-03-18 06:17:00,1,2679.0,1842.0,0.687,12.595,123,59,21,38,64,21,43,7,0.0,0.0
1014,870,2020-03-18 06:20:00,1,2669.0,1912.0,0.716,12.635,76,27,9,18,49,6,43,0,0.0,0.0
1014,871,2020-03-18 06:23:00,1,2665.0,1903.0,0.714,12.608,43,6,4,2,37,3,34,0,0.0,0.0
1014,872,2020-03-18 06:26:00,1,2626.0,2050.0,0.78,12.617,28,0,0,0,28,3,25,0,0.0,0.0
1014,873,2020-03-18 06:29:00,1,2465.0,1894.0,0.768,11.811,30,0,0,0,30,4,26,0,0.0,0.0
1014,874,2020-03-18 06:32:00,1,2204.0,1725.0,0.783,10.595,47,7,2,5,40,8,32,0,0.0,0.0
1014,875,2020-03-18 06:35:00,1,2127.0,1597.0,0.751,10.151,26,0,0,0,26,2,24,0,0.0,0.0
1014,876,2020-03-18 06:38:00,1,1937.0,1518.0,0.784,9.315,26,1,0,1,25,4,21,0,0.0,0.0
1014,877,2020-03-18 06:41:00,1,1929.0,1500.0,0.777,9.263,27,1,0,1,26,6,20,0,0.0,0.0
1014,878,2020-03-18 06:44:00,1,1939.0,1451.0,0.748,9.248,28,3,0,3,25,0,25,0,0.0,0.0
1014,879,2020-03-18 06:47:00,1,2027.0,1524.0,0.752,9.675,26,0,0,0,26,0,26,0,0.0,0.0
1014,880,2020-03-18 06:50:00,1,1937.0,1480.0,0.764,9.269,23,0,0,0,23,0,23,0,0.0,0.0
1014,881,2020-03-18 06:53:00,1,1947.0,1435.0,0.737,9.259,45,9,4,5,36,4,32,0,0.0,0.0
1014,882,2020-03-18 06:56:00,1,2130.0,1557.0,0.731,10.118,17,1,0,1,16,0,16,0,0.0,0.0
1014,883,2020-03-18 06:59:00,1,1935.0,1502.0,0.776,9.286,29,2,0,2,27,0,27,0,0.0,0.0
1014,884,2020-03-18 07:02:00,1,1951.0,1427.0,0.732,9.267,16,0,0,0,16,0,16,0,0.0,0.0
1014,885,2020-03-18 07:05:00,1,1958.0,1428.0,0.729,9.295,23,0,0,0,23,4,19,0,0.0,0.0
1014,886,2020-03-18 07:08:00,1,1961.0,1404.0,0.716,9.281,33,0,0,0,33,6,27,0,0.0,0.0
1014,887,2020-03-18 07:11:00,1,1857.0,1390.0,0.749,8.856,27,0,0,0,27,0,27,0,0.0,0.0
1014,888,2020-03-18 07:14:00,1,1945.0,1440.0,0.741,9.257,29,0,0,0,29,2,27,0,0.0,0.0
1014,889,2020-03-18 07:17:00,1,1940.0,1454.0,0.75,9.252,36,2,1,1,34,2,32,0,0.0,0.0
1014,890,2020-03-18 07:20:00,1,1947.0,1414.0,0.726,9.238,25,0,0,0,25,0,25,0,0.0,0.0
1014,891,2020-03-18 07:23:00,1,1964.0,1367.0,0.696,9.25,22,0,0,0,22,0,22,0,0.0,0.0
1014,892,2020-03-18 07:26:00,1,2036.0,1497.0,0.735,9.679,24,0,0,0,24,0,24,0,0.0,0.0
1014,893,2020-03-18 07:29:00,1,1942.0,1453.0,0.748,9.261,27,1,0,1,26,0,26,0,0.0,0.0
1014,894,2020-03-18 07:32:00,1,2121.0,1628.0,0.767,10.161,63,26,8,18,37,3,34,3,0.0,0.0
1014,895,2020-03-18 07:35:00,1,2825.0,2188.0,0.775,13.553,212,83,42,41,129,82,47,26,0.08,0.0
1014,896,2020-03-18 07:38:00,1,2634.0,2067.0,0.785,12.666,517,196,153,43,321,232,89,91,0.14,0.0
1014,897,2020-03-18 07:41:00,1,2790.0,2202.0,0.789,13.429,299,115,87,28,184,126,58,48,0.06,0.0
1014,898,2020-03-18 07:44:00,1,2830.0,2174.0,0.768,13.558,402,154,112,42,248,185,63,32,0.18,0.0
1014,899,2020-03-18 07:47:00,1,2786.0,2229.0,0.8,13.444,365,170,119,51,195,139,56,99,0.09,0.0
1014,900,2020-03-18 07:50:00,1,2814.0,2221.0,0.789,13.549,155,53,33,20,102,65,37,39,0.04,0.0
1014,901,2020-03-18 07:53:00,1,2889.0,2318.0,0.803,13.948,258,124,80,44,134,85,49,28,0.07,0.0
1014,902,2020-03-18 07:56:00,1,2798.0,2252.0,0.805,13.517,419,153,117,36,266,187,79,48,0.02,0.0
1014,903,2020-03-18 07:59:00,1,2785.0,2301.0,0.826,13.519,109,43,12,31,66,17,49,0,0.0,0.0
1014,904,2020-03-18 08:02:00,1,2804.0,2256.0,0.805,13.546,30,5,0,5,25,0,25,0,0.0,0.0
1014,905,2020-03-18 08:05:00,1,2607.0,2182.0,0.837,12.689,72,37,0,37,35,0,35,0,0.0,0.0
1014,906,2020-03-18 08:08:00,1,2619.0,2108.0,0.805,12.652,56,29,0,29,27,0,27,0,0.0,0.0
1014,907,2020-03-18 08:11:00,1,2531.0,2041.0,0.806,12.23,87,60,25,35,27,0,27,0,0.0,0.0
1014,908,2020-03-18 08:14:00,1,2447.0,1988.0,0.812,11.842,149,120,69,51,29,0,29,0,0.0,0.0
1014,909,2020-03-18 08:17:00,1,2363.0,1895.0,0.802,11.407,128,86,50,36,42,0,42,0,0.0,0.0
1014,910,2020-03-18 08:20:00,1,2266.0,1833.0,0.809,10.956,103,36,17,19,67,27,40,0,0.0,0.0
1014,911,2020-03-18 08:23:00,1,2374.0,1842.0,0.776,11.393,51,19,2,17,32,3,29,3,0.04,0.0
1014,912,2020-03-18 08:26:00,1,2626.0,2055.0,0.783,12.621,262,151,96,55,111,74,37,11,0.26,0.02
1014,913,2020-03-18 08:29:00,1,2646.0,1998.5,0.756,12.637,378,225,173,52,153,116,37,29,0.1,0.0
1014,914,2020-03-18 08:32:00,1,2666.0,1942.0,0.729,12.653,206,93,54,39,113,76,37,25,0.07,0.23
1014,915,2020-03-18 08:35:00,1,2906.0,2226.0,0.766,13.913,95,60,22,38,35,12,23,61,0.0,0.0
1014,916,2020-03-18 08:38:00,1,2889.0,2273.0,0.787,13.902,133,72,31,41,61,29,32,58,0.0,0.0
1014,917,2020-03-18 08:41:00,1,2957.0,2382.0,0.806,14.287,337,189,135,54,148,99,49,99,0.0,0.18
1014,918,2020-03-18 08:44:00,1,2971.0,2428.0,0.817,14.393,240,115,85,30,125,83,42,38,0.0,0.22
1014,919,2020-03-18 08:47:00,1,2586.0,2181.0,0.843,12.606,88,60,22,38,28,10,18,0,0.0,0.0
1014,920,2020-03-18 08:50:00,1,2767.0,2345.0,0.848,13.498,189,90,56,34,99,45,54,44,0.0,0.0
1014,921,2020-03-18 08:53:00,1,3194.0,2766.0,0.866,15.648,144,75,50,25,69,46,23,7,0.11,0.0
1014,922,2020-03-18 08:56:00,1,2760.0,2404.0,0.871,13.535,66,37,10,27,29,4,25,0,0.0,0.0
1014,923,2020-03-18 08:59:00,1,3080.0,2770.0,0.899,15.2,56,21,12,9,35,23,12,0,0.0,0.08
1014,924,2020-03-18 09:02:00,1,3080.0,2738.0,0.889,15.167,42,14,10,4,28,12,16,0,0.0,0.71
1014,925,2020-03-18 09:05:00,1,2735.0,2501.0,0.915,13.543,70,16,10,6,54,35,19,0,0.0,0.06
1014,926,2020-03-18 09:08:00,1,2520.0,2467.0,0.979,12.661,44,8,3,5,36,35,1,0,0.0,0.0
1014,927,2020-03-18 09:11:00,1,2522.0,2437.0,0.966,12.636,22,2,0,2,20,20,0,0,0.0,0.0
1014,928,2020-03-18 09:14:00,1,2527.0,2429.0,0.961,12.645,23,4,0,4,19,19,0,0,0.0,0.0
1014,929,2020-03-18 09:17:00,1,2532.0,2396.0,0.946,12.629,29,7,2,5,22,21,1,0,0.0,0.0
1014,930,2020-03-18 09:20:00,1,2577.0,2289.0,0.888,12.687,36,25,0,25,11,6,5,0,0.0,0.0
1014,931,2020-03-18 09:23:00,1,2376.0,2214.0,0.932,11.813,32,7,6,1,25,17,8,0,0.0,0.0
1014,932,2020-03-18 09:26:00,1,2392.0,2183.0,0.912,11.841,46,3,1,2,43,21,22,0,0.0,0.0
1014,933,2020-03-18 09:29:00,1,2402.0,2133.0,0.888,11.824,51,12,0,12,39,10,29,0,0.0,0.0
1014,934,2020-03-18 09:32:00,1,2322.0,2059.0,0.886,11.43,15,4,0,4,11,11,0,0,0.0,0.0
1014,935,2020-03-18 09:35:00,1,2301.0,2094.0,0.91,11.386,114,51,40,11,63,57,6,2,0.0,0.0
1014,936,2020-03-18 09:38:00,1,2390.0,2201.0,0.921,11.855,179,82,39,43,97,49,48,81,0.0,0.0
1014,937,2020-03-18 09:41:00,1,3099.0,2734.0,0.882,15.238,185,101,57,44,84,40,44,81,0.0,0.0
1014,938,2020-03-18 09:44:00,1,3076.0,2835.0,0.922,15.259,113,82,40,42,31,20,11,82,0.0,0.0
1014,939,2020-03-18 09:47:00,1,2975.0,2740.0,0.921,14.754,275,136,88,48,139,111,28,28,0.18,0.0
1014,940,2020-03-18 09:50:00,1,3066.0,2808.0,0.916,15.189,440,253,201,52,187,136,51,66,0.0,0.0
1014,941,2020-03-18 09:53:00,1,2890.0,2694.0,0.932,14.371,207,95,61,34,112,86,26,6,0.0,0.0
1014,942,2020-03-18 09:56:00,1,3211.0,3125.0,0.973,16.111,78,68,34,34,10,2,8,8,0.0,0.0
1014,943,2020-03-18 09:59:00,1,3209.0,3068.0,0.956,16.04,95,88,45,43,7,2,5,0,0.0,0.0
1014,944,2020-03-18 10:02:00,1,3226.0,3026.0,0.938,16.06,31,26,13,13,5,2,3,0,0.0,0.0
1014,945,2020-03-18 10:05:00,1,3040.0,2863.0,0.942,15.149,7,5,3,2,2,0,2,0,0.0,0.0
1014,946,2020-03-18 10:08:00,1,2799.0,2694.0,0.962,14.01,18,12,7,5,6,0,6,0,0.0,0.0
1014,947,2020-03-18 10:11:00,1,2805.0,2595.0,0.925,13.926,28,27,2,25,1,0,1,0,0.0,0.0
1014,948,2020-03-18 10:14:00,1,2821.0,2594.0,0.92,13.985,59,50,14,36,9,0,9,0,0.0,0.0
1014,949,2020-03-18 10:17:00,1,2788.0,2710.0,0.972,13.985,85,56,21,35,29,13,16,1,0.0,0.0
1014,950,2020-03-18 10:20:00,1,2974.0,2772.0,0.932,14.788,12,0,0,0,12,3,9,0,0.0,0.0
1014,951,2020-03-18 10:23:00,1,2880.0,2736.0,0.95,14.377,27,13,0,13,14,2,12,0,0.0,0.0
1014,952,2020-03-18 10:26:00,1,2827.0,2571.0,0.909,13.983,5,3,0,3,2,0,2,0,0.0,0.0
1014,953,2020-03-18 10:29:00,1,2547.0,2397.0,0.941,12.689,13,2,0,2,11,4,7,0,0.0,0.0
1014,954,2020-03-18 10:32:00,1,2371.0,2193.0,0.925,11.77,202,128,84,44,74,46,28,49,0.0,0.0
1014,955,2020-03-18 10:35:00,1,2990.0,2696.0,0.902,14.763,165,109,60,49,56,29,27,77,0.0,0.0
1014,956,2020-03-18 10:38:00,1,3044.0,2876.0,0.945,15.176,313,150,113,37,163,114,49,111,0.0,0.0
1014,957,2020-03-18 10:41:00,1,3059.0,2803.0,0.916,15.154,492,287,232,55,205,151,54,35,0.0,0.0
1014,958,2020-03-18 10:44:00,1,3048.0,2905.0,0.953,15.224,120,76,39,37,44,29,15,8,0.0,0.0
1014,959,2020-03-18 10:47:00,1,3237.0,3015.0,0.931,16.093,62,56,27,29,6,1,5,0,0.0,0.0
1014,960,2020-03-18 10:50:00,1,3048.0,2897.0,0.95,15.215,16,13,5,8,3,0,3,0,0.0,0.0
1014,961,2020-03-18 10:53:00,1,2973.0,2753.0,0.926,14.763,30,24,13,11,6,0,6,0,0.0,0.2
1014,962,2020-03-18 10:56:00,1,2794.0,2684.0,0.961,13.98,10,6,2,4,4,0,4,0,0.0,0.0
1014,963,2020-03-18 10:59:00,1,2810.0,2646.0,0.941,14.002,3,0,0,0,3,0,3,0,0.0,0.0
1014,964,2020-03-18 11:02:00,1,2727.0,2555.0,0.937,13.572,2,0,0,0,2,0,2,0,0.0,0.0
1014,965,2020-03-18 11:05:00,1,2619.0,2511.0,0.959,13.099,6,2,1,1,4,0,4,0,0.0,0.16
1014,966,2020-03-18 11:08:00,1,2553.0,2394.0,0.938,12.709,180,110,63,47,70,39,31,41,0.0,0.0
1014,967,2020-03-18 11:11:00,1,3100.0,2735.0,0.882,15.244,258,128,87,41,130,94,36,61,0.11,0.0
1014,968,2020-03-18 11:14:00,1,3065.0,2798.0,0.913,15.175,164,77,53,24,87,55,32,16,0.0,0.0
1014,969,2020-03-18 11:17:00,1,3245.0,2973.0,0.916,16.078,62,38,12,26,24,6,18,1,0.0,0.0
1014,970,2020-03-18 11:20:00,1,3050.0,2905.0,0.953,15.232,12,6,0,6,6,0,6,0,0.0,0.0
1014,971,2020-03-18 11:23:00,1,2979.0,2786.0,0.935,14.821,10,4,1,3,6,0,6,0,0.0,0.0
1014,972,2020-03-18 11:26:00,1,2790.0,2679.0,0.96,13.956,16,3,2,1,13,7,6,0,0.0,0.0
1014,973,2020-03-18 11:29:00,1,2779.0,2681.0,0.9645,13.916,6,0,0,0,6,0,6,0,0.0,0.0
1014,974,2020-03-18 11:32:00,1,2768.0,2683.0,0.969,13.876,20,3,2,1,17,3,14,0,0.0,0.0
1014,975,2020-03-18 11:35:00,1,2782.0,2672.0,0.961,13.918,46,36,0,36,10,0,10,0,0.0,0.0
1014,976,2020-03-18 11:38:00,1,2791.0,2634.0,0.944,13.911,33,25,1,24,8,0,8,0,0.0,0.05
1014,977,2020-03-18 11:41:00,1,2809.0,2611.0,0.93,13.958,6,0,0,0,6,0,6,0,0.0,0.0
1014,978,2020-03-18 11:44:00,1,2714.0,2541.0,0.936,13.507,7,0,0,0,7,4,3,0,0.0,0.0
1014,979,2020-03-18 11:47:00,1,2640.0,2509.0,0.95,13.178,3,0,0,0,3,0,3,0,0.0,0.0
1014,980,2020-03-18 11:50:00,1,2515.0,2446.0,0.972,12.617,132,54,34,20,78,48,30,23,0.27,0.0
1014,981,2020-03-18 11:53:00,1,2799.0,2631.0,0.94,13.943,66,21,16,5,45,14,31,8,0.0,0.0
1014,982,2020-03-18 11:56:00,1,2801.0,2631.0,0.939,13.949,37,12,5,7,25,8,17,0,0.0,0.02
1014,983,2020-03-18 11:59:00,1,2775.0,2686.0,0.968,13.908,57,31,22,9,26,9,17,0,0.0,0.0
1014,984,2020-03-18 12:02:00,1,2980.0,2755.0,0.925,14.793,29,13,2,11,16,0,16,0,0.0,0.0
1014,985,2020-03-18 12:05:00,1,2987.0,2772.0,0.928,14.839,29,20,6,14,9,0,9,0,0.0,0.0
1014,986,2020-03-18 12:08:00,1,2788.0,2709.0,0.972,13.984,102,71,40,31,31,11,20,1,0.0,0.28
1014,987,2020-03-18 12:11:00,1,2979.0,2746.0,0.922,14.778,130,112,60,52,18,6,12,4,0.0,0.01
1014,988,2020-03-18 12:14:00,1,3070.0,2859.0,0.931,15.261,216,144,98,46,72,48,24,27,0.1,0.0
1014,989,2020-03-18 12:17:00,1,3064.0,2819.0,0.92,15.192,44,30,13,17,14,7,7,0,0.0,0.0
1014,990,2020-03-18 12:20:00,1,2781.0,2710.0,0.974,13.955,6,0,0,0,6,0,6,0,0.0,0.0
1014,991,2020-03-18 12:23:00,1,2814.0,2594.0,0.922,13.959,14,3,1,2,11,0,11,0,0.0,0.0
1014,992,2020-03-18 12:26:00,1,2621.0,2509.0,0.957,13.104,7,2,0,2,5,0,5,0,0.0,0.0
1014,993,2020-03-18 12:29:00,1,2823.0,2533.0,0.897,13.929,5,0,0,0,5,0,5,0,0.0,0.0
1014,994,2020-03-18 12:32:00,1,2731.0,2506.0,0.918,13.537,99,70,45,25,29,17,12,27,0.0,0.0
1014,995,2020-03-18 12:35:00,1,3068.0,2761.0,0.9,15.143,278,126,87,39,152,100,52,50,0.09,0.0
1014,996,2020-03-18 12:38:00,1,2892.0,2702.0,0.934,14.387,498,272,207,65,226,148,78,31,0.0,0.0
1014,997,2020-03-18 12:41:00,1,3069.0,2840.0,0.925,15.236,501,287,217,70,214,151,63,28,0.0,0.0
1014,998,2020-03-18 12:44:00,1,2989.0,2755.0,0.922,14.826,347,163,119,44,184,138,46,11,0.0,0.0
1014,999,2020-03-18 12:47:00,1,3235.0,3041.0,0.94,16.114,41,36,9,27,5,0,5,0,0.0,0.0
1014,1000,2020-03-18 12:50:00,1,3217.0,3061.0,0.952,16.062,77,52,16,36,25,3,22,0,0.0,0.0
1014,1001,2020-03-18 12:53:00,1,3209.0,3090.0,0.963,16.063,64,53,26,27,11,1,10,0,0.0,0.0
1014,1002,2020-03-18 12:56:00,1,3124.0,2983.0,0.955,15.609,22,18,13,5,4,2,2,0,0.0,0.0
1014,1003,2020-03-18 12:59:00,1,3068.0,2842.0,0.926,15.232,18,17,4,13,1,0,1,0,0.0,0.0
1014,1004,2020-03-18 13:02:00,1,3046.0,2876.0,0.944,15.186,5,2,0,2,3,0,3,0,0.0,0.0
1014,1005,2020-03-18 13:05:00,1,2980.0,2727.0,0.915,14.761,5,2,0,2,3,0,3,0,0.0,0.0
1014,1006,2020-03-18 13:08:00,1,3000.0,2677.0,0.893,14.782,189,97,60,37,92,50,42,57,0.0,0.0
1014,1007,2020-03-18 13:11:00,1,3202.0,3153.0,0.985,16.106,260,91,63,28,169,130,39,25,0.0,0.0
1014,1008,2020-03-18 13:14:00,1,3054.0,2819.0,0.923,15.155,6,5,1,4,1,1,0,0,0.0,0.0
1014,1009,2020-03-18 13:17:00,1,3064.0,2834.0,0.925,15.21,4,4,2,2,0,0,0,0,0.0,0.0
1014,1010,2020-03-18 13:20:00,1,3055.0,2834.0,0.928,15.174,19,12,7,5,7,3,4,0,0.0,0.0
1014,1011,2020-03-18 13:23:00,1,3060.0,2861.0,0.935,15.223,30,14,2,12,16,3,13,0,0.0,0.0
1014,1012,2020-03-18 13:26:00,1,2973.0,2753.0,0.926,14.761,22,15,1,14,7,2,5,0,0.0,0.0
1014,1013,2020-03-18 13:29:00,1,2780.0,2709.0,0.974,13.954,60,41,25,16,19,7,12,0,0.0,0.0
1014,1014,2020-03-18 13:32:00,1,2797.0,2646.0,0.946,13.949,17,5,0,5,12,0,12,0,0.0,0.0
1014,1015,2020-03-18 13:35:00,1,2787.0,2695.0,0.967,13.964,10,2,0,2,8,0,8,0,0.0,0.0
1014,1016,2020-03-18 13:38:00,1,2815.0,2590.0,0.92,13.958,21,15,1,14,6,0,6,0,0.0,0.0
1014,1017,2020-03-18 13:41:00,1,2628.0,2495.0,0.949,13.118,85,57,46,11,28,12,16,13,0.0,0.14
1014,1018,2020-03-18 13:44:00,1,2993.0,2719.0,0.908,14.804,55,22,12,10,33,16,17,0,0.15,0.0
1014,1019,2020-03-18 13:47:00,1,3056.0,2853.0,0.934,15.199,81,50,36,14,31,24,7,47,0.0,0.0
1014,1020,2020-03-18 13:50:00,1,3078.0,2839.0,0.922,15.272,11,2,1,1,9,4,5,0,0.0,0.0
1014,1021,2020-03-18 13:53:00,1,3084.0,2803.0,0.909,15.255,8,2,0,2,6,0,6,0,0.0,0.04
1014,1022,2020-03-18 13:56:00,1,2973.0,2780.0,0.935,14.791,61,43,25,18,18,9,9,2,0.0,0.0
1014,1023,2020-03-18 13:59:00,1,3072.0,2856.0,0.93,15.266,356,207,144,63,149,103,46,33,0.0,0.0
1014,1024,2020-03-18 14:02:00,1,3136.0,2967.0,0.946,15.638,107,92,49,43,15,5,10,1,0.0,0.0
1014,1025,2020-03-18 14:05:00,1,3131.0,2966.0,0.947,15.621,99,89,56,33,10,2,8,1,0.0,0.0
1014,1026,2020-03-18 14:08:00,1,3239.0,2970.0,0.917,16.049,71,51,15,36,20,6,14,0,0.0,0.0
1014,1027,2020-03-18 14:11:00,1,3237.0,2986.0,0.923,16.058,25,24,2,22,1,1,0,0,0.0,0.15
1014,1028,2020-03-18 14:14:00,1,3127.0,2968.0,0.949,15.606,37,33,16,17,4,1,3,0,0.0,0.01
1014,1029,2020-03-18 14:17:00,1,3045.0,2943.0,0.967,15.255,7,0,0,0,7,3,4,0,0.0,0.0
1014,1030,2020-03-18 14:20:00,1,2975.0,2774.0,0.933,14.791,6,1,1,0,5,1,4,0,0.0,0.0
1014,1031,2020-03-18 14:23:00,1,2970.0,2770.0,0.933,14.77,276,147,122,25,129,91,38,27,0.22,0.0
1014,1032,2020-03-18 14:26:00,1,2975.0,2740.0,0.921,14.755,5,1,0,1,4,0,4,0,0.0,0.0
1014,1033,2020-03-18 14:29:00,1,2936.0,2711.0,0.9235,14.57,6,4,0,4,2,0,2,0,0.0,0.0
1014,1034,2020-03-18 14:32:00,1,2897.0,2682.0,0.926,14.385,17,0,0,0,17,9,8,0,0.0,0.0
1014,1035,2020-03-18 14:35:00,1,2924.0,2563.0,0.876,14.358,92,55,33,22,37,20,17,25,0.0,0.0
1014,1036,2020-03-18 14:38:00,1,3187.0,2761.0,0.866,15.616,151,62,38,24,89,48,41,38,0.18,0.0
1014,1037,2020-03-18 14:41:00,1,2877.0,2693.0,0.936,14.317,10,2,1,1,8,2,6,0,0.0,0.0
1014,1038,2020-03-18 14:44:00,1,2884.0,2724.0,0.945,14.377,8,4,0,4,4,2,2,0,0.0,0.0
1014,1039,2020-03-18 14:47:00,1,2880.0,2713.0,0.942,14.35,6,0,0,0,6,3,3,0,0.0,0.0
1014,1040,2020-03-18 14:50:00,1,2908.0,2645.0,0.91,14.385,27,7,4,3,20,11,9,0,0.0,0.1
1014,1041,2020-03-18 14:53:00,1,2903.0,2643.0,0.91,14.364,24,13,5,8,11,2,9,0,0.0,0.0
1014,1042,2020-03-18 14:56:00,1,2899.0,2680.0,0.924,14.389,11,0,0,0,11,0,11,0,0.0,0.0
1014,1043,2020-03-18 14:59:00,1,2902.0,2653.0,0.914,14.372,168,72,39,33,96,57,39,51,0.0,0.17
1014,1044,2020-03-18 15:02:00,1,2884.0,2696.0,0.935,14.349,221,106,72,34,115,76,39,18,0.0,0.0
1014,1045,2020-03-18 15:05:00,1,3167.0,2874.0,0.908,15.658,9,3,2,1,6,0,6,0,0.0,0.0
1014,1046,2020-03-18 15:08:00,1,3079.0,2794.0,0.907,15.225,73,63,53,10,10,0,10,0,0.0,0.28
1014,1047,2020-03-18 15:11:00,1,2977.0,2764.0,0.928,14.79,16,9,8,1,7,0,7,0,0.0,0.0
1014,1048,2020-03-18 15:14:00,1,3169.0,2839.0,0.896,15.628,8,2,1,1,6,0,6,0,0.0,0.0
1014,1049,2020-03-18 15:17:00,1,3174.0,2840.0,0.895,15.651,8,0,0,0,8,0,8,0,0.0,0.0
1014,1050,2020-03-18 15:20:00,1,3173.0,2867.0,0.904,15.676,10,8,4,4,2,0,2,0,0.0,0.0
1014,1051,2020-03-18 15:23:00,1,3180.0,2782.0,0.875,15.607,25,23,13,10,2,0,2,0,0.0,0.0
1014,1052,2020-03-18 15:26:00,1,2981.0,2703.0,0.907,14.737,168,87,67,20,81,62,19,2,0.02,0.0
1014,1053,2020-03-18 15:29:00,1,2889.0,2690.0,0.931,14.363,14,7,4,3,7,0,7,0,0.0,0.0
1014,1054,2020-03-18 15:32:00,1,2897.0,2671.0,0.922,14.37,4,1,1,0,3,0,3,0,0.0,0.0
1014,1055,2020-03-18 15:35:00,1,2922.0,2598.0,0.889,14.389,11,3,1,2,8,0,8,0,0.0,0.0
1014,1056,2020-03-18 15:38:00,1,2926.0,2554.0,0.873,14.355,8,3,2,1,5,0,5,0,0.0,0.0
1014,1057,2020-03-18 15:41:00,1,2726.0,2522.0,0.925,13.535,12,6,3,3,6,0,6,0,0.0,0.0
1014,1058,2020-03-18 15:44:00,1,2837.0,2514.0,0.886,13.961,139,59,36,23,80,46,34,40,0.0,0.0
1014,1059,2020-03-18 15:47:00,1,2992.0,2706.0,0.904,14.783,131,27,9,18,104,56,48,2,0.09,0.0
1014,1060,2020-03-18 15:50:00,1,2923.0,2618.0,0.895,14.417,157,65,35,30,92,52,40,18,0.0,0.0
1014,1061,2020-03-18 15:53:00,1,3160.0,2859.0,0.905,15.615,13,1,0,1,12,5,7,0,0.0,0.0
1014,1062,2020-03-18 15:56:00,1,3072.0,2802.0,0.912,15.205,7,0,0,0,7,2,5,0,0.0,0.0
1014,1063,2020-03-18 15:59:00,1,3169.0,2806.0,0.885,15.59,12,0,0,0,12,3,9,0,0.0,0.0
1014,1064,2020-03-18 16:02:00,1,3076.0,2778.0,0.903,15.196,12,5,3,2,7,2,5,0,0.0,0.0
1014,1065,2020-03-18 16:05:00,1,2893.0,2695.0,0.932,14.382,3,0,0,0,3,1,2,0,0.0,0.0
1014,1066,2020-03-18 16:08:00,1,2923.0,2555.0,0.874,14.344,1,0,0,0,1,0,1,0,0.0,0.0
1014,1067,2020-03-18 16:11:00,1,2932.0,2550.0,0.87,14.375,159,56,35,21,103,62,41,53,0.0,0.0
1014,1068,2020-03-18 16:14:00,1,2892.0,2697.0,0.933,14.381,160,76,38,38,84,67,17,5,0.0,0.0
1014,1069,2020-03-18 16:17:00,1,3190.0,2808.0,0.88,15.676,33,19,3,16,14,1,13,0,0.01,0.0
1014,1070,2020-03-18 16:20:00,1,3071.0,2817.0,0.917,15.219,27,19,7,12,8,0,8,0,0.0,0.0
1014,1071,2020-03-18 16:23:00,1,3171.0,2874.0,0.906,15.677,20,6,3,3,14,1,13,0,0.0,0.0
1014,1072,2020-03-18 16:26:00,1,3156.0,2880.0,0.913,15.623,12,0,0,0,12,1,11,0,0.0,0.0
1014,1073,2020-03-18 16:29:00,1,3167.0,2881.0,0.91,15.667,14,5,3,2,9,2,7,0,0.0,0.0
1014,1074,2020-03-18 16:32:00,1,3241.0,2933.0,0.905,16.017,65,47,19,28,18,0,18,0,0.0,0.0
1014,1075,2020-03-18 16:35:00,1,3148.0,2838.0,0.902,15.544,37,27,16,11,10,0,10,0,0.0,0.0
1014,1076,2020-03-18 16:38:00,1,3178.0,2797.0,0.88,15.619,123,58,40,18,65,35,30,21,0.0,0.0
1014,1077,2020-03-18 16:41:00,1,3323.0,3039.0,0.914,16.458,255,92,44,48,163,119,44,26,0.09,0.0
1014,1078,2020-03-18 16:44:00,1,3349.0,2976.0,0.889,16.491,62,21,5,16,41,14,27,1,0.0,0.0
1014,1079,2020-03-18 16:47:00,1,3314.0,3135.0,0.946,16.528,87,52,23,29,35,5,30,3,0.0,0.0
1014,1080,2020-03-18 16:50:00,1,3329.0,3117.0,0.936,16.565,37,30,17,13,7,0,7,0,0.0,0.0
1014,1081,2020-03-18 16:53:00,1,3317.0,3055.0,0.921,16.453,35,27,13,14,8,0,8,0,0.0,0.0
1014,1082,2020-03-18 16:56:00,1,3239.0,3006.0,0.928,16.088,12,6,1,5,6,0,6,0,0.0,0.0
1014,1083,2020-03-18 16:59:00,1,3343.0,3010.0,0.9,16.504,163,87,69,18,76,53,23,12,0.12,0.0
1014,1084,2020-03-18 17:02:00,1,3303.0,3071.0,0.93,16.412,55,41,25,16,14,9,5,0,0.0,0.0
1014,1085,2020-03-18 17:05:00,1,3310.0,3128.0,0.945,16.505,36,13,3,10,23,4,19,1,0.0,0.0
1014,1086,2020-03-18 17:08:00,1,3314.0,3097.0,0.935,16.484,37,22,9,13,15,8,7,1,0.0,0.0
1014,1087,2020-03-18 17:11:00,1,3327.0,3015.0,0.906,16.448,29,16,3,13,13,4,9,0,0.0,0.0
1014,1088,2020-03-18 17:14:00,1,3172.0,2856.0,0.9,15.661,25,16,7,9,9,2,7,0,0.0,0.0
1014,1089,2020-03-18 17:17:00,1,2886.0,2724.0,0.944,14.387,146,65,42,23,81,49,32,43,0.0,0.0
1014,1090,2020-03-18 17:20:00,1,3497.0,3233.0,0.925,17.36,187,59,34,25,128,85,43,45,0.02,0.0
1014,1091,2020-03-18 17:23:00,1,3169.0,2875.0,0.907,15.67,448,256,215,41,192,164,28,152,0.0,0.0
1014,1092,2020-03-18 17:26:00,1,3304.0,3070.0,0.929,16.415,510,272,221,51,238,176,62,80,0.03,0.0
1014,1093,2020-03-18 17:29:00,1,3342.5,3135.5,0.938,16.641,979,516,408,108,463,352,111,34,0.0,0.0
1014,1094,2020-03-18 17:32:00,1,3381.0,3201.0,0.947,16.867,754,392,321,71,362,277,85,55,0.0,0.0
1014,1095,2020-03-18 17:35:00,1,3387.0,3206.0,0.947,16.893,429,207,164,43,222,160,62,40,0.0,0.0
1014,1096,2020-03-18 17:38:00,1,3337.0,3018.0,0.905,16.489,248,102,62,40,146,91,55,1,0.0,0.0
1014,1097,2020-03-18 17:41:00,1,3585.0,3287.0,0.917,17.764,265,175,129,46,90,55,35,10,0.0,0.0
1014,1098,2020-03-18 17:44:00,1,3309.0,3135.0,0.948,16.508,260,152,102,50,108,79,29,4,0.07,0.0
1014,1099,2020-03-18 17:47:00,1,3307.0,3126.0,0.945,16.49,33,24,9,15,9,1,8,0,0.0,0.0
1014,1100,2020-03-18 17:50:00,1,3327.0,3047.0,0.916,16.481,80,64,21,43,16,3,13,2,0.0,0.0
1014,1101,2020-03-18 17:53:00,1,3320.0,3059.0,0.921,16.469,42,18,7,11,24,6,18,0,0.0,0.12
1014,1102,2020-03-18 17:56:00,1,3138.0,2983.0,0.95,15.666,15,1,1,0,14,0,14,0,0.0,0.19
1014,1103,2020-03-18 17:59:00,1,3145.0,2891.0,0.919,15.59,31,14,10,4,17,4,13,0,0.0,0.0
1014,1104,2020-03-18 18:02:00,0,3162.0,2851.0,0.902,15.613,52,45,21,24,7,4,3,0,0.0,0.0
1014,1105,2020-03-18 18:05:00,0,3163.0,2807.0,0.887,15.571,395,250,199,51,145,107,38,83,0.0,0.0
1014,1106,2020-03-18 18:08:00,0,3136.0,2917.0,0.93,15.586,211,123,83,40,88,57,31,23,0.0,0.0
1014,1107,2020-03-18 18:11:00,0,3173.0,2869.0,0.904,15.679,11,8,2,6,3,0,3,0,0.0,0.0
1014,1108,2020-03-18 18:14:00,0,2888.0,2711.0,0.939,14.378,4,4,0,4,0,0,0,0,0.0,0.0
1014,1109,2020-03-18 18:17:00,0,2977.0,2717.0,0.913,14.739,7,2,1,1,5,2,3,0,0.0,0.0
1014,1110,2020-03-18 18:20:00,0,2988.0,2722.0,0.911,14.784,14,2,0,2,12,3,9,0,0.0,0.0
1014,1111,2020-03-18 18:23:00,0,3087.0,2751.0,0.891,15.208,103,42,29,13,61,40,21,20,0.0,0.0
1014,1112,2020-03-18 18:26:00,0,3185.0,2777.0,0.872,15.625,172,27,12,15,145,95,50,60,0.18,0.0
1014,1113,2020-03-18 18:29:00,0,3156.0,2898.0,0.918,15.642,159,84,63,21,75,43,32,21,0.0,0.0
1014,1114,2020-03-18 18:32:00,0,3327.0,3019.0,0.908,16.449,131,111,66,45,20,4,16,7,0.0,0.0
1014,1115,2020-03-18 18:35:00,0,3319.0,3120.0,0.94,16.53,176,112,50,62,64,33,31,5,0.0,0.0
1014,1116,2020-03-18 18:38:00,0,3215.0,2973.0,0.925,15.961,258,164,113,51,94,67,27,62,0.0,0.0
1014,1117,2020-03-18 18:41:00,0,3321.0,3072.0,0.925,16.484,356,183,139,44,173,132,41,48,0.0,0.04
1014,1118,2020-03-18 18:44:00,0,3311.0,3054.0,0.922,16.428,540,299,238,61,241,184,57,68,0.0,0.0
1014,1119,2020-03-18 18:47:00,0,3583.0,3281.0,0.916,17.749,571,304,213,91,267,208,59,80,0.07,0.0
1014,1120,2020-03-18 18:50:00,0,3149.0,2962.0,0.941,15.688,969,435,346,89,534,410,124,25,0.0,0.0
1014,1121,2020-03-18 18:53:00,0,3293.0,3138.0,0.953,16.449,797,403,318,85,394,317,77,64,0.11,0.0
1014,1122,2020-03-18 18:56:00,0,3319.0,3092.0,0.932,16.499,353,196,152,44,157,116,41,26,0.0,0.0
1014,1123,2020-03-18 18:59:00,0,3343.0,3025.0,0.905,16.522,173,112,77,35,61,36,25,35,0.0,0.0
1014,1124,2020-03-18 19:02:00,0,3285.0,3156.0,0.961,16.436,402,218,172,46,184,147,37,185,0.02,0.0
1014,1125,2020-03-18 19:05:00,0,3535.0,3387.0,0.958,17.678,799,437,371,66,362,290,72,263,0.0,0.0
1014,1126,2020-03-18 19:08:00,0,3829.0,3519.0,0.919,18.982,511,255,212,43,256,197,59,189,0.22,0.0
1014,1127,2020-03-18 19:11:00,0,3569.0,3386.0,0.949,17.812,315,136,73,63,179,118,61,29,0.01,0.0
1014,1128,2020-03-18 19:14:00,0,3573.0,3373.0,0.944,17.81,580,278,216,62,302,235,67,55,0.0,0.0
1014,1129,2020-03-18 19:17:00,0,3390.0,3244.0,0.957,16.947,311,136,91,45,175,109,66,16,0.0,0.0
1014,1130,2020-03-18 19:20:00,0,3569.0,3309.0,0.927,17.724,116,89,41,48,27,6,21,4,0.0,0.0
1014,1131,2020-03-18 19:23:00,0,3588.0,3265.0,0.91,17.75,101,65,16,49,36,4,32,9,0.0,0.0
1014,1132,2020-03-18 19:26:00,0,3288.0,3196.0,0.972,16.492,113,71,49,22,42,9,33,21,0.0,0.0
1014,1133,2020-03-18 19:29:00,0,3305.0,3089.0,0.934,16.443,40,23,18,5,17,9,8,26,0.0,0.0
1014,1134,2020-03-18 19:32:00,0,3149.0,2939.0,0.933,15.663,0,0,0,0,0,0,0,0,0.0,0.0
1014,1135,2020-03-18 19:35:00,0,3077.0,2809.0,0.913,15.232,89,48,37,11,41,33,8,18,0.0,0.0
1014,1136,2020-03-18 19:38:00,0,3378.0,3284.0,0.972,16.945,164,61,33,28,103,67,36,27,0.0,0.0
1014,1137,2020-03-18 19:41:00,0,3321.0,3090.0,0.93,16.506,534,259,215,44,275,201,74,115,0.0,0.0
1014,1138,2020-03-18 19:44:00,0,3154.0,2945.0,0.934,15.687,301,145,103,42,156,119,37,31,0.0,0.0
1014,1139,2020-03-18 19:47:00,0,3143.0,2947.0,0.938,15.646,1,0,0,0,1,1,0,0,0.0,0.0
1014,1140,2020-03-18 19:50:00,0,3115.0,2972.0,0.954,15.561,0,0,0,0,0,0,0,0,0.0,0.0
1014,1141,2020-03-18 19:53:00,0,3166.0,2888.0,0.912,15.672,0,0,0,0,0,0,0,0,0.0,0.0
1014,1142,2020-03-18 19:56:00,0,3069.0,2808.0,0.915,15.2,0,0,0,0,0,0,0,0,0.0,0.0
1014,1143,2020-03-18 19:59:00,0,2877.0,2750.0,0.956,14.379,38,21,15,6,17,8,9,7,0.0,0.0
1014,1144,2020-03-18 20:02:00,0,3072.0,2810.0,0.915,15.214,230,112,88,24,118,81,37,34,0.16,0.0
1014,1145,2020-03-18 20:05:00,0,3134.0,2943.0,0.939,15.605,10,0,0,0,10,6,4,0,0.0,0.0
1014,1146,2020-03-18 20:08:00,0,3160.0,2916.0,0.923,15.68,0,0,0,0,0,0,0,0,0.0,0.0
1014,1147,2020-03-18 20:11:00,0,3071.0,2832.0,0.922,15.235,59,40,25,15,19,12,7,0,0.0,0.0
1014,1148,2020-03-18 20:14:00,0,2984.0,2809.0,0.941,14.868,12,11,3,8,1,0,1,0,0.0,0.0
1014,1149,2020-03-18 20:17:00,0,3069.0,2829.0,0.922,15.225,164,81,61,20,83,52,31,2,0.0,0.0
1014,1150,2020-03-18 20:20:00,0,3153.0,2916.0,0.925,15.651,34,9,5,4,25,8,17,8,0.0,0.0
1014,1151,2020-03-18 20:23:00,0,3143.0,2974.0,0.946,15.675,83,56,16,40,27,2,25,7,0.0,0.0
1014,1152,2020-03-18 20:26:00,0,3126.0,3022.0,0.967,15.664,151,86,54,32,65,29,36,4,0.14,0.0
1014,1153,2020-03-18 20:29:00,0,2994.5,2907.5,0.971,15.0185,0,0,0,0,0,0,0,0,0.0,0.0
1014,1154,2020-03-18 20:32:00,0,2863.0,2793.0,0.975,14.373,0,0,0,0,0,0,0,0,0.0,0.0
1014,1155,2020-03-18 20:35:00,0,2866.0,2775.0,0.968,14.364,0,0,0,0,0,0,0,0,0.0,0.0
1014,1156,2020-03-18 20:38:00,0,2883.0,2696.0,0.935,14.343,0,0,0,0,0,0,0,0,0.0,0.0
1014,1157,2020-03-18 20:41:00,0,2864.0,2680.0,0.936,14.249,77,39,31,8,38,23,15,7,0.2,0.0
1014,1158,2020-03-18 20:44:00,0,2802.0,2565.0,0.915,13.879,210,81,38,43,129,76,53,0,0.0,0.0
1014,1159,2020-03-18 20:47:00,0,2967.0,2798.0,0.943,14.787,364,143,98,45,221,145,76,24,0.0,0.0
1014,1160,2020-03-18 20:50:00,0,2891.0,2760.0,0.955,14.448,638,277,210,67,361,267,94,14,0.0,0.0
1014,1161,2020-03-18 20:53:00,0,3128.0,2996.0,0.958,15.641,216,89,55,34,127,74,53,5,0.0,0.0
1014,1162,2020-03-18 20:56:00,0,3126.0,2933.0,0.938,15.564,431,222,174,48,209,161,48,125,0.0,0.0
1014,1163,2020-03-18 20:59:00,0,3137.0,2968.0,0.946,15.647,478,238,189,49,240,178,62,38,0.0,0.0
1014,1164,2020-03-18 21:02:00,0,3316.0,3055.0,0.921,16.448,91,36,0,36,55,16,39,12,0.0,0.0
1014,1165,2020-03-18 21:05:00,0,3299.0,3098.0,0.939,16.426,215,96,48,48,119,65,54,30,0.0,0.0
1014,1166,2020-03-18 21:08:00,0,3221.0,3017.0,0.937,16.031,269,123,88,35,146,94,52,22,0.0,0.0
1014,1167,2020-03-18 21:11:00,0,3231.0,3061.0,0.947,16.118,35,3,1,2,32,8,24,0,0.0,0.0
1014,1168,2020-03-18 21:14:00,0,3134.0,2942.0,0.939,15.604,60,34,6,28,26,2,24,5,0.0,0.0
1014,1169,2020-03-18 21:17:00,0,3119.0,2992.0,0.959,15.599,99,58,16,42,41,8,33,0,0.0,0.0
1014,1170,2020-03-18 21:20:00,0,3126.0,2992.0,0.957,15.627,238,118,87,31,120,85,35,5,0.09,0.0
1014,1171,2020-03-18 21:23:00,0,3144.0,3000.0,0.954,15.707,126,50,21,29,76,39,37,4,0.0,0.0
1014,1172,2020-03-18 21:26:00,0,3149.0,2932.0,0.931,15.652,90,61,24,37,29,7,22,1,0.0,0.0
1014,1173,2020-03-18 21:29:00,0,3173.0,2858.0,0.901,15.666,137,71,41,30,66,38,28,38,0.08,0.0
1014,1174,2020-03-18 21:32:00,0,3217.0,3070.0,0.954,16.073,485,273,212,61,212,166,46,119,0.0,0.0
1014,1175,2020-03-18 21:35:00,0,3131.0,2997.0,0.957,15.652,393,203,156,47,190,142,48,146,0.01,0.07
1014,1176,2020-03-18 21:38:00,0,3300.0,3090.0,0.936,16.424,447,203,153,50,244,183,61,13,0.12,0.15
1014,1177,2020-03-18 21:41:00,0,3324.0,3048.0,0.917,16.47,84,45,11,34,39,17,22,4,0.0,0.0
1014,1178,2020-03-18 21:44:00,0,3325.0,3006.0,0.904,16.429,195,91,71,20,104,71,33,13,0.06,0.0
1014,1179,2020-03-18 21:47:00,0,3313.0,3060.0,0.924,16.442,79,61,23,38,18,3,15,8,0.0,0.0
1014,1180,2020-03-18 21:50:00,0,3330.0,3085.0,0.926,16.533,65,55,16,39,10,1,9,0,0.0,0.0
1014,1181,2020-03-18 21:53:00,0,3222.0,2993.0,0.929,16.007,214,92,44,48,122,68,54,1,0.0,0.0
1014,1182,2020-03-18 21:56:00,0,3153.0,2886.0,0.915,15.618,314,166,119,47,148,99,49,3,0.04,0.0
1014,1183,2020-03-18 21:59:00,0,3168.0,2867.0,0.905,15.654,501,213,164,49,288,215,73,61,0.05,0.0
1014,1184,2020-03-18 22:02:00,0,3135.0,2991.0,0.954,15.661,158,68,34,34,90,61,29,5,0.0,0.0
1014,1185,2020-03-18 22:05:00,0,3170.0,2917.0,0.92,15.72,4,2,1,1,2,0,2,0,0.0,0.0
1014,1186,2020-03-18 22:08:00,0,3074.0,2823.0,0.919,15.236,0,0,0,0,0,0,0,0,0.0,0.0
1014,1187,2020-03-18 22:11:00,0,2875.0,2708.0,0.942,14.326,5,2,1,1,3,0,3,0,0.0,0.0
1014,1188,2020-03-18 22:14:00,0,2895.0,2696.0,0.931,14.392,267,108,83,25,159,113,46,31,0.3,0.0
1014,1189,2020-03-18 22:17:00,0,2902.0,2653.0,0.914,14.372,420,156,103,53,264,197,67,29,0.0,0.0
1014,1190,2020-03-18 22:20:00,0,2883.0,2730.0,0.947,14.381,399,226,166,60,173,119,54,21,0.0,0.0
1014,1191,2020-03-18 22:23:00,0,3165.0,2865.0,0.905,15.641,1234,505,375,130,729,576,153,12,0.0,0.0
1014,1192,2020-03-18 22:26:00,0,3173.0,2904.0,0.915,15.718,550,249,172,77,301,227,74,20,0.0,0.0
1014,1193,2020-03-18 22:29:00,0,3188.0,2849.0,0.894,15.717,137,51,33,18,86,62,24,39,0.0,0.0
1014,1194,2020-03-18 22:32:00,0,3177.0,2823.0,0.889,15.642,52,38,8,30,14,2,12,0,0.0,0.0
1014,1195,2020-03-18 22:35:00,0,2990.0,2770.0,0.926,14.848,71,64,27,37,7,1,6,0,0.0,0.0
1014,1196,2020-03-18 22:38:00,0,3079.0,2767.0,0.899,15.194,120,95,47,48,25,3,22,1,0.02,0.0
1014,1197,2020-03-18 22:41:00,0,3087.0,2798.0,0.906,15.261,228,111,83,28,117,79,38,7,0.18,0.0
1014,1198,2020-03-18 22:44:00,0,2877.0,2710.0,0.942,14.337,4,0,0,0,4,1,3,0,0.0,0.0
1014,1199,2020-03-18 22:47:00,0,2809.0,2585.0,0.92,13.928,4,0,0,0,4,3,1,0,0.0,0.0
1014,1200,2020-03-18 22:50:00,0,2613.0,2520.0,0.964,13.086,67,37,29,8,30,14,16,14,0.0,0.0
1014,1201,2020-03-18 22:53:00,0,3192.0,2802.0,0.878,15.678,235,127,85,42,108,66,42,80,0.01,0.0
1014,1202,2020-03-18 22:56:00,0,3085.0,2786.0,0.903,15.237,280,156,103,53,124,80,44,21,0.05,0.0
1014,1203,2020-03-18 22:59:00,0,3140.0,2948.0,0.939,15.636,8,4,2,2,4,2,2,0,0.0,0.0
1014,1204,2020-03-18 23:02:00,0,3075.0,2833.0,0.922,15.25,3,0,0,0,3,1,2,0,0.0,0.0
1014,1205,2020-03-18 23:05:00,0,3071.0,2793.0,0.909,15.194,2,0,0,0,2,1,1,0,0.0,0.0
1014,1206,2020-03-18 23:08:00,0,3311.0,3072.0,0.928,16.447,45,33,17,16,12,7,5,0,0.0,0.0
1014,1207,2020-03-18 23:11:00,0,3236.0,2986.0,0.923,16.056,32,20,13,7,12,5,7,0,0.0,0.0
1014,1208,2020-03-18 23:14:00,0,3125.0,2973.0,0.951,15.604,85,74,65,9,11,7,4,0,0.0,0.0
1014,1209,2020-03-18 23:17:00,0,3165.0,2824.0,0.892,15.597,174,110,73,37,64,41,23,2,0.12,0.0
1014,1210,2020-03-18 23:20:00,0,3140.0,2930.0,0.933,15.615,112,72,29,43,40,13,27,0,0.0,0.0
1014,1211,2020-03-18 23:23:00,0,3236.0,3019.0,0.933,16.092,87,48,10,38,39,11,28,0,0.0,0.0
1014,1212,2020-03-18 23:26:00,0,3119.0,2973.0,0.953,15.58,250,124,79,45,126,90,36,15,0.33,0.0
1014,1213,2020-03-18 23:29:00,0,3196.0,2931.5,0.918,15.837,194,93,61,32,101,76,25,31,0.0,0.0
1014,1214,2020-03-18 23:32:00,0,3273.0,2890.0,0.883,16.094,149,76,52,24,73,34,39,26,0.0,0.0
1014,1215,2020-03-18 23:35:00,0,3268.0,2842.0,0.87,16.022,282,123,82,41,159,104,55,13,0.0,0.0
1014,1216,2020-03-18 23:38:00,0,2998.0,2739.0,0.914,14.843,600,274,216,58,326,257,69,179,0.0,0.0
1014,1217,2020-03-18 23:41:00,0,3271.0,2860.0,0.874,16.055,466,222,182,40,244,188,56,192,0.0,0.0
1014,1218,2020-03-18 23:44:00,0,3245.0,2922.0,0.9,16.02,404,184,137,47,220,161,59,86,0.0,0.0
1014,1219,2020-03-18 23:47:00,0,3271.0,2910.0,0.89,16.109,84,57,23,34,27,16,11,6,0.0,0.0
1014,1220,2020-03-18 23:50:00,0,3259.0,2869.0,0.88,16.014,285,133,96,37,152,99,53,36,0.0,0.0
1014,1221,2020-03-18 23:53:00,0,3263.0,2892.0,0.886,16.06,51,26,21,5,25,13,12,74,0.0,0.0
1014,1222,2020-03-18 23:56:00,0,3005.0,2728.0,0.908,14.861,110,38,19,19,72,39,33,0,0.0,0.0
1014,1223,2020-03-18 23:59:00,0,3018.0,2668.0,0.884,14.846,226,119,85,34,107,74,33,10,0.0,0.0
1014,1224,2020-03-19 00:02:00,0,3189.0,2739.0,0.859,15.599,158,95,56,39,63,42,21,5,0.0,0.0
1014,1225,2020-03-19 00:05:00,0,2997.0,2628.0,0.877,14.719,21,21,9,12,0,0,0,0,0.0,0.0
1014,1226,2020-03-19 00:08:00,0,2822.0,2485.0,0.88,13.871,0,0,0,0,0,0,0,0,0.0,0.0
1014,1227,2020-03-19 00:11:00,0,2738.0,2434.0,0.889,13.484,2,1,1,0,1,1,0,0,0.0,0.0
1014,1228,2020-03-19 00:14:00,0,2841.0,2492.0,0.877,13.951,0,0,0,0,0,0,0,0,0.0,0.0
1014,1229,2020-03-19 00:17:00,0,3022.0,2616.0,0.866,14.802,84,34,22,12,50,29,21,31,0.0,0.0
1014,1230,2020-03-19 00:20:00,0,3296.0,2772.0,0.841,16.055,162,68,37,31,94,58,36,12,0.11,0.0
1014,1231,2020-03-19 00:23:00,0,3377.0,2898.0,0.858,16.513,108,81,36,45,27,1,26,2,0.0,0.0
1014,1232,2020-03-19 00:26:00,0,3445.0,2936.0,0.852,16.825,65,34,16,18,31,9,22,2,0.0,0.0
1014,1233,2020-03-19 00:29:00,0,3275.0,2886.0,0.881,16.099,2,0,0,0,2,1,1,0,0.0,0.0
1014,1234,2020-03-19 00:32:00,0,3286.0,2853.0,0.868,16.103,0,0,0,0,0,0,0,0,0.0,0.0
1014,1235,2020-03-19 00:35:00,0,3273.0,2857.0,0.873,16.059,0,0,0,0,0,0,0,0,0.0,0.0
1014,1236,2020-03-19 00:38:00,0,3423.0,3025.0,0.884,16.836,86,46,32,14,40,22,18,2,0.33,0.0
1014,1237,2020-03-19 00:41:00,0,3438.0,2998.0,0.872,16.865,4,1,0,1,3,1,2,0,0.0,0.0
1014,1238,2020-03-19 00:44:00,0,3354.0,2937.0,0.876,16.465,92,46,16,30,46,2,44,0,0.0,0.0
1014,1239,2020-03-19 00:47:00,0,3452.0,2990.0,0.866,16.909,80,48,20,28,32,3,29,0,0.0,0.0
1014,1240,2020-03-19 00:50:00,0,3452.0,3003.0,0.87,16.926,200,116,81,35,84,49,35,47,0.03,0.0
1014,1241,2020-03-19 00:53:00,0,3273.0,2858.0,0.873,16.06,157,74,52,22,83,49,34,37,0.0,0.0
1014,1242,2020-03-19 00:56:00,0,3093.0,2710.0,0.876,15.186,114,57,38,19,57,32,25,0,0.0,0.0
1014,1243,2020-03-19 00:59:00,0,3179.0,2755.0,0.867,15.575,203,91,70,21,112,76,36,33,0.0,0.0
1014,1244,2020-03-19 01:02:00,0,3271.0,2882.0,0.881,16.077,314,153,116,37,161,113,48,91,0.0,0.0
1014,1245,2020-03-19 01:05:00,0,3256.0,2872.0,0.882,16.01,84,57,24,33,27,9,18,5,0.0,0.0
1014,1246,2020-03-19 01:08:00,0,3280.0,2759.0,0.841,15.978,314,155,117,38,159,113,46,23,0.06,0.0
1014,1247,2020-03-19 01:11:00,0,3099.0,2655.0,0.857,15.15,198,68,48,20,130,84,46,62,0.02,0.0
1014,1248,2020-03-19 01:14:00,0,3015.0,2610.0,0.866,14.77,53,29,16,13,24,5,19,35,0.0,0.0
1014,1249,2020-03-19 01:17:00,0,3030.0,2623.0,0.866,14.842,190,85,49,36,105,75,30,4,0.2,0.0
1014,1250,2020-03-19 01:20:00,0,3115.0,2655.0,0.852,15.214,89,47,27,20,42,25,17,3,0.0,0.0
1014,1251,2020-03-19 01:23:00,0,3013.0,2630.0,0.873,14.783,190,119,77,42,71,38,33,10,0.0,0.0
1014,1252,2020-03-19 01:26:00,0,3027.0,2638.0,0.871,14.849,285,133,93,40,152,112,40,38,0.0,0.0
1014,1253,2020-03-19 01:29:00,0,3023.0,2551.0,0.844,14.736,984,468,398,70,516,389,127,44,0.09,0.0
1014,1254,2020-03-19 01:32:00,0,2954.0,2457.0,0.832,14.361,285,133,104,29,152,112,40,9,0.0,0.45
1014,1255,2020-03-19 01:35:00,0,3298.0,2705.0,0.82,15.987,37,18,6,12,19,3,16,7,0.0,0.03
1014,1256,2020-03-19 01:38:00,0,3019.0,2561.0,0.848,14.731,6,1,0,1,5,0,5,0,0.0,0.0
1014,1257,2020-03-19 01:41:00,0,2763.0,2419.0,0.875,13.564,10,10,2,8,0,0,0,0,0.0,0.0
1014,1258,2020-03-19 01:44:00,0,2792.0,2324.0,0.832,13.573,83,47,30,17,36,17,19,27,0.0,0.0
1014,1259,2020-03-19 01:47:00,0,3230.0,2577.0,0.798,15.579,198,109,69,40,89,59,30,84,0.0,0.0
1014,1260,2020-03-19 01:50:00,0,3124.0,2586.0,0.828,15.17,47,24,11,13,23,15,8,1,0.0,0.0
1014,1261,2020-03-19 01:53:00,0,3024.0,2597.0,0.859,14.79,13,3,0,3,10,4,6,0,0.0,0.0
1014,1262,2020-03-19 01:56:00,0,3029.0,2595.0,0.857,14.809,13,2,1,1,11,1,10,0,0.0,0.0
1014,1263,2020-03-19 01:59:00,0,2999.0,2639.0,0.88,14.739,23,10,5,5,13,4,9,0,0.0,0.0
1014,1264,2020-03-19 02:02:00,0,3292.0,2779.0,0.844,16.049,22,16,11,5,6,3,3,0,0.0,0.0
1014,1265,2020-03-19 02:05:00,0,3000.0,2680.0,0.893,14.787,58,22,11,11,36,15,21,4,0.0,0.0
1014,1266,2020-03-19 02:08:00,0,3286.0,2812.0,0.856,16.059,48,34,10,24,14,0,14,0,0.0,0.0
1014,1267,2020-03-19 02:11:00,0,3282.0,2814.0,0.858,16.046,67,49,11,38,18,2,16,4,0.0,0.0
1014,1268,2020-03-19 02:14:00,0,3254.0,2912.0,0.895,16.043,220,116,84,32,104,62,42,45,0.16,0.0
1014,1269,2020-03-19 02:17:00,0,3273.0,2809.0,0.858,16.004,74,39,33,6,35,21,14,1,0.0,0.0
1014,1270,2020-03-19 02:20:00,0,2995.0,2740.0,0.915,14.833,0,0,0,0,0,0,0,0,0.0,0.0
1014,1271,2020-03-19 02:23:00,0,2977.0,2715.0,0.912,14.734,2,1,1,0,1,0,1,0,0.0,0.0
1014,1272,2020-03-19 02:26:00,0,3014.0,2676.0,0.888,14.84,2,1,0,1,1,0,1,0,0.0,0.0
1014,1273,2020-03-19 02:29:00,0,3189.5,2789.0,0.875,15.656,84,56,33,23,28,8,20,36,0.0,0.0
1014,1274,2020-03-19 02:32:00,0,3365.0,2902.0,0.862,16.472,98,54,31,23,44,28,16,62,0.07,0.0
1014,1275,2020-03-19 02:35:00,0,3259.0,2916.0,0.895,16.067,178,104,79,25,74,47,27,43,0.0,0.0
1014,1276,2020-03-19 02:38:00,0,3256.0,2910.0,0.894,16.05,177,96,76,20,81,59,22,61,0.0,0.0
1014,1277,2020-03-19 02:41:00,0,3270.0,2833.0,0.866,16.021,292,171,119,52,121,87,34,43,0.0,0.0
1014,1278,2020-03-19 02:44:00,0,3261.0,2868.0,0.88,16.023,135,91,54,37,44,27,17,40,0.0,0.0
1014,1279,2020-03-19 02:47:00,0,2997.0,2727.0,0.91,14.826,0,0,0,0,0,0,0,0,0.0,0.0
1014,1280,2020-03-19 02:50:00,0,3263.0,2879.0,0.882,16.042,2,2,1,1,0,0,0,0,0.0,0.0
1014,1281,2020-03-19 02:53:00,0,3259.0,2849.0,0.874,15.995,14,12,7,5,2,1,1,0,0.0,0.0
1014,1282,2020-03-19 02:56:00,0,3181.0,2782.0,0.875,15.612,68,53,43,10,15,4,11,4,0.0,0.0
1014,1283,2020-03-19 02:59:00,0,3250.0,2844.0,0.875,15.952,14,0,0,0,14,1,13,0,0.0,0.0
1014,1284,2020-03-19 03:02:00,0,3253.0,2868.0,0.882,15.991,126,87,49,38,39,14,25,11,0.19,0.0
1014,1285,2020-03-19 03:05:00,0,3238.0,2900.0,0.896,15.97,109,60,25,35,49,17,32,0,0.0,0.0
1014,1286,2020-03-19 03:08:00,0,3260.0,2916.0,0.895,16.072,114,58,23,35,56,22,34,9,0.0,0.0
1014,1287,2020-03-19 03:11:00,0,3258.0,2900.0,0.89,16.046,250,137,95,42,113,76,37,22,0.0,0.0
1014,1288,2020-03-19 03:14:00,0,3432.0,3033.0,0.884,16.881,387,204,157,47,183,127,56,83,0.0,0.0
1014,1289,2020-03-19 03:17:00,0,3285.0,2906.0,0.884,16.16,77,31,20,11,46,26,20,8,0.0,0.0
1014,1290,2020-03-19 03:20:00,0,3005.0,2650.0,0.882,14.773,0,0,0,0,0,0,0,0,0.0,0.0
1014,1291,2020-03-19 03:23:00,0,3052.0,2529.0,0.829,14.824,0,0,0,0,0,0,0,0,0.0,0.0
1014,1292,2020-03-19 03:26:00,0,3038.0,2497.0,0.822,14.736,90,44,24,20,46,24,22,32,0.0,0.0
1014,1293,2020-03-19 03:29:00,0,3309.0,2731.0,0.825,16.06,120,64,37,27,56,25,31,15,0.16,0.0
1014,1294,2020-03-19 03:32:00,0,3285.0,2791.0,0.85,16.031,50,31,8,23,19,3,16,3,0.0,0.0
1014,1295,2020-03-19 03:35:00,0,3264.0,2857.0,0.875,16.023,24,9,0,9,15,0,15,1,0.0,0.0
1014,1296,2020-03-19 03:38:00,0,3370.0,2900.0,0.86,16.489,67,33,8,25,34,8,26,1,0.0,0.0
1014,1297,2020-03-19 03:41:00,0,3274.0,2868.0,0.876,16.075,149,57,51,6,92,57,35,12,0.0,0.0
1014,1298,2020-03-19 03:44:00,0,3191.0,2757.0,0.864,15.626,0,0,0,0,0,0,0,0,0.0,0.0
1014,1299,2020-03-19 03:47:00,0,3283.0,2832.0,0.863,16.069,0,0,0,0,0,0,0,0,0.0,0.0
1014,1300,2020-03-19 03:50:00,0,3287.0,2808.0,0.854,16.059,58,29,25,4,29,17,12,3,0.0,0.0
1014,1301,2020-03-19 03:53:00,0,3285.0,2844.0,0.866,16.092,15,2,1,1,13,6,7,0,0.0,0.0
1014,1302,2020-03-19 03:56:00,0,3320.0,2682.0,0.808,16.049,92,47,34,13,45,26,19,8,0.0,0.0
1014,1303,2020-03-19 03:59:00,0,3314.0,2741.0,0.827,16.093,141,49,32,17,92,64,28,3,0.25,0.0
1014,1304,2020-03-19 04:02:00,0,3475.0,2792.0,0.803,16.785,49,40,7,33,9,1,8,1,0.0,0.0
1014,1305,2020-03-19 04:05:00,0,3484.0,2886.0,0.828,16.923,77,36,11,25,41,5,36,2,0.0,0.0
1014,1306,2020-03-19 04:08:00,0,3382.0,2849.0,0.842,16.481,258,120,89,31,138,91,47,41,0.0,0.0
1014,1307,2020-03-19 04:11:00,0,3285.0,2765.0,0.842,16.003,287,130,99,31,157,121,36,22,0.0,0.0
1014,1308,2020-03-19 04:14:00,0,3216.0,2658.0,0.826,15.614,0,0,0,0,0,0,0,0,0.0,0.0
1014,1309,2020-03-19 04:17:00,0,3049.0,2474.0,0.812,14.751,0,0,0,0,0,0,0,0,0.0,0.0
1014,1310,2020-03-19 04:20:00,0,2950.0,2450.0,0.831,14.336,0,0,0,0,0,0,0,0,0.0,0.0
1014,1311,2020-03-19 04:23:00,0,3047.0,2477.0,0.813,14.748,74,42,26,16,32,10,22,42,0.0,0.0
1014,1312,2020-03-19 04:26:00,0,3305.0,2717.0,0.822,16.03,176,88,55,33,88,46,42,24,0.09,0.0
1014,1313,2020-03-19 04:29:00,0,3306.0,2704.0,0.818,16.019,84,54,23,31,30,3,27,2,0.0,0.0
1014,1314,2020-03-19 04:32:00,0,3297.0,2757.0,0.836,16.042,47,30,7,23,17,2,15,1,0.0,0.0
1014,1315,2020-03-19 04:35:00,0,3278.0,2805.0,0.856,16.02,115,105,55,50,10,2,8,0,0.0,0.0
1014,1316,2020-03-19 04:38:00,0,3282.0,2847.0,0.868,16.082,41,34,17,17,7,2,5,0,0.0,0.0
1014,1317,2020-03-19 04:41:00,0,3197.0,2710.0,0.848,15.597,4,1,1,0,3,1,2,0,0.0,0.0
1014,1318,2020-03-19 04:44:00,0,3269.0,2880.0,0.881,16.069,79,49,37,12,30,11,19,4,0.0,0.0
1014,1319,2020-03-19 04:47:00,0,3249.0,2864.0,0.881,15.973,19,16,10,6,3,0,3,0,0.0,0.0
1014,1320,2020-03-19 04:50:00,0,3012.0,2643.0,0.877,14.794,164,72,46,26,92,55,37,50,0.0,0.0
1014,1321,2020-03-19 04:53:00,0,3275.0,2823.0,0.862,16.028,328,141,102,39,187,123,64,58,0.12,0.0
1014,1322,2020-03-19 04:56:00,0,3486.0,2908.0,0.834,16.955,344,147,106,41,197,150,47,90,0.0,0.0
1014,1323,2020-03-19 04:59:00,0,3473.0,2909.0,0.838,16.904,529,275,233,42,254,194,60,238,0.0,0.0
1014,1324,2020-03-19 05:02:00,0,3673.0,3288.0,0.895,18.113,483,202,143,59,281,213,68,50,0.0,0.0
1014,1325,2020-03-19 05:05:00,0,3208.0,2752.0,0.858,15.685,622,298,243,55,324,242,82,47,0.0,0.0
1014,1326,2020-03-19 05:08:00,0,3414.0,3145.0,0.921,16.932,354,176,141,35,178,131,47,127,0.0,0.0
1014,1327,2020-03-19 05:11:00,0,3354.0,2934.0,0.875,16.461,145,96,67,29,49,22,27,84,0.0,0.0
1014,1328,2020-03-19 05:14:00,0,3435.0,3022.0,0.88,16.879,72,47,23,24,25,10,15,2,0.0,0.0
1014,1329,2020-03-19 05:17:00,0,3267.0,2859.0,0.875,16.039,5,5,2,3,0,0,0,0,0.0,0.0
1014,1330,2020-03-19 05:20:00,0,3191.0,2692.0,0.844,15.552,10,10,5,5,0,0,0,0,0.0,0.0
1014,1331,2020-03-19 05:23:00,0,3005.0,2630.0,0.875,14.752,14,14,4,10,0,0,0,0,0.0,0.0
1014,1332,2020-03-19 05:26:00,0,3126.0,2625.0,0.84,15.223,150,55,31,24,95,59,36,29,0.0,0.0
1014,1333,2020-03-19 05:29:00,0,3163.0,2666.0,0.843,15.4145,62,33,22,11,29,16,13,0,0.0,0.0
1014,1334,2020-03-19 05:32:00,0,3200.0,2707.0,0.846,15.606,15,7,4,3,8,2,6,0,0.0,0.0
1014,1335,2020-03-19 05:35:00,0,3096.0,2696.0,0.871,15.184,12,12,1,11,0,0,0,0,0.0,0.0
1014,1336,2020-03-19 05:38:00,0,3106.0,2722.0,0.876,15.252,15,15,10,5,0,0,0,0,0.0,0.0
1014,1337,2020-03-19 05:41:00,0,3277.0,2865.0,0.874,16.082,45,32,9,23,13,0,13,0,0.0,0.0
1014,1338,2020-03-19 05:44:00,0,3290.0,2779.0,0.845,16.04,162,83,52,31,79,36,43,13,0.05,0.0
1014,1339,2020-03-19 05:47:00,0,3438.0,3013.0,0.876,16.884,6,1,1,0,5,5,0,0,0.0,0.0
1014,1340,2020-03-19 05:50:00,0,3455.0,2954.0,0.855,16.882,1,0,0,0,1,1,0,0,0.0,0.0
1014,1341,2020-03-19 05:53:00,0,3268.0,2878.0,0.881,16.06,0,0,0,0,0,0,0,0,0.0,0.0
1014,1342,2020-03-19 05:56:00,0,3255.0,2894.0,0.889,16.027,0,0,0,0,0,0,0,0,0.0,0.0
1014,1343,2020-03-19 05:59:00,0,3274.0,2866.0,0.875,16.073,0,0,0,0,0,0,0,0,0.0,0.0
1014,1344,2020-03-19 06:02:00,1,3271.0,2830.0,0.865,16.022,225,155,115,40,70,50,20,8,0.1,0.0
1014,1345,2020-03-19 06:05:00,1,3482.0,2892.0,0.831,16.92,104,84,51,33,20,5,15,4,0.0,0.0
1014,1346,2020-03-19 06:08:00,1,3273.0,2802.0,0.856,15.999,241,124,89,35,117,80,37,37,0.0,0.0
1014,1347,2020-03-19 06:11:00,1,3031.0,2566.0,0.847,14.782,128,91,54,37,37,15,22,3,0.0,0.0
1014,1348,2020-03-19 06:14:00,1,3297.0,2753.0,0.835,16.04,158,75,50,25,83,60,23,32,0.01,0.0
1014,1349,2020-03-19 06:17:00,1,3039.0,2472.0,0.813,14.711,140,64,48,16,76,54,22,8,0.0,0.0
1014,1350,2020-03-19 06:20:00,1,2771.0,2338.0,0.844,13.505,6,5,1,4,1,1,0,0,0.0,0.0
1014,1351,2020-03-19 06:23:00,1,2762.0,2301.0,0.833,13.432,22,10,0,10,12,4,8,0,0.0,0.0
1014,1352,2020-03-19 06:26:00,1,2789.0,2242.0,0.804,13.473,165,63,40,23,102,64,38,5,0.03,0.0
1014,1353,2020-03-19 06:29:00,1,3057.0,2428.0,0.794,14.734,44,18,0,18,26,0,26,0,0.0,0.0
1014,1354,2020-03-19 06:32:00,1,2768.0,2317.0,0.837,13.47,22,1,0,1,21,0,21,0,0.0,0.0
1014,1355,2020-03-19 06:35:00,1,2779.0,2306.0,0.83,13.502,42,22,16,6,20,12,8,0,0.0,0.0
1014,1356,2020-03-19 06:38:00,1,2781.0,2234.0,0.804,13.43,9,5,1,4,4,0,4,0,0.0,0.0
1014,1357,2020-03-19 06:41:00,1,2828.0,2103.0,0.743,13.472,154,88,57,31,66,30,36,48,0.0,0.0
1014,1358,2020-03-19 06:44:00,1,3078.0,2370.0,0.77,14.752,267,119,82,37,148,114,34,22,0.0,0.0
1014,1359,2020-03-19 06:47:00,1,3067.0,2487.0,0.811,14.838,54,30,2,28,24,0,24,10,0.0,0.0
1014,1360,2020-03-19 06:50:00,1,3238.0,2551.0,0.788,15.582,161,82,52,30,79,48,31,16,0.0,0.0
1014,1361,2020-03-19 06:53:00,1,3224.0,2619.0,0.812,15.603,18,14,4,10,4,0,4,0,0.0,0.0
1014,1362,2020-03-19 06:56:00,1,3212.0,2669.0,0.831,15.609,57,30,4,26,27,2,25,0,0.0,0.0
1014,1363,2020-03-19 06:59:00,1,3305.0,2714.0,0.821,16.026,80,30,1,29,50,0,50,0,0.0,0.0
1014,1364,2020-03-19 07:02:00,1,3206.0,2714.0,0.847,15.635,38,27,7,20,11,0,11,0,0.0,0.0
1014,1365,2020-03-19 07:05:00,1,3027.0,2598.0,0.858,14.801,10,0,0,0,10,0,10,0,0.0,0.0
1014,1366,2020-03-19 07:08:00,1,2933.0,2538.0,0.865,14.367,45,25,18,7,20,11,9,11,0.0,0.0
1014,1367,2020-03-19 07:11:00,1,2843.0,2469.0,0.869,13.934,162,57,22,35,105,54,51,28,0.0,0.0
1014,1368,2020-03-19 07:14:00,1,3021.0,2539.0,0.84,14.715,78,34,27,7,44,35,9,1,0.0,0.0
1014,1369,2020-03-19 07:17:00,1,2925.0,2535.0,0.867,14.33,0,0,0,0,0,0,0,0,0.0,0.0
1014,1370,2020-03-19 07:20:00,1,2824.0,2513.0,0.89,13.91,0,0,0,0,0,0,0,0,0.0,0.0
1014,1371,2020-03-19 07:23:00,1,3011.0,2584.0,0.858,14.724,23,11,7,4,12,7,5,0,0.0,0.0
1014,1372,2020-03-19 07:26:00,1,2822.0,2526.0,0.895,13.917,1,1,1,0,0,0,0,0,0.0,0.0
1014,1373,2020-03-19 07:29:00,1,2741.0,2487.0,0.908,13.552,6,6,1,5,0,0,0,0,0.0,0.0
1014,1374,2020-03-19 07:32:00,1,2742.0,2478.0,0.904,13.547,162,137,108,29,25,14,11,15,0.0,0.0
1014,1375,2020-03-19 07:35:00,1,2740.0,2442.0,0.891,13.501,70,20,6,14,50,18,32,0,0.0,0.0
1014,1376,2020-03-19 07:38:00,1,3024.0,2581.0,0.854,14.772,140,86,54,32,54,25,29,11,0.0,0.0
1014,1377,2020-03-19 07:41:00,1,3044.0,2542.0,0.835,14.808,128,80,39,41,48,20,28,12,0.0,0.0
1014,1378,2020-03-19 07:44:00,1,2845.0,2430.0,0.854,13.899,168,90,59,31,78,47,31,45,0.0,0.0
1014,1379,2020-03-19 07:47:00,1,3037.0,2532.0,0.834,14.77,37,26,15,11,11,1,10,1,0.0,0.0
1014,1380,2020-03-19 07:50:00,1,2757.0,2391.0,0.867,13.511,2,2,1,1,0,0,0,0,0.0,0.0
1014,1381,2020-03-19 07:53:00,1,2773.0,2361.0,0.851,13.541,6,2,1,1,4,0,4,0,0.0,0.0
1014,1382,2020-03-19 07:56:00,1,2767.0,2333.0,0.843,13.484,1,0,0,0,1,0,1,0,0.0,0.0
1014,1383,2020-03-19 07:59:00,1,2753.0,2376.0,0.863,13.478,0,0,0,0,0,0,0,0,0.0,0.0
1014,1384,2020-03-19 08:02:00,1,2773.0,2325.0,0.838,13.499,0,0,0,0,0,0,0,0,0.0,0.0
1014,1385,2020-03-19 08:05:00,1,2782.0,2294.0,0.824,13.502,66,37,21,16,29,18,11,13,0.0,0.0
1014,1386,2020-03-19 08:08:00,1,3052.0,2449.0,0.803,14.736,178,74,45,29,104,57,47,21,0.46,0.0
1014,1387,2020-03-19 08:11:00,1,3047.0,2483.0,0.815,14.757,90,47,19,28,43,0,43,0,0.0,0.0
1014,1388,2020-03-19 08:14:00,1,3035.0,2557.0,0.842,14.79,75,44,14,30,31,3,28,0,0.0,0.0
1014,1389,2020-03-19 08:17:00,1,3026.0,2593.0,0.857,14.794,24,19,6,13,5,0,5,0,0.0,0.0
1014,1390,2020-03-19 08:20:00,1,2744.0,2472.0,0.901,13.547,11,6,0,6,5,1,4,0,0.0,0.0
1014,1391,2020-03-19 08:23:00,1,2744.0,2395.0,0.873,13.462,1,0,0,0,1,0,1,0,0.0,0.0
1014,1392,2020-03-19 08:26:00,1,2767.0,2382.0,0.861,13.54,0,0,0,0,0,0,0,0,0.0,0.0
1014,1393,2020-03-19 08:29:00,1,2732.5,2321.5,0.8495,13.337,2,1,0,1,1,0,1,0,0.0,0.0
1014,1394,2020-03-19 08:32:00,1,2698.0,2261.0,0.838,13.134,38,28,24,4,10,4,6,5,0.0,0.0
1014,1395,2020-03-19 08:35:00,1,2594.0,2213.0,0.853,12.671,2,1,0,1,1,0,1,0,0.0,0.0
1014,1396,2020-03-19 08:38:00,1,2611.0,2171.0,0.832,12.69,0,0,0,0,0,0,0,0,0.0,0.0
1014,1397,2020-03-19 08:41:00,1,2804.0,2212.0,0.789,13.495,6,0,0,0,6,0,6,0,0.0,0.0
1014,1398,2020-03-19 08:44:00,1,2725.0,2178.0,0.799,13.148,0,0,0,0,0,0,0,0,0.0,0.0
1014,1399,2020-03-19 08:47:00,1,2617.0,2078.0,0.794,12.611,3,0,0,0,3,0,3,0,0.0,0.0
1014,1400,2020-03-19 08:50:00,1,2636.0,2015.0,0.764,12.619,1,0,0,0,1,0,1,0,0.0,0.0
1014,1401,2020-03-19 08:53:00,1,2654.0,1975.0,0.744,12.643,0,0,0,0,0,0,0,0,0.0,0.0
1014,1402,2020-03-19 08:56:00,1,2649.0,1984.0,0.749,12.634,73,34,25,9,39,19,20,12,0.0,0.0
1014,1403,2020-03-19 08:59:00,1,2745.0,2081.0,0.758,13.118,1,0,0,0,1,1,0,0,0.0,0.0
1014,1404,2020-03-19 09:02:00,1,2638.0,2028.0,0.769,12.64,41,17,2,15,24,0,24,0,0.0,0.0
1014,1405,2020-03-19 09:05:00,1,2664.0,1960.0,0.735,12.668,2,1,0,1,1,0,1,0,0.0,0.0
1014,1406,2020-03-19 09:08:00,1,2575.0,1905.0,0.74,12.253,6,1,0,1,5,0,5,0,0.0,0.0
1014,1407,2020-03-19 09:11:00,1,2660.0,1929.0,0.725,12.615,0,0,0,0,0,0,0,0,0.0,0.0
1014,1408,2020-03-19 09:14:00,1,2477.0,1833.0,0.74,11.787,0,0,0,0,0,0,0,0,0.0,0.0
1014,1409,2020-03-19 09:17:00,1,2478.0,1837.0,0.741,11.795,0,0,0,0,0,0,0,0,0.0,0.0
1014,1410,2020-03-19 09:20:00,1,2577.0,1848.0,0.717,12.2,41,28,23,5,13,7,6,5,0.0,0.0
1014,1411,2020-03-19 09:23:00,1,2581.0,1848.0,0.716,12.216,4,4,1,3,0,0,0,0,0.0,0.0
1014,1412,2020-03-19 09:26:00,1,2592.0,1850.0,0.714,12.259,7,5,0,5,2,1,1,0,0.0,0.0
1014,1413,2020-03-19 09:29:00,1,2486.0,1833.0,0.737,11.826,0,0,0,0,0,0,0,0,0.0,0.0
1014,1414,2020-03-19 09:32:00,1,2470.0,1833.0,0.742,11.763,0,0,0,0,0,0,0,0,0.0,0.0
1014,1415,2020-03-19 09:35:00,1,2588.0,1860.0,0.719,12.257,0,0,0,0,0,0,0,0,0.0,0.0
1014,1416,2020-03-19 09:38:00,1,2597.0,1802.0,0.694,12.229,0,0,0,0,0,0,0,0,0.0,0.0
1014,1417,2020-03-19 09:41:00,1,2680.0,1906.0,0.711,12.67,0,0,0,0,0,0,0,0,0.0,0.0
1014,1418,2020-03-19 09:44:00,1,2690.0,1872.0,0.696,12.671,13,6,6,0,7,2,5,0,0.0,0.0
1014,1419,2020-03-19 09:47:00,1,2679.0,1893.0,0.707,12.65,3,3,0,3,0,0,0,0,0.0,0.0
1014,1420,2020-03-19 09:50:00,1,2487.0,1803.0,0.725,11.798,34,12,6,6,22,11,11,15,0.0,0.0
1014,1421,2020-03-19 09:53:00,1,2644.0,1981.0,0.749,12.612,104,26,7,19,78,35,43,25,0.0,0.0
1014,1422,2020-03-19 09:56:00,1,2916.0,2214.0,0.759,13.939,170,77,47,30,93,52,41,67,0.0,0.0
1014,1423,2020-03-19 09:59:00,1,2996.0,2280.0,0.761,14.327,201,90,55,35,111,58,53,20,0.0,0.0
1014,1424,2020-03-19 10:02:00,1,2879.0,2296.0,0.798,13.885,82,39,13,26,43,15,28,6,0.0,0.0
1014,1425,2020-03-19 10:05:00,1,2870.0,2338.0,0.815,13.895,165,74,39,35,91,41,50,11,0.0,0.0
1014,1426,2020-03-19 10:08:00,1,2958.0,2400.0,0.811,14.312,28,12,6,6,16,2,14,5,0.0,0.0
1014,1427,2020-03-19 10:11:00,1,2776.0,2359.0,0.85,13.551,3,1,0,1,2,0,2,0,0.0,0.0
1014,1428,2020-03-19 10:14:00,1,2689.0,2213.0,0.823,13.044,4,1,1,0,3,0,3,0,0.0,0.0
1014,1429,2020-03-19 10:17:00,1,2609.0,2133.0,0.818,12.641,19,10,6,4,9,1,8,5,0.0,0.0
1014,1430,2020-03-19 10:20:00,1,2768.0,2340.0,0.846,13.496,130,75,42,33,55,29,26,60,0.0,0.26
1014,1431,2020-03-19 10:23:00,1,2777.0,2348.0,0.846,13.542,72,61,33,28,11,1,10,4,0.0,0.31
1014,1432,2020-03-19 10:26:00,1,3059.0,2504.0,0.819,14.823,57,40,10,30,17,7,10,0,0.0,0.02
1014,1433,2020-03-19 10:29:00,1,3017.0,2619.0,0.868,14.784,28,7,4,3,21,3,18,0,0.0,0.0
1014,1434,2020-03-19 10:32:00,1,3017.0,2624.0,0.87,14.793,57,51,10,41,6,0,6,0,0.0,0.0
1014,1435,2020-03-19 10:35:00,1,2992.0,2723.0,0.91,14.804,85,58,25,33,27,9,18,0,0.0,0.0
1014,1436,2020-03-19 10:38:00,1,3000.0,2653.0,0.884,14.758,0,0,0,0,0,0,0,0,0.0,0.0
1014,1437,2020-03-19 10:41:00,1,2811.0,2556.0,0.909,13.906,0,0,0,0,0,0,0,0,0.0,0.0
1014,1438,2020-03-19 10:44:00,1,2737.0,2493.0,0.911,13.543,10,5,2,3,5,0,5,0,0.0,0.0
1014,1439,2020-03-19 10:47:00,1,2762.0,2361.0,0.855,13.495,15,6,3,3,9,0,9,0,0.0,0.0
1014,1440,2020-03-19 10:50:00,1,2759.0,2436.0,0.883,13.567,3,1,0,1,2,0,2,0,0.0,0.0
1014,1441,2020-03-19 10:53:00,1,2691.0,2276.0,0.846,13.123,0,0,0,0,0,0,0,0,0.0,0.0
1014,1442,2020-03-19 10:56:00,1,2610.0,2187.0,0.838,12.704,0,0,0,0,0,0,0,0,0.0,0.0
1014,1443,2020-03-19 10:59:00,1,2620.0,2129.0,0.812,12.682,0,0,0,0,0,0,0,0,0.0,0.0
1014,1444,2020-03-19 11:02:00,1,2617.0,2107.0,0.805,12.643,0,0,0,0,0,0,0,0,0.0,0.0
1014,1445,2020-03-19 11:05:00,1,2636.0,2060.0,0.782,12.668,0,0,0,0,0,0,0,0,0.0,0.0
1014,1446,2020-03-19 11:08:00,1,2613.0,2108.0,0.807,12.629,0,0,0,0,0,0,0,0,0.0,0.0
1014,1447,2020-03-19 11:11:00,1,2626.0,2076.0,0.79,12.644,0,0,0,0,0,0,0,0,0.0,0.0
1014,1448,2020-03-19 11:14:00,1,2630.0,2017.0,0.767,12.596,141,67,47,20,74,48,26,13,0.0,0.0
1014,1449,2020-03-19 11:17:00,1,2816.0,2120.0,0.753,13.443,0,0,0,0,0,0,0,0,0.0,0.0
1014,1450,2020-03-19 11:20:00,1,2625.0,2012.0,0.767,12.571,1,0,0,0,1,0,1,0,0.0,0.0
1014,1451,2020-03-19 11:23:00,1,2637.0,2061.0,0.782,12.673,0,0,0,0,0,0,0,0,0.0,0.0
1014,1452,2020-03-19 11:26:00,1,2631.0,2050.0,0.779,12.638,4,2,1,1,2,0,2,0,0.0,0.0
1014,1453,2020-03-19 11:29:00,1,2591.5,2022.5,0.7805,12.4505,15,4,0,4,11,0,11,0,0.0,0.0
1014,1454,2020-03-19 11:32:00,1,2552.0,1995.0,0.782,12.263,3,0,0,0,3,0,3,0,0.0,0.0
1014,1455,2020-03-19 11:35:00,1,2360.0,1880.0,0.796,11.38,1,0,0,0,1,0,1,0,0.0,0.0
1014,1456,2020-03-19 11:38:00,1,2656.0,2019.0,0.76,12.7,26,17,12,5,9,8,1,0,0.0,0.0
1014,1457,2020-03-19 11:41:00,1,2464.0,1883.0,0.764,11.793,0,0,0,0,0,0,0,0,0.0,0.0
1014,1458,2020-03-19 11:44:00,1,2378.0,1849.0,0.778,11.416,0,0,0,0,0,0,0,0,0.0,0.0
1014,1459,2020-03-19 11:47:00,1,2375.0,1842.0,0.776,11.397,0,0,0,0,0,0,0,0,0.0,0.0
1014,1460,2020-03-19 11:50:00,1,2388.0,1766.0,0.739,11.366,0,0,0,0,0,0,0,0,0.0,0.0
1014,1461,2020-03-19 11:53:00,1,2406.0,1729.0,0.719,11.393,0,0,0,0,0,0,0,0,0.0,0.0
1014,1462,2020-03-19 11:56:00,1,2216.0,1662.0,0.75,10.571,0,0,0,0,0,0,0,0,0.0,0.0
1014,1463,2020-03-19 11:59:00,1,2208.0,1642.0,0.744,10.517,20,11,6,5,9,3,6,24,0.0,0.0
1014,1464,2020-03-19 12:02:00,1,2667.0,1958.0,0.734,12.675,141,104,57,47,37,23,14,66,0.0,0.0
1014,1465,2020-03-19 12:05:00,1,2848.0,2084.0,0.732,13.529,61,42,9,33,19,0,19,0,0.0,0.0
1014,1466,2020-03-19 12:08:00,1,2800.0,2244.0,0.802,13.518,24,16,2,14,8,0,8,0,0.0,0.0
1014,1467,2020-03-19 12:11:00,1,2893.0,2356.0,0.814,14.007,68,47,8,39,21,0,21,0,0.0,0.0
1014,1468,2020-03-19 12:14:00,1,2958.0,2412.0,0.815,14.324,44,35,13,22,9,0,9,0,0.0,0.0
1014,1469,2020-03-19 12:17:00,1,2844.0,2385.0,0.839,13.846,67,52,33,19,15,0,15,0,0.0,0.0
1014,1470,2020-03-19 12:20:00,1,2851.0,2456.0,0.861,13.95,162,89,54,35,73,43,30,35,0.0,0.0
1014,1471,2020-03-19 12:23:00,1,3047.0,2471.0,0.811,14.741,171,83,54,29,88,53,35,72,0.0,0.0
1014,1472,2020-03-19 12:26:00,1,3046.0,2499.0,0.82,14.77,749,297,213,84,452,341,111,8,0.0,0.0
1014,1473,2020-03-19 12:29:00,1,3018.0,2614.0,0.866,14.785,1076,525,439,86,551,423,128,0,0.0,0.0
1014,1474,2020-03-19 12:32:00,1,3025.0,2552.0,0.844,14.743,513,353,331,22,160,100,60,2,0.0,0.0
1014,1475,2020-03-19 12:35:00,1,3193.0,2690.0,0.842,15.558,284,148,99,49,136,85,51,9,0.0,0.0
1014,1476,2020-03-19 12:38:00,1,3202.0,2729.0,0.852,15.638,93,25,15,10,68,17,51,0,0.0,0.0
1014,1477,2020-03-19 12:41:00,1,3092.0,2706.0,0.875,15.18,58,55,14,41,3,1,2,0,0.0,0.0
1014,1478,2020-03-19 12:44:00,1,3008.0,2647.0,0.88,14.781,30,25,6,19,5,1,4,0,0.0,0.0
1014,1479,2020-03-19 12:47:00,1,2740.0,2490.0,0.909,13.55,2,2,0,2,0,0,0,0,0.0,0.0
1014,1480,2020-03-19 12:50:00,1,2769.0,2374.0,0.857,13.536,7,6,2,4,1,1,0,0,0.0,0.0
1014,1481,2020-03-19 12:53:00,1,2754.0,2401.0,0.872,13.508,30,26,1,25,4,1,3,0,0.0,0.0
1014,1482,2020-03-19 12:56:00,1,2695.0,2257.0,0.838,13.116,0,0,0,0,0,0,0,0,0.0,0.0
1014,1483,2020-03-19 12:59:00,1,2608.0,2111.0,0.81,12.614,0,0,0,0,0,0,0,0,0.0,0.0
1014,1484,2020-03-19 13:02:00,1,2632.0,2063.0,0.784,12.653,0,0,0,0,0,0,0,0,0.0,0.0
1014,1485,2020-03-19 13:05:00,1,2347.0,1943.0,0.828,11.397,86,41,29,12,45,21,24,22,0.0,0.0
1014,1486,2020-03-19 13:08:00,1,2797.0,2248.0,0.804,13.511,93,49,26,23,44,17,27,42,0.0,0.12
1014,1487,2020-03-19 13:11:00,1,2774.0,2300.0,0.829,13.476,27,9,6,3,18,6,12,2,0.0,0.0
1014,1488,2020-03-19 13:14:00,1,2789.0,2278.0,0.817,13.512,2,1,1,0,1,0,1,0,0.0,0.0
1014,1489,2020-03-19 13:17:00,1,2779.0,2320.0,0.835,13.517,12,9,8,1,3,1,2,0,0.0,0.0
1014,1490,2020-03-19 13:20:00,1,2767.0,2390.0,0.864,13.547,0,0,0,0,0,0,0,0,0.0,0.0
1014,1491,2020-03-19 13:23:00,1,2835.0,2498.0,0.881,13.936,0,0,0,0,0,0,0,0,0.0,0.0
1014,1492,2020-03-19 13:26:00,1,2744.0,2443.0,0.89,13.515,0,0,0,0,0,0,0,0,0.0,0.0
1014,1493,2020-03-19 13:29:00,1,2757.0,2401.0,0.871,13.519,0,0,0,0,0,0,0,0,0.0,0.0
1014,1494,2020-03-19 13:32:00,1,2551.0,2289.0,0.897,12.583,0,0,0,0,0,0,0,0,0.0,0.0
1014,1495,2020-03-19 13:35:00,1,2568.0,2296.0,0.894,12.661,2,1,1,0,1,1,0,0,0.0,0.0
1014,1496,2020-03-19 13:38:00,1,2778.0,2347.0,0.845,13.544,121,71,33,38,50,22,28,43,0.0,0.0
1014,1497,2020-03-19 13:41:00,1,2765.0,2319.0,0.839,13.461,108,48,35,13,60,31,29,0,0.0,0.0
1014,1498,2020-03-19 13:44:00,1,3024.0,2567.0,0.849,14.758,56,36,15,21,20,2,18,1,0.0,0.0
1014,1499,2020-03-19 13:47:00,1,3012.0,2598.0,0.863,14.742,69,48,14,34,21,3,18,0,0.0,0.0
1014,1500,2020-03-19 13:50:00,1,3009.0,2637.0,0.876,14.776,91,75,46,29,16,0,16,0,0.0,0.0
1014,1501,2020-03-19 13:53:00,1,2728.0,2538.0,0.931,13.557,5,5,4,1,0,0,0,0,0.0,0.0
1014,1502,2020-03-19 13:56:00,1,2746.0,2427.0,0.884,13.505,0,0,0,0,0,0,0,0,0.0,0.0
1014,1503,2020-03-19 13:59:00,1,2773.0,2331.0,0.84,13.507,0,0,0,0,0,0,0,0,0.0,0.0
1014,1504,2020-03-19 14:02:00,1,2578.0,2266.0,0.879,12.667,0,0,0,0,0,0,0,0,0.0,0.0
1014,1505,2020-03-19 14:05:00,1,2604.0,2194.0,0.842,12.688,0,0,0,0,0,0,0,0,0.0,0.0
1014,1506,2020-03-19 14:08:00,1,2621.0,2116.0,0.807,12.671,0,0,0,0,0,0,0,0,0.0,0.0
1014,1507,2020-03-19 14:11:00,1,2619.0,2087.0,0.797,12.63,0,0,0,0,0,0,0,0,0.0,0.0
1014,1508,2020-03-19 14:14:00,1,2519.0,2037.0,0.809,12.18,0,0,0,0,0,0,0,0,0.0,0.0
1014,1509,2020-03-19 14:17:00,1,2548.0,2036.0,0.799,12.292,80,29,14,15,51,22,29,35,0.0,0.0
1014,1510,2020-03-19 14:20:00,1,2934.0,2495.0,0.85,14.323,59,36,23,13,23,10,13,3,0.0,0.0
1014,1511,2020-03-19 14:23:00,1,3304.0,2684.0,0.812,15.99,234,110,76,34,124,86,38,10,0.0,0.0
1014,1512,2020-03-19 14:26:00,1,3467.0,2992.0,0.863,16.974,226,107,71,36,119,91,28,59,0.21,0.0
1014,1513,2020-03-19 14:29:00,1,3246.5,2769.5,0.8525,15.8585,317,168,127,41,149,105,44,112,0.0,0.0
1014,1514,2020-03-19 14:32:00,1,3026.0,2547.0,0.842,14.743,173,80,51,29,93,54,39,13,0.0,0.03
1014,1515,2020-03-19 14:35:00,1,3031.0,2547.0,0.84,14.762,177,91,69,22,86,60,26,7,0.0,0.05
1014,1516,2020-03-19 14:38:00,1,2956.0,2448.0,0.828,14.359,6,2,0,2,4,0,4,0,0.0,0.0
1014,1517,2020-03-19 14:41:00,1,2669.0,2292.0,0.859,13.053,6,6,4,2,0,0,0,0,0.0,0.0
1014,1518,2020-03-19 14:44:00,1,2705.0,2200.0,0.813,13.094,2,2,0,2,0,0,0,0,0.0,0.0
1014,1519,2020-03-19 14:47:00,1,2726.0,2110.0,0.774,13.075,73,48,20,28,25,12,13,50,0.0,0.0
1014,1520,2020-03-19 14:50:00,1,3240.0,2553.0,0.788,15.591,114,56,24,32,58,20,38,21,0.0,0.0
1014,1521,2020-03-19 14:53:00,1,2787.0,2286.0,0.82,13.511,17,9,3,6,8,3,5,1,0.0,0.0
1014,1522,2020-03-19 14:56:00,1,2684.0,2261.0,0.842,13.079,40,24,20,4,16,11,5,0,0.0,0.0
1014,1523,2020-03-19 14:59:00,1,2857.0,2382.0,0.834,13.896,6,2,0,2,4,0,4,0,0.0,0.0
1014,1524,2020-03-19 15:02:00,1,2945.0,2459.0,0.835,14.326,462,188,133,55,274,204,70,0,0.0,0.0
1014,1525,2020-03-19 15:05:00,1,3194.0,2724.0,0.853,15.601,295,159,115,44,136,94,42,0,0.0,0.0
1014,1526,2020-03-19 15:08:00,1,2947.0,2450.0,0.831,14.322,0,0,0,0,0,0,0,0,0.0,0.0
1014,1527,2020-03-19 15:11:00,1,2947.0,2489.0,0.845,14.366,1,0,0,0,1,0,1,0,0.0,0.0
1014,1528,2020-03-19 15:14:00,1,2665.0,2390.0,0.897,13.148,0,0,0,0,0,0,0,0,0.0,0.0
1014,1529,2020-03-19 15:17:00,1,2948.0,2514.0,0.853,14.399,113,55,26,29,58,20,38,52,0.0,0.0
1014,1530,2020-03-19 15:20:00,1,3203.0,2726.0,0.851,15.639,41,27,3,24,14,3,11,8,0.0,0.0
1014,1531,2020-03-19 15:23:00,1,3098.0,2655.0,0.857,15.144,58,32,9,23,26,0,26,0,0.0,0.19
1014,1532,2020-03-19 15:26:00,1,3185.0,2839.0,0.892,15.69,241,115,79,36,126,83,43,6,0.0,0.13
1014,1533,2020-03-19 15:29:00,1,3092.0,2748.0,0.889,15.226,11,11,3,8,0,0,0,0,0.0,0.0
1014,1534,2020-03-19 15:32:00,1,2912.0,2583.0,0.887,14.334,0,0,0,0,0,0,0,0,0.0,0.0
1014,1535,2020-03-19 15:35:00,1,2910.0,2548.0,0.876,14.286,103,51,31,20,52,15,37,55,0.0,0.0
1014,1536,2020-03-19 15:38:00,1,3077.0,2757.0,0.896,15.176,117,50,19,31,67,28,39,19,0.25,0.0
1014,1537,2020-03-19 15:41:00,1,2902.0,2619.0,0.902,14.332,81,15,0,15,66,28,38,0,0.0,0.0
1014,1538,2020-03-19 15:44:00,1,3075.0,2793.0,0.908,15.21,113,65,43,22,48,31,17,0,0.0,0.0
1014,1539,2020-03-19 15:47:00,1,2892.0,2756.0,0.953,14.446,12,3,0,3,9,0,9,0,0.0,0.0
1014,1540,2020-03-19 15:50:00,1,2894.0,2651.0,0.916,14.337,6,2,0,2,4,0,4,0,0.0,0.0
1014,1541,2020-03-19 15:53:00,1,2609.0,2551.0,0.978,13.103,7,5,4,1,2,0,2,0,0.0,0.0
1014,1542,2020-03-19 15:56:00,1,2631.0,2520.0,0.958,13.155,0,0,0,0,0,0,0,0,0.0,0.0
1014,1543,2020-03-19 15:59:00,1,2635.0,2476.0,0.94,13.123,1,1,0,1,0,0,0,0,0.0,0.0
1014,1544,2020-03-19 16:02:00,1,2665.0,2388.0,0.896,13.146,101,60,36,24,41,16,25,68,0.0,0.0
1014,1545,2020-03-19 16:05:00,1,3194.0,2751.0,0.861,15.629,94,59,29,30,35,17,18,81,0.0,0.03
1014,1546,2020-03-19 16:08:00,1,3193.0,2783.0,0.872,15.663,227,100,74,26,127,86,41,22,0.13,0.0
1014,1547,2020-03-19 16:11:00,1,2753.0,2453.0,0.891,13.562,0,0,0,0,0,0,0,0,0.0,0.0
1014,1548,2020-03-19 16:14:00,1,2906.0,2647.0,0.911,14.378,0,0,0,0,0,0,0,0,0.0,0.0
1014,1549,2020-03-19 16:17:00,1,2895.0,2714.0,0.937,14.413,0,0,0,0,0,0,0,0,0.0,0.0
1014,1550,2020-03-19 16:20:00,1,2893.0,2661.0,0.92,14.343,0,0,0,0,0,0,0,0,0.0,0.0
1014,1551,2020-03-19 16:23:00,1,2893.0,2696.0,0.932,14.382,1,0,0,0,1,1,0,0,0.0,0.0
1014,1552,2020-03-19 16:26:00,1,2887.0,2686.0,0.93,14.35,112,27,21,6,85,58,27,1,0.0,0.0
1014,1553,2020-03-19 16:29:00,1,2704.0,2574.0,0.952,13.504,2,1,0,1,1,0,1,0,0.0,0.0
1014,1554,2020-03-19 16:32:00,1,2702.0,2603.0,0.964,13.528,0,0,0,0,0,0,0,0,0.0,0.0
1014,1555,2020-03-19 16:35:00,1,2609.0,2559.0,0.981,13.111,6,3,3,0,3,1,2,0,0.0,0.0
1014,1556,2020-03-19 16:38:00,1,2601.0,2543.0,0.978,13.065,96,51,30,21,45,14,31,50,0.0,0.0
1014,1557,2020-03-19 16:41:00,1,3154.0,2861.0,0.907,15.593,71,22,8,14,49,29,20,11,0.3,0.0
1014,1558,2020-03-19 16:44:00,1,2622.0,2539.0,0.968,13.141,46,22,17,5,24,13,11,0,0.0,0.0
1014,1559,2020-03-19 16:47:00,1,2864.0,2808.0,0.98,14.394,57,21,14,7,36,4,32,3,0.0,0.0
1014,1560,2020-03-19 16:50:00,1,3171.0,2914.0,0.919,15.719,60,47,19,28,13,0,13,2,0.0,0.0
1014,1561,2020-03-19 16:53:00,1,3172.0,2869.0,0.904,15.672,54,31,14,17,23,0,23,0,0.0,0.0
1014,1562,2020-03-19 16:56:00,1,2879.0,2724.0,0.946,14.359,14,11,2,9,3,0,3,0,0.0,0.0
1014,1563,2020-03-19 16:59:00,1,2893.0,2668.0,0.922,14.353,39,32,22,10,7,2,5,8,0.0,0.0
1014,1564,2020-03-19 17:02:00,1,3089.0,2782.0,0.9,15.252,123,76,43,33,47,28,19,70,0.0,0.06
1014,1565,2020-03-19 17:05:00,1,3310.0,3109.0,0.939,16.485,173,68,36,32,105,63,42,45,0.18,0.0
1014,1566,2020-03-19 17:08:00,1,3080.0,2760.0,0.896,15.192,198,115,82,33,83,48,35,53,0.0,0.0
1014,1567,2020-03-19 17:11:00,1,3162.0,2900.0,0.917,15.67,9,9,7,2,0,0,0,0,0.0,0.0
1014,1568,2020-03-19 17:14:00,1,3085.0,2839.0,0.92,15.298,2,0,0,0,2,1,1,0,0.0,0.0
1014,1569,2020-03-19 17:17:00,1,2881.0,2705.0,0.939,14.345,14,9,3,6,5,1,4,7,0.0,0.0
1014,1570,2020-03-19 17:20:00,1,3067.0,2791.0,0.91,15.174,114,80,44,36,34,11,23,52,0.0,0.24
1014,1571,2020-03-19 17:23:00,1,3075.0,2792.0,0.908,15.205,115,48,35,13,67,49,18,2,0.0,0.0
1014,1572,2020-03-19 17:26:00,1,2868.0,2785.0,0.971,14.382,4,4,0,4,0,0,0,0,0.0,0.06
1014,1573,2020-03-19 17:29:00,1,3066.0,2847.5,0.9315,15.232,8,7,2,5,1,1,0,0,0.0,0.0
1014,1574,2020-03-19 17:32:00,1,3264.0,2910.0,0.892,16.082,22,22,6,16,0,0,0,0,0.0,0.19
1014,1575,2020-03-19 17:35:00,1,3259.0,2910.0,0.893,16.062,17,16,6,10,1,1,0,0,0.0,0.0
1014,1576,2020-03-19 17:38:00,1,3233.0,2990.0,0.925,16.049,105,86,57,29,19,4,15,46,0.0,0.0
1014,1577,2020-03-19 17:41:00,1,3227.0,3080.0,0.954,16.125,213,102,72,30,111,74,37,62,0.0,0.0
1014,1578,2020-03-19 17:44:00,1,3155.0,2877.0,0.912,15.616,173,83,48,35,90,64,26,58,0.09,0.0
1014,1579,2020-03-19 17:47:00,1,3245.0,2975.0,0.917,16.08,168,116,78,38,52,30,22,30,0.0,0.0
1014,1580,2020-03-19 17:50:00,1,3214.0,3052.0,0.95,16.041,213,99,75,24,114,74,40,51,0.0,0.0
1014,1581,2020-03-19 17:53:00,1,3252.0,2893.0,0.89,16.015,86,44,31,13,42,28,14,2,0.0,0.0
1014,1582,2020-03-19 17:56:00,1,3241.0,2933.0,0.905,16.019,0,0,0,0,0,0,0,0,0.0,0.0
1014,1583,2020-03-19 17:59:00,1,3069.0,2822.0,0.919,15.218,2,2,2,0,0,0,0,0,0.0,0.0
1014,1584,2020-03-19 18:02:00,0,3172.0,2862.0,0.902,15.666,12,8,1,7,4,1,3,0,0.0,0.0
1014,1585,2020-03-19 18:05:00,0,3263.0,2867.0,0.879,16.029,1,1,0,1,0,0,0,0,0.0,0.0
1014,1586,2020-03-19 18:08:00,0,3256.0,2836.0,0.871,15.967,8,3,1,2,5,3,2,0,0.0,0.03
1014,1587,2020-03-19 18:11:00,0,3448.0,3032.0,0.879,16.941,72,56,38,18,16,10,6,0,0.0,0.0
1014,1588,2020-03-19 18:14:00,0,3450.0,2997.0,0.869,16.91,60,58,18,40,2,0,2,7,0.0,0.0
1014,1589,2020-03-19 18:17:00,0,3431.0,3103.0,0.904,16.955,38,38,10,28,0,0,0,3,0.0,0.0
1014,1590,2020-03-19 18:20:00,0,3509.0,3181.0,0.906,17.349,64,52,10,42,12,0,12,4,0.0,0.0
1014,1591,2020-03-19 18:23:00,0,3708.0,3236.0,0.873,18.191,81,61,33,28,20,7,13,4,0.0,0.0
1014,1592,2020-03-19 18:26:00,0,3723.0,3203.0,0.86,18.215,230,104,80,24,126,79,47,44,0.0,0.0
1014,1593,2020-03-19 18:29:00,0,3716.0,3175.0,0.854,18.158,9,6,1,5,3,2,1,0,0.0,0.4
1014,1594,2020-03-19 18:32:00,0,3431.0,3054.0,0.89,16.899,225,132,100,32,93,66,27,6,0.0,0.03
1014,1595,2020-03-19 18:35:00,0,3453.0,3005.0,0.87,16.932,379,198,147,51,181,126,55,54,0.08,0.0
1014,1596,2020-03-19 18:38:00,0,3446.0,2951.0,0.856,16.843,211,129,97,32,82,53,29,17,0.0,0.0
1014,1597,2020-03-19 18:41:00,0,3463.0,2926.0,0.845,16.884,26,18,11,7,8,4,4,0,0.0,0.0
1014,1598,2020-03-19 18:44:00,0,3510.0,2803.0,0.799,16.931,5,0,0,0,5,0,5,0,0.0,0.0
1014,1599,2020-03-19 18:47:00,0,3300.0,2744.0,0.832,16.039,155,86,64,22,69,51,18,2,0.0,0.0
1014,1600,2020-03-19 18:50:00,0,3493.0,2843.0,0.814,16.912,34,29,18,11,5,1,4,0,0.0,0.0
1014,1601,2020-03-19 18:53:00,0,3492.0,2851.0,0.816,16.917,41,34,19,15,7,0,7,0,0.0,0.0
1014,1602,2020-03-19 18:56:00,0,3672.0,2948.0,0.803,17.731,87,59,41,18,28,14,14,0,0.0,0.0
1014,1603,2020-03-19 18:59:00,0,3498.0,2769.0,0.792,16.849,27,13,5,8,14,2,12,0,0.0,0.0
1014,1604,2020-03-19 19:02:00,0,3325.0,2627.0,0.79,16.011,1,0,0,0,1,1,0,0,0.0,0.0
1014,1605,2020-03-19 19:05:00,0,3325.0,2681.0,0.806,16.07,33,18,10,8,15,11,4,1,0.0,0.0
1014,1606,2020-03-19 19:08:00,0,3503.0,2739.0,0.782,16.835,15,7,4,3,8,0,8,5,0.0,0.0
1014,1607,2020-03-19 19:11:00,0,3486.0,2805.0,0.805,16.841,73,63,30,33,10,0,10,7,0.0,0.0
1014,1608,2020-03-19 19:14:00,0,3573.0,2904.0,0.813,17.292,42,41,22,19,1,0,1,2,0.0,0.0
1014,1609,2020-03-19 19:17:00,0,3781.0,2944.0,0.778,18.158,20,20,5,15,0,0,0,1,0.0,0.0
1014,1610,2020-03-19 19:20:00,0,3785.0,2999.0,0.792,18.233,133,127,63,64,6,0,6,21,0.0,0.0
1014,1611,2020-03-19 19:23:00,0,3936.0,3076.0,0.781,18.915,332,189,131,58,143,103,40,48,0.0,0.0
1014,1612,2020-03-19 19:26:00,0,3939.0,3038.0,0.771,18.884,136,56,33,23,80,53,27,13,0.0,0.0
1014,1613,2020-03-19 19:29:00,0,3858.0,3031.0,0.786,18.556,259,98,75,23,161,109,52,49,0.0,0.0
1014,1614,2020-03-19 19:32:00,0,3773.0,2974.0,0.788,18.157,407,212,157,55,195,144,51,82,0.0,0.0
1014,1615,2020-03-19 19:35:00,0,3765.0,2944.0,0.782,18.094,603,341,280,61,262,209,53,190,0.0,0.0
1014,1616,2020-03-19 19:38:00,0,4038.0,3102.0,0.768,19.344,480,262,199,63,218,159,59,68,0.0,0.0
1014,1617,2020-03-19 19:41:00,0,3767.0,2888.0,0.767,18.039,223,151,107,44,72,55,17,14,0.01,0.0
1014,1618,2020-03-19 19:44:00,0,3523.0,2742.0,0.778,16.917,145,68,26,42,77,46,31,7,0.0,0.0
1014,1619,2020-03-19 19:47:00,0,3706.0,2836.0,0.765,17.743,395,236,189,47,159,126,33,137,0.0,0.0
1014,1620,2020-03-19 19:50:00,0,3786.0,2882.0,0.761,18.109,177,74,53,21,103,67,36,16,0.0,0.0
1014,1621,2020-03-19 19:53:00,0,3701.0,2839.0,0.767,17.727,216,130,95,35,86,60,26,18,0.03,0.0
1014,1622,2020-03-19 19:56:00,0,3802.0,2857.0,0.751,18.144,387,239,171,68,148,103,45,42,0.07,0.0
1014,1623,2020-03-19 19:59:00,0,3799.0,2821.0,0.742,18.094,314,147,99,48,167,112,55,19,0.0,0.0
1014,1624,2020-03-19 20:02:00,0,3528.0,2620.0,0.742,16.802,110,95,43,52,15,3,12,3,0.0,0.0
1014,1625,2020-03-19 20:05:00,0,3818.0,2792.0,0.731,18.136,78,67,23,44,11,0,11,0,0.0,0.0
1014,1626,2020-03-19 20:08:00,0,3525.0,2658.0,0.754,16.834,188,86,47,39,102,66,36,2,0.0,0.0
1014,1627,2020-03-19 20:11:00,0,3458.0,2544.0,0.736,16.443,112,84,38,46,28,10,18,0,0.0,0.0
1014,1628,2020-03-19 20:14:00,0,3795.0,2783.0,0.733,18.035,155,67,34,33,88,45,43,2,0.0,0.0
1014,1629,2020-03-19 20:17:00,0,3352.0,2569.0,0.766,16.053,381,172,117,55,209,141,68,14,0.0,0.0
1014,1630,2020-03-19 20:20:00,0,3557.0,2609.0,0.734,16.903,41,24,15,9,17,0,17,4,0.0,0.0
1014,1631,2020-03-19 20:23:00,0,3355.0,2514.0,0.749,16.001,45,45,1,44,0,0,0,0,0.0,0.0
1014,1632,2020-03-19 20:26:00,0,3377.0,2431.0,0.72,15.999,29,29,0,29,0,0,0,0,0.0,0.0
1014,1633,2020-03-19 20:29:00,0,3230.5,2372.0,0.735,15.355,8,7,0,7,1,0,1,0,0.0,0.0
1014,1634,2020-03-19 20:32:00,0,3084.0,2313.0,0.75,14.711,20,12,0,12,8,0,8,0,0.0,0.0
1014,1635,2020-03-19 20:35:00,0,3103.0,2287.0,0.737,14.759,15,15,2,13,0,0,0,0,0.0,0.0
1014,1636,2020-03-19 20:38:00,0,3107.0,2265.0,0.729,14.75,82,59,38,21,23,10,13,5,0.0,0.0
1014,1637,2020-03-19 20:41:00,0,3111.0,2233.0,0.718,14.729,130,69,25,44,61,21,40,0,0.0,0.0
1014,1638,2020-03-19 20:44:00,0,3093.0,2291.0,0.741,14.725,324,199,124,75,125,91,34,3,0.0,0.0
1014,1639,2020-03-19 20:47:00,0,3087.0,2333.0,0.756,14.748,193,109,88,21,84,59,25,11,0.0,0.0
1014,1640,2020-03-19 20:50:00,0,3107.0,2250.0,0.724,14.733,0,0,0,0,0,0,0,0,0.0,0.0
1014,1641,2020-03-19 20:53:00,0,2823.0,2121.0,0.751,13.47,18,17,11,6,1,1,0,0,0.0,0.0
1014,1642,2020-03-19 20:56:00,0,2858.0,2002.0,0.701,13.477,2,2,1,1,0,0,0,0,0.0,0.0
1014,1643,2020-03-19 20:59:00,0,2673.0,1895.0,0.709,12.629,4,4,2,2,0,0,0,0,0.0,0.0
1014,1644,2020-03-19 21:02:00,0,2865.0,2045.0,0.714,13.551,11,11,3,8,0,0,0,0,0.0,0.0
1014,1645,2020-03-19 21:05:00,0,2853.0,2039.0,0.715,13.5,33,33,4,29,0,0,0,0,0.0,0.0
1014,1646,2020-03-19 21:08:00,0,2769.0,1954.0,0.706,13.074,71,53,41,12,18,13,5,0,0.0,0.0
1014,1647,2020-03-19 21:11:00,0,2771.0,1980.0,0.714,13.111,0,0,0,0,0,0,0,0,0.01,0.0
1014,1648,2020-03-19 21:14:00,0,2662.0,1931.0,0.726,12.625,7,7,4,3,0,0,0,0,0.0,0.0
1014,1649,2020-03-19 21:17:00,0,2765.0,1952.0,0.706,13.057,0,0,0,0,0,0,0,0,0.0,0.0
1014,1650,2020-03-19 21:20:00,0,2870.0,1957.0,0.682,13.474,41,41,19,22,0,0,0,1,0.0,0.0
1014,1651,2020-03-19 21:23:00,0,3136.0,2180.0,0.695,14.769,117,98,56,42,19,1,18,6,0.0,0.0
1014,1652,2020-03-19 21:26:00,0,3034.0,2164.0,0.713,14.349,214,138,81,57,76,41,35,17,0.0,0.0
1014,1653,2020-03-19 21:29:00,0,3112.0,2289.0,0.736,14.794,112,73,38,35,39,19,20,0,0.01,0.0
1014,1654,2020-03-19 21:32:00,0,3278.0,2375.0,0.725,15.546,306,177,118,59,129,91,38,8,0.02,0.0
1014,1655,2020-03-19 21:35:00,0,3099.0,2316.0,0.747,14.773,72,58,21,37,14,8,6,0,0.0,0.0
1014,1656,2020-03-19 21:38:00,0,2831.0,2088.0,0.738,13.466,35,11,4,7,24,3,21,0,0.0,0.0
1014,1657,2020-03-19 21:41:00,0,3097.0,2335.0,0.754,14.787,175,86,51,35,89,52,37,8,0.29,0.0
1014,1658,2020-03-19 21:44:00,0,3282.0,2402.0,0.732,15.591,24,21,15,6,3,0,3,0,0.0,0.0
1014,1659,2020-03-19 21:47:00,0,3099.0,2283.0,0.737,14.737,4,4,1,3,0,0,0,0,0.0,0.0
1014,1660,2020-03-19 21:50:00,0,2912.0,2245.0,0.771,13.959,20,20,4,16,0,0,0,0,0.0,0.0
1014,1661,2020-03-19 21:53:00,0,2827.0,2151.0,0.761,13.519,9,7,0,7,2,1,1,0,0.0,0.0
1014,1662,2020-03-19 21:56:00,0,2731.0,2089.0,0.765,13.075,0,0,0,0,0,0,0,0,0.0,0.0
1014,1663,2020-03-19 21:59:00,0,2642.0,2025.0,0.767,12.651,28,25,5,20,3,1,2,0,0.0,0.0
1014,1664,2020-03-19 22:02:00,0,2645.0,1975.0,0.747,12.61,24,23,0,23,1,0,1,0,0.0,0.0
1014,1665,2020-03-19 22:05:00,0,2633.0,2068.0,0.785,12.664,2,2,1,1,0,0,0,0,0.0,0.0
1014,1666,2020-03-19 22:08:00,0,2783.0,2310.0,0.83,13.522,1,1,0,1,0,0,0,0,0.0,0.0
1014,1667,2020-03-19 22:11:00,0,2861.0,2381.0,0.832,13.909,0,0,0,0,0,0,0,0,0.0,0.0
1014,1668,2020-03-19 22:14:00,0,2872.0,2401.0,0.836,13.973,337,173,129,44,164,124,40,20,0.0,0.0
1014,1669,2020-03-19 22:17:00,0,3055.0,2439.0,0.799,14.736,1,1,0,1,0,0,0,0,0.0,0.0
1014,1670,2020-03-19 22:20:00,0,2781.0,2308.0,0.83,13.511,0,0,0,0,0,0,0,4,0.0,0.0
1014,1671,2020-03-19 22:23:00,0,2797.0,2270.0,0.811,13.532,7,7,3,4,0,0,0,0,0.0,0.0
1014,1672,2020-03-19 22:26:00,0,2785.0,2262.0,0.812,13.479,57,53,45,8,4,0,4,1,0.0,0.0
1014,1673,2020-03-19 22:29:00,0,2596.0,2210.0,0.851,12.677,2,2,0,2,0,0,0,0,0.0,0.0
1014,1674,2020-03-19 22:32:00,0,2694.0,2207.0,0.819,13.057,5,5,0,5,0,0,0,0,0.0,0.0
1014,1675,2020-03-19 22:35:00,0,2778.0,2281.0,0.821,13.469,60,31,7,24,29,0,29,3,0.0,0.0
1014,1676,2020-03-19 22:38:00,0,3047.0,2454.0,0.805,14.721,38,31,9,22,7,0,7,3,0.0,0.0
1014,1677,2020-03-19 22:41:00,0,3336.0,2598.0,0.779,16.022,76,45,22,23,31,7,24,2,0.0,0.0
1014,1678,2020-03-19 22:44:00,0,3331.0,2658.0,0.798,16.067,417,159,104,55,258,186,72,29,0.03,0.0
1014,1679,2020-03-19 22:47:00,0,3353.0,2547.0,0.76,16.031,279,112,65,47,167,115,52,4,0.0,0.0
1014,1680,2020-03-19 22:50:00,0,3045.0,2445.0,0.803,14.706,29,25,22,3,4,2,2,2,0.0,0.0
1014,1681,2020-03-19 22:53:00,0,3352.0,2545.0,0.759,16.025,49,36,10,26,13,4,9,0,0.0,0.0
1014,1682,2020-03-19 22:56:00,0,3339.0,2583.0,0.773,16.018,244,126,68,58,118,73,45,6,0.0,0.0
1014,1683,2020-03-19 22:59:00,0,3348.0,2534.0,0.757,15.997,196,144,87,57,52,22,30,19,0.0,0.0
1014,1684,2020-03-19 23:02:00,0,3445.0,2631.0,0.764,16.486,456,245,172,73,211,154,57,45,0.0,0.0
1014,1685,2020-03-19 23:05:00,0,3375.0,2496.0,0.74,16.06,103,70,52,18,33,25,8,4,0.0,0.0
1014,1686,2020-03-19 23:08:00,0,3372.0,2492.0,0.739,16.044,0,0,0,0,0,0,0,0,0.0,0.0
1014,1687,2020-03-19 23:11:00,0,3090.0,2349.0,0.76,14.777,1,0,0,0,1,0,1,0,0.0,0.0
1014,1688,2020-03-19 23:14:00,0,3011.0,2242.0,0.745,14.345,0,0,0,0,0,0,0,0,0.0,0.0
1014,1689,2020-03-19 23:17:00,0,2833.0,2102.0,0.742,13.49,30,30,2,28,0,0,0,0,0.0,0.0
1014,1690,2020-03-19 23:20:00,0,2650.0,1993.0,0.752,12.646,25,21,11,10,4,2,2,0,0.0,0.0
1014,1691,2020-03-19 23:23:00,0,2657.0,1947.0,0.733,12.625,180,117,77,40,63,44,19,18,0.12,0.0
1014,1692,2020-03-19 23:26:00,0,2831.0,2095.0,0.74,13.473,49,4,1,3,45,0,45,0,0.0,0.0
1014,1693,2020-03-19 23:29:00,0,2831.0,2083.0,0.736,13.46,23,17,6,11,6,0,6,0,0.0,0.0
1014,1694,2020-03-19 23:32:00,0,2831.0,2071.0,0.732,13.447,0,0,0,0,0,0,0,0,0.0,0.0
1014,1695,2020-03-19 23:35:00,0,2828.0,2092.0,0.74,13.458,0,0,0,0,0,0,0,0,0.0,0.0
1014,1696,2020-03-19 23:38:00,0,2838.0,2112.0,0.744,13.52,6,4,4,0,2,0,2,2,0.0,0.0
1014,1697,2020-03-19 23:41:00,0,2836.0,2088.0,0.736,13.488,8,7,1,6,1,0,1,0,0.0,0.0
1014,1698,2020-03-19 23:44:00,0,2849.0,2023.0,0.71,13.463,27,9,5,4,18,4,14,0,0.0,0.0
1014,1699,2020-03-19 23:47:00,0,2852.0,2024.0,0.71,13.48,0,0,0,0,0,0,0,0,0.0,0.0
1014,1700,2020-03-19 23:50:00,0,2752.0,2000.0,0.727,13.056,0,0,0,0,0,0,0,0,0.0,0.0
1014,1701,2020-03-19 23:53:00,0,2859.0,2021.0,0.707,13.504,12,12,4,8,0,0,0,0,0.0,0.0
1014,1702,2020-03-19 23:56:00,0,2839.0,1990.0,0.701,13.392,164,81,53,28,83,58,25,6,0.0,0.0
1014,1703,2020-03-19 23:59:00,0,2863.0,2035.0,0.711,13.533,282,98,63,35,184,123,61,8,0.0,0.0
1014,1704,2020-03-20 00:02:00,0,2858.0,2042.0,0.714,13.523,147,72,34,38,75,30,45,0,0.0,0.0
1014,1705,2020-03-20 00:05:00,0,2821.0,2129.0,0.755,13.47,142,86,46,40,56,34,22,4,0.0,0.0
1014,1706,2020-03-20 00:08:00,0,2836.0,2124.0,0.749,13.527,177,89,49,40,88,54,34,0,0.0,0.0
1014,1707,2020-03-20 00:11:00,0,2930.0,2139.0,0.73,13.912,359,144,90,54,215,184,31,0,0.0,0.0
1014,1708,2020-03-20 00:14:00,0,3106.0,2235.0,0.719,14.713,592,249,195,54,343,289,54,148,0.0,0.0
1014,1709,2020-03-20 00:17:00,0,3554.0,2628.0,0.739,16.915,371,209,141,68,162,122,40,31,0.0,0.0
1014,1710,2020-03-20 00:20:00,0,3022.0,2189.0,0.724,14.331,189,98,48,50,91,40,51,20,0.0,0.0
1014,1711,2020-03-20 00:23:00,0,3284.0,2351.0,0.716,15.543,158,95,61,34,63,39,24,5,0.0,0.0
1014,1712,2020-03-20 00:26:00,0,3383.0,2462.0,0.728,16.054,269,139,93,46,130,78,52,17,0.0,0.0
1014,1713,2020-03-20 00:29:00,0,3381.0,2410.0,0.713,15.989,239,144,84,60,95,56,39,24,0.04,0.0
1014,1714,2020-03-20 00:32:00,0,3369.0,2460.0,0.73,15.997,309,174,131,43,135,91,44,106,0.04,0.0
1014,1715,2020-03-20 00:35:00,0,3394.0,2440.0,0.719,16.072,189,96,70,26,93,63,30,83,0.0,0.0
1014,1716,2020-03-20 00:38:00,0,3367.0,2453.0,0.729,15.984,245,121,79,42,124,80,44,29,0.0,0.0
1014,1717,2020-03-20 00:41:00,0,3302.0,2387.0,0.723,15.654,255,147,78,69,108,58,50,0,0.0,0.0
1014,1718,2020-03-20 00:44:00,0,3084.0,2321.0,0.753,14.72,146,106,63,43,40,18,22,21,0.0,0.0
1014,1719,2020-03-20 00:47:00,0,3179.0,2355.0,0.741,15.132,0,0,0,0,0,0,0,0,0.0,0.0
1014,1720,2020-03-20 00:50:00,0,3114.0,2262.0,0.726,14.773,15,11,2,9,4,0,4,5,0.0,0.0
1014,1721,2020-03-20 00:53:00,0,3032.0,2210.0,0.729,14.392,0,0,0,0,0,0,0,0,0.0,0.0
1014,1722,2020-03-20 00:56:00,0,2818.0,2103.0,0.746,13.431,15,15,2,13,0,0,0,0,0.0,0.0
1014,1723,2020-03-20 00:59:00,0,2858.0,2054.0,0.718,13.536,1,0,0,0,1,0,1,0,0.0,0.0
1014,1724,2020-03-20 01:02:00,0,2655.0,1981.0,0.746,12.655,7,7,4,3,0,0,0,0,0.0,0.0
1014,1725,2020-03-20 01:05:00,0,2674.0,1904.0,0.712,12.645,16,13,1,12,3,0,3,0,0.0,0.0
1014,1726,2020-03-20 01:08:00,0,2590.0,1809.0,0.698,12.207,54,46,9,37,8,0,8,0,0.0,0.0
1014,1727,2020-03-20 01:11:00,0,2688.0,1839.0,0.684,12.628,218,114,97,17,104,82,22,12,0.0,0.0
1014,1728,2020-03-20 01:14:00,0,2694.0,1824.0,0.677,12.633,1,1,0,1,0,0,0,0,0.0,0.0
1014,1729,2020-03-20 01:17:00,0,2402.0,1714.0,0.714,11.362,0,0,0,0,0,0,0,0,0.0,0.0
1014,1730,2020-03-20 01:20:00,0,2331.0,1632.0,0.7,10.992,0,0,0,0,0,0,0,0,0.0,0.0
1014,1731,2020-03-20 01:23:00,0,2136.0,1565.0,0.733,10.15,13,11,6,5,2,1,1,0,0.0,0.0
1014,1732,2020-03-20 01:26:00,0,2137.0,1550.0,0.725,10.136,23,23,11,12,0,0,0,0,0.0,0.0
1014,1733,2020-03-20 01:29:00,0,2327.0,1641.0,0.706,10.984,8,8,3,5,0,0,0,0,0.0,0.0
1014,1734,2020-03-20 01:32:00,0,2435.0,1652.0,0.678,11.424,4,4,2,2,0,0,0,0,0.0,0.0
1014,1735,2020-03-20 01:35:00,0,2495.0,1744.0,0.699,11.761,13,13,5,8,0,0,0,0,0.0,0.0
1014,1736,2020-03-20 01:38:00,0,2707.0,1796.0,0.663,12.654,7,7,3,4,0,0,0,0,0.0,0.0
1014,1737,2020-03-20 01:41:00,0,2693.0,1882.0,0.699,12.694,86,68,41,27,18,0,18,15,0.0,0.0
1014,1738,2020-03-20 01:44:00,0,2851.0,2060.0,0.723,13.513,57,28,16,12,29,0,29,6,0.0,0.0
1014,1739,2020-03-20 01:47:00,0,2943.0,2171.0,0.738,13.999,167,87,45,42,80,62,18,17,0.02,0.0
1014,1740,2020-03-20 01:50:00,0,3122.0,2260.0,0.724,14.804,354,195,148,47,159,113,46,25,0.07,0.0
1014,1741,2020-03-20 01:53:00,0,2931.0,2157.0,0.736,13.937,168,102,46,56,66,24,42,1,0.0,0.0
1014,1742,2020-03-20 01:56:00,0,3105.0,2303.0,0.742,14.783,329,216,152,64,113,84,29,26,0.0,0.0
1014,1743,2020-03-20 01:59:00,0,3301.0,2330.0,0.706,15.586,174,114,76,38,60,44,16,11,0.0,0.0
1014,1744,2020-03-20 02:02:00,0,2847.0,2102.0,0.738,13.544,81,33,26,7,48,36,12,4,0.0,0.0
1014,1745,2020-03-20 02:05:00,0,3103.0,2204.0,0.71,14.669,0,0,0,0,0,0,0,0,0.0,0.0
1014,1746,2020-03-20 02:08:00,0,2848.0,2136.0,0.75,13.588,0,0,0,0,0,0,0,0,0.0,0.0
1014,1747,2020-03-20 02:11:00,0,2834.0,2051.0,0.724,13.438,30,17,2,15,13,1,12,0,0.0,0.0
1014,1748,2020-03-20 02:14:00,0,2840.0,2018.0,0.71,13.425,8,6,3,3,2,0,2,0,0.0,0.0
1014,1749,2020-03-20 02:17:00,0,2859.0,1968.0,0.688,13.445,6,6,4,2,0,0,0,0,0.0,0.0
1014,1750,2020-03-20 02:20:00,0,2761.0,1954.0,0.708,13.044,0,0,0,0,0,0,0,0,0.0,0.0
1014,1751,2020-03-20 02:23:00,0,2777.0,1942.0,0.699,13.092,13,0,0,0,13,1,12,0,0.0,0.0
1014,1752,2020-03-20 02:26:00,0,2758.0,1945.0,0.705,13.021,8,0,0,0,8,1,7,2,0.0,0.0
1014,1753,2020-03-20 02:29:00,0,2765.0,1945.5,0.7035,13.048,47,42,16,26,5,2,3,0,0.0,0.0
1014,1754,2020-03-20 02:32:00,0,2772.0,1946.0,0.702,13.075,78,43,34,9,35,23,12,4,0.0,0.0
1014,1755,2020-03-20 02:35:00,0,2689.0,1881.0,0.7,12.68,122,94,38,56,28,12,16,0,0.0,0.0
1014,1756,2020-03-20 02:38:00,0,2856.0,2007.0,0.703,13.473,213,114,75,39,99,63,36,7,0.1,0.0
1014,1757,2020-03-20 02:41:00,0,2822.0,2098.0,0.743,13.443,318,174,121,53,144,98,46,53,0.0,0.0
1014,1758,2020-03-20 02:44:00,0,2855.0,1963.0,0.688,13.423,123,87,36,51,36,12,24,0,0.0,0.0
1014,1759,2020-03-20 02:47:00,0,2835.0,2098.0,0.74,13.494,181,122,76,46,59,38,21,9,0.0,0.0
1014,1760,2020-03-20 02:50:00,0,2860.0,2052.0,0.718,13.541,4,2,1,1,2,0,2,0,0.0,0.0
1014,1761,2020-03-20 02:53:00,0,2684.0,1899.0,0.708,12.677,3,3,1,2,0,0,0,0,0.0,0.0
1014,1762,2020-03-20 02:56:00,0,2695.0,1808.0,0.671,12.621,18,13,6,7,5,0,5,0,0.0,0.0
1014,1763,2020-03-20 02:59:00,0,2691.0,1833.0,0.681,12.631,1,1,0,1,0,0,0,0,0.0,0.0
1014,1764,2020-03-20 03:02:00,0,2397.0,1738.0,0.725,11.37,11,11,6,5,0,0,0,0,0.0,0.0
1014,1765,2020-03-20 03:05:00,0,2425.0,1646.0,0.679,11.376,9,9,4,5,0,0,0,0,0.0,0.0
1014,1766,2020-03-20 03:08:00,0,2222.0,1589.0,0.715,10.515,11,11,4,7,0,0,0,0,0.0,0.0
1014,1767,2020-03-20 03:11:00,0,2230.0,1608.0,0.721,10.569,0,0,0,0,0,0,0,0,0.0,0.0
1014,1768,2020-03-20 03:14:00,0,2324.0,1619.0,0.697,10.949,27,26,15,11,1,0,1,0,0.0,0.0
1014,1769,2020-03-20 03:17:00,0,2506.0,1757.0,0.701,11.82,0,0,0,0,0,0,0,0,0.0,0.0
1014,1770,2020-03-20 03:20:00,0,2407.0,1743.0,0.724,11.415,0,0,0,0,0,0,0,0,0.0,0.0
1014,1771,2020-03-20 03:23:00,0,2409.0,1682.0,0.698,11.355,0,0,0,0,0,0,0,0,0.0,0.0
1014,1772,2020-03-20 03:26:00,0,2327.0,1644.0,0.706,10.989,0,0,0,0,0,0,0,0,0.0,0.0
1014,1773,2020-03-20 03:29:00,0,2316.0,1617.0,0.699,10.915,2,2,1,1,0,0,0,0,0.0,0.0
1014,1774,2020-03-20 03:32:00,0,2142.0,1568.0,0.732,10.175,9,9,1,8,0,0,0,0,0.0,0.0
1014,1775,2020-03-20 03:35:00,0,2123.0,1566.0,0.738,10.098,2,2,0,2,0,0,0,0,0.0,0.0
1014,1776,2020-03-20 03:38:00,0,2421.0,1661.0,0.686,11.38,20,20,7,13,0,0,0,0,0.0,0.0
1014,1777,2020-03-20 03:41:00,0,2598.0,1807.0,0.695,12.238,66,55,19,36,11,0,11,10,0.0,0.0
1014,1778,2020-03-20 03:44:00,0,2687.0,1884.0,0.701,12.673,34,23,9,14,11,0,11,1,0.0,0.0
1014,1779,2020-03-20 03:47:00,0,2747.0,1960.0,0.714,12.995,52,39,6,33,13,0,13,0,0.0,0.0
1014,1780,2020-03-20 03:50:00,0,2859.0,2047.0,0.716,13.532,0,0,0,0,0,0,0,0,0.0,0.0
1014,1781,2020-03-20 03:53:00,0,2850.0,2029.0,0.712,13.476,44,44,0,44,0,0,0,0,0.0,0.0
1014,1782,2020-03-20 03:56:00,0,2831.0,2115.0,0.747,13.496,230,142,99,43,88,56,32,18,0.01,0.0
1014,1783,2020-03-20 03:59:00,0,2840.0,2104.0,0.741,13.517,326,166,130,36,160,109,51,15,0.0,0.0
1014,1784,2020-03-20 04:02:00,0,2836.0,2113.0,0.745,13.513,268,170,120,50,98,58,40,9,0.0,0.0
1014,1785,2020-03-20 04:05:00,0,2850.0,2072.0,0.727,13.524,135,81,55,26,54,38,16,5,0.0,0.0
1014,1786,2020-03-20 04:08:00,0,2771.0,1972.0,0.712,13.104,11,11,0,11,0,0,0,0,0.0,0.0
1014,1787,2020-03-20 04:11:00,0,2701.0,1811.0,0.671,12.649,5,5,0,5,0,0,0,0,0.0,0.0
1014,1788,2020-03-20 04:14:00,0,2408.0,1696.0,0.704,11.364,20,20,0,20,0,0,0,0,0.0,0.0
1014,1789,2020-03-20 04:17:00,0,2310.0,1609.0,0.697,10.883,0,0,0,0,0,0,0,0,0.0,0.0
1014,1790,2020-03-20 04:20:00,0,2145.0,1552.0,0.724,10.168,18,18,2,16,0,0,0,0,0.0,0.0
1014,1791,2020-03-20 04:23:00,0,2317.0,1627.0,0.702,10.93,1,1,0,1,0,0,0,0,0.0,0.0
1014,1792,2020-03-20 04:26:00,0,2135.0,1574.0,0.737,10.154,2,2,0,2,0,0,0,0,0.0,0.0
1014,1793,2020-03-20 04:29:00,0,2139.0,1504.0,0.703,10.091,2,2,0,2,0,0,0,0,0.0,0.0
1014,1794,2020-03-20 04:32:00,0,2163.0,1465.0,0.677,10.144,0,0,0,0,0,0,0,0,0.0,0.0
1014,1795,2020-03-20 04:35:00,0,2151.0,1469.0,0.683,10.103,2,2,1,1,0,0,0,0,0.0,0.0
1014,1796,2020-03-20 04:38:00,0,2127.0,1537.0,0.723,10.083,7,7,4,3,0,0,0,0,0.0,0.0
1014,1797,2020-03-20 04:41:00,0,2133.0,1574.0,0.738,10.149,6,6,2,4,0,0,0,0,0.0,0.0
1014,1798,2020-03-20 04:44:00,0,2118.0,1587.0,0.749,10.104,16,15,10,5,1,0,1,0,0.0,0.0
1014,1799,2020-03-20 04:47:00,0,2421.0,1685.0,0.696,11.404,41,33,21,12,8,1,7,2,0.0,0.0
1014,1800,2020-03-20 04:50:00,0,2419.0,1667.0,0.689,11.377,21,21,4,17,0,0,0,0,0.0,0.0
1014,1801,2020-03-20 04:53:00,0,2119.0,1600.0,0.755,10.119,13,13,3,10,0,0,0,0,0.0,0.0
1014,1802,2020-03-20 04:56:00,0,2117.0,1592.0,0.752,10.104,22,21,9,12,1,1,0,0,0.0,0.0
1014,1803,2020-03-20 04:59:00,0,2226.0,1613.0,0.724,10.556,6,6,0,6,0,0,0,0,0.0,0.0
1014,1804,2020-03-20 05:02:00,0,2133.0,1547.0,0.725,10.118,21,15,8,7,6,0,6,3,0.0,0.0
1014,1805,2020-03-20 05:05:00,0,2494.0,1783.0,0.715,11.803,80,69,33,36,11,0,11,23,0.0,0.0
1014,1806,2020-03-20 05:08:00,0,2681.0,1938.0,0.723,12.708,271,175,135,40,96,55,41,7,0.0,0.0
1014,1807,2020-03-20 05:11:00,0,2847.0,2015.0,0.708,13.45,10,10,6,4,0,0,0,0,0.0,0.0
1014,1808,2020-03-20 05:14:00,0,2685.0,1919.0,0.715,12.706,5,5,2,3,0,0,0,0,0.0,0.0
1014,1809,2020-03-20 05:17:00,0,2486.0,1770.0,0.712,11.753,3,2,1,1,1,1,0,0,0.0,0.0
1014,1810,2020-03-20 05:20:00,0,2421.0,1661.0,0.686,11.377,14,13,1,12,1,0,1,0,0.0,0.0
1014,1811,2020-03-20 05:23:00,0,2120.0,1565.0,0.738,10.087,0,0,0,0,0,0,0,0,0.0,0.0
1014,1812,2020-03-20 05:26:00,0,2131.0,1500.0,0.704,10.056,6,4,2,2,2,0,2,0,0.0,0.0
1014,1813,2020-03-20 05:29:00,0,2359.5,1646.5,0.6985,11.1195,52,52,29,23,0,0,0,1,0.0,0.0
1014,1814,2020-03-20 05:32:00,0,2588.0,1793.0,0.693,12.183,43,43,12,31,0,0,0,8,0.01,0.0
1014,1815,2020-03-20 05:35:00,0,2680.0,1847.0,0.689,12.604,95,64,41,23,31,13,18,18,0.0,0.0
1014,1816,2020-03-20 05:38:00,0,2848.0,2040.0,0.716,13.481,207,108,73,35,99,65,34,20,0.06,0.0
1014,1817,2020-03-20 05:41:00,0,2824.0,2136.0,0.756,13.493,207,82,53,29,125,84,41,11,0.02,0.0
1014,1818,2020-03-20 05:44:00,0,2655.0,1978.0,0.745,12.653,32,27,14,13,5,2,3,0,0.0,0.0
1014,1819,2020-03-20 05:47:00,0,2667.0,1908.0,0.715,12.621,0,0,0,0,0,0,0,0,0.0,0.0
1014,1820,2020-03-20 05:50:00,0,2491.0,1774.0,0.712,11.779,0,0,0,0,0,0,0,0,0.0,0.0
1014,1821,2020-03-20 05:53:00,0,2423.0,1665.0,0.687,11.392,3,3,0,3,0,0,0,0,0.0,0.0
1014,1822,2020-03-20 05:56:00,0,2129.0,1580.0,0.742,10.136,2,2,0,2,0,0,0,0,0.01,0.0
1014,1823,2020-03-20 05:59:00,0,2145.0,1507.0,0.703,10.118,13,13,9,4,0,0,0,0,0.01,0.0
1014,1824,2020-03-20 06:02:00,1,2131.0,1590.0,0.746,10.155,186,110,69,41,76,49,27,41,0.0,0.0
1014,1825,2020-03-20 06:05:00,1,2853.0,1986.0,0.696,13.441,147,73,32,41,74,41,33,79,0.0,0.0
1014,1826,2020-03-20 06:08:00,1,3094.0,2276.0,0.736,14.712,215,75,32,43,140,90,50,87,0.0,0.0
1014,1827,2020-03-20 06:11:00,1,3278.0,2445.0,0.746,15.621,134,81,42,39,53,24,29,81,0.0,0.0
1014,1828,2020-03-20 06:14:00,1,3519.0,2727.0,0.775,16.887,179,121,77,44,58,29,29,135,0.0,0.0
1014,1829,2020-03-20 06:17:00,1,3359.0,2585.0,0.769,16.098,558,278,208,70,280,221,59,101,0.09,0.0
1014,1830,2020-03-20 06:20:00,1,2777.0,2270.0,0.817,13.455,208,134,89,45,74,42,32,103,0.0,0.0
1014,1831,2020-03-20 06:23:00,1,3495.0,2837.0,0.812,16.91,208,143,79,64,65,24,41,101,0.0,0.0
1014,1832,2020-03-20 06:26:00,1,3438.0,3037.0,0.883,16.908,121,84,52,32,37,13,24,99,0.0,0.08
1014,1833,2020-03-20 06:29:00,1,3677.0,3240.0,0.881,18.076,272,126,92,34,146,106,40,20,0.19,0.48
1014,1834,2020-03-20 06:32:00,1,3048.0,2569.0,0.843,14.855,170,70,48,22,100,54,46,57,0.0,0.0
1014,1835,2020-03-20 06:35:00,1,3490.0,3204.0,0.918,17.296,264,146,96,50,118,71,47,76,0.0,0.0
1014,1836,2020-03-20 06:38:00,1,3238.0,2990.0,0.924,16.067,312,150,110,40,162,116,46,33,0.05,0.0
1014,1837,2020-03-20 06:41:00,1,3417.0,3079.0,0.901,16.874,180,176,102,74,4,2,2,19,0.0,0.0
1014,1838,2020-03-20 06:44:00,1,3390.0,3197.0,0.943,16.895,163,132,80,52,31,12,19,55,0.0,0.0
1014,1839,2020-03-20 06:47:00,1,3651.0,3394.0,0.93,18.141,200,105,59,46,95,52,43,64,0.34,0.0
1014,1840,2020-03-20 06:50:00,1,3390.0,3236.0,0.954,16.939,216,101,70,31,115,65,50,49,0.0,0.0
1014,1841,2020-03-20 06:53:00,1,3244.0,2967.0,0.915,16.065,160,93,69,24,67,46,21,12,0.03,0.32
1014,1842,2020-03-20 06:56:00,1,3649.0,3364.0,0.922,18.103,411,196,149,47,215,177,38,94,0.0,0.09
1014,1843,2020-03-20 06:59:00,1,3802.0,3595.0,0.946,18.96,403,222,160,62,181,130,51,29,0.0,0.0
1014,1844,2020-03-20 07:02:00,1,3876.0,3735.0,0.964,19.405,205,109,72,37,96,58,38,21,0.0,0.0
1014,1845,2020-03-20 07:05:00,1,3867.0,3808.0,0.985,19.453,70,46,26,20,24,0,24,19,0.0,0.02
1014,1846,2020-03-20 07:08:00,1,3893.0,3710.0,0.953,19.446,67,29,16,13,38,2,36,1,0.0,0.0
1014,1847,2020-03-20 07:11:00,1,3686.0,3617.0,0.981,18.526,40,24,6,18,16,0,16,0,0.0,0.0
1014,1848,2020-03-20 07:14:00,1,3646.0,3483.0,0.955,18.221,0,0,0,0,0,0,0,0,0.0,0.0
1014,1849,2020-03-20 07:17:00,1,3373.0,3284.0,0.974,16.926,0,0,0,0,0,0,0,0,0.0,0.0
1014,1850,2020-03-20 07:20:00,1,3194.0,3170.0,0.993,16.093,0,0,0,0,0,0,0,0,0.0,0.0
1014,1851,2020-03-20 07:23:00,1,3228.0,3040.0,0.942,16.083,0,0,0,0,0,0,0,0,0.0,0.0
1014,1852,2020-03-20 07:26:00,1,3039.0,2942.0,0.968,15.232,73,41,26,15,32,14,18,16,0.0,0.29
1014,1853,2020-03-20 07:29:00,1,3306.0,3167.0,0.958,16.53,61,19,5,14,42,23,19,0,0.0,0.26
1014,1854,2020-03-20 07:32:00,1,3204.0,3154.0,0.984,16.116,176,74,60,14,102,67,35,14,0.15,0.0
1014,1855,2020-03-20 07:35:00,1,3283.0,3227.0,0.983,16.507,9,4,1,3,5,0,5,0,0.0,0.0
1014,1856,2020-03-20 07:38:00,1,3196.0,3132.0,0.98,16.06,22,14,6,8,8,1,7,0,0.0,0.0
1014,1857,2020-03-20 07:41:00,1,3222.0,3026.0,0.939,16.045,21,20,11,9,1,0,1,0,0.0,0.0
1014,1858,2020-03-20 07:44:00,1,2945.0,2837.0,0.963,14.744,80,49,29,20,31,13,18,27,0.0,0.0
1014,1859,2020-03-20 07:47:00,1,3197.0,3114.0,0.974,16.045,151,51,36,15,100,79,21,5,0.21,0.0
1014,1860,2020-03-20 07:50:00,1,3195.0,3160.0,0.989,16.085,2,2,1,1,0,0,0,0,0.0,0.0
1014,1861,2020-03-20 07:53:00,1,3225.0,3059.0,0.948,16.094,16,2,1,1,14,1,13,0,0.0,0.0
1014,1862,2020-03-20 07:56:00,1,2926.0,2977.0,1.017,14.826,3,0,0,0,3,0,3,0,0.0,0.0
1014,1863,2020-03-20 07:59:00,1,2946.0,2916.0,0.99,14.836,0,0,0,0,0,0,0,0,0.0,0.0
1014,1864,2020-03-20 08:02:00,1,2867.0,2782.0,0.97,14.375,83,44,17,27,39,13,26,27,0.0,0.0
1014,1865,2020-03-20 08:05:00,1,3373.0,3262.0,0.967,16.9,244,86,53,33,158,98,60,42,0.0,0.0
1014,1866,2020-03-20 08:08:00,1,3215.0,3060.0,0.952,16.056,163,77,35,42,86,43,43,32,0.0,0.0
1014,1867,2020-03-20 08:11:00,1,3366.0,3329.0,0.989,16.947,371,191,146,45,180,132,48,145,0.0,0.0
1014,1868,2020-03-20 08:14:00,1,3392.0,3210.0,0.946,16.917,386,194,151,43,192,139,53,169,0.0,0.0
1014,1869,2020-03-20 08:17:00,1,3354.0,3364.0,1.003,16.937,271,120,94,26,151,112,39,141,0.0,0.0
1014,1870,2020-03-20 08:20:00,1,3348.0,3401.0,1.016,16.955,79,36,28,8,43,32,11,102,0.0,0.0
1014,1871,2020-03-20 08:23:00,1,3300.0,3189.0,0.966,16.532,211,110,67,43,101,57,44,70,0.0,0.0
1014,1872,2020-03-20 08:26:00,1,3347.0,3375.0,1.008,16.922,81,44,14,30,37,10,27,20,0.0,0.0
1014,1873,2020-03-20 08:29:00,1,3360.5,3320.5,0.988,16.9165,144,122,59,63,22,3,19,18,0.0,0.0
1014,1874,2020-03-20 08:32:00,1,3374.0,3266.0,0.968,16.911,68,42,11,31,26,0,26,0,0.0,0.0
1014,1875,2020-03-20 08:35:00,1,3382.0,3221.0,0.952,16.888,32,25,0,25,7,0,7,0,0.0,0.0
1014,1876,2020-03-20 08:38:00,1,3399.0,3181.0,0.936,16.914,177,89,63,26,88,67,21,11,0.11,0.0
1014,1877,2020-03-20 08:41:00,1,3410.0,3177.0,0.931,16.953,13,13,5,8,0,0,0,0,0.0,0.0
1014,1878,2020-03-20 08:44:00,1,3026.0,2908.0,0.961,15.14,4,2,1,1,2,0,2,0,0.0,0.0
1014,1879,2020-03-20 08:47:00,1,2985.0,2752.0,0.922,14.809,67,44,24,20,23,7,16,36,0.0,0.0
1014,1880,2020-03-20 08:50:00,1,3443.0,3383.0,0.982,17.311,104,57,32,25,47,29,18,13,0.0,0.0
1014,1881,2020-03-20 08:53:00,1,3212.0,3093.0,0.963,16.079,5,0,0,0,5,1,4,0,0.0,0.08
1014,1882,2020-03-20 08:56:00,1,3237.0,2995.0,0.925,16.07,0,0,0,0,0,0,0,0,0.0,0.02
1014,1883,2020-03-20 08:59:00,1,3032.0,2916.0,0.962,15.175,5,1,1,0,4,0,4,0,0.0,0.0
1014,1884,2020-03-20 09:02:00,1,2964.0,2803.0,0.946,14.783,22,15,10,5,7,1,6,0,0.0,0.0
1014,1885,2020-03-20 09:05:00,1,2975.0,2758.0,0.927,14.773,23,20,17,3,3,0,3,2,0.0,0.0
1014,1886,2020-03-20 09:08:00,1,3054.0,2864.0,0.938,15.203,69,52,30,22,17,6,11,55,0.0,0.0
1014,1887,2020-03-20 09:11:00,1,2942.0,2883.0,0.98,14.783,145,67,48,19,78,45,33,1,0.0,0.0
1014,1888,2020-03-20 09:14:00,1,3141.0,2970.0,0.946,15.663,22,3,1,2,19,0,19,0,0.0,0.0
1014,1889,2020-03-20 09:17:00,1,2951.0,2809.0,0.952,14.738,27,3,1,2,24,0,24,0,0.0,0.0
1014,1890,2020-03-20 09:20:00,1,2956.0,2865.0,0.969,14.82,6,6,0,6,0,0,0,0,0.0,0.0
1014,1891,2020-03-20 09:23:00,1,2933.0,2903.0,0.99,14.768,40,32,4,28,8,0,8,0,0.0,0.0
1014,1892,2020-03-20 09:26:00,1,2954.0,2852.0,0.965,14.794,54,39,17,22,15,9,6,11,0.0,0.0
1014,1893,2020-03-20 09:29:00,1,3248.0,3012.0,0.927,16.132,123,57,25,32,66,27,39,70,0.01,0.0
1014,1894,2020-03-20 09:32:00,1,3234.0,3019.0,0.934,16.083,144,110,71,39,34,17,17,0,0.01,0.04
1014,1895,2020-03-20 09:35:00,1,3384.0,3209.0,0.948,16.885,86,36,15,21,50,0,50,2,0.0,0.0
1014,1896,2020-03-20 09:38:00,1,3380.0,3264.0,0.966,16.93,25,12,2,10,13,2,11,0,0.0,0.0
1014,1897,2020-03-20 09:41:00,1,3190.0,3180.0,0.997,16.09,14,8,4,4,6,2,4,0,0.0,0.0
1014,1898,2020-03-20 09:44:00,1,3129.0,3021.0,0.966,15.673,0,0,0,0,0,0,0,0,0.0,0.0
1014,1899,2020-03-20 09:47:00,1,2954.0,2844.0,0.963,14.786,99,73,42,31,26,9,17,49,0.0,0.0
1014,1900,2020-03-20 09:50:00,1,3135.0,2939.0,0.937,15.607,106,38,30,8,68,47,21,0,0.16,0.0
1014,1901,2020-03-20 09:53:00,1,3109.0,2979.0,0.958,15.546,0,0,0,0,0,0,0,0,0.0,0.0
1014,1902,2020-03-20 09:56:00,1,2922.0,2943.0,1.007,14.772,0,0,0,0,0,0,0,0,0.0,0.0
1014,1903,2020-03-20 09:59:00,1,2944.0,2911.0,0.989,14.823,0,0,0,0,0,0,0,0,0.0,0.0
1014,1904,2020-03-20 10:02:00,1,2961.0,2815.0,0.951,14.782,0,0,0,0,0,0,0,0,0.0,0.0
1014,1905,2020-03-20 10:05:00,1,2779.0,2691.0,0.968,13.93,86,42,26,16,44,16,28,23,0.0,0.0
1014,1906,2020-03-20 10:08:00,1,2963.0,2801.0,0.945,14.776,110,40,28,12,70,48,22,10,0.24,0.0
1014,1907,2020-03-20 10:11:00,1,3133.0,2991.0,0.954,15.656,0,0,0,0,0,0,0,0,0.0,0.0
1014,1908,2020-03-20 10:14:00,1,2927.0,2898.0,0.99,14.74,0,0,0,0,0,0,0,0,0.0,0.0
1014,1909,2020-03-20 10:17:00,1,2950.0,2871.0,0.973,14.8,0,0,0,0,0,0,0,0,0.0,0.0
1014,1910,2020-03-20 10:20:00,1,2955.0,2861.0,0.968,14.81,0,0,0,0,0,0,0,0,0.0,0.0
1014,1911,2020-03-20 10:23:00,1,2868.0,2790.0,0.973,14.387,40,21,12,9,19,9,10,13,0.0,0.0
1014,1912,2020-03-20 10:26:00,1,2955.0,2871.0,0.972,14.821,181,71,45,26,110,51,59,40,0.0,0.0
1014,1913,2020-03-20 10:29:00,1,2938.0,2907.0,0.989,14.793,8,4,2,2,4,1,3,0,0.0,0.0
1014,1914,2020-03-20 10:32:00,1,3032.0,2975.0,0.981,15.24,6,2,2,0,4,2,2,0,0.0,0.0
1014,1915,2020-03-20 10:35:00,1,2945.0,2886.0,0.98,14.8,2,1,1,0,1,0,1,0,0.0,0.0
1014,1916,2020-03-20 10:38:00,1,2952.0,2799.0,0.948,14.73,3,1,0,1,2,0,2,0,0.0,0.0
1014,1917,2020-03-20 10:41:00,1,2966.0,2831.0,0.955,14.82,2,1,0,1,1,0,1,0,0.0,0.0
1014,1918,2020-03-20 10:44:00,1,2880.0,2757.0,0.957,14.398,117,58,37,21,59,27,32,50,0.0,0.0
1014,1919,2020-03-20 10:47:00,1,2946.0,2892.0,0.982,14.807,366,194,129,65,172,111,61,0,0.0,0.0
1014,1920,2020-03-20 10:50:00,1,2960.0,2856.0,0.965,14.822,419,156,108,48,263,186,77,31,0.0,0.0
1014,1921,2020-03-20 10:53:00,1,3194.0,3144.0,0.984,16.063,249,122,87,35,127,85,42,66,0.0,0.0
1014,1922,2020-03-20 10:56:00,1,3188.0,3138.0,0.984,16.033,468,230,182,48,238,165,73,30,0.0,0.0
1014,1923,2020-03-20 10:59:00,1,3395.0,3270.0,0.963,16.995,133,38,5,33,95,39,56,66,0.0,0.0
1014,1924,2020-03-20 11:02:00,1,3288.0,3161.0,0.961,16.453,116,38,21,17,78,33,45,55,0.0,0.0
1014,1925,2020-03-20 11:05:00,1,3191.0,3157.0,0.989,16.067,32,19,8,11,13,2,11,3,0.0,0.0
1014,1926,2020-03-20 11:08:00,1,3193.0,3086.0,0.966,15.998,200,104,56,48,96,59,37,22,0.0,0.0
1014,1927,2020-03-20 11:11:00,1,3199.0,3121.0,0.976,16.058,32,21,6,15,11,4,7,0,0.0,0.0
1014,1928,2020-03-20 11:14:00,1,2934.0,2889.0,0.985,14.757,31,17,3,14,14,1,13,0,0.0,0.0
1014,1929,2020-03-20 11:17:00,1,2961.0,2786.0,0.941,14.75,6,2,0,2,4,2,2,0,0.0,0.0
1014,1930,2020-03-20 11:20:00,1,2694.0,2689.0,0.998,13.59,0,0,0,0,0,0,0,0,0.0,0.0
1014,1931,2020-03-20 11:23:00,1,2717.0,2554.0,0.94,13.534,3,0,0,0,3,0,3,0,0.0,0.0
1014,1932,2020-03-20 11:26:00,1,2709.0,2572.0,0.95,13.521,0,0,0,0,0,0,0,0,0.0,0.0
1014,1933,2020-03-20 11:29:00,1,2697.0,2620.5,0.972,13.527,97,46,27,19,51,23,28,21,0.0,0.16
1014,1934,2020-03-20 11:32:00,1,2685.0,2669.0,0.994,13.533,99,37,26,11,62,43,19,2,0.23,0.0
1014,1935,2020-03-20 11:35:00,1,2975.0,2782.0,0.935,14.803,0,0,0,0,0,0,0,0,0.0,0.08
1014,1936,2020-03-20 11:38:00,1,2970.0,2808.0,0.945,14.811,0,0,0,0,0,0,0,0,0.0,0.0
1014,1937,2020-03-20 11:41:00,1,2965.0,2843.0,0.959,14.828,1,0,0,0,1,1,0,0,0.0,0.0
1014,1938,2020-03-20 11:44:00,1,2967.0,2785.0,0.939,14.775,23,18,11,7,5,0,5,0,0.0,0.0
1014,1939,2020-03-20 11:47:00,1,2961.0,2829.0,0.956,14.797,1,0,0,0,1,0,1,0,0.0,0.0
1014,1940,2020-03-20 11:50:00,1,2680.0,2673.0,0.997,13.52,59,26,12,14,33,15,18,38,0.0,0.13
1014,1941,2020-03-20 11:53:00,1,3120.0,3024.0,0.969,15.639,125,60,39,21,65,44,21,11,0.0,0.17
1014,1942,2020-03-20 11:56:00,1,3233.0,3022.0,0.935,16.083,55,54,26,28,1,0,1,22,0.0,0.0
1014,1943,2020-03-20 11:59:00,1,3207.0,3103.0,0.967,16.072,58,57,18,39,1,0,1,18,0.0,0.0
1014,1944,2020-03-20 12:02:00,1,3199.0,3127.0,0.977,16.065,14,9,3,6,5,1,4,0,0.0,0.17
1014,1945,2020-03-20 12:05:00,1,3034.0,2964.0,0.977,15.235,0,0,0,0,0,0,0,0,0.0,0.0
1014,1946,2020-03-20 12:08:00,1,2959.0,2845.0,0.962,14.806,8,3,2,1,5,0,5,0,0.0,0.0
1015,1,2020-03-16 10:53:00,1,4282.0,3409.0,0.796,20.646,779,495,408,87,284,204,80,112,0.0,0.0
1015,2,2020-03-16 10:56:00,1,4356.0,3513.0,0.807,21.053,657,423,358,65,234,171,63,96,0.0,0.01
1015,3,2020-03-16 10:59:00,1,4382.0,3532.0,0.806,21.176,649,410,311,99,239,185,54,72,0.0,0.0
1015,4,2020-03-16 11:02:00,1,4384.0,3462.0,0.79,21.106,741,488,398,90,253,183,70,62,0.0,0.0
1015,5,2020-03-16 11:05:00,1,4358.0,3444.0,0.79,20.984,483,337,256,81,146,102,44,68,0.0,0.0
1015,6,2020-03-16 11:08:00,1,4406.0,3511.0,0.797,21.245,410,255,191,64,155,110,45,102,0.0,0.0
1015,7,2020-03-16 11:11:00,1,4327.0,3390.0,0.783,20.804,599,402,306,96,197,142,55,52,0.03,0.02
1015,8,2020-03-16 11:14:00,1,4297.0,3401.0,0.792,20.695,396,251,195,56,145,102,43,73,0.0,0.0
1015,9,2020-03-16 11:17:00,1,4233.0,3278.0,0.774,20.309,161,71,39,32,90,48,42,22,0.0,0.0
1015,10,2020-03-16 11:20:00,1,3996.0,3134.0,0.784,19.214,275,182,133,49,93,53,40,37,0.0,0.0
1015,11,2020-03-16 11:23:00,1,3961.0,3070.0,0.775,19.007,519,387,299,88,132,94,38,34,0.0,0.01
1015,12,2020-03-16 11:26:00,1,4055.0,3054.0,0.753,19.359,516,357,269,88,159,107,52,42,0.0,0.0
1015,13,2020-03-16 11:29:00,1,3796.0,2956.0,0.779,18.23,202,167,115,52,35,17,18,26,0.0,0.0
1015,14,2020-03-16 11:32:00,1,3807.5,2962.5,0.778,18.282,94,56,32,24,38,14,24,6,0.0,0.0
1015,15,2020-03-16 11:35:00,1,3819.0,2969.0,0.777,18.334,158,117,79,38,41,18,23,3,0.02,0.0
1015,16,2020-03-16 11:38:00,1,3669.0,2748.0,0.749,17.498,22,21,0,21,1,1,0,0,0.0,0.0
1015,17,2020-03-16 11:41:00,1,3465.0,2592.0,0.748,16.522,2,1,1,0,1,0,1,0,0.03,0.0
1015,18,2020-03-16 11:44:00,1,3365.0,2487.0,0.739,16.011,2,0,0,0,2,0,2,0,0.0,0.0
1015,19,2020-03-16 11:47:00,1,3174.0,2380.0,0.75,15.14,130,129,91,38,1,0,1,0,0.0,0.0
1015,20,2020-03-16 11:50:00,1,3179.0,2290.0,0.72,15.059,7,7,2,5,0,0,0,5,0.0,0.0
1015,21,2020-03-16 11:53:00,1,2922.0,2229.0,0.763,13.98,1,0,0,0,1,0,1,0,0.0,0.0
1015,22,2020-03-16 11:56:00,1,2932.0,2204.0,0.751,13.994,220,150,99,51,70,40,30,12,0.0,0.0
1015,23,2020-03-16 11:59:00,1,3168.0,2363.0,0.746,15.097,210,169,117,52,41,25,16,29,0.0,0.0
1015,24,2020-03-16 12:02:00,1,3342.0,2568.0,0.768,16.011,445,314,236,78,131,83,48,28,0.0,0.0
1015,25,2020-03-16 12:05:00,1,3424.0,2692.0,0.786,16.47,345,247,178,69,98,57,41,17,0.0,0.0
1015,26,2020-03-16 12:08:00,1,3359.0,2549.0,0.759,16.057,64,31,20,11,33,5,28,3,0.0,0.0
1015,27,2020-03-16 12:11:00,1,3453.0,2596.0,0.752,16.479,100,98,35,63,2,2,0,3,0.0,0.0
1015,28,2020-03-16 12:14:00,1,3514.0,2746.0,0.781,16.885,524,361,272,89,163,107,56,2,0.0,0.03
1015,29,2020-03-16 12:17:00,1,3678.0,2823.0,0.768,17.618,663,499,383,116,164,105,59,9,0.0,0.04
1015,30,2020-03-16 12:20:00,1,3689.0,2851.0,0.773,17.692,411,315,248,67,96,54,42,10,0.0,0.0
1015,31,2020-03-16 12:23:00,1,3310.0,2547.0,0.769,15.859,1,0,0,0,1,0,1,0,0.01,0.0
1015,32,2020-03-16 12:26:00,1,3050.0,2286.0,0.749,14.548,1,0,0,0,1,0,1,0,0.0,0.0
1015,33,2020-03-16 12:29:00,1,3067.0,2273.0,0.741,14.601,63,39,20,19,24,11,13,0,0.0,0.0
1015,34,2020-03-16 12:32:00,1,2952.0,2226.0,0.754,14.096,43,22,0,22,21,0,21,0,0.0,0.0
1015,35,2020-03-16 12:35:00,1,2927.0,2210.0,0.755,13.982,36,15,0,15,21,2,19,0,0.0,0.0
1015,36,2020-03-16 12:38:00,1,2962.0,2225.0,0.751,14.135,0,0,0,0,0,0,0,0,0.0,0.0
1015,37,2020-03-16 12:41:00,1,2937.0,2168.0,0.738,13.972,0,0,0,0,0,0,0,0,0.0,0.0
1015,38,2020-03-16 12:44:00,1,2458.0,1745.0,0.71,11.618,15,1,0,1,14,2,12,0,0.0,0.0
1015,39,2020-03-16 12:47:00,1,2209.0,1543.0,0.698,10.414,12,0,0,0,12,4,8,0,0.0,0.0
1015,40,2020-03-16 12:50:00,1,2263.0,1616.0,0.714,10.706,16,2,0,2,14,1,13,0,0.0,0.0
1015,41,2020-03-16 12:53:00,1,2565.0,1840.0,0.717,12.144,1,0,0,0,1,0,1,0,0.0,0.0
1015,42,2020-03-16 12:56:00,1,2786.0,2121.0,0.761,13.326,7,1,0,1,6,3,3,0,0.0,0.0
1015,43,2020-03-16 12:59:00,1,3184.0,2371.0,0.745,15.172,14,5,3,2,9,2,7,2,0.0,0.0
1015,44,2020-03-16 13:02:00,1,3151.0,2403.0,0.763,15.074,0,0,0,0,0,0,0,0,0.0,0.0
1015,45,2020-03-16 13:05:00,1,3155.0,2392.0,0.758,15.078,13,7,1,6,6,1,5,0,0.0,0.0
1015,46,2020-03-16 13:08:00,1,3244.0,2374.0,0.732,15.411,96,69,40,29,27,12,15,0,0.0,0.0
1015,47,2020-03-16 13:11:00,1,2547.0,1897.0,0.745,12.136,9,0,0,0,9,1,8,0,0.0,0.0
1015,48,2020-03-16 13:14:00,1,2615.0,1836.0,0.702,12.337,6,0,0,0,6,0,6,0,0.0,0.0
1015,49,2020-03-16 13:17:00,1,2579.0,1850.0,0.717,12.209,4,4,1,3,0,0,0,0,0.0,0.0
1015,50,2020-03-16 13:20:00,1,2795.0,2050.0,0.733,13.285,6,3,1,2,3,1,2,0,0.0,0.0
1015,51,2020-03-16 13:23:00,1,2619.0,1940.0,0.741,12.467,2,0,0,0,2,0,2,0,0.0,0.0
1015,52,2020-03-16 13:26:00,1,2581.0,1849.0,0.717,12.215,0,0,0,0,0,0,0,0,0.0,0.0
1015,53,2020-03-16 13:29:00,1,2405.0,1746.0,0.726,11.409,0,0,0,0,0,0,0,0,0.0,0.0
1015,54,2020-03-16 13:32:00,1,2352.0,1699.0,0.722,11.149,0,0,0,0,0,0,0,0,0.0,0.0
1015,55,2020-03-16 13:35:00,1,2283.0,1702.0,0.745,10.878,5,5,1,4,0,0,0,0,0.0,0.0
1015,56,2020-03-16 13:38:00,1,2169.0,1654.0,0.762,10.379,3,3,0,3,0,0,0,0,0.0,0.0
1015,57,2020-03-16 13:41:00,1,2403.0,1728.0,0.719,11.383,0,0,0,0,0,0,0,0,0.0,0.0
1015,58,2020-03-16 13:44:00,1,2570.0,1862.0,0.724,12.19,0,0,0,0,0,0,0,0,0.0,0.0
1015,59,2020-03-16 13:47:00,1,2653.0,1999.0,0.754,12.666,6,3,1,2,3,1,2,0,0.0,0.0
1015,60,2020-03-16 13:50:00,1,2739.0,2034.0,0.743,13.045,0,0,0,0,0,0,0,0,0.0,0.0
1015,61,2020-03-16 13:53:00,1,2532.0,1979.0,0.782,12.167,12,9,2,7,3,0,3,0,0.0,0.0
1015,62,2020-03-16 13:56:00,1,2406.0,1813.0,0.754,11.486,55,36,21,15,19,12,7,3,0.0,0.0
1015,63,2020-03-16 13:59:00,1,3313.0,2536.0,0.765,15.86,480,313,241,72,167,131,36,43,0.0,0.0
1015,64,2020-03-16 14:02:00,1,3493.0,2619.0,0.75,16.664,218,123,95,28,95,85,10,31,0.0,0.0
1015,65,2020-03-16 14:05:00,1,3487.0,2659.0,0.762,16.683,186,93,63,30,93,82,11,4,0.0,0.0
1015,66,2020-03-16 14:08:00,1,3414.0,2706.0,0.793,16.447,330,141,89,52,189,164,25,6,0.0,0.0
1015,67,2020-03-16 14:11:00,1,3846.0,2957.0,0.769,18.427,93,49,17,32,44,38,6,1,0.0,0.0
1015,68,2020-03-16 14:14:00,1,3782.0,2966.0,0.784,18.187,71,57,14,43,14,14,0,0,0.0,0.0
1015,69,2020-03-16 14:17:00,1,3147.0,2355.0,0.748,15.008,52,33,18,15,19,17,2,0,0.0,0.0
1015,70,2020-03-16 14:20:00,1,2797.0,2082.0,0.744,13.327,2,1,0,1,1,1,0,0,0.0,0.0
1015,71,2020-03-16 14:23:00,1,2782.0,2030.0,0.73,13.209,33,10,6,4,23,22,1,0,0.0,0.0
1015,72,2020-03-16 14:26:00,1,2645.0,1973.0,0.746,12.605,11,4,0,4,7,7,0,0,0.0,0.0
1015,73,2020-03-16 14:29:00,1,2681.0,2013.0,0.751,12.79,42,21,8,13,21,19,2,0,0.0,0.0
1015,74,2020-03-16 14:32:00,1,2613.5,1982.0,0.7585,12.4915,49,18,11,7,31,29,2,0,0.0,0.0
1015,75,2020-03-16 14:35:00,1,2546.0,1951.0,0.766,12.193,68,11,5,6,57,54,3,0,0.0,0.0
1015,76,2020-03-16 14:38:00,1,2556.0,1887.0,0.738,12.161,168,0,0,0,168,154,14,0,0.0,0.0
1015,77,2020-03-16 14:41:00,1,2468.0,1848.0,0.749,11.77,30,23,12,11,7,7,0,0,0.0,0.0
1015,78,2020-03-16 14:44:00,1,2548.0,1909.0,0.749,12.152,0,0,0,0,0,0,0,0,0.0,0.0
1015,79,2020-03-16 14:47:00,1,2485.0,1878.0,0.756,11.87,5,3,0,3,2,2,0,0,0.0,0.0
1015,80,2020-03-16 14:50:00,1,2404.0,1827.0,0.76,11.493,1,1,0,1,0,0,0,0,0.0,0.0
1015,81,2020-03-16 14:53:00,1,2573.0,1903.0,0.74,12.243,3,3,1,2,0,0,0,0,0.0,0.0
1015,82,2020-03-16 14:56:00,1,2569.0,2004.0,0.78,12.341,4,4,0,4,0,0,0,0,0.0,0.0
1015,83,2020-03-16 14:59:00,1,2583.0,1988.0,0.77,12.378,5,5,0,5,0,0,0,0,0.0,0.0
1015,84,2020-03-16 15:02:00,1,2576.0,1924.0,0.747,12.279,6,6,0,6,0,0,0,0,0.0,0.0
1015,85,2020-03-16 15:05:00,1,2600.0,1962.0,0.755,12.417,3,3,0,3,0,0,0,0,0.0,0.0
1015,86,2020-03-16 15:08:00,1,2546.0,1941.0,0.762,12.182,7,7,0,7,0,0,0,0,0.0,0.0
1015,87,2020-03-16 15:11:00,1,2600.0,1938.0,0.745,12.39,9,9,0,9,0,0,0,0,0.0,0.0
1015,88,2020-03-16 15:14:00,1,2560.0,1887.0,0.737,12.176,0,0,0,0,0,0,0,0,0.0,0.0
1015,89,2020-03-16 15:17:00,1,2543.0,1895.0,0.745,12.118,5,1,0,1,4,4,0,0,0.0,0.0
1015,90,2020-03-16 15:20:00,1,2527.0,1962.0,0.776,12.131,39,26,0,26,13,12,1,0,0.0,0.0
1015,91,2020-03-16 15:23:00,1,2568.0,1983.0,0.772,12.315,4,1,0,1,3,3,0,0,0.0,0.0
1015,92,2020-03-16 15:26:00,1,2535.0,1989.0,0.785,12.189,11,7,0,7,4,4,0,0,0.0,0.0
1015,93,2020-03-16 15:29:00,1,2529.0,2016.0,0.797,12.195,3,0,0,0,3,2,1,0,0.0,0.0
1015,94,2020-03-16 15:32:00,1,2560.0,2006.0,0.783,12.307,234,87,52,35,147,68,79,0,0.0,0.0
1015,95,2020-03-16 15:35:00,1,2560.0,1993.0,0.779,12.293,69,11,3,8,58,55,3,0,0.0,0.0
1015,96,2020-03-16 15:38:00,1,2535.0,1938.0,0.764,12.136,326,26,10,16,300,285,15,9,0.0,0.0
1015,97,2020-03-16 15:41:00,1,2699.0,1969.0,0.73,12.815,151,29,8,21,122,115,7,0,0.0,0.0
1015,98,2020-03-16 15:44:00,1,2816.0,2045.0,0.726,13.36,122,27,7,20,95,89,6,0,0.0,0.0
1015,99,2020-03-16 15:47:00,1,2822.0,2132.0,0.755,13.48,22,0,0,0,22,0,22,0,0.0,0.0
1015,100,2020-03-16 15:50:00,1,2820.0,2128.0,0.755,13.466,196,118,84,34,78,29,49,10,0.0,0.0
1015,101,2020-03-16 15:53:00,1,2792.0,2092.0,0.749,13.319,1,1,1,0,0,0,0,0,0.0,0.0
1015,102,2020-03-16 15:56:00,1,2546.0,1977.0,0.776,12.219,2,2,1,1,0,0,0,0,0.0,0.0
1015,103,2020-03-16 15:59:00,1,2529.0,1911.0,0.755,12.081,7,7,0,7,0,0,0,0,0.0,0.0
1015,104,2020-03-16 16:02:00,1,2583.0,1899.0,0.735,12.279,6,6,2,4,0,0,0,0,0.0,0.0
1015,105,2020-03-16 16:05:00,1,2430.0,1798.0,0.74,11.566,18,18,8,10,0,0,0,0,0.0,0.0
1015,106,2020-03-16 16:08:00,1,2458.0,1795.0,0.73,11.673,16,16,3,13,0,0,0,0,0.0,0.0
1015,107,2020-03-16 16:11:00,1,2473.0,1769.0,0.715,11.704,15,15,1,14,0,0,0,0,0.0,0.0
1015,108,2020-03-16 16:14:00,1,2329.0,1669.0,0.717,11.024,41,7,3,4,34,4,30,0,0.0,0.0
1015,109,2020-03-16 16:17:00,1,2409.0,1839.0,0.763,11.528,147,67,47,20,80,18,62,2,0.0,0.0
1015,110,2020-03-16 16:20:00,1,2462.0,1831.0,0.744,11.729,45,31,13,18,14,4,10,0,0.0,0.0
1015,111,2020-03-16 16:23:00,1,2401.0,1737.0,0.724,11.382,60,8,2,6,52,0,52,0,0.0,0.0
1015,112,2020-03-16 16:26:00,1,2185.0,1668.0,0.764,10.458,73,1,0,1,72,0,72,0,0.0,0.0
1015,113,2020-03-16 16:29:00,1,2221.0,1608.0,0.724,10.53,180,104,70,34,76,33,43,8,0.0,0.0
1015,114,2020-03-16 16:32:00,1,2386.0,1852.0,0.776,11.452,43,0,0,0,43,1,42,0,0.0,0.0
1015,115,2020-03-16 16:35:00,1,2399.0,1883.0,0.785,11.535,85,2,1,1,83,0,83,0,0.0,0.0
1015,116,2020-03-16 16:38:00,1,2479.0,1899.0,0.766,11.87,26,0,0,0,26,0,26,0,0.0,0.0
1015,117,2020-03-16 16:41:00,1,2383.0,1829.0,0.768,11.413,2,2,0,2,0,0,0,0,0.0,0.0
1015,118,2020-03-16 16:44:00,1,2414.0,1767.0,0.732,11.466,39,5,2,3,34,4,30,0,0.0,0.0
1015,119,2020-03-16 16:47:00,1,2411.0,1783.0,0.74,11.475,57,13,4,9,44,0,44,0,0.0,0.0
1015,120,2020-03-16 16:50:00,1,2396.0,1813.0,0.757,11.448,7,7,1,6,0,0,0,0,0.0,0.0
1015,121,2020-03-16 16:53:00,1,2403.0,1747.0,0.727,11.403,180,173,142,31,7,2,5,0,0.0,0.0
1015,122,2020-03-16 16:56:00,1,2415.0,1767.0,0.732,11.472,51,21,6,15,30,0,30,0,0.0,0.0
1015,123,2020-03-16 16:59:00,1,2643.0,2027.0,0.767,12.656,59,0,0,0,59,0,59,0,0.0,0.0
1015,124,2020-03-16 17:02:00,1,2562.0,1904.0,0.743,12.204,93,9,4,5,84,0,84,0,0.0,0.0
1015,125,2020-03-16 17:05:00,1,2485.0,1836.0,0.739,11.826,92,0,0,0,92,0,92,0,0.0,0.0
1015,126,2020-03-16 17:08:00,1,2420.0,1755.0,0.725,11.477,92,0,0,0,92,0,92,0,0.0,0.0
1015,127,2020-03-16 17:11:00,1,2259.0,1677.0,0.742,10.757,92,8,0,8,84,0,84,0,0.0,0.0
1015,128,2020-03-16 17:14:00,1,2190.0,1643.0,0.75,10.447,26,1,0,1,25,0,25,0,0.0,0.0
1015,129,2020-03-16 17:17:00,1,2166.0,1633.0,0.754,10.344,47,17,4,13,30,0,30,0,0.0,0.0
1015,130,2020-03-16 17:20:00,1,2215.0,1559.0,0.704,10.452,23,4,0,4,19,4,15,0,0.0,0.0
1015,131,2020-03-16 17:23:00,1,2938.0,2135.0,0.727,13.939,160,117,76,41,43,21,22,21,0.0,0.0
1015,132,2020-03-16 17:26:00,1,2742.0,2052.0,0.749,13.074,66,45,20,25,21,13,8,13,0.0,0.0
1015,133,2020-03-16 17:29:00,1,2558.0,1947.0,0.761,12.235,1,0,0,0,1,1,0,0,0.0,0.0
1015,134,2020-03-16 17:32:00,1,2522.5,1904.0,0.755,12.0465,14,14,11,3,0,0,0,0,0.0,0.0
1015,135,2020-03-16 17:35:00,1,2487.0,1861.0,0.749,11.858,11,11,8,3,0,0,0,0,0.0,0.0
1015,136,2020-03-16 17:38:00,1,2488.0,1818.0,0.731,11.818,1,1,0,1,0,0,0,0,0.0,0.0
1015,137,2020-03-16 17:41:00,1,2357.0,1700.0,0.721,11.167,3,0,0,0,3,0,3,0,0.0,0.0
1015,138,2020-03-16 17:44:00,1,2527.0,1781.0,0.705,11.928,2,2,1,1,0,0,0,0,0.0,0.0
1015,139,2020-03-16 17:47:00,1,2508.0,1833.0,0.731,11.911,10,9,0,9,1,0,1,0,0.0,0.0
1015,140,2020-03-16 17:50:00,1,2469.0,1775.0,0.719,11.694,13,12,2,10,1,0,1,0,0.0,0.0
1015,141,2020-03-16 17:53:00,1,2495.0,1832.0,0.734,11.861,6,6,0,6,0,0,0,0,0.0,0.0
1015,142,2020-03-16 17:56:00,1,2502.0,1794.0,0.717,11.846,14,13,1,12,1,1,0,0,0.0,0.0
1015,143,2020-03-16 17:59:00,1,2540.0,1793.0,0.706,11.994,22,22,7,15,0,0,0,0,0.0,0.0
1015,144,2020-03-16 18:02:00,0,2525.0,1804.0,0.715,11.945,33,29,8,21,4,2,2,0,0.0,0.0
1015,145,2020-03-16 18:05:00,0,2478.0,1763.0,0.711,11.718,194,144,107,37,50,31,19,7,0.0,0.0
1015,146,2020-03-16 18:08:00,0,3127.0,2291.0,0.733,14.856,151,109,65,44,42,27,15,11,0.0,0.0
1015,147,2020-03-16 18:11:00,0,2918.0,2078.0,0.712,13.797,28,28,4,24,0,0,0,0,0.0,0.0
1015,148,2020-03-16 18:14:00,0,3882.0,2877.0,0.741,18.48,39,38,8,30,1,1,0,0,0.0,0.0
1015,149,2020-03-16 18:17:00,0,4122.0,3176.0,0.771,19.76,306,228,155,73,78,45,33,37,0.0,0.0
1015,150,2020-03-16 18:20:00,0,4154.0,3230.0,0.778,19.944,424,307,240,67,117,64,53,92,0.0,0.0
1015,151,2020-03-16 18:23:00,0,3883.0,2944.0,0.758,18.559,467,350,288,62,117,84,33,119,0.0,0.0
1015,152,2020-03-16 18:26:00,0,3936.0,2990.0,0.76,18.817,315,237,179,58,78,42,36,132,0.0,0.0
1015,153,2020-03-16 18:29:00,0,3796.0,2913.0,0.767,18.184,357,259,208,51,98,63,35,30,0.0,0.0
1015,154,2020-03-16 18:32:00,0,3793.0,2870.0,0.757,18.124,340,251,193,58,89,46,43,96,0.0,0.0
1015,155,2020-03-16 18:35:00,0,3453.0,2547.0,0.738,16.425,188,149,104,45,39,28,11,9,0.0,0.0
1015,156,2020-03-16 18:38:00,0,3408.0,2518.0,0.739,16.218,37,36,15,21,1,0,1,5,0.0,0.0
1015,157,2020-03-16 18:41:00,0,3832.0,2862.0,0.747,18.266,76,62,25,37,14,8,6,1,0.0,0.0
1015,158,2020-03-16 18:44:00,0,3535.0,2665.0,0.754,16.877,26,26,7,19,0,0,0,0,0.0,0.0
1015,159,2020-03-16 18:47:00,0,3608.0,2684.0,0.744,17.188,115,78,56,22,37,22,15,9,0.0,0.0
1015,160,2020-03-16 18:50:00,0,2873.0,2177.0,0.758,13.73,1,1,1,0,0,0,0,0,0.0,0.0
1015,161,2020-03-16 18:53:00,0,2652.0,1906.0,0.719,12.56,2,1,1,0,1,0,1,0,0.0,0.0
1015,162,2020-03-16 18:56:00,0,2643.0,1988.0,0.752,12.613,2,1,1,0,1,0,1,0,0.0,0.0
1015,163,2020-03-16 18:59:00,0,2318.0,1721.0,0.742,11.04,24,24,15,9,0,0,0,0,0.0,0.0
1015,164,2020-03-16 19:02:00,0,2150.0,1488.0,0.692,10.121,57,57,29,28,0,0,0,0,0.0,0.0
1015,165,2020-03-16 19:05:00,0,2895.0,2027.0,0.7,13.649,82,82,33,49,0,0,0,6,0.0,0.0
1015,166,2020-03-16 19:08:00,0,3749.0,2846.0,0.759,17.923,290,213,153,60,77,45,32,47,0.0,0.0
1015,167,2020-03-16 19:11:00,0,3796.0,2817.0,0.742,18.077,371,283,222,61,88,58,30,89,0.0,0.0
1015,168,2020-03-16 19:14:00,0,3772.0,2858.0,0.758,18.027,207,140,102,38,67,47,20,31,0.0,0.0
1015,169,2020-03-16 19:17:00,0,3108.0,2268.0,0.73,14.757,5,5,2,3,0,0,0,0,0.0,0.0
1015,170,2020-03-16 19:20:00,0,3009.0,2146.0,0.713,14.234,132,86,74,12,46,34,12,7,0.0,0.0
1015,171,2020-03-16 19:23:00,0,3285.0,2428.0,0.739,15.632,13,5,1,4,8,3,5,0,0.0,0.0
1015,172,2020-03-16 19:26:00,0,3228.0,2328.0,0.721,15.297,27,16,1,15,11,1,10,0,0.0,0.0
1015,173,2020-03-16 19:29:00,0,3264.0,2332.0,0.714,15.442,53,39,15,24,14,9,5,0,0.0,0.0
1015,174,2020-03-16 19:32:00,0,3122.0,2259.0,0.723,14.803,11,10,3,7,1,1,0,0,0.0,0.0
1015,175,2020-03-16 19:35:00,0,3223.0,2325.0,0.721,15.274,63,62,26,36,1,0,1,3,0.0,0.0
1015,176,2020-03-16 19:38:00,0,3279.0,2438.0,0.743,15.62,216,143,91,52,73,46,27,37,0.0,0.0
1015,177,2020-03-16 19:41:00,0,3221.0,2386.0,0.741,15.332,506,365,294,71,141,101,40,111,0.0,0.0
1015,178,2020-03-16 19:44:00,0,3528.0,2719.0,0.771,16.913,519,368,272,96,151,86,65,38,0.0,0.0
1015,179,2020-03-16 19:47:00,0,3414.0,2568.0,0.752,16.296,520,299,242,57,221,146,75,71,0.0,0.0
1015,180,2020-03-16 19:50:00,0,3535.0,2636.0,0.746,16.845,462,288,223,65,174,128,46,64,0.0,0.0
1015,181,2020-03-16 19:53:00,0,3527.0,2639.0,0.748,16.819,488,301,241,60,187,125,62,90,0.0,0.0
1015,182,2020-03-16 19:56:00,0,3512.0,2659.0,0.757,16.781,449,279,213,66,170,125,45,86,0.0,0.0
1015,183,2020-03-16 19:59:00,0,3533.0,2624.0,0.743,16.825,469,312,243,69,157,101,56,106,0.0,0.0
1015,184,2020-03-16 20:02:00,0,3386.0,2514.0,0.743,16.126,391,274,196,78,117,58,59,74,0.0,0.0
1015,185,2020-03-16 20:05:00,0,3267.0,2429.0,0.744,15.563,526,363,293,70,163,114,49,51,0.0,0.0
1015,186,2020-03-16 20:08:00,0,3351.0,2437.0,0.727,15.901,395,266,219,47,129,85,44,85,0.0,0.0
1015,187,2020-03-16 20:11:00,0,3041.0,2254.0,0.741,14.479,123,90,52,38,33,9,24,5,0.0,0.0
1015,188,2020-03-16 20:14:00,0,3391.0,2451.0,0.723,16.073,59,59,6,53,0,0,0,0,0.0,0.0
1015,189,2020-03-16 20:17:00,0,3373.0,2491.0,0.738,16.049,58,56,25,31,2,1,1,3,0.0,0.0
1015,190,2020-03-16 20:20:00,0,3239.0,2388.0,0.737,15.405,182,138,98,40,44,31,13,0,0.0,0.0
1015,191,2020-03-16 20:23:00,0,3005.0,2252.0,0.75,14.332,2,2,0,2,0,0,0,0,0.0,0.0
1015,192,2020-03-16 20:26:00,0,2853.0,2089.0,0.732,13.555,12,12,2,10,0,0,0,0,0.0,0.0
1015,193,2020-03-16 20:29:00,0,2878.0,2068.0,0.718,13.63,15,15,3,12,0,0,0,0,0.0,0.0
1015,194,2020-03-16 20:32:00,0,2935.0,2079.5,0.7085,13.8665,2,2,0,2,0,0,0,0,0.0,0.0
1015,195,2020-03-16 20:35:00,0,2992.0,2091.0,0.699,14.103,19,16,0,16,3,1,2,0,0.0,0.0
1015,196,2020-03-16 20:38:00,0,2986.0,2086.0,0.699,14.076,9,9,0,9,0,0,0,0,0.0,0.0
1015,197,2020-03-16 20:41:00,0,2959.0,2021.0,0.683,13.898,15,15,0,15,0,0,0,0,0.0,0.0
1015,198,2020-03-16 20:44:00,0,2976.0,2096.0,0.704,14.046,18,18,0,18,0,0,0,3,0.0,0.0
1015,199,2020-03-16 20:47:00,0,2878.0,1997.0,0.694,13.551,173,131,84,47,42,23,19,26,0.0,0.0
1015,200,2020-03-16 20:50:00,0,3113.0,2190.0,0.703,14.691,213,143,88,55,70,20,50,98,0.0,0.0
1015,201,2020-03-16 20:53:00,0,3117.0,2234.0,0.717,14.755,372,223,178,45,149,104,45,149,0.0,0.0
1015,202,2020-03-16 20:56:00,0,3353.0,2410.0,0.719,15.881,488,336,263,73,152,107,45,68,0.0,0.0
1015,203,2020-03-16 20:59:00,0,3332.0,2361.0,0.709,15.741,246,159,114,45,87,47,40,35,0.0,0.0
1015,204,2020-03-16 21:02:00,0,3258.0,2357.0,0.723,15.446,118,84,49,35,34,13,21,38,0.0,0.0
1015,205,2020-03-16 21:05:00,0,3280.0,2360.0,0.72,15.537,83,59,24,35,24,3,21,1,0.0,0.0
1015,206,2020-03-16 21:08:00,0,3335.0,2488.0,0.746,15.897,142,101,52,49,41,15,26,30,0.0,0.0
1015,207,2020-03-16 21:11:00,0,3366.0,2406.0,0.715,15.928,326,204,138,66,122,76,46,27,0.0,0.0
1015,208,2020-03-16 21:14:00,0,3349.0,2438.0,0.728,15.893,588,400,328,72,188,135,53,12,0.0,0.0
1015,209,2020-03-16 21:17:00,0,3513.0,2534.0,0.722,16.646,409,269,200,69,140,95,45,115,0.0,0.0
1015,210,2020-03-16 21:20:00,0,3353.0,2430.0,0.725,15.902,357,246,180,66,111,67,44,66,0.0,0.0
1015,211,2020-03-16 21:23:00,0,3084.0,2261.0,0.733,14.653,389,290,218,72,99,54,45,42,0.0,0.0
1015,212,2020-03-16 21:26:00,0,3145.0,2323.0,0.739,14.963,458,299,236,63,159,105,54,75,0.0,0.0
1015,213,2020-03-16 21:29:00,0,3194.0,2317.0,0.725,15.152,486,319,253,66,167,114,53,99,0.0,0.0
1015,214,2020-03-16 21:32:00,0,3371.0,2375.0,0.704,15.913,501,362,293,69,139,82,57,39,0.0,0.0
1015,215,2020-03-16 21:35:00,0,3131.0,2255.0,0.72,14.832,209,130,93,37,79,25,54,8,0.0,0.0
1015,216,2020-03-16 21:38:00,0,3121.0,2290.0,0.734,14.831,268,183,134,49,85,51,34,33,0.0,0.0
1015,217,2020-03-16 21:41:00,0,2991.0,2146.0,0.717,14.162,118,104,58,46,14,5,9,3,0.0,0.0
1015,218,2020-03-16 21:44:00,0,3338.0,2378.0,0.712,15.787,94,94,49,45,0,0,0,0,0.0,0.0
1015,219,2020-03-16 21:47:00,0,3380.0,2393.0,0.708,15.968,74,73,36,37,1,1,0,0,0.0,0.0
1015,220,2020-03-16 21:50:00,0,3139.0,2224.0,0.709,14.832,16,16,0,16,0,0,0,0,0.0,0.0
1015,221,2020-03-16 21:53:00,0,2928.0,2131.0,0.728,13.896,20,20,2,18,0,0,0,0,0.0,0.0
1015,222,2020-03-16 21:56:00,0,2931.0,2114.0,0.721,13.89,213,143,79,64,70,11,59,81,0.0,0.0
1015,223,2020-03-16 21:59:00,0,3107.0,2303.0,0.741,14.792,355,240,170,70,115,74,41,58,0.0,0.03
1015,224,2020-03-16 22:02:00,0,3096.0,2313.0,0.747,14.758,407,295,232,63,112,49,63,129,0.0,0.01
1015,225,2020-03-16 22:05:00,0,3110.0,2262.0,0.727,14.757,552,335,270,65,217,150,67,97,0.0,0.06
1015,226,2020-03-16 22:08:00,0,3474.0,2768.0,0.797,16.753,528,347,287,60,181,126,55,130,0.0,0.0
1015,227,2020-03-16 22:11:00,0,3361.0,2611.0,0.777,16.132,496,297,239,58,199,133,66,113,0.0,0.0
1015,228,2020-03-16 22:14:00,0,3051.0,2413.0,0.791,14.691,375,230,184,46,145,88,57,98,0.0,0.0
1015,229,2020-03-16 22:17:00,0,3610.0,2874.0,0.796,17.405,482,288,218,70,194,140,54,62,0.0,0.0
1015,230,2020-03-16 22:20:00,0,2479.0,1877.0,0.757,11.844,395,215,148,67,180,125,55,42,0.0,0.0
1015,231,2020-03-16 22:23:00,0,3448.0,2748.0,0.797,16.627,555,290,228,62,265,178,87,38,0.0,0.03
1015,232,2020-03-16 22:26:00,0,2316.0,1748.0,0.755,11.06,25,19,13,6,6,3,3,0,0.0,0.0
1015,233,2020-03-16 22:29:00,0,1959.0,1455.0,0.743,9.33,4,1,1,0,3,0,3,0,0.0,0.0
1015,234,2020-03-16 22:32:00,0,1814.0,1317.0,0.726,8.608,12,8,2,6,4,0,4,0,0.0,0.0
1015,235,2020-03-16 22:35:00,0,2009.0,1425.0,0.709,9.495,20,17,1,16,3,0,3,0,0.0,0.0
1015,236,2020-03-16 22:38:00,0,3313.0,2589.0,0.781,15.921,10,10,0,10,0,0,0,0,0.0,0.0
1015,237,2020-03-16 22:41:00,0,3426.0,2701.0,0.788,16.489,133,86,57,29,47,19,28,34,0.0,0.0
1015,238,2020-03-16 22:44:00,0,3573.0,2758.0,0.772,17.131,299,197,129,68,102,34,68,92,0.0,0.01
1015,239,2020-03-16 22:47:00,0,3465.0,2726.0,0.787,16.669,310,160,121,39,150,100,50,95,0.0,0.0
1015,240,2020-03-16 22:50:00,0,3285.0,2546.0,0.775,15.761,533,305,244,61,228,167,61,107,0.0,0.0
1015,241,2020-03-16 22:53:00,0,3391.0,2670.0,0.787,16.318,482,326,261,65,156,89,67,100,0.0,0.0
1015,242,2020-03-16 22:56:00,0,3403.0,2695.0,0.792,16.393,568,357,293,64,211,156,55,124,0.0,0.03
1015,243,2020-03-16 22:59:00,0,3949.0,3168.0,0.802,19.066,638,370,300,70,268,198,70,150,0.0,0.0
1015,244,2020-03-16 23:02:00,0,3869.0,3104.0,0.802,18.679,222,141,97,44,81,57,24,15,0.0,0.12
1015,245,2020-03-16 23:05:00,0,2715.0,2109.0,0.777,13.034,374,222,164,58,152,108,44,24,0.0,0.0
1015,246,2020-03-16 23:08:00,0,3419.0,2724.0,0.797,16.489,492,291,231,60,201,138,63,64,0.0,0.0
1015,247,2020-03-16 23:11:00,0,3077.0,2358.0,0.766,14.735,592,321,246,75,271,199,72,92,0.0,0.0
1015,248,2020-03-16 23:14:00,0,3612.0,2812.0,0.779,17.345,583,378,309,69,205,140,65,39,0.0,0.0
1015,249,2020-03-16 23:17:00,0,3348.0,2520.0,0.753,15.983,1009,595,473,122,414,313,101,41,0.0,0.0
1015,250,2020-03-16 23:20:00,0,4269.0,3175.0,0.744,20.335,560,292,234,58,268,187,81,53,0.0,0.0
1015,251,2020-03-16 23:23:00,0,3290.0,2496.0,0.759,15.725,655,402,331,71,253,184,69,176,0.0,0.0
1015,252,2020-03-16 23:26:00,0,3399.0,2532.0,0.745,16.196,654,444,364,80,210,149,61,182,0.0,0.0
1015,253,2020-03-16 23:29:00,0,3302.0,2398.0,0.726,15.665,264,151,120,31,113,68,45,7,0.0,0.0
1015,254,2020-03-16 23:32:00,0,3548.5,2604.0,0.733,16.8655,67,36,16,20,31,8,23,5,0.0,0.0
1015,255,2020-03-16 23:35:00,0,3795.0,2810.0,0.74,18.066,62,36,13,23,26,7,19,6,0.0,0.0
1015,256,2020-03-16 23:38:00,0,3705.0,2767.0,0.747,17.662,191,99,58,41,92,26,66,125,0.0,0.0
1015,257,2020-03-16 23:41:00,0,3838.0,2835.0,0.739,18.26,525,266,217,49,259,186,73,90,0.0,0.0
1015,258,2020-03-16 23:44:00,0,3321.0,2424.0,0.73,15.769,577,322,267,55,255,182,73,97,0.0,0.0
1015,259,2020-03-16 23:47:00,0,3284.0,2381.0,0.725,15.578,740,447,389,58,293,220,73,321,0.0,0.0
1015,260,2020-03-16 23:50:00,0,3846.0,2891.0,0.752,18.354,782,441,378,63,341,271,70,307,0.0,0.0
1015,261,2020-03-16 23:53:00,0,3856.0,2898.0,0.751,18.403,509,296,238,58,213,169,44,168,0.0,0.0
1015,262,2020-03-16 23:56:00,0,3845.0,2894.0,0.753,18.354,589,319,247,72,270,191,79,71,0.0,0.0
1015,263,2020-03-16 23:59:00,0,3354.0,2464.0,0.735,15.942,568,439,341,98,129,79,50,47,0.0,0.0
1015,264,2020-03-17 00:02:00,0,3341.0,2476.0,0.741,15.904,147,112,68,44,35,20,15,20,0.0,0.0
1015,265,2020-03-17 00:05:00,0,3590.0,2660.0,0.741,17.089,39,39,15,24,0,0,0,13,0.0,0.0
1015,266,2020-03-17 00:08:00,0,3562.0,2696.0,0.757,17.021,33,33,1,32,0,0,0,13,0.0,0.0
1015,267,2020-03-17 00:11:00,0,3567.0,2651.0,0.743,16.99,211,142,103,39,69,34,35,68,0.0,0.0
1015,268,2020-03-17 00:14:00,0,3333.0,2454.0,0.736,15.848,367,235,183,52,132,84,48,190,0.0,0.0
1015,269,2020-03-17 00:17:00,0,3005.0,2239.0,0.745,14.319,392,279,224,55,113,72,41,99,0.0,0.0
1015,270,2020-03-17 00:20:00,0,2899.0,2165.0,0.747,13.818,358,237,183,54,121,80,41,33,0.0,0.0
1015,271,2020-03-17 00:23:00,0,3314.0,2407.0,0.726,15.724,495,323,245,78,172,120,52,5,0.0,0.0
1015,272,2020-03-17 00:26:00,0,3104.0,2342.0,0.754,14.822,329,255,190,65,74,34,40,2,0.0,0.0
1015,273,2020-03-17 00:29:00,0,3327.0,2409.0,0.724,15.778,218,160,119,41,58,40,18,22,0.0,0.0
1015,274,2020-03-17 00:32:00,0,3267.0,2459.0,0.753,15.593,505,321,247,74,184,115,69,160,0.0,0.0
1015,275,2020-03-17 00:35:00,0,3462.0,2614.0,0.755,16.534,522,365,287,78,157,96,61,159,0.0,0.0
1015,276,2020-03-17 00:38:00,0,3095.0,2332.0,0.754,14.778,476,306,238,68,170,121,49,64,0.0,0.0
1015,277,2020-03-17 00:41:00,0,3301.0,2477.0,0.751,15.748,85,61,25,36,24,8,16,9,0.0,0.0
1015,278,2020-03-17 00:44:00,0,3411.0,2593.0,0.76,16.31,231,150,105,45,81,46,35,21,0.0,0.0
1015,279,2020-03-17 00:47:00,0,3281.0,2510.0,0.765,15.708,411,276,220,56,135,95,40,56,0.0,0.05
1015,280,2020-03-17 00:50:00,0,3179.0,2406.0,0.757,15.189,376,266,221,45,110,65,45,7,0.0,0.0
1015,281,2020-03-17 00:53:00,0,2893.0,2252.0,0.778,13.892,275,205,147,58,70,54,16,16,0.0,0.0
1015,282,2020-03-17 00:56:00,0,2651.0,1983.0,0.748,12.64,84,83,4,79,1,0,1,0,0.0,0.0
1015,283,2020-03-17 00:59:00,0,2724.0,1991.0,0.731,12.938,69,69,4,65,0,0,0,0,0.0,0.0
1015,284,2020-03-17 01:02:00,0,2798.0,2084.0,0.745,13.332,249,189,112,77,60,15,45,90,0.0,0.0
1015,285,2020-03-17 01:05:00,0,3366.0,2427.0,0.721,15.951,235,154,87,67,81,10,71,120,0.0,0.0
1015,286,2020-03-17 01:08:00,0,2952.0,2222.0,0.753,14.091,428,275,199,76,153,106,47,123,0.0,0.04
1015,287,2020-03-17 01:11:00,0,3090.0,2336.0,0.756,14.761,512,311,253,58,201,139,62,100,0.0,0.01
1015,288,2020-03-17 01:14:00,0,2856.0,2185.0,0.765,13.673,402,273,220,53,129,90,39,107,0.0,0.01
1015,289,2020-03-17 01:17:00,0,2815.0,2149.0,0.763,13.47,220,136,103,33,84,55,29,174,0.0,0.0
1015,290,2020-03-17 01:20:00,0,3512.0,2755.0,0.785,16.886,648,422,357,65,226,173,53,282,0.0,0.0
1015,291,2020-03-17 01:23:00,0,3336.0,2585.0,0.775,16.006,909,592,480,112,317,238,79,92,0.0,0.04
1015,292,2020-03-17 01:26:00,0,2960.0,2282.0,0.771,14.189,766,506,398,108,260,175,85,39,0.0,0.0
1015,293,2020-03-17 01:29:00,0,2688.0,2114.0,0.786,12.931,439,264,208,56,175,126,49,19,0.0,0.0
1015,294,2020-03-17 01:32:00,0,3000.0,2307.0,0.769,14.376,28,26,7,19,2,1,1,2,0.0,0.0
1015,295,2020-03-17 01:35:00,0,3450.0,2680.0,0.777,16.56,41,39,14,25,2,0,2,1,0.0,0.0
1015,296,2020-03-17 01:38:00,0,3482.0,2667.0,0.766,16.674,65,65,36,29,0,0,0,1,0.0,0.0
1015,297,2020-03-17 01:41:00,0,3300.0,2543.0,0.771,15.817,11,11,3,8,0,0,0,0,0.0,0.0
1015,298,2020-03-17 01:44:00,0,3317.0,2460.0,0.742,15.795,7,7,2,5,0,0,0,0,0.0,0.0
1015,299,2020-03-17 01:47:00,0,3105.0,2350.0,0.757,14.835,3,2,0,2,1,0,1,0,0.0,0.0
1015,300,2020-03-17 01:50:00,0,3002.0,2248.0,0.749,14.316,9,8,4,4,1,0,1,0,0.0,0.0
1015,301,2020-03-17 01:53:00,0,2716.0,2046.0,0.753,12.968,173,111,82,29,62,30,32,69,0.0,0.0
1015,302,2020-03-17 01:56:00,0,3324.0,2519.0,0.758,15.887,272,162,131,31,110,57,53,93,0.0,0.05
1015,303,2020-03-17 01:59:00,0,3290.0,2490.0,0.757,15.719,353,196,154,42,157,104,53,162,0.0,0.0
1015,304,2020-03-17 02:02:00,0,3031.0,2337.0,0.771,14.531,388,308,242,66,80,63,17,57,0.2,0.0
1015,305,2020-03-17 02:05:00,0,3315.0,2463.0,0.743,15.787,180,146,101,45,34,18,16,5,0.09,0.0
1015,306,2020-03-17 02:08:00,0,3413.0,2592.0,0.759,16.319,235,167,118,49,68,43,25,0,0.1,0.0
1015,307,2020-03-17 02:11:00,0,3289.0,2548.0,0.775,15.78,520,301,245,56,219,157,62,20,0.0,0.0
1015,308,2020-03-17 02:14:00,0,3463.0,2647.0,0.764,16.575,506,297,230,67,209,152,57,38,0.0,0.0
1015,309,2020-03-17 02:17:00,0,3607.0,2753.0,0.763,17.258,381,190,148,42,191,123,68,85,0.0,0.0
1015,310,2020-03-17 02:20:00,0,3298.0,2448.0,0.742,15.706,444,259,218,41,185,125,60,172,0.0,0.0
1015,311,2020-03-17 02:23:00,0,2939.0,2210.0,0.752,14.027,253,138,100,38,115,65,50,11,0.0,0.0
1015,312,2020-03-17 02:26:00,0,2908.0,2201.0,0.757,13.896,294,171,131,40,123,83,40,15,0.0,0.0
1015,313,2020-03-17 02:29:00,0,2746.0,1960.0,0.714,12.991,134,76,51,25,58,39,19,3,0.0,0.0
1015,314,2020-03-17 02:32:00,0,3085.5,2268.5,0.733,14.6685,46,34,5,29,12,0,12,1,0.0,0.0
1015,315,2020-03-17 02:35:00,0,3425.0,2577.0,0.752,16.346,65,27,7,20,38,0,38,0,0.0,0.0
1015,316,2020-03-17 02:38:00,0,3294.0,2448.0,0.743,15.69,5,3,0,3,2,0,2,0,0.0,0.0
1015,317,2020-03-17 02:41:00,0,3075.0,2254.0,0.733,14.61,11,4,2,2,7,4,3,0,0.0,0.0
1015,318,2020-03-17 02:44:00,0,2861.0,2107.0,0.736,13.606,0,0,0,0,0,0,0,0,0.0,0.0
1015,319,2020-03-17 02:47:00,0,2505.0,1759.0,0.702,11.818,211,148,106,42,63,31,32,41,0.0,0.0
1015,320,2020-03-17 02:50:00,0,3147.0,2291.0,0.728,14.936,215,163,96,67,52,5,47,102,0.0,0.0
1015,321,2020-03-17 02:53:00,0,2960.0,2188.0,0.739,14.085,242,161,112,49,81,42,39,35,0.0,0.03
1015,322,2020-03-17 02:56:00,0,1974.0,1401.0,0.71,9.33,16,15,5,10,1,0,1,0,0.0,0.0
1015,323,2020-03-17 02:59:00,0,1991.0,1325.0,0.666,9.312,60,36,16,20,24,2,22,0,0.0,0.0
1015,324,2020-03-17 03:02:00,0,2817.0,2069.0,0.734,13.391,8,3,0,3,5,0,5,0,0.0,0.0
1015,325,2020-03-17 03:05:00,0,3082.0,2266.0,0.735,14.651,2,0,0,0,2,0,2,0,0.0,0.0
1015,326,2020-03-17 03:08:00,0,3321.0,2496.0,0.752,15.847,1,0,0,0,1,0,1,0,0.0,0.0
1015,327,2020-03-17 03:11:00,0,3255.0,2451.0,0.753,15.537,2,0,0,0,2,1,1,0,0.0,0.0
1015,328,2020-03-17 03:14:00,0,3257.0,2453.0,0.753,15.55,13,5,1,4,8,1,7,0,0.0,0.0
1015,329,2020-03-17 03:17:00,0,3094.0,2323.0,0.751,14.762,0,0,0,0,0,0,0,0,0.0,0.0
1015,330,2020-03-17 03:20:00,0,2952.0,2164.0,0.733,14.026,6,4,0,4,2,1,1,0,0.0,0.01
1015,331,2020-03-17 03:23:00,0,2699.0,2100.0,0.778,12.958,1,0,0,0,1,0,1,0,0.0,0.0
1015,332,2020-03-17 03:26:00,0,2699.0,2004.0,0.743,12.853,5,3,0,3,2,0,2,0,0.0,0.0
1015,333,2020-03-17 03:29:00,0,2567.0,1961.0,0.764,12.286,2,1,1,0,1,0,1,0,0.0,0.0
1015,334,2020-03-17 03:32:00,0,2528.0,1862.0,0.737,12.023,0,0,0,0,0,0,0,0,0.0,0.0
1015,335,2020-03-17 03:35:00,0,2595.0,1850.0,0.713,12.273,0,0,0,0,0,0,0,0,0.0,0.0
1015,336,2020-03-17 03:38:00,0,2518.0,1831.0,0.727,11.948,137,88,73,15,49,28,21,25,0.0,0.0
1015,337,2020-03-17 03:41:00,0,2543.0,1922.0,0.756,12.148,352,181,137,44,171,120,51,78,0.0,0.03
1015,338,2020-03-17 03:44:00,0,2314.0,1780.0,0.769,11.086,323,182,142,40,141,82,59,82,0.0,0.0
1015,339,2020-03-17 03:47:00,0,2771.0,2081.0,0.751,13.224,176,114,75,39,62,10,52,75,0.0,0.0
1015,340,2020-03-17 03:50:00,0,2318.0,1767.0,0.762,11.091,23,21,0,21,2,0,2,15,0.0,0.0
1015,341,2020-03-17 03:53:00,0,2124.0,1483.0,0.698,10.011,70,52,37,15,18,9,9,0,0.0,0.0
1015,342,2020-03-17 03:56:00,0,2518.0,1799.0,0.715,11.914,5,4,1,3,1,0,1,0,0.0,0.0
1015,343,2020-03-17 03:59:00,0,2697.0,2046.0,0.759,12.891,10,9,0,9,1,1,0,0,0.0,0.0
1015,344,2020-03-17 04:02:00,0,2923.0,2157.0,0.738,13.905,3,3,0,3,0,0,0,0,0.0,0.0
1015,345,2020-03-17 04:05:00,0,2715.0,2064.0,0.76,12.982,16,16,2,14,0,0,0,0,0.0,0.0
1015,346,2020-03-17 04:08:00,0,2892.0,2109.0,0.729,13.728,9,9,5,4,0,0,0,0,0.0,0.0
1015,347,2020-03-17 04:11:00,0,2954.0,2177.0,0.737,14.049,4,4,3,1,0,0,0,0,0.0,0.0
1015,348,2020-03-17 04:14:00,0,2894.0,2099.0,0.725,13.726,0,0,0,0,0,0,0,0,0.0,0.0
1015,349,2020-03-17 04:17:00,0,2712.0,1977.0,0.729,12.876,80,51,38,13,29,11,18,20,0.0,0.0
1015,350,2020-03-17 04:20:00,0,2515.0,1795.0,0.714,11.898,129,80,58,22,49,19,30,11,0.0,0.0
1015,351,2020-03-17 04:23:00,0,2764.0,2079.0,0.752,13.194,26,9,3,6,17,2,15,0,0.0,0.0
1015,352,2020-03-17 04:26:00,0,2728.0,1941.0,0.712,12.897,11,1,0,1,10,2,8,0,0.0,0.0
1015,353,2020-03-17 04:29:00,0,2546.0,1859.0,0.73,12.088,26,5,1,4,21,2,19,0,0.0,0.0
1015,354,2020-03-17 04:32:00,0,2581.0,1835.0,0.711,12.201,10,9,4,5,1,0,1,0,0.0,0.0
1015,355,2020-03-17 04:35:00,0,2221.0,1527.0,0.688,10.442,8,5,0,5,3,0,3,0,0.0,0.0
1015,356,2020-03-17 04:38:00,0,1975.0,1451.0,0.735,9.389,8,7,1,6,1,1,0,0,0.0,0.0
1015,357,2020-03-17 04:41:00,0,2369.0,1642.0,0.693,11.152,7,6,2,4,1,0,1,0,0.0,0.0
1015,358,2020-03-17 04:44:00,0,2966.0,2044.0,0.689,13.949,166,113,74,39,53,21,32,7,0.0,0.0
1015,359,2020-03-17 04:47:00,0,2919.0,2081.0,0.713,13.803,3,3,1,2,0,0,0,0,0.0,0.0
1015,360,2020-03-17 04:50:00,0,2763.0,2009.0,0.727,13.11,2,2,1,1,0,0,0,0,0.0,0.0
1015,361,2020-03-17 04:53:00,0,2712.0,1995.0,0.736,12.893,1,1,0,1,0,0,0,0,0.0,0.0
1015,362,2020-03-17 04:56:00,0,2934.0,2091.0,0.713,13.877,40,40,15,25,0,0,0,1,0.0,0.0
1015,363,2020-03-17 04:59:00,0,3019.0,2203.0,0.73,14.334,96,88,35,53,8,1,7,5,0.0,0.0
1015,364,2020-03-17 05:02:00,0,3117.0,2235.0,0.717,14.755,119,119,73,46,0,0,0,2,0.0,0.0
1015,365,2020-03-17 05:05:00,0,3081.0,2267.0,0.736,14.65,72,56,17,39,16,6,10,5,0.0,0.0
1015,366,2020-03-17 05:08:00,0,3074.0,2286.0,0.744,14.643,336,209,155,54,127,80,47,92,0.0,0.0
1015,367,2020-03-17 05:11:00,0,2938.0,2210.0,0.752,14.024,562,341,275,66,221,161,60,163,0.0,0.02
1015,368,2020-03-17 05:14:00,0,2931.0,2161.0,0.737,13.941,385,244,194,50,141,98,43,78,0.09,0.0
1015,369,2020-03-17 05:17:00,0,2805.0,2080.0,0.742,13.354,316,182,145,37,134,95,39,41,0.02,0.0
1015,370,2020-03-17 05:20:00,0,2579.0,1819.0,0.705,12.175,486,261,201,60,225,162,63,16,0.0,0.0
1015,371,2020-03-17 05:23:00,0,3126.0,2336.0,0.747,14.904,389,230,172,58,159,111,48,53,0.08,0.04
1015,372,2020-03-17 05:26:00,0,3201.0,2304.0,0.72,15.162,494,182,146,36,312,245,67,16,0.0,0.0
1015,373,2020-03-17 05:29:00,0,3048.0,2212.0,0.726,14.458,430,113,79,34,317,235,82,7,0.0,0.0
1015,374,2020-03-17 05:32:00,0,3216.5,2292.0,0.7135,15.211,414,135,105,30,279,209,70,86,0.0,0.0
1015,375,2020-03-17 05:35:00,0,3385.0,2372.0,0.701,15.964,356,132,83,49,224,139,85,114,0.0,0.0
1015,376,2020-03-17 05:38:00,0,3455.0,2476.0,0.717,16.357,299,108,69,39,191,118,73,93,0.0,0.02
1015,377,2020-03-17 05:41:00,0,2442.0,1736.0,0.711,11.543,49,9,0,9,40,5,35,0,0.0,0.0
1015,378,2020-03-17 05:44:00,0,1719.0,1089.0,0.634,7.98,195,34,11,23,161,95,66,2,0.0,0.01
1015,379,2020-03-17 05:47:00,0,2405.0,1592.0,0.662,11.238,473,147,114,33,326,235,91,17,0.0,0.03
1015,380,2020-03-17 05:50:00,0,3019.0,2202.0,0.729,14.333,766,287,230,57,479,365,114,29,0.0,0.0
1015,381,2020-03-17 05:53:00,0,3549.0,2652.0,0.747,16.92,687,265,210,55,422,319,103,168,0.0,0.0
1015,382,2020-03-17 05:56:00,0,3493.0,2647.0,0.758,16.694,785,298,222,76,487,384,103,77,0.0,0.0
1015,383,2020-03-17 05:59:00,0,3020.0,2199.0,0.728,14.333,637,204,153,51,433,324,109,6,0.14,0.01
1015,384,2020-03-17 06:02:00,1,3888.0,2959.0,0.761,18.595,932,420,358,62,512,413,99,143,0.0,0.0
1015,385,2020-03-17 06:05:00,1,3429.0,2566.0,0.748,16.352,660,291,255,36,369,302,67,257,0.0,0.03
1015,386,2020-03-17 06:08:00,1,3680.0,2859.0,0.777,17.664,706,253,204,49,453,369,84,63,0.0,0.01
1015,387,2020-03-17 06:11:00,1,3657.0,2773.0,0.758,17.48,471,193,152,41,278,201,77,52,0.0,0.0
1015,388,2020-03-17 06:14:00,1,3234.0,2417.0,0.748,15.417,825,268,199,69,557,462,95,36,0.0,0.0
1015,389,2020-03-17 06:17:00,1,3405.0,2562.0,0.753,16.251,781,248,193,55,533,430,103,6,0.0,0.0
1015,390,2020-03-17 06:20:00,1,2732.0,1979.0,0.724,12.954,221,31,0,31,190,147,43,0,0.0,0.0
1015,391,2020-03-17 06:23:00,1,3551.0,2668.0,0.751,16.946,616,95,60,35,521,418,103,0,0.0,0.0
1015,392,2020-03-17 06:26:00,1,3571.0,2682.0,0.751,17.04,857,348,281,67,509,404,105,1,0.0,0.0
1015,393,2020-03-17 06:29:00,1,3560.0,2619.0,0.736,16.926,784,306,245,61,478,363,115,8,0.0,0.0
1015,394,2020-03-17 06:32:00,1,3231.0,2408.0,0.745,15.395,574,188,140,48,386,299,87,33,0.0,0.0
1015,395,2020-03-17 06:35:00,1,2345.0,1636.0,0.698,11.049,33,14,6,8,19,11,8,0,0.0,0.0
1015,396,2020-03-17 06:38:00,1,2315.0,1611.0,0.696,10.906,43,12,9,3,31,26,5,0,0.0,0.0
1015,397,2020-03-17 06:41:00,1,3360.0,2397.0,0.714,15.892,1271,469,372,97,802,661,141,5,0.0,0.0
1015,398,2020-03-17 06:44:00,1,3404.0,2381.0,0.7,16.048,651,258,195,63,393,301,92,89,0.0,0.0
1015,399,2020-03-17 06:47:00,1,3606.0,2602.0,0.722,17.09,340,92,63,29,248,167,81,53,0.0,0.03
1015,400,2020-03-17 06:50:00,1,2288.0,1513.0,0.661,10.689,102,15,1,14,87,51,36,0,0.0,0.0
1015,401,2020-03-17 06:53:00,1,2662.0,1763.0,0.662,12.439,161,28,15,13,133,93,40,14,0.0,0.0
1015,402,2020-03-17 06:56:00,1,1942.0,1315.0,0.677,9.107,0,0,0,0,0,0,0,0,0.0,0.0
1015,403,2020-03-17 06:59:00,1,1920.0,1292.0,0.673,8.996,8,3,0,3,5,2,3,0,0.0,0.0
1015,404,2020-03-17 07:02:00,1,2316.0,1627.0,0.702,10.927,0,0,0,0,0,0,0,0,0.0,0.0
1015,405,2020-03-17 07:05:00,1,2062.0,1397.0,0.677,9.672,15,4,2,2,11,8,3,0,0.0,0.0
1015,406,2020-03-17 07:08:00,1,2377.0,1639.0,0.69,11.181,249,88,56,32,161,105,56,26,0.0,0.0
1015,407,2020-03-17 07:11:00,1,3462.0,2725.0,0.787,16.659,337,91,50,41,246,176,70,37,0.0,0.03
1015,408,2020-03-17 07:14:00,1,2021.0,1462.0,0.723,9.581,49,1,0,1,48,0,48,0,0.0,0.0
1015,409,2020-03-17 07:17:00,1,2759.0,2147.0,0.778,13.25,278,0,0,0,278,228,50,0,0.0,0.0
1015,410,2020-03-17 07:20:00,1,3385.0,2600.0,0.768,16.217,396,0,0,0,396,324,72,0,0.0,0.0
1015,411,2020-03-17 07:23:00,1,3391.0,2567.0,0.757,16.203,496,0,0,0,496,373,123,0,0.0,0.0
1015,412,2020-03-17 07:26:00,1,3160.0,2421.0,0.766,15.131,366,0,0,0,366,289,77,0,0.0,0.0
1015,413,2020-03-17 07:29:00,1,2859.0,2159.0,0.755,13.654,516,11,1,10,505,403,102,0,0.0,0.0
1015,414,2020-03-17 07:32:00,1,2755.0,2096.0,0.761,13.175,66,2,2,0,64,41,23,0,0.0,0.0
1015,415,2020-03-17 07:35:00,1,2773.0,2097.0,0.756,13.246,99,9,4,5,90,48,42,0,0.0,0.0
1015,416,2020-03-17 07:38:00,1,2807.0,2083.0,0.742,13.368,619,31,2,29,588,514,74,0,0.0,0.0
1015,417,2020-03-17 07:41:00,1,2798.0,2018.0,0.721,13.26,653,27,3,24,626,520,106,0,0.0,0.0
1015,418,2020-03-17 07:44:00,1,2653.0,1870.0,0.705,12.522,131,13,6,7,118,98,20,0,0.0,0.0
1015,419,2020-03-17 07:47:00,1,2265.0,1545.0,0.682,10.636,1,1,0,1,0,0,0,0,0.0,0.0
1015,420,2020-03-17 07:50:00,1,2078.0,1464.0,0.705,9.809,15,3,1,2,12,5,7,0,0.0,0.0
1015,421,2020-03-17 07:53:00,1,2333.0,1541.0,0.661,10.899,1,0,0,0,1,0,1,0,0.0,0.0
1015,422,2020-03-17 07:56:00,1,2426.0,1667.0,0.687,11.405,40,16,10,6,24,14,10,0,0.0,0.0
1015,423,2020-03-17 07:59:00,1,2635.0,1892.0,0.718,12.475,2,0,0,0,2,1,1,0,0.0,0.0
1015,424,2020-03-17 08:02:00,1,2641.0,1929.0,0.73,12.541,6,2,1,1,4,2,2,0,0.0,0.0
1015,425,2020-03-17 08:05:00,1,2684.0,1834.0,0.683,12.608,4,4,1,3,0,0,0,0,0.0,0.0
1015,426,2020-03-17 08:08:00,1,2624.0,1780.0,0.678,12.308,90,8,3,5,82,22,60,0,0.0,0.0
1015,427,2020-03-17 08:11:00,1,2651.0,1816.0,0.685,12.456,64,2,1,1,62,6,56,0,0.0,0.0
1015,428,2020-03-17 08:14:00,1,2459.0,1696.0,0.69,11.567,71,0,0,0,71,9,62,0,0.0,0.0
1015,429,2020-03-17 08:17:00,1,2416.0,1669.0,0.691,11.367,71,2,0,2,69,12,57,0,0.0,0.0
1015,430,2020-03-17 08:20:00,1,2459.0,1728.0,0.703,11.601,152,0,0,0,152,90,62,0,0.0,0.0
1015,431,2020-03-17 08:23:00,1,2432.0,1675.0,0.689,11.439,390,0,0,0,390,304,86,0,0.0,0.0
1015,432,2020-03-17 08:26:00,1,2441.0,1665.0,0.682,11.462,410,0,0,0,410,305,105,0,0.0,0.0
1015,433,2020-03-17 08:29:00,1,2393.0,1685.0,0.704,11.295,404,0,0,0,404,289,115,0,0.0,0.0
1015,434,2020-03-17 08:32:00,1,2342.0,1654.0,0.7065,11.059,187,0,0,0,187,113,74,0,0.0,0.0
1015,435,2020-03-17 08:35:00,1,2291.0,1623.0,0.709,10.823,512,123,94,29,389,284,105,25,0.0,0.0
1015,436,2020-03-17 08:38:00,1,2814.0,2063.0,0.733,13.371,715,73,30,43,642,509,133,40,0.0,0.0
1015,437,2020-03-17 08:41:00,1,3059.0,2232.0,0.73,14.523,654,159,98,61,495,386,109,19,0.0,0.0
1015,438,2020-03-17 08:44:00,1,3149.0,2331.0,0.74,14.988,640,225,170,55,415,333,82,49,0.0,0.0
1015,439,2020-03-17 08:47:00,1,2982.0,2220.0,0.744,14.207,1249,436,335,101,813,662,151,2,0.0,0.0
1015,440,2020-03-17 08:50:00,1,3180.0,2337.0,0.735,15.115,1459,550,476,74,909,780,129,11,0.0,0.0
1015,441,2020-03-17 08:53:00,1,3155.0,2333.0,0.739,15.014,1154,394,335,59,760,656,104,16,0.0,0.0
1015,442,2020-03-17 08:56:00,1,2654.0,1836.0,0.692,12.489,611,188,131,57,423,353,70,8,0.16,0.0
1015,443,2020-03-17 08:59:00,1,3038.0,2171.0,0.715,14.373,922,287,224,63,635,520,115,29,0.0,0.0
1015,444,2020-03-17 09:02:00,1,3033.0,2251.0,0.742,14.443,1131,355,271,84,776,622,154,1,0.0,0.0
1015,445,2020-03-17 09:05:00,1,3212.0,2279.0,0.709,15.181,1464,546,444,102,918,760,158,18,0.0,0.0
1015,446,2020-03-17 09:08:00,1,2995.0,2198.0,0.734,14.233,1248,420,340,80,828,667,161,10,0.0,0.0
1015,447,2020-03-17 09:11:00,1,3018.0,2169.0,0.719,14.294,993,315,257,58,678,564,114,5,0.0,0.0
1015,448,2020-03-17 09:14:00,1,3004.0,2156.0,0.718,14.222,1759,479,399,80,1280,1099,181,29,0.0,0.0
1015,449,2020-03-17 09:17:00,1,2876.0,2094.0,0.728,13.649,736,246,185,61,490,377,113,25,0.0,0.0
1015,450,2020-03-17 09:20:00,1,2813.0,2024.0,0.72,13.323,1057,415,331,84,642,502,140,28,0.0,0.0
1015,451,2020-03-17 09:23:00,1,2827.0,2026.0,0.717,13.383,1265,416,345,71,849,699,150,9,0.0,0.0
1015,452,2020-03-17 09:26:00,1,2925.0,2037.0,0.696,13.782,1191,421,348,73,770,619,151,11,0.0,0.0
1015,453,2020-03-17 09:29:00,1,3031.0,2225.0,0.734,14.407,505,162,120,42,343,250,93,21,0.0,0.0
1015,454,2020-03-17 09:32:00,1,2801.0,1948.0,0.695,13.194,497,22,3,19,475,359,116,2,0.0,0.0
1015,455,2020-03-17 09:35:00,1,2808.0,1980.0,0.705,13.257,274,6,1,5,268,179,89,0,0.0,0.0
1015,456,2020-03-17 09:38:00,1,2706.0,1885.0,0.697,12.75,14,0,0,0,14,0,14,0,0.0,0.0
1015,457,2020-03-17 09:41:00,1,2514.0,1749.0,0.696,11.842,42,7,2,5,35,1,34,0,0.0,0.0
1015,458,2020-03-17 09:44:00,1,2415.0,1667.0,0.69,11.361,0,0,0,0,0,0,0,0,0.0,0.0
1015,459,2020-03-17 09:47:00,1,2301.0,1595.0,0.693,10.831,0,0,0,0,0,0,0,0,0.0,0.0
1015,460,2020-03-17 09:50:00,1,2292.0,1550.0,0.676,10.748,115,59,36,23,56,34,22,0,0.0,0.0
1015,461,2020-03-17 09:53:00,1,2448.0,1710.0,0.699,11.539,204,114,40,74,90,48,42,1,0.0,0.0
1015,462,2020-03-17 09:56:00,1,2621.0,1876.0,0.715,12.406,166,43,14,29,123,63,60,0,0.0,0.0
1015,463,2020-03-17 09:59:00,1,2504.0,1754.0,0.7,11.809,81,0,0,0,81,8,73,0,0.0,0.0
1015,464,2020-03-17 10:02:00,1,2445.0,1648.0,0.674,11.458,64,1,0,1,63,7,56,0,0.0,0.0
1015,465,2020-03-17 10:05:00,1,2302.0,1564.0,0.679,10.802,0,0,0,0,0,0,0,0,0.0,0.0
1015,466,2020-03-17 10:08:00,1,2301.0,1530.0,0.665,10.759,4,1,0,1,3,0,3,0,0.0,0.0
1015,467,2020-03-17 10:11:00,1,2344.0,1553.0,0.663,10.955,13,6,0,6,7,3,4,0,0.0,0.0
1015,468,2020-03-17 10:14:00,1,2438.0,1645.0,0.675,11.426,19,18,0,18,1,0,1,0,0.0,0.0
1015,469,2020-03-17 10:17:00,1,2169.0,1486.0,0.685,10.194,61,60,0,60,1,0,1,0,0.0,0.0
1015,470,2020-03-17 10:20:00,1,2087.0,1396.0,0.669,9.768,41,32,0,32,9,5,4,0,0.0,0.0
1015,471,2020-03-17 10:23:00,1,2082.0,1453.0,0.698,9.814,2,2,0,2,0,0,0,0,0.0,0.0
1015,472,2020-03-17 10:26:00,1,2138.0,1481.0,0.693,10.065,4,4,0,4,0,0,0,0,0.0,0.0
1015,473,2020-03-17 10:29:00,1,2075.0,1431.0,0.69,9.76,0,0,0,0,0,0,0,0,0.0,0.0
1015,474,2020-03-17 10:32:00,1,2057.0,1372.0,0.667,9.624,1,0,0,0,1,1,0,0,0.0,0.0
1015,475,2020-03-17 10:35:00,1,2063.0,1441.0,0.698,9.724,2,0,0,0,2,0,2,0,0.0,0.0
1015,476,2020-03-17 10:38:00,1,2293.0,1549.0,0.676,10.75,52,27,8,19,25,11,14,0,0.0,0.0
1015,477,2020-03-17 10:41:00,1,2226.0,1493.0,0.671,10.423,33,0,0,0,33,0,33,0,0.0,0.0
1015,478,2020-03-17 10:44:00,1,2173.0,1492.0,0.687,10.214,175,25,12,13,150,93,57,0,0.0,0.0
1015,479,2020-03-17 10:47:00,1,2266.0,1552.0,0.685,10.647,32,11,5,6,21,2,19,0,0.0,0.0
1015,480,2020-03-17 10:50:00,1,2143.0,1484.0,0.693,10.087,92,12,5,7,80,21,59,0,0.0,0.0
1015,481,2020-03-17 10:53:00,1,2021.0,1439.0,0.712,9.557,87,10,1,9,77,9,68,0,0.0,0.0
1015,482,2020-03-17 10:56:00,1,2189.0,1474.0,0.674,10.255,62,2,0,2,60,0,60,0,0.0,0.0
1015,483,2020-03-17 10:59:00,1,2271.0,1561.0,0.687,10.675,43,2,0,2,41,0,41,0,0.0,0.0
1015,484,2020-03-17 11:02:00,1,2323.0,1600.0,0.688,10.926,60,0,0,0,60,1,59,0,0.0,0.0
1015,485,2020-03-17 11:05:00,1,2378.0,1638.0,0.689,11.183,36,0,0,0,36,4,32,0,0.0,0.0
1015,486,2020-03-17 11:08:00,1,2285.0,1607.0,0.703,10.781,33,2,0,2,31,4,27,0,0.0,0.0
1015,487,2020-03-17 11:11:00,1,2269.0,1561.0,0.688,10.668,122,37,14,23,85,45,40,0,0.0,0.0
1015,488,2020-03-17 11:14:00,1,2442.0,1743.0,0.714,11.552,305,42,15,27,263,199,64,1,0.0,0.0
1015,489,2020-03-17 11:17:00,1,2276.0,1596.0,0.701,10.734,89,6,4,2,83,21,62,0,0.0,0.0
1015,490,2020-03-17 11:20:00,1,2328.0,1597.0,0.686,10.942,165,12,4,8,153,74,79,0,0.0,0.0
1015,491,2020-03-17 11:23:00,1,2294.0,1535.0,0.669,10.739,96,3,3,0,93,23,70,0,0.0,0.0
1015,492,2020-03-17 11:26:00,1,2326.0,1535.0,0.66,10.864,83,7,2,5,76,8,68,0,0.0,0.0
1015,493,2020-03-17 11:29:00,1,2337.0,1550.0,0.663,10.924,61,0,0,0,61,2,59,0,0.0,0.0
1015,494,2020-03-17 11:32:00,1,2153.0,1498.0,0.699,10.141,73,6,0,6,67,4,63,0,0.0,0.0
1015,495,2020-03-17 11:35:00,1,1969.0,1446.0,0.735,9.358,331,41,20,21,290,219,71,0,0.0,0.0
1015,496,2020-03-17 11:38:00,1,2198.0,1498.0,0.681,10.318,593,0,0,0,593,498,95,0,0.0,0.0
1015,497,2020-03-17 11:41:00,1,2111.0,1470.0,0.696,9.947,1054,0,0,0,1054,952,102,0,0.0,0.0
1015,498,2020-03-17 11:44:00,1,1977.0,1455.0,0.736,9.4,402,2,1,1,400,346,54,0,0.0,0.0
1015,499,2020-03-17 11:47:00,1,1989.0,1392.0,0.7,9.378,90,3,1,2,87,19,68,0,0.0,0.0
1015,500,2020-03-17 11:50:00,1,1989.0,1396.0,0.702,9.382,69,9,6,3,60,0,60,0,0.0,0.0
1015,501,2020-03-17 11:53:00,1,2215.0,1482.0,0.669,10.367,43,1,0,1,42,4,38,0,0.0,0.0
1015,502,2020-03-17 11:56:00,1,1987.0,1433.0,0.721,9.415,4,0,0,0,4,3,1,0,0.0,0.0
1015,503,2020-03-17 11:59:00,1,2116.0,1486.0,0.702,9.982,5,2,1,1,3,1,2,0,0.0,0.0
1015,504,2020-03-17 12:02:00,1,1981.0,1371.0,0.692,9.324,0,0,0,0,0,0,0,0,0.0,0.0
1015,505,2020-03-17 12:05:00,1,1902.0,1333.0,0.701,8.971,0,0,0,0,0,0,0,0,0.0,0.0
1015,506,2020-03-17 12:08:00,1,1985.0,1363.0,0.687,9.329,72,34,22,12,38,29,9,0,0.0,0.0
1015,507,2020-03-17 12:11:00,1,1968.0,1448.0,0.736,9.355,15,7,4,3,8,1,7,0,0.0,0.0
1015,508,2020-03-17 12:14:00,1,2232.0,1517.0,0.679,10.474,22,0,0,0,22,3,19,0,0.0,0.0
1015,509,2020-03-17 12:17:00,1,2229.0,1576.0,0.707,10.528,49,5,3,2,44,6,38,0,0.0,0.0
1015,510,2020-03-17 12:20:00,1,2302.0,1641.0,0.713,10.888,65,1,1,0,64,2,62,0,0.0,0.0
1015,511,2020-03-17 12:23:00,1,2177.0,1579.0,0.725,10.327,175,16,6,10,159,75,84,0,0.0,0.0
1015,512,2020-03-17 12:26:00,1,2340.0,1663.0,0.711,11.062,321,42,7,35,279,196,83,0,0.0,0.0
1015,513,2020-03-17 12:29:00,1,2542.0,1821.0,0.716,12.032,458,95,54,41,363,258,105,21,0.0,0.0
1015,514,2020-03-17 12:32:00,1,2546.0,1929.0,0.758,12.169,824,299,238,61,525,416,109,39,0.0,0.0
1015,515,2020-03-17 12:35:00,1,2907.0,2209.0,0.76,13.898,697,280,219,61,417,334,83,101,0.0,0.0
1015,516,2020-03-17 12:38:00,1,2706.0,2052.0,0.758,12.934,1113,449,352,97,664,522,142,27,0.0,0.0
1015,517,2020-03-17 12:41:00,1,2949.0,2185.0,0.741,14.039,590,234,171,63,356,270,86,41,0.1,0.04
1015,518,2020-03-17 12:44:00,1,2556.0,1827.0,0.715,12.095,915,385,294,91,530,406,124,42,0.0,0.0
1015,519,2020-03-17 12:47:00,1,2973.0,2207.0,0.742,14.159,1145,482,393,89,663,541,122,13,0.0,0.0
1015,520,2020-03-17 12:50:00,1,2958.0,2227.0,0.753,14.123,1059,334,268,66,725,632,93,18,0.0,0.0
1015,521,2020-03-17 12:53:00,1,3103.0,2268.0,0.731,14.737,807,371,293,78,436,336,100,16,0.0,0.0
1015,522,2020-03-17 12:56:00,1,2959.0,2220.0,0.75,14.117,1142,406,313,93,736,602,134,12,0.0,0.0
1015,523,2020-03-17 12:59:00,1,2842.0,2079.0,0.731,13.499,788,135,85,50,653,552,101,1,0.0,0.0
1015,524,2020-03-17 13:02:00,1,2713.0,1993.0,0.735,12.895,555,27,3,24,528,470,58,1,0.0,0.0
1015,525,2020-03-17 13:05:00,1,2681.0,1967.0,0.734,12.74,385,24,11,13,361,296,65,0,0.0,0.0
1015,526,2020-03-17 13:08:00,1,2739.0,1976.0,0.722,12.979,930,106,66,40,824,685,139,3,0.0,0.0
1015,527,2020-03-17 13:11:00,1,2734.0,2043.0,0.747,13.036,255,24,2,22,231,169,62,0,0.0,0.0
1015,528,2020-03-17 13:14:00,1,2545.0,1823.0,0.716,12.048,50,8,4,4,42,1,41,0,0.0,0.0
1015,529,2020-03-17 13:17:00,1,2451.0,1745.0,0.712,11.59,350,7,4,3,343,281,62,0,0.0,0.0
1015,530,2020-03-17 13:20:00,1,2324.0,1644.0,0.707,10.977,25,0,0,0,25,1,24,0,0.0,0.0
1015,531,2020-03-17 13:23:00,1,2345.0,1628.0,0.694,11.042,59,5,1,4,54,24,30,0,0.0,0.0
1015,532,2020-03-17 13:26:00,1,2347.0,1690.0,0.72,11.119,516,7,0,7,509,449,60,0,0.0,0.0
1015,533,2020-03-17 13:29:00,1,1990.0,1425.0,0.716,9.418,534,12,0,12,522,435,87,0,0.0,0.0
1015,534,2020-03-17 13:32:00,1,1999.0,1352.0,0.676,9.372,251,14,8,6,237,194,43,0,0.0,0.0
1015,535,2020-03-17 13:35:00,1,1833.0,1219.0,0.665,8.572,12,0,0,0,12,0,12,0,0.0,0.0
1015,536,2020-03-17 13:38:00,1,1860.0,1240.0,0.667,8.702,4,0,0,0,4,0,4,0,0.0,0.0
1015,537,2020-03-17 13:41:00,1,1989.0,1312.0,0.66,9.29,15,0,0,0,15,0,15,0,0.0,0.0
1015,538,2020-03-17 13:44:00,1,1940.0,1391.0,0.717,9.185,9,1,0,1,8,0,8,0,0.0,0.0
1015,539,2020-03-17 13:47:00,1,2258.0,1487.0,0.659,10.543,23,0,0,0,23,0,23,0,0.0,0.0
1015,540,2020-03-17 13:50:00,1,2345.0,1709.0,0.729,11.131,125,31,19,12,94,72,22,0,0.0,0.0
1015,541,2020-03-17 13:53:00,1,2580.0,1827.0,0.708,12.191,1,0,0,0,1,0,1,0,0.0,0.0
1015,542,2020-03-17 13:56:00,1,2327.0,1664.0,0.715,11.01,9,0,0,0,9,0,9,0,0.0,0.0
1015,543,2020-03-17 13:59:00,1,2165.0,1599.0,0.739,10.301,360,1,0,1,359,309,50,0,0.0,0.0
1015,544,2020-03-17 14:02:00,1,2373.0,1641.0,0.691,11.166,546,0,0,0,546,485,61,0,0.0,0.0
1015,545,2020-03-17 14:05:00,1,2212.0,1582.0,0.715,10.469,165,27,9,18,138,113,25,0,0.0,0.0
1015,546,2020-03-17 14:08:00,1,1984.0,1369.0,0.69,9.332,27,19,0,19,8,0,8,0,0.0,0.0
1015,547,2020-03-17 14:11:00,1,1829.0,1325.0,0.724,8.675,9,8,0,8,1,0,1,0,0.0,0.0
1015,548,2020-03-17 14:14:00,1,1966.0,1351.0,0.687,9.241,5,1,0,1,4,4,0,0,0.0,0.0
1015,549,2020-03-17 14:17:00,1,1958.0,1381.0,0.706,9.243,7,3,1,2,4,4,0,0,0.0,0.0
1015,550,2020-03-17 14:20:00,1,2221.0,1528.0,0.688,10.441,0,0,0,0,0,0,0,0,0.0,0.0
1015,551,2020-03-17 14:23:00,1,1969.0,1360.0,0.691,9.264,3,2,0,2,1,0,1,0,0.0,0.0
1015,552,2020-03-17 14:26:00,1,1830.0,1232.0,0.673,8.575,3,0,0,0,3,0,3,0,0.0,0.0
1015,553,2020-03-17 14:29:00,1,2060.0,1424.0,0.691,9.692,437,90,53,37,347,271,76,2,0.0,0.0
1015,554,2020-03-17 14:32:00,1,2556.0,1812.5,0.706,12.0775,652,146,108,38,506,427,79,2,0.0,0.0
1015,555,2020-03-17 14:35:00,1,3052.0,2201.0,0.721,14.463,913,60,26,34,853,755,98,4,0.0,0.0
1015,556,2020-03-17 14:38:00,1,2800.0,2141.0,0.765,13.403,701,182,143,39,519,438,81,24,0.0,0.0
1015,557,2020-03-17 14:41:00,1,2850.0,2114.0,0.742,13.571,611,203,158,45,408,340,68,40,0.0,0.0
1015,558,2020-03-17 14:44:00,1,2798.0,2061.0,0.737,13.306,49,31,20,11,18,12,6,0,0.0,0.0
1015,559,2020-03-17 14:47:00,1,2453.0,1731.0,0.706,11.582,0,0,0,0,0,0,0,0,0.0,0.0
1015,560,2020-03-17 14:50:00,1,2314.0,1552.0,0.671,10.836,3,0,0,0,3,1,2,0,0.0,0.0
1015,561,2020-03-17 14:53:00,1,2202.0,1470.0,0.667,10.303,0,0,0,0,0,0,0,0,0.0,0.0
1015,562,2020-03-17 14:56:00,1,2226.0,1494.0,0.671,10.423,2,0,0,0,2,0,2,0,0.0,0.0
1015,563,2020-03-17 14:59:00,1,2202.0,1493.0,0.678,10.328,0,0,0,0,0,0,0,0,0.0,0.0
1015,564,2020-03-17 15:02:00,1,2112.0,1466.0,0.694,9.946,2,0,0,0,2,0,2,0,0.0,0.0
1015,565,2020-03-17 15:05:00,1,2250.0,1525.0,0.678,10.552,6,3,1,2,3,1,2,0,0.0,0.0
1015,566,2020-03-17 15:08:00,1,2273.0,1586.0,0.698,10.711,1,0,0,0,1,1,0,0,0.0,0.0
1015,567,2020-03-17 15:11:00,1,2222.0,1515.0,0.682,10.433,31,6,5,1,25,19,6,0,0.0,0.0
1015,568,2020-03-17 15:14:00,1,2270.0,1614.0,0.711,10.731,25,8,4,4,17,12,5,0,0.0,0.0
1015,569,2020-03-17 15:17:00,1,2380.0,1645.0,0.691,11.197,11,0,0,0,11,6,5,0,0.0,0.0
1015,570,2020-03-17 15:20:00,1,2360.0,1646.0,0.697,11.122,35,2,1,1,33,10,23,0,0.0,0.0
1015,571,2020-03-17 15:23:00,1,2176.0,1522.0,0.7,10.259,13,0,0,0,13,5,8,0,0.0,0.0
1015,572,2020-03-17 15:26:00,1,2063.0,1356.0,0.657,9.631,43,7,6,1,36,5,31,0,0.0,0.0
1015,573,2020-03-17 15:29:00,1,2151.0,1509.0,0.702,10.144,73,0,0,0,73,46,27,0,0.0,0.0
1015,574,2020-03-17 15:32:00,1,2254.0,1614.0,0.716,10.667,59,0,0,0,59,28,31,0,0.0,0.0
1015,575,2020-03-17 15:35:00,1,2249.0,1626.0,0.723,10.663,57,0,0,0,57,26,31,0,0.0,0.0
1015,576,2020-03-17 15:38:00,1,2386.0,1701.0,0.713,11.283,17,7,1,6,10,3,7,0,0.0,0.0
1015,577,2020-03-17 15:41:00,1,2216.0,1512.0,0.683,10.404,48,35,22,13,13,6,7,0,0.0,0.0
1015,578,2020-03-17 15:44:00,1,2310.0,1527.0,0.661,10.792,31,6,3,3,25,4,21,0,0.0,0.0
1015,579,2020-03-17 15:47:00,1,2058.0,1455.0,0.707,9.718,16,13,4,9,3,0,3,0,0.0,0.0
1015,580,2020-03-17 15:50:00,1,2064.0,1416.0,0.686,9.701,10,7,4,3,3,1,2,0,0.0,0.0
1015,581,2020-03-17 15:53:00,1,2051.0,1469.0,0.716,9.707,25,22,6,16,3,1,2,0,0.0,0.0
1015,582,2020-03-17 15:56:00,1,2097.0,1375.0,0.656,9.787,2,2,0,2,0,0,0,0,0.0,0.0
1015,583,2020-03-17 15:59:00,1,1910.0,1328.0,0.695,8.998,16,13,9,4,3,1,2,0,0.0,0.0
1015,584,2020-03-17 16:02:00,1,2073.0,1454.0,0.701,9.778,7,6,0,6,1,0,1,0,0.0,0.0
1015,585,2020-03-17 16:05:00,1,2112.0,1488.0,0.705,9.971,47,46,2,44,1,0,1,0,0.0,0.0
1015,586,2020-03-17 16:08:00,1,2141.0,1502.0,0.702,10.1,21,20,6,14,1,0,1,0,0.0,0.0
1015,587,2020-03-17 16:11:00,1,2274.0,1506.0,0.662,10.627,29,15,12,3,14,8,6,0,0.0,0.0
1015,588,2020-03-17 16:14:00,1,2284.0,1647.0,0.721,10.821,155,75,35,40,80,49,31,1,0.0,0.0
1015,589,2020-03-17 16:17:00,1,2607.0,1821.0,0.699,12.288,253,140,93,47,113,68,45,7,0.0,0.0
1015,590,2020-03-17 16:20:00,1,2684.0,1950.0,0.727,12.735,322,230,188,42,92,37,55,3,0.0,0.0
1015,591,2020-03-17 16:23:00,1,2694.0,1895.0,0.703,12.712,162,111,81,30,51,2,49,0,0.0,0.0
1015,592,2020-03-17 16:26:00,1,2814.0,1996.0,0.709,13.296,456,310,238,72,146,93,53,26,0.0,0.0
1015,593,2020-03-17 16:29:00,1,2566.0,1855.0,0.723,12.162,53,37,17,20,16,8,8,0,0.0,0.0
1015,594,2020-03-17 16:32:00,1,2439.0,1820.0,0.746,11.623,70,70,23,47,0,0,0,0,0.0,0.0
1015,595,2020-03-17 16:35:00,1,2294.0,1666.0,0.726,10.885,62,62,0,62,0,0,0,0,0.0,0.0
1015,596,2020-03-17 16:38:00,1,2196.0,1499.0,0.683,10.311,178,176,116,60,2,1,1,0,0.0,0.0
1015,597,2020-03-17 16:41:00,1,2303.0,1483.0,0.644,10.717,57,57,17,40,0,0,0,0,0.0,0.0
1015,598,2020-03-17 16:44:00,1,2309.0,1541.0,0.667,10.804,32,32,4,28,0,0,0,0,0.0,0.0
1015,599,2020-03-17 16:47:00,1,2129.0,1462.0,0.687,10.006,57,56,8,48,1,0,1,0,0.0,0.0
1015,600,2020-03-17 16:50:00,1,2305.0,1519.0,0.659,10.764,132,130,74,56,2,0,2,0,0.0,0.0
1015,601,2020-03-17 16:53:00,1,2307.0,1533.0,0.664,10.787,45,45,18,27,0,0,0,0,0.0,0.0
1015,602,2020-03-17 16:56:00,1,1914.0,1239.0,0.647,8.912,80,80,35,45,0,0,0,0,0.0,0.0
1015,603,2020-03-17 16:59:00,1,1701.0,1142.0,0.672,7.966,71,54,0,54,17,2,15,0,0.0,0.0
1015,604,2020-03-17 17:02:00,1,1694.0,1149.0,0.678,7.948,96,61,11,50,35,4,31,0,0.0,0.0
1015,605,2020-03-17 17:05:00,1,2432.0,1692.0,0.696,11.455,652,348,308,40,304,213,91,3,0.0,0.0
1015,606,2020-03-17 17:08:00,1,3033.0,2143.0,0.706,14.325,474,342,317,25,132,63,69,67,0.0,0.0
1015,607,2020-03-17 17:11:00,1,3177.0,2261.0,0.712,15.02,375,302,279,23,73,5,68,76,0.0,0.01
1015,608,2020-03-17 17:14:00,1,2778.0,2063.0,0.743,13.229,657,366,302,64,291,235,56,74,0.02,0.0
1015,609,2020-03-17 17:17:00,1,2128.0,1487.0,0.699,10.031,192,42,19,23,150,114,36,2,0.0,0.0
1015,610,2020-03-17 17:20:00,1,2078.0,1353.0,0.651,9.686,100,19,4,15,81,43,38,0,0.0,0.0
1015,611,2020-03-17 17:23:00,1,2768.0,2059.0,0.744,13.187,300,62,20,42,238,168,70,2,0.0,0.0
1015,612,2020-03-17 17:26:00,1,3298.0,2515.0,0.763,15.778,59,14,2,12,45,20,25,0,0.0,0.0
1015,613,2020-03-17 17:29:00,1,2662.0,2008.0,0.754,12.711,23,7,0,7,16,7,9,0,0.0,0.0
1015,614,2020-03-17 17:32:00,1,2619.0,1943.5,0.742,12.47,14,4,0,4,10,7,3,0,0.0,0.0
1015,615,2020-03-17 17:35:00,1,2576.0,1879.0,0.73,12.229,37,12,6,6,25,12,13,0,0.0,0.0
1015,616,2020-03-17 17:38:00,1,2418.0,1749.0,0.723,11.465,27,15,5,10,12,4,8,0,0.0,0.0
1015,617,2020-03-17 17:41:00,1,2492.0,1819.0,0.73,11.832,11,4,0,4,7,4,3,0,0.0,0.0
1015,618,2020-03-17 17:44:00,1,2677.0,1875.0,0.7,12.625,49,3,0,3,46,22,24,0,0.0,0.0
1015,619,2020-03-17 17:47:00,1,2631.0,1851.0,0.703,12.416,29,1,0,1,28,7,21,0,0.0,0.0
1015,620,2020-03-17 17:50:00,1,2695.0,1879.0,0.697,12.699,31,6,1,5,25,19,6,0,0.0,0.0
1015,621,2020-03-17 17:53:00,1,2425.0,1737.0,0.716,11.476,124,46,32,14,78,34,44,3,0.0,0.0
1015,622,2020-03-17 17:56:00,1,2799.0,1979.0,0.707,13.219,239,145,89,56,94,32,62,100,0.0,0.0
1015,623,2020-03-17 17:59:00,1,3183.0,2267.0,0.712,15.053,232,124,72,52,108,44,64,58,0.05,0.1
1015,624,2020-03-17 18:02:00,0,2015.0,1443.0,0.716,9.535,549,129,70,59,420,324,96,6,0.0,0.0
1015,625,2020-03-17 18:05:00,0,1919.0,1282.0,0.668,8.982,288,61,25,36,227,146,81,1,0.0,0.0
1015,626,2020-03-17 18:08:00,0,2210.0,1492.0,0.675,10.359,221,29,13,16,192,128,64,0,0.0,0.0
1015,627,2020-03-17 18:11:00,0,2083.0,1431.0,0.687,9.793,77,11,0,11,66,8,58,0,0.0,0.0
1015,628,2020-03-17 18:14:00,0,1927.0,1368.0,0.71,9.109,99,25,0,25,74,14,60,0,0.0,0.0
1015,629,2020-03-17 18:17:00,0,2039.0,1479.0,0.725,9.672,6,0,0,0,6,2,4,0,0.0,0.0
1015,630,2020-03-17 18:20:00,0,2218.0,1549.0,0.699,10.453,84,10,8,2,74,17,57,0,0.0,0.0
1015,631,2020-03-17 18:23:00,0,2036.0,1498.0,0.736,9.679,31,0,0,0,31,0,31,0,0.0,0.0
1015,632,2020-03-17 18:26:00,0,2028.0,1483.0,0.731,9.633,87,11,3,8,76,13,63,0,0.0,0.0
1015,633,2020-03-17 18:29:00,0,2140.0,1525.0,0.713,10.119,118,39,24,15,79,42,37,0,0.0,0.0
1015,634,2020-03-17 18:32:00,0,3180.0,2396.0,0.753,15.183,120,71,21,50,49,21,28,8,0.0,0.0
1015,635,2020-03-17 18:35:00,0,3764.0,2966.0,0.788,18.113,145,70,28,42,75,30,45,3,0.0,0.0
1015,636,2020-03-17 18:38:00,0,3814.0,3014.0,0.79,18.366,421,219,160,59,202,155,47,86,0.0,0.0
1015,637,2020-03-17 18:41:00,0,4069.0,3146.0,0.773,19.516,614,223,181,42,391,308,83,129,0.0,0.0
1015,638,2020-03-17 18:44:00,0,3531.0,2734.0,0.774,16.938,781,304,248,56,477,404,73,199,0.0,0.0
1015,639,2020-03-17 18:47:00,0,3519.0,2722.0,0.774,16.879,739,326,266,60,413,315,98,181,0.0,0.0
1015,640,2020-03-17 18:50:00,0,3852.0,2925.0,0.759,18.415,520,150,84,66,370,282,88,154,0.0,0.0
1015,641,2020-03-17 18:53:00,0,3812.0,2940.0,0.771,18.276,488,199,139,60,289,194,95,96,0.0,0.02
1015,642,2020-03-17 18:56:00,0,3828.0,2965.0,0.775,18.367,906,395,333,62,511,405,106,142,0.0,0.04
1015,643,2020-03-17 18:59:00,0,3340.0,2571.0,0.77,16.007,1072,471,395,76,601,475,126,89,0.0,0.04
1015,644,2020-03-17 19:02:00,0,2261.0,1656.0,0.732,10.741,499,99,50,49,400,297,103,41,0.0,0.0
1015,645,2020-03-17 19:05:00,0,3697.0,2949.0,0.798,17.832,974,380,311,69,594,483,111,151,0.0,0.0
1015,646,2020-03-17 19:08:00,0,4175.0,3288.0,0.788,20.089,759,292,228,64,467,376,91,157,0.0,0.0
1015,647,2020-03-17 19:11:00,0,3653.0,2927.0,0.801,17.633,523,83,64,19,440,350,90,23,0.24,0.13
1015,648,2020-03-17 19:14:00,0,2787.0,2180.0,0.782,13.394,555,171,122,49,384,286,98,16,0.0,0.0
1015,649,2020-03-17 19:17:00,0,2436.0,1712.0,0.703,11.493,378,84,45,39,294,202,92,9,0.0,0.0
1015,650,2020-03-17 19:20:00,0,3810.0,3086.0,0.81,18.429,794,289,232,57,505,410,95,103,0.0,0.0
1015,651,2020-03-17 19:23:00,0,4341.0,3385.0,0.78,20.85,1023,361,292,69,662,527,135,116,0.0,0.13
1015,652,2020-03-17 19:26:00,0,3692.0,2885.0,0.781,17.742,563,199,139,60,364,274,90,97,0.0,0.0
1015,653,2020-03-17 19:29:00,0,3927.0,3092.0,0.787,18.897,401,128,77,51,273,193,80,104,0.0,0.0
1015,654,2020-03-17 19:32:00,0,3681.0,2869.0,0.779,17.681,923,331,264,67,592,481,111,146,0.0,0.0
1015,655,2020-03-17 19:35:00,0,2952.0,2254.0,0.763,14.128,1706,475,376,99,1231,1069,162,29,0.0,0.0
1015,656,2020-03-17 19:38:00,0,3130.0,2441.0,0.78,15.033,802,290,231,59,512,442,70,123,0.0,0.0
1015,657,2020-03-17 19:41:00,0,2603.0,2002.0,0.769,12.474,1073,314,239,75,759,677,82,50,0.0,0.0
1015,658,2020-03-17 19:44:00,0,3896.0,3194.0,0.82,18.885,471,124,86,38,347,292,55,42,0.2,0.0
1015,659,2020-03-17 19:47:00,0,2491.0,1896.0,0.761,11.913,394,78,35,43,316,244,72,1,0.0,0.0
1015,660,2020-03-17 19:50:00,0,3578.0,2872.0,0.803,17.279,275,100,48,52,175,130,45,0,0.0,0.0
1015,661,2020-03-17 19:53:00,0,3887.0,3146.0,0.809,18.797,343,89,56,33,254,197,57,11,0.0,0.0
1015,662,2020-03-17 19:56:00,0,3912.0,3217.0,0.822,18.974,446,130,76,54,316,266,50,106,0.0,0.0
1015,663,2020-03-17 19:59:00,0,3991.0,3297.0,0.826,19.374,545,169,127,42,376,313,63,127,0.0,0.0
1015,664,2020-03-17 20:02:00,0,3678.0,3008.0,0.818,17.822,860,306,253,53,554,468,86,221,0.0,0.0
1015,665,2020-03-17 20:05:00,0,3843.0,3296.0,0.858,18.79,993,387,319,68,606,500,106,208,0.0,0.0
1015,666,2020-03-17 20:08:00,0,3564.0,2993.0,0.84,17.356,1121,456,363,93,665,550,115,118,0.0,0.0
1015,667,2020-03-17 20:11:00,0,3851.0,3251.0,0.844,18.772,1280,450,364,86,830,691,139,56,0.02,0.0
1015,668,2020-03-17 20:14:00,0,3863.0,3136.0,0.812,18.693,799,287,220,67,512,410,102,18,0.0,0.0
1015,669,2020-03-17 20:17:00,0,2382.0,1846.0,0.775,11.429,250,6,1,5,244,170,74,0,0.0,0.0
1015,670,2020-03-17 20:20:00,0,2190.0,1572.0,0.718,10.372,221,53,29,24,168,87,81,29,0.0,0.0
1015,671,2020-03-17 20:23:00,0,3715.0,3033.0,0.816,17.993,479,188,124,64,291,189,102,132,0.0,0.0
1015,672,2020-03-17 20:26:00,0,3666.0,3057.0,0.834,17.829,596,192,143,49,404,305,99,149,0.0,0.0
1015,673,2020-03-17 20:29:00,0,4211.0,3541.0,0.841,20.513,426,166,120,46,260,197,63,101,0.59,0.37
1015,674,2020-03-17 20:32:00,0,3481.5,2889.0,0.827,16.9165,489,189,152,37,300,216,84,85,0.0,0.0
1015,675,2020-03-17 20:35:00,0,2752.0,2237.0,0.813,13.32,381,49,23,26,332,237,95,18,0.0,0.0
1015,676,2020-03-17 20:38:00,0,2983.0,2321.0,0.778,14.325,361,33,9,24,328,239,89,1,0.0,0.0
1015,677,2020-03-17 20:41:00,0,3786.0,3209.0,0.848,18.469,295,91,57,34,204,115,89,22,0.0,0.0
1015,678,2020-03-17 20:44:00,0,4029.0,3307.0,0.821,19.536,295,85,48,37,210,131,79,99,0.0,0.0
1015,679,2020-03-17 20:47:00,0,2759.0,2165.0,0.785,13.266,185,31,28,3,154,84,70,8,0.0,0.0
1015,680,2020-03-17 20:50:00,0,2029.0,1518.0,0.748,9.678,70,0,0,0,70,10,60,0,0.0,0.0
1015,681,2020-03-17 20:53:00,0,2071.0,1506.0,0.728,9.826,110,8,1,7,102,38,64,0,0.0,0.0
1015,682,2020-03-17 20:56:00,0,2018.0,1508.0,0.747,9.619,78,0,0,0,78,18,60,0,0.0,0.0
1015,683,2020-03-17 20:59:00,0,2094.0,1562.0,0.746,9.98,230,47,34,13,183,112,71,18,0.0,0.0
1015,684,2020-03-17 21:02:00,0,3794.0,3218.0,0.848,18.509,378,135,77,58,243,163,80,111,0.0,0.0
1015,685,2020-03-17 21:05:00,0,3784.0,3220.0,0.851,18.474,623,230,181,49,393,310,83,87,0.0,0.0
1015,686,2020-03-17 21:08:00,0,3467.0,2911.0,0.84,16.882,1062,413,336,77,649,536,113,120,0.0,0.0
1015,687,2020-03-17 21:11:00,0,3956.0,3434.0,0.868,19.388,731,302,250,52,429,336,93,161,0.0,0.0
1015,688,2020-03-17 21:14:00,0,3745.0,3312.0,0.884,18.422,948,421,344,77,527,426,101,130,0.0,0.0
1015,689,2020-03-17 21:17:00,0,3505.0,3015.0,0.86,17.147,480,190,135,55,290,230,60,41,0.66,0.0
1015,690,2020-03-17 21:20:00,0,3855.0,3402.0,0.882,18.954,1025,313,241,72,712,609,103,67,0.0,0.0
1015,691,2020-03-17 21:23:00,0,2548.0,2000.0,0.785,12.255,345,35,17,18,310,207,103,32,0.0,0.0
1015,692,2020-03-17 21:26:00,0,3846.0,3322.0,0.864,18.831,794,323,259,64,471,355,116,121,0.0,0.0
1015,693,2020-03-17 21:29:00,0,3809.0,3210.0,0.843,18.563,412,175,109,66,237,147,90,117,0.0,0.0
1015,694,2020-03-17 21:32:00,0,3928.0,3411.0,0.868,19.251,529,191,136,55,338,237,101,129,0.0,0.0
1015,695,2020-03-17 21:35:00,0,4160.0,3649.0,0.877,20.431,788,310,256,54,478,384,94,160,0.0,0.0
1015,696,2020-03-17 21:38:00,0,3778.0,3315.0,0.878,18.554,762,264,214,50,498,393,105,105,0.0,0.0
1015,697,2020-03-17 21:41:00,0,3598.0,3151.0,0.876,17.667,702,289,229,60,413,316,97,75,0.0,0.0
1015,698,2020-03-17 21:44:00,0,3496.0,2945.0,0.842,17.036,265,113,66,47,152,80,72,17,0.0,0.0
1015,699,2020-03-17 21:47:00,0,2627.0,2003.0,0.762,12.566,358,101,50,51,257,162,95,3,0.0,0.0
1015,700,2020-03-17 21:50:00,0,3438.0,2944.0,0.856,16.806,275,51,14,37,224,132,92,0,0.0,0.0
1015,701,2020-03-17 21:53:00,0,3765.0,3193.0,0.848,18.371,217,57,10,47,160,80,80,0,0.0,0.0
1015,702,2020-03-17 21:56:00,0,3589.0,3110.0,0.867,17.584,356,77,31,46,279,198,81,0,0.0,0.0
1015,703,2020-03-17 21:59:00,0,3630.0,3000.0,0.826,17.623,569,176,143,33,393,299,94,69,0.0,0.0
1015,704,2020-03-17 22:02:00,0,3347.0,2660.0,0.795,16.133,388,136,96,40,252,189,63,57,0.0,0.0
1015,705,2020-03-17 22:05:00,0,3596.0,2920.0,0.812,17.401,150,42,12,30,108,39,69,0,0.0,0.0
1015,706,2020-03-17 22:08:00,0,3505.0,2815.0,0.803,16.927,245,87,40,47,158,82,76,0,0.0,0.0
1015,707,2020-03-17 22:11:00,0,3353.0,2669.0,0.796,16.168,250,91,54,37,159,79,80,0,0.24,0.0
1015,708,2020-03-17 22:14:00,0,3363.0,2628.0,0.781,16.161,239,84,62,22,155,107,48,5,0.0,0.02
1015,709,2020-03-17 22:17:00,0,3375.0,2628.0,0.779,16.207,79,12,2,10,67,0,67,0,0.0,0.0
1015,710,2020-03-17 22:20:00,0,3130.0,2481.0,0.793,15.079,65,4,0,4,61,0,61,0,0.0,0.0
1015,711,2020-03-17 22:23:00,0,3136.0,2464.0,0.786,15.085,204,93,69,24,111,53,58,32,0.0,0.0
1015,712,2020-03-17 22:26:00,0,2757.0,2099.0,0.761,13.187,341,133,78,55,208,132,76,116,0.0,0.0
1015,713,2020-03-17 22:29:00,0,3298.0,2592.0,0.786,15.865,390,134,73,61,256,160,96,104,0.0,0.0
1015,714,2020-03-17 22:32:00,0,3122.0,2551.0,0.817,15.127,634,197,153,44,437,332,105,119,0.0,0.0
1015,715,2020-03-17 22:35:00,0,3036.0,2493.0,0.821,14.721,906,338,282,56,568,448,120,158,0.0,0.0
1015,716,2020-03-17 22:38:00,0,3040.0,2441.0,0.803,14.68,713,330,283,47,383,320,63,286,0.0,0.0
1015,717,2020-03-17 22:41:00,0,3220.0,2648.0,0.822,15.618,1156,433,359,74,723,592,131,96,0.0,0.0
1015,718,2020-03-17 22:44:00,0,3342.0,2692.0,0.805,16.149,644,176,136,40,468,354,114,71,0.0,0.0
1015,719,2020-03-17 22:47:00,0,3434.0,2908.0,0.847,16.749,718,257,191,66,461,359,102,86,0.0,0.0
1015,720,2020-03-17 22:50:00,0,2627.0,2008.0,0.764,12.575,317,114,67,47,203,125,78,24,0.0,0.0
1015,721,2020-03-17 22:53:00,0,3347.0,2729.0,0.815,16.211,274,46,4,42,228,143,85,8,0.0,0.0
1015,722,2020-03-17 22:56:00,0,3624.0,3098.0,0.855,17.707,190,13,2,11,177,103,74,1,0.0,0.0
1015,723,2020-03-17 22:59:00,0,3340.0,2708.0,0.811,16.157,70,3,0,3,67,6,61,0,0.0,0.0
1015,724,2020-03-17 23:02:00,0,3294.0,2662.0,0.808,15.924,313,113,62,51,200,131,69,40,0.0,0.0
1015,725,2020-03-17 23:05:00,0,3675.0,2976.0,0.81,17.775,385,142,83,59,243,158,85,83,0.0,0.0
1015,726,2020-03-17 23:08:00,0,3674.0,3088.0,0.84,17.892,416,101,67,34,315,209,106,98,0.0,0.0
1015,727,2020-03-17 23:11:00,0,3488.0,2894.0,0.83,16.947,898,340,277,63,558,448,110,119,0.0,0.0
1015,728,2020-03-17 23:14:00,0,3324.0,2720.0,0.818,16.109,456,154,119,35,302,217,85,55,0.37,0.11
1015,729,2020-03-17 23:17:00,0,4238.0,3649.0,0.861,20.739,334,134,109,25,200,155,45,73,0.0,0.0
1015,730,2020-03-17 23:20:00,0,3580.0,3040.0,0.849,17.47,1289,469,375,94,820,663,157,45,0.0,0.0
1015,731,2020-03-17 23:23:00,0,2683.0,2231.0,0.831,13.041,1652,775,621,154,877,693,184,18,0.0,0.73
1015,732,2020-03-17 23:26:00,0,3340.0,2741.0,0.821,16.193,625,246,182,64,379,304,75,94,0.0,0.0
1015,733,2020-03-17 23:29:00,0,2708.0,2296.0,0.848,13.213,667,341,260,81,326,249,77,51,0.0,0.0
1015,734,2020-03-17 23:32:00,0,2938.0,2433.5,0.83,14.2705,351,136,89,47,215,163,52,45,0.38,0.0
1015,735,2020-03-17 23:35:00,0,3168.0,2571.0,0.812,15.328,208,56,15,41,152,85,67,21,0.0,0.0
1015,736,2020-03-17 23:38:00,0,3515.0,2812.0,0.8,16.965,281,84,43,41,197,137,60,4,0.0,0.0
1015,737,2020-03-17 23:41:00,0,3524.0,2864.0,0.813,17.056,507,225,158,67,282,200,82,1,0.0,0.0
1015,738,2020-03-17 23:44:00,0,3340.0,2684.0,0.804,16.13,811,271,216,55,540,410,130,97,0.0,0.0
1015,739,2020-03-17 23:47:00,0,3458.0,2892.0,0.836,16.827,342,132,80,52,210,119,91,121,0.0,0.0
1015,740,2020-03-17 23:50:00,0,3537.0,2990.0,0.845,17.247,351,101,71,30,250,166,84,93,0.0,0.0
1015,741,2020-03-17 23:53:00,0,3608.0,3139.0,0.87,17.69,289,80,58,22,209,131,78,41,0.0,0.0
1015,742,2020-03-17 23:56:00,0,3687.0,3065.0,0.831,17.922,501,177,143,34,324,247,77,90,0.0,0.0
1015,743,2020-03-17 23:59:00,0,3312.0,2752.0,0.831,16.096,656,255,206,49,401,318,83,113,0.0,0.0
1015,744,2020-03-18 00:02:00,0,2918.0,2490.0,0.853,14.254,619,216,162,54,403,320,83,38,0.0,0.0
1015,745,2020-03-18 00:05:00,0,3447.0,2839.0,0.824,16.724,961,341,256,85,620,488,132,2,0.24,0.0
1015,746,2020-03-18 00:08:00,0,3010.0,2492.0,0.828,14.62,539,239,180,59,300,223,77,22,0.0,0.0
1015,747,2020-03-18 00:11:00,0,3454.0,2976.0,0.862,16.904,451,158,119,39,293,233,60,53,0.0,0.0
1015,748,2020-03-18 00:14:00,0,2895.0,2393.0,0.827,14.056,619,175,128,47,444,337,107,2,0.0,0.0
1015,749,2020-03-18 00:17:00,0,3465.0,2843.0,0.821,16.801,695,268,206,62,427,320,107,50,0.0,0.0
1015,750,2020-03-18 00:20:00,0,3237.0,2678.0,0.827,15.72,404,105,69,36,299,259,40,24,0.0,0.0
1015,751,2020-03-18 00:23:00,0,3328.0,2724.0,0.818,16.126,393,70,31,39,323,288,35,1,0.0,0.0
1015,752,2020-03-18 00:26:00,0,3267.0,2674.0,0.818,15.831,171,34,10,24,137,114,23,0,0.0,0.0
1015,753,2020-03-18 00:29:00,0,3076.0,2504.0,0.814,14.894,601,161,110,51,440,341,99,0,0.1,0.0
1015,754,2020-03-18 00:32:00,0,3053.0,2493.0,0.816,14.79,985,380,308,72,605,489,116,17,0.0,0.0
1015,755,2020-03-18 00:35:00,0,2943.0,2443.0,0.83,14.302,1107,410,318,92,697,571,126,32,0.11,0.0
1015,756,2020-03-18 00:38:00,0,3115.0,2600.0,0.835,15.153,626,303,218,85,323,235,88,5,0.0,0.0
1015,757,2020-03-18 00:41:00,0,3128.0,2536.0,0.811,15.132,547,224,172,52,323,235,88,2,0.0,0.0
1015,758,2020-03-18 00:44:00,0,3069.0,2485.0,0.81,14.842,667,247,193,54,420,314,106,105,0.0,0.0
1015,759,2020-03-18 00:47:00,0,3357.0,2640.0,0.786,16.151,233,65,31,34,168,89,79,85,0.0,0.0
1015,760,2020-03-18 00:50:00,0,3152.0,2493.0,0.791,15.181,226,74,44,30,152,88,64,64,0.0,0.0
1015,761,2020-03-18 00:53:00,0,3478.0,2886.0,0.83,16.898,283,124,99,25,159,124,35,48,0.0,0.0
1015,762,2020-03-18 00:56:00,0,3324.0,2782.0,0.837,16.175,4,4,1,3,0,0,0,0,0.0,0.0
1015,763,2020-03-18 00:59:00,0,2784.0,2253.0,0.809,13.464,275,62,42,20,213,137,76,0,0.0,0.0
1015,764,2020-03-18 01:02:00,0,2735.0,2214.0,0.809,13.227,219,31,14,17,188,122,66,0,0.0,0.0
1015,765,2020-03-18 01:05:00,0,2718.0,2238.0,0.824,13.187,232,5,0,5,227,137,90,0,0.0,0.0
1015,766,2020-03-18 01:08:00,0,2749.0,2228.0,0.81,13.3,171,13,2,11,158,109,49,0,0.0,0.0
1015,767,2020-03-18 01:11:00,0,2765.0,2265.0,0.819,13.402,500,57,30,27,443,326,117,0,0.18,0.0
1015,768,2020-03-18 01:14:00,0,3002.0,2457.0,0.818,14.55,322,61,24,37,261,167,94,3,0.0,0.0
1015,769,2020-03-18 01:17:00,0,2736.0,2347.0,0.858,13.379,224,33,11,22,191,113,78,0,0.0,0.0
1015,770,2020-03-18 01:20:00,0,2717.0,2241.0,0.825,13.186,91,11,5,6,80,24,56,0,0.0,0.0
1015,771,2020-03-18 01:23:00,0,2709.0,2187.0,0.807,13.095,92,1,1,0,91,34,57,0,0.0,0.0
1015,772,2020-03-18 01:26:00,0,2595.0,2070.0,0.798,12.517,124,15,0,15,109,52,57,0,0.0,0.0
1015,773,2020-03-18 01:29:00,0,2598.0,2073.0,0.798,12.53,83,19,3,16,64,5,59,0,0.0,0.0
1015,774,2020-03-18 01:32:00,0,2620.0,2044.0,0.78,12.587,84,29,2,27,55,2,53,0,0.0,0.0
1015,775,2020-03-18 01:35:00,0,2615.0,2005.0,0.767,12.522,198,57,27,30,141,64,77,0,0.0,0.0
1015,776,2020-03-18 01:38:00,0,2616.0,2088.0,0.798,12.618,120,0,0,0,120,60,60,0,0.0,0.0
1015,777,2020-03-18 01:41:00,0,2794.0,2146.0,0.768,13.383,172,9,2,7,163,98,65,0,0.0,0.0
1015,778,2020-03-18 01:44:00,0,2795.0,2214.0,0.792,13.464,381,4,1,3,377,312,65,0,0.0,0.0
1015,779,2020-03-18 01:47:00,0,2602.0,2054.0,0.789,12.525,192,4,0,4,188,122,66,0,0.0,0.0
1015,780,2020-03-18 01:50:00,0,2629.0,2013.0,0.765,12.589,255,15,2,13,240,201,39,0,0.0,0.0
1015,781,2020-03-18 01:53:00,0,2706.0,2102.0,0.777,12.991,157,22,12,10,135,70,65,7,0.0,0.0
1015,782,2020-03-18 01:56:00,0,2775.0,2118.0,0.763,13.28,184,32,15,17,152,86,66,0,0.0,0.0
1015,783,2020-03-18 01:59:00,0,2658.0,2028.0,0.763,12.719,70,2,1,1,68,14,54,0,0.0,0.0
1015,784,2020-03-18 02:02:00,0,2606.0,1953.0,0.749,12.432,196,4,1,3,192,127,65,0,0.0,0.0
1015,785,2020-03-18 02:05:00,0,2672.0,1969.0,0.737,12.706,179,1,0,1,178,110,68,0,0.0,0.0
1015,786,2020-03-18 02:08:00,0,2395.0,1844.0,0.77,11.476,71,0,0,0,71,13,58,0,0.0,0.0
1015,787,2020-03-18 02:11:00,0,2570.0,1887.0,0.734,12.215,197,23,11,12,174,112,62,0,0.0,0.0
1015,788,2020-03-18 02:14:00,0,2641.0,1983.0,0.751,12.6,509,129,89,40,380,281,99,64,0.0,0.0
1015,789,2020-03-18 02:17:00,0,2924.0,2219.0,0.759,13.979,306,90,49,41,216,138,78,83,0.0,0.0
1015,790,2020-03-18 02:20:00,0,3146.0,2450.0,0.779,15.107,271,80,38,42,191,116,75,114,0.0,0.0
1015,791,2020-03-18 02:23:00,0,2918.0,2272.0,0.779,14.013,457,152,115,37,305,232,73,143,0.0,0.0
1015,792,2020-03-18 02:26:00,0,2955.0,2320.0,0.785,14.21,736,305,258,47,431,352,79,271,0.0,0.0
1015,793,2020-03-18 02:29:00,0,3626.0,3099.0,0.855,17.718,549,262,204,58,287,215,72,122,0.12,0.0
1015,794,2020-03-18 02:32:00,0,3202.5,2695.5,0.84,15.6025,484,171,128,43,313,233,80,117,0.0,0.0
1015,795,2020-03-18 02:35:00,0,2779.0,2292.0,0.825,13.487,744,275,225,50,469,381,88,126,0.0,0.0
1015,796,2020-03-18 02:38:00,0,3451.0,2933.0,0.85,16.844,1053,392,316,76,661,532,129,104,0.0,0.0
1015,797,2020-03-18 02:41:00,0,3479.0,2854.0,0.82,16.868,396,148,100,48,248,169,79,3,0.0,0.0
1015,798,2020-03-18 02:44:00,0,3578.0,3080.0,0.861,17.506,247,69,43,26,178,118,60,2,0.0,0.0
1015,799,2020-03-18 02:47:00,0,3650.0,3015.0,0.826,17.719,250,62,25,37,188,120,68,0,0.0,0.0
1015,800,2020-03-18 02:50:00,0,3539.0,2888.0,0.816,17.14,156,10,4,6,146,89,57,0,0.0,0.0
1015,801,2020-03-18 02:53:00,0,3211.0,2655.0,0.827,15.589,125,12,5,7,113,61,52,0,0.0,0.0
1015,802,2020-03-18 02:56:00,0,3005.0,2474.0,0.823,14.579,83,48,26,22,35,19,16,0,0.0,0.0
1015,803,2020-03-18 02:59:00,0,2981.0,2431.0,0.816,14.435,37,25,8,17,12,7,5,0,0.0,0.0
1015,804,2020-03-18 03:02:00,0,2929.0,2369.0,0.809,14.162,5,4,1,3,1,0,1,0,0.0,0.0
1015,805,2020-03-18 03:05:00,0,2988.0,2380.0,0.796,14.409,58,4,1,3,54,0,54,0,0.0,0.0
1015,806,2020-03-18 03:08:00,0,2757.0,2227.0,0.808,13.33,51,1,1,0,50,9,41,0,0.0,0.0
1015,807,2020-03-18 03:11:00,0,2832.0,2180.0,0.77,13.573,68,12,1,11,56,11,45,0,0.0,0.0
1015,808,2020-03-18 03:14:00,0,2918.0,2370.0,0.812,14.123,70,16,4,12,54,6,48,0,0.0,0.0
1015,809,2020-03-18 03:17:00,0,2740.0,2247.0,0.82,13.283,11,10,0,10,1,0,1,0,0.0,0.0
1015,810,2020-03-18 03:20:00,0,2887.0,2364.0,0.819,13.992,302,94,61,33,208,128,80,63,0.19,0.0
1015,811,2020-03-18 03:23:00,0,3151.0,2601.0,0.826,15.294,291,108,64,44,183,99,84,111,0.0,0.0
1015,812,2020-03-18 03:26:00,0,3166.0,2735.0,0.864,15.504,470,188,145,43,282,209,73,42,0.0,0.0
1015,813,2020-03-18 03:29:00,0,3076.0,2675.0,0.87,15.079,684,279,218,61,405,317,88,35,0.0,0.0
1015,814,2020-03-18 03:32:00,0,3134.0,2690.0,0.858,15.325,575,235,188,47,340,273,67,153,0.0,0.0
1015,815,2020-03-18 03:35:00,0,4228.0,3675.0,0.869,20.725,311,146,106,40,165,129,36,18,0.0,0.0
1015,816,2020-03-18 03:38:00,0,3003.0,2550.0,0.849,14.656,953,320,235,85,633,490,143,10,0.0,0.0
1015,817,2020-03-18 03:41:00,0,3121.0,2613.0,0.837,15.19,201,64,47,17,137,108,29,14,0.0,0.0
1015,818,2020-03-18 03:44:00,0,3324.0,2824.0,0.85,16.223,0,0,0,0,0,0,0,0,0.0,0.0
1015,819,2020-03-18 03:47:00,0,3169.0,2673.0,0.844,15.445,70,7,1,6,63,22,41,0,0.0,0.0
1015,820,2020-03-18 03:50:00,0,2936.0,2522.0,0.859,14.36,71,0,0,0,71,14,57,0,0.0,0.0
1015,821,2020-03-18 03:53:00,0,2932.0,2377.0,0.811,14.184,66,3,1,2,63,4,59,0,0.0,0.0
1015,822,2020-03-18 03:56:00,0,2948.0,2444.0,0.829,14.323,64,4,1,3,60,0,60,0,0.0,0.0
1015,823,2020-03-18 03:59:00,0,2721.0,2372.0,0.872,13.348,70,5,1,4,65,4,61,0,0.0,0.0
1015,824,2020-03-18 04:02:00,0,2738.0,2286.0,0.835,13.319,42,0,0,0,42,0,42,0,0.0,0.0
1015,825,2020-03-18 04:05:00,0,2918.0,2411.0,0.826,14.167,86,20,5,15,66,29,37,0,0.0,0.0
1015,826,2020-03-18 04:08:00,0,2950.0,2411.0,0.817,14.292,152,19,4,15,133,69,64,1,0.0,0.0
1015,827,2020-03-18 04:11:00,0,2713.0,2271.0,0.837,13.203,59,0,0,0,59,0,59,0,0.0,0.0
1015,828,2020-03-18 04:14:00,0,2726.0,2281.0,0.837,13.265,67,13,1,12,54,12,42,0,0.0,0.0
1015,829,2020-03-18 04:17:00,0,2573.0,2140.0,0.832,12.505,11,4,0,4,7,5,2,0,0.0,0.0
1015,830,2020-03-18 04:20:00,0,2590.0,2136.0,0.825,12.569,274,117,80,37,157,96,61,71,0.0,0.0
1015,831,2020-03-18 04:23:00,0,2613.0,2193.0,0.839,12.724,270,61,30,31,209,131,78,130,0.0,0.0
1015,832,2020-03-18 04:26:00,0,2743.0,2304.0,0.84,13.358,450,149,107,42,301,235,66,33,0.0,0.11
1015,833,2020-03-18 04:29:00,0,2594.0,2135.0,0.823,12.585,863,307,237,70,556,433,123,7,0.0,0.0
1015,834,2020-03-18 04:32:00,0,3222.0,2780.0,0.863,15.773,536,194,155,39,342,262,80,24,0.0,0.04
1015,835,2020-03-18 04:35:00,0,2762.0,2375.0,0.86,13.512,712,254,177,77,458,349,109,2,0.0,0.0
1015,836,2020-03-18 04:38:00,0,3306.0,2810.0,0.85,16.136,351,75,35,40,276,189,87,0,0.0,0.0
1015,837,2020-03-18 04:41:00,0,3290.0,2818.0,0.856,16.082,227,60,24,36,167,105,62,0,0.0,0.0
1015,838,2020-03-18 04:44:00,0,3093.0,2674.0,0.864,15.148,166,8,2,6,158,80,78,0,0.0,0.0
1015,839,2020-03-18 04:47:00,0,2932.0,2477.0,0.845,14.296,189,1,0,1,188,114,74,0,0.0,0.0
1015,840,2020-03-18 04:50:00,0,2974.0,2432.0,0.818,14.41,78,1,0,1,77,23,54,0,0.0,0.0
1015,841,2020-03-18 04:53:00,0,2913.0,2402.0,0.825,14.136,68,3,0,3,65,19,46,0,0.0,0.0
1015,842,2020-03-18 04:56:00,0,2702.0,2198.0,0.814,13.081,93,13,2,11,80,25,55,0,0.0,0.0
1015,843,2020-03-18 04:59:00,0,2737.0,2240.0,0.818,13.265,187,2,0,2,185,142,43,0,0.0,0.0
1015,844,2020-03-18 05:02:00,0,2682.0,2215.0,0.826,13.018,114,1,0,1,113,80,33,0,0.0,0.0
1015,845,2020-03-18 05:05:00,0,2587.0,2192.0,0.847,12.618,75,1,0,1,74,26,48,0,0.0,0.0
1015,846,2020-03-18 05:08:00,0,2762.0,2282.0,0.826,13.408,53,3,0,3,50,4,46,0,0.0,0.0
1015,847,2020-03-18 05:11:00,0,2733.0,2304.0,0.843,13.319,291,75,33,42,216,135,81,0,0.0,0.0
1015,848,2020-03-18 05:14:00,0,2810.0,2366.0,0.842,13.689,262,85,65,20,177,110,67,0,0.29,0.0
1015,849,2020-03-18 05:17:00,0,2605.0,2190.0,0.841,12.69,67,0,0,0,67,6,61,0,0.0,0.0
1015,850,2020-03-18 05:20:00,0,2614.0,2045.0,0.782,12.565,97,13,3,10,84,19,65,0,0.0,0.0
1015,851,2020-03-18 05:23:00,0,2621.0,2051.0,0.782,12.598,99,9,2,7,90,28,62,0,0.0,0.0
1015,852,2020-03-18 05:26:00,0,2739.0,2204.0,0.805,13.233,156,35,17,18,121,56,65,0,0.0,0.0
1015,853,2020-03-18 05:29:00,0,2879.0,2335.0,0.811,13.93,330,71,28,43,259,171,88,3,0.0,0.0
1015,854,2020-03-18 05:32:00,0,2994.5,2439.0,0.8145,14.5005,398,93,44,49,305,215,90,1,0.0,0.0
1015,855,2020-03-18 05:35:00,0,3110.0,2543.0,0.818,15.071,562,181,130,51,381,290,91,74,0.0,0.0
1015,856,2020-03-18 05:38:00,0,3131.0,2638.0,0.843,15.259,525,222,173,49,303,220,83,139,0.0,0.06
1015,857,2020-03-18 05:41:00,0,3060.0,2514.0,0.822,14.84,631,266,212,54,365,282,83,66,0.29,0.0
1015,858,2020-03-18 05:44:00,0,3280.0,2717.0,0.828,15.929,221,99,70,29,122,88,34,35,0.0,0.0
1015,859,2020-03-18 05:47:00,0,3371.0,2814.0,0.835,16.396,31,4,2,2,27,1,26,0,0.0,0.0
1015,860,2020-03-18 05:50:00,0,2949.0,2444.0,0.829,14.325,68,9,0,9,59,3,56,0,0.0,0.0
1015,861,2020-03-18 05:53:00,0,2741.0,2289.0,0.835,13.334,107,23,16,7,84,18,66,0,0.0,0.0
1015,862,2020-03-18 05:56:00,0,1992.0,1573.0,0.79,9.59,56,0,0,0,56,4,52,0,0.0,0.0
1015,863,2020-03-18 05:59:00,0,2447.0,1940.0,0.793,11.789,47,0,0,0,47,0,47,0,0.0,0.0
1015,864,2020-03-18 06:02:00,1,2823.0,2290.0,0.811,13.656,361,137,105,32,224,155,69,34,0.0,0.0
1015,865,2020-03-18 06:05:00,1,2987.0,2429.0,0.813,14.459,347,129,99,30,218,136,82,154,0.0,0.0
1015,866,2020-03-18 06:08:00,1,3270.0,2643.0,0.808,15.81,257,73,41,32,184,101,83,83,0.0,0.06
1015,867,2020-03-18 06:11:00,1,2923.0,2397.0,0.82,14.17,354,111,77,34,243,170,73,8,0.0,0.01
1015,868,2020-03-18 06:14:00,1,2882.0,2337.0,0.811,13.942,198,71,35,36,127,89,38,5,0.0,0.0
1015,869,2020-03-18 06:17:00,1,3007.0,2451.0,0.815,14.564,10,4,1,3,6,2,4,0,0.0,0.0
1015,870,2020-03-18 06:20:00,1,2907.0,2355.0,0.81,14.06,40,1,0,1,39,2,37,0,0.0,0.0
1015,871,2020-03-18 06:23:00,1,2736.0,2306.0,0.843,13.331,188,17,0,17,171,132,39,0,0.0,0.0
1015,872,2020-03-18 06:26:00,1,2778.0,2222.0,0.8,13.405,176,0,0,0,176,121,55,0,0.0,0.0
1015,873,2020-03-18 06:29:00,1,2615.0,2178.0,0.833,12.714,78,1,0,1,77,21,56,0,0.0,0.0
1015,874,2020-03-18 06:32:00,1,2597.0,2104.0,0.81,12.561,91,0,0,0,91,30,61,0,0.0,0.0
1015,875,2020-03-18 06:35:00,1,2595.0,2072.0,0.799,12.519,56,13,8,5,43,22,21,0,0.0,0.0
1015,876,2020-03-18 06:38:00,1,2448.0,1922.0,0.785,11.775,38,7,2,5,31,20,11,0,0.0,0.0
1015,877,2020-03-18 06:41:00,1,2363.0,1925.0,0.815,11.441,18,5,3,2,13,9,4,0,0.0,0.0
1015,878,2020-03-18 06:44:00,1,2354.0,1857.0,0.789,11.333,1,0,0,0,1,0,1,0,0.0,0.0
1015,879,2020-03-18 06:47:00,1,2384.0,1955.0,0.82,11.558,16,2,1,1,14,7,7,0,0.0,0.0
1015,880,2020-03-18 06:50:00,1,2233.0,1864.0,0.835,10.862,87,29,19,10,58,36,22,0,0.0,0.0
1015,881,2020-03-18 06:53:00,1,2305.0,1864.0,0.809,11.146,101,0,0,0,101,34,67,0,0.0,0.0
1015,882,2020-03-18 06:56:00,1,2392.0,1903.0,0.796,11.531,89,0,0,0,89,37,52,0,0.0,0.0
1015,883,2020-03-18 06:59:00,1,2390.0,1842.0,0.77,11.458,189,3,0,3,186,150,36,0,0.0,0.0
1015,884,2020-03-18 07:02:00,1,2588.0,2096.0,0.81,12.518,118,31,16,15,87,31,56,0,0.0,0.0
1015,885,2020-03-18 07:05:00,1,2628.0,2046.0,0.779,12.618,83,27,9,18,56,2,54,0,0.0,0.0
1015,886,2020-03-18 07:08:00,1,2641.0,2157.0,0.817,12.794,161,4,0,4,157,96,61,0,0.0,0.0
1015,887,2020-03-18 07:11:00,1,2358.0,1900.0,0.806,11.396,56,8,4,4,48,9,39,0,0.0,0.0
1015,888,2020-03-18 07:14:00,1,2384.0,1920.0,0.806,11.518,149,15,8,7,134,64,70,0,0.0,0.0
1015,889,2020-03-18 07:17:00,1,2465.0,1967.0,0.798,11.89,183,3,3,0,180,122,58,0,0.0,0.0
1015,890,2020-03-18 07:20:00,1,2399.0,1920.0,0.8,11.579,157,3,1,2,154,89,65,0,0.0,0.0
1015,891,2020-03-18 07:23:00,1,2452.0,1953.0,0.797,11.823,6,2,1,1,4,1,3,0,0.0,0.0
1015,892,2020-03-18 07:26:00,1,2396.0,1979.0,0.826,11.632,11,0,0,0,11,0,11,0,0.0,0.0
1015,893,2020-03-18 07:29:00,1,2583.0,1992.0,0.771,12.382,55,0,0,0,55,4,51,0,0.0,0.0
1015,894,2020-03-18 07:32:00,1,2415.0,1910.0,0.791,11.63,141,30,19,11,111,39,72,0,0.0,0.0
1015,895,2020-03-18 07:35:00,1,2623.0,2083.0,0.794,12.639,334,86,53,33,248,168,80,0,0.0,0.0
1015,896,2020-03-18 07:38:00,1,2771.0,2133.0,0.77,13.279,534,162,116,46,372,250,122,51,0.0,0.0
1015,897,2020-03-18 07:41:00,1,2591.0,2082.0,0.804,12.515,98,4,1,3,94,43,51,0,0.0,0.0
1015,898,2020-03-18 07:44:00,1,2488.0,1921.0,0.772,11.931,94,0,0,0,94,36,58,0,0.0,0.0
1015,899,2020-03-18 07:47:00,1,2639.0,1955.0,0.741,12.563,111,5,4,1,106,42,64,0,0.0,0.0
1015,900,2020-03-18 07:50:00,1,2382.0,1888.0,0.793,11.477,195,10,2,8,185,116,69,0,0.0,0.0
1015,901,2020-03-18 07:53:00,1,2437.0,1799.0,0.738,11.592,294,0,0,0,294,259,35,0,0.0,0.0
1015,902,2020-03-18 07:56:00,1,2410.0,1785.0,0.741,11.471,315,2,1,1,313,234,79,0,0.0,0.0
1015,903,2020-03-18 07:59:00,1,2427.0,1794.0,0.739,11.548,191,33,7,26,158,77,81,0,0.0,0.0
1015,904,2020-03-18 08:02:00,1,2547.0,1887.0,0.741,12.123,182,13,8,5,169,95,74,0,0.0,0.0
1015,905,2020-03-18 08:05:00,1,2412.0,1839.0,0.762,11.538,139,59,35,24,80,4,76,0,0.0,0.0
1015,906,2020-03-18 08:08:00,1,2389.0,1807.0,0.757,11.414,107,47,8,39,60,2,58,0,0.0,0.0
1015,907,2020-03-18 08:11:00,1,2409.0,1822.0,0.756,11.51,30,0,0,0,30,0,30,0,0.0,0.0
1015,908,2020-03-18 08:14:00,1,2601.0,1988.0,0.764,12.449,189,4,1,3,185,132,53,0,0.0,0.0
1015,909,2020-03-18 08:17:00,1,2382.0,1813.0,0.761,11.393,185,61,40,21,124,66,58,0,0.0,0.0
1015,910,2020-03-18 08:20:00,1,2361.0,1760.0,0.746,11.253,108,10,7,3,98,27,71,0,0.0,0.0
1015,911,2020-03-18 08:23:00,1,2431.0,1797.0,0.739,11.57,156,0,0,0,156,91,65,0,0.0,0.0
1015,912,2020-03-18 08:26:00,1,2279.0,1673.0,0.734,10.833,497,183,131,52,314,221,93,7,0.0,0.02
1015,913,2020-03-18 08:29:00,1,3167.0,2410.0,0.761,15.148,318,112,74,38,206,142,64,19,0.29,0.03
1015,914,2020-03-18 08:32:00,1,2802.5,2148.5,0.7675,13.4215,303,83,53,30,220,149,71,59,0.0,0.12
1015,915,2020-03-18 08:35:00,1,2438.0,1887.0,0.774,11.695,362,127,83,44,235,141,94,39,0.0,0.07
1015,916,2020-03-18 08:38:00,1,3223.0,2582.0,0.801,15.558,878,280,210,70,598,470,128,18,0.0,0.05
1015,917,2020-03-18 08:41:00,1,3178.0,2587.0,0.814,15.387,824,264,199,65,560,446,114,9,0.0,0.18
1015,918,2020-03-18 08:44:00,1,3070.0,2544.0,0.828,14.914,605,213,162,51,392,315,77,14,0.0,0.0
1015,919,2020-03-18 08:47:00,1,2946.0,2477.0,0.841,14.352,928,311,224,87,617,490,127,1,0.0,0.0
1015,920,2020-03-18 08:50:00,1,2964.0,2517.0,0.849,14.465,724,303,233,70,421,320,101,3,0.0,0.0
1015,921,2020-03-18 08:53:00,1,2949.0,2435.0,0.826,14.313,342,145,109,36,197,138,59,12,0.0,0.0
1015,922,2020-03-18 08:56:00,1,2817.0,2344.0,0.832,13.693,106,42,14,28,64,32,32,0,0.0,0.0
1015,923,2020-03-18 08:59:00,1,2929.0,2397.0,0.818,14.193,191,47,14,33,144,86,58,0,0.0,0.01
1015,924,2020-03-18 09:02:00,1,2963.0,2412.0,0.814,14.344,343,124,91,33,219,149,70,0,0.0,0.01
1015,925,2020-03-18 09:05:00,1,2823.0,2316.0,0.821,13.686,252,46,6,40,206,130,76,0,0.0,0.01
1015,926,2020-03-18 09:08:00,1,2969.0,2414.0,0.813,14.37,463,26,5,21,437,321,116,0,0.0,0.0
1015,927,2020-03-18 09:11:00,1,2839.0,2250.0,0.793,13.676,517,90,55,35,427,362,65,0,0.0,0.0
1015,928,2020-03-18 09:14:00,1,2432.0,1928.0,0.793,11.715,255,4,0,4,251,193,58,0,0.0,0.0
1015,929,2020-03-18 09:17:00,1,2622.0,2093.0,0.798,12.65,208,66,46,20,142,88,54,0,0.0,0.01
1015,930,2020-03-18 09:20:00,1,2617.0,1969.0,0.753,12.491,24,0,0,0,24,2,22,0,0.0,0.0
1015,931,2020-03-18 09:23:00,1,2485.0,1908.0,0.768,11.903,38,0,0,0,38,8,30,0,0.0,0.0
1015,932,2020-03-18 09:26:00,1,2488.0,1919.0,0.771,11.929,43,0,0,0,43,7,36,0,0.0,0.02
1015,933,2020-03-18 09:29:00,1,2479.0,1839.0,0.742,11.805,33,0,0,0,33,3,30,0,0.0,0.0
1015,934,2020-03-18 09:32:00,1,2254.0,1752.0,0.777,10.821,33,0,0,0,33,2,31,0,0.0,0.0
1015,935,2020-03-18 09:35:00,1,2291.0,1756.0,0.766,10.969,48,0,0,0,48,19,29,0,0.0,0.0
1015,936,2020-03-18 09:38:00,1,2284.0,1656.0,0.725,10.834,233,46,29,17,187,115,72,1,0.0,0.0
1015,937,2020-03-18 09:41:00,1,2847.0,2230.0,0.783,13.688,252,75,37,38,177,118,59,64,0.0,0.08
1015,938,2020-03-18 09:44:00,1,2834.0,2280.0,0.805,13.691,356,54,42,12,302,221,81,20,0.0,0.0
1015,939,2020-03-18 09:47:00,1,2657.0,2086.0,0.785,12.778,146,19,9,10,127,79,48,0,0.0,0.0
1015,940,2020-03-18 09:50:00,1,2634.0,2008.0,0.762,12.601,55,0,0,0,55,12,43,0,0.0,0.0
1015,941,2020-03-18 09:53:00,1,2482.0,1936.0,0.78,11.921,73,6,2,4,67,26,41,0,0.0,0.0
1015,942,2020-03-18 09:56:00,1,2568.0,2148.0,0.836,12.498,122,1,0,1,121,77,44,0,0.0,0.01
1015,943,2020-03-18 09:59:00,1,2568.0,2196.0,0.855,12.548,115,0,0,0,115,57,58,0,0.0,0.0
1015,944,2020-03-18 10:02:00,1,2713.0,2218.0,0.817,13.145,98,2,1,1,96,37,59,0,0.0,0.0
1015,945,2020-03-18 10:05:00,1,2618.0,2129.0,0.813,12.67,6,1,0,1,5,2,3,0,0.0,0.0
1015,946,2020-03-18 10:08:00,1,2587.0,2067.0,0.799,12.482,2,2,0,2,0,0,0,0,0.0,0.0
1015,947,2020-03-18 10:11:00,1,2727.0,2210.0,0.811,13.19,131,22,13,9,109,62,47,0,0.0,0.0
1015,948,2020-03-18 10:14:00,1,2604.0,2158.0,0.829,12.651,163,12,3,9,151,116,35,0,0.0,0.0
1015,949,2020-03-18 10:17:00,1,2632.0,2072.0,0.787,12.663,174,16,7,9,158,99,59,0,0.0,0.0
1015,950,2020-03-18 10:20:00,1,2600.0,2051.0,0.789,12.515,91,1,1,0,90,70,20,0,0.0,0.0
1015,951,2020-03-18 10:23:00,1,2633.0,2024.0,0.769,12.615,34,12,7,5,22,12,10,0,0.0,0.0
1015,952,2020-03-18 10:26:00,1,2403.0,1817.0,0.756,11.478,148,41,32,9,107,69,38,3,0.0,0.0
1015,953,2020-03-18 10:29:00,1,2084.0,1638.0,0.786,10.024,35,0,0,0,35,6,29,0,0.0,0.0
1015,954,2020-03-18 10:32:00,1,2272.0,1700.0,0.748,10.835,62,1,0,1,61,23,38,0,0.0,0.01
1015,955,2020-03-18 10:35:00,1,2258.0,1715.0,0.759,10.794,153,14,7,7,139,78,61,0,0.0,0.0
1015,956,2020-03-18 10:38:00,1,2244.0,1640.0,0.731,10.656,133,5,1,4,128,68,60,0,0.0,0.0
1015,957,2020-03-18 10:41:00,1,2247.0,1766.0,0.786,10.808,102,4,3,1,98,50,48,0,0.0,0.0
1015,958,2020-03-18 10:44:00,1,2138.0,1568.0,0.733,10.159,64,0,0,0,64,17,47,0,0.0,0.0
1015,959,2020-03-18 10:47:00,1,2101.0,1569.0,0.747,10.016,66,3,0,3,63,26,37,0,0.0,0.0
1015,960,2020-03-18 10:50:00,1,2075.0,1581.0,0.762,9.926,44,2,1,1,42,12,30,0,0.0,0.0
1015,961,2020-03-18 10:53:00,1,2113.0,1592.0,0.754,10.087,43,2,0,2,41,2,39,0,0.0,0.0
1015,962,2020-03-18 10:56:00,1,2120.0,1555.0,0.734,10.074,121,37,10,27,84,41,43,0,0.0,0.0
1015,963,2020-03-18 10:59:00,1,2411.0,1823.0,0.756,11.517,266,73,41,32,193,131,62,56,0.0,0.04
1015,964,2020-03-18 11:02:00,1,2924.0,2324.0,0.795,14.094,429,176,137,39,253,193,60,49,0.01,0.0
1015,965,2020-03-18 11:05:00,1,2940.0,2325.0,0.791,14.157,953,344,255,89,609,490,119,60,0.0,0.0
1015,966,2020-03-18 11:08:00,1,2928.0,2326.0,0.794,14.111,1452,552,421,131,900,706,194,0,0.0,0.04
1015,967,2020-03-18 11:11:00,1,2968.0,2408.0,0.812,14.359,914,346,275,71,568,435,133,6,0.0,0.0
1015,968,2020-03-18 11:14:00,1,2988.0,2446.0,0.819,14.481,623,240,180,60,383,301,82,12,0.0,0.0
1015,969,2020-03-18 11:17:00,1,3118.0,2544.0,0.816,15.103,675,240,181,59,435,347,88,13,0.0,0.0
1015,970,2020-03-18 11:20:00,1,3007.0,2425.0,0.806,14.534,893,306,234,72,587,464,123,6,0.0,0.0
1015,971,2020-03-18 11:23:00,1,2961.0,2375.0,0.802,14.298,538,242,186,56,296,226,70,38,0.0,0.0
1015,972,2020-03-18 11:26:00,1,2674.0,2180.0,0.815,12.949,170,56,37,19,114,70,44,6,0.0,0.0
1015,973,2020-03-18 11:29:00,1,2590.0,2125.0,0.82,12.556,424,68,33,35,356,276,80,0,0.0,0.0
1015,974,2020-03-18 11:32:00,1,2650.0,2147.5,0.8105,12.8185,308,38,8,30,270,188,82,1,0.0,0.0
1015,975,2020-03-18 11:35:00,1,2710.0,2170.0,0.801,13.081,215,31,3,28,184,127,57,0,0.0,0.0
1015,976,2020-03-18 11:38:00,1,2679.0,2114.0,0.789,12.895,336,69,27,42,267,188,79,0,0.0,0.0
1015,977,2020-03-18 11:41:00,1,2971.0,2222.0,0.748,14.168,286,53,28,25,233,149,84,0,0.0,0.0
1015,978,2020-03-18 11:44:00,1,2858.0,2162.0,0.756,13.654,131,13,3,10,118,74,44,0,0.0,0.0
1015,979,2020-03-18 11:47:00,1,2794.0,2121.0,0.759,13.359,37,0,0,0,37,2,35,0,0.0,0.0
1015,980,2020-03-18 11:50:00,1,2691.0,2062.0,0.766,12.885,341,107,72,35,234,165,69,1,0.0,0.0
1015,981,2020-03-18 11:53:00,1,2947.0,2295.0,0.779,14.15,453,124,82,42,329,248,81,2,0.09,0.0
1015,982,2020-03-18 11:56:00,1,2645.0,1921.0,0.726,12.551,195,8,0,8,187,111,76,0,0.0,0.0
1015,983,2020-03-18 11:59:00,1,2500.0,1790.0,0.716,11.833,192,1,0,1,191,120,71,0,0.0,0.0
1015,984,2020-03-18 12:02:00,1,2389.0,1739.0,0.728,11.339,227,20,2,18,207,131,76,0,0.0,0.0
1015,985,2020-03-18 12:05:00,1,2347.0,1776.0,0.757,11.215,179,0,0,0,179,116,63,0,0.0,0.0
1015,986,2020-03-18 12:08:00,1,2548.0,1902.0,0.746,12.147,116,2,0,2,114,66,48,0,0.0,0.0
1015,987,2020-03-18 12:11:00,1,2601.0,1831.0,0.704,12.275,67,0,0,0,67,32,35,0,0.0,0.0
1015,988,2020-03-18 12:14:00,1,2528.0,1785.0,0.706,11.937,105,1,1,0,104,57,47,0,0.0,0.0
1015,989,2020-03-18 12:17:00,1,2528.0,1780.0,0.704,11.932,53,0,0,0,53,27,26,0,0.0,0.0
1015,990,2020-03-18 12:20:00,1,2418.0,1768.0,0.731,11.485,1,0,0,0,1,0,1,0,0.0,0.0
1015,991,2020-03-18 12:23:00,1,2493.0,1779.0,0.714,11.791,20,19,1,18,1,0,1,0,0.0,0.0
1015,992,2020-03-18 12:26:00,1,2340.0,1716.0,0.733,11.118,48,17,10,7,31,18,13,0,0.0,0.0
1015,993,2020-03-18 12:29:00,1,2358.0,1644.0,0.697,11.11,34,0,0,0,34,22,12,0,0.0,0.0
1015,994,2020-03-18 12:32:00,1,2354.0,1702.0,0.723,11.16,0,0,0,0,0,0,0,0,0.0,0.0
1015,995,2020-03-18 12:35:00,1,2398.0,1748.0,0.729,11.386,63,1,1,0,62,15,47,0,0.0,0.0
1015,996,2020-03-18 12:38:00,1,2352.0,1691.0,0.719,11.14,234,2,0,2,232,187,45,0,0.0,0.0
1015,997,2020-03-18 12:41:00,1,2372.0,1667.0,0.703,11.191,376,4,0,4,372,278,94,0,0.0,0.0
1015,998,2020-03-18 12:44:00,1,2177.0,1575.0,0.723,10.321,307,1,0,1,306,226,80,0,0.0,0.0
1015,999,2020-03-18 12:47:00,1,2225.0,1552.0,0.698,10.485,144,0,0,0,144,107,37,0,0.0,0.0
1015,1000,2020-03-18 12:50:00,1,2209.0,1526.0,0.691,10.392,90,12,9,3,78,60,18,0,0.0,0.0
1015,1001,2020-03-18 12:53:00,1,2175.0,1572.0,0.723,10.312,234,0,0,0,234,215,19,0,0.0,0.0
1015,1002,2020-03-18 12:56:00,1,2172.0,1562.0,0.719,10.289,58,13,6,7,45,32,13,0,0.0,0.0
1015,1003,2020-03-18 12:59:00,1,2203.0,1576.0,0.716,10.425,14,8,1,7,6,3,3,0,0.0,0.0
1015,1004,2020-03-18 13:02:00,1,2199.0,1555.0,0.707,10.387,173,52,21,31,121,72,49,0,0.0,0.0
1015,1005,2020-03-18 13:05:00,1,2328.0,1749.0,0.752,11.109,564,71,35,36,493,365,128,0,0.0,0.0
1015,1006,2020-03-18 13:08:00,1,2593.0,1872.0,0.722,12.291,447,66,25,41,381,269,112,1,0.0,0.0
1015,1007,2020-03-18 13:11:00,1,2485.0,1792.0,0.721,11.777,39,2,1,1,37,6,31,0,0.0,0.0
1015,1008,2020-03-18 13:14:00,1,2340.0,1733.0,0.741,11.14,43,3,0,3,40,9,31,0,0.0,0.0
1015,1009,2020-03-18 13:17:00,1,2341.0,1733.0,0.74,11.145,60,3,0,3,57,25,32,0,0.0,0.0
1015,1010,2020-03-18 13:20:00,1,2358.0,1718.0,0.728,11.193,72,16,2,14,56,27,29,0,0.0,0.0
1015,1011,2020-03-18 13:23:00,1,2616.0,1897.0,0.725,12.407,69,0,0,0,69,25,44,0,0.0,0.0
1015,1012,2020-03-18 13:26:00,1,2336.0,1683.0,0.721,11.066,168,10,7,3,158,89,69,0,0.0,0.0
1015,1013,2020-03-18 13:29:00,1,2272.0,1613.0,0.71,10.736,159,3,2,1,156,80,76,0,0.0,0.0
1015,1014,2020-03-18 13:32:00,1,2217.0,1494.0,0.674,10.391,186,14,10,4,172,93,79,16,0.0,0.0
1015,1015,2020-03-18 13:35:00,1,2610.0,1804.0,0.691,12.282,285,118,83,35,167,99,68,66,0.0,0.07
1015,1016,2020-03-18 13:38:00,1,2735.0,1951.0,0.713,12.936,318,106,74,32,212,151,61,78,0.1,0.0
1015,1017,2020-03-18 13:41:00,1,2745.0,1999.0,0.728,13.027,750,272,212,60,478,374,104,18,0.0,0.0
1015,1018,2020-03-18 13:44:00,1,2712.0,2071.0,0.764,12.979,772,299,217,82,473,372,101,2,0.0,0.0
1015,1019,2020-03-18 13:47:00,1,2763.0,2170.0,0.785,13.29,727,303,237,66,424,328,96,65,0.0,0.0
1015,1020,2020-03-18 13:50:00,1,2788.0,2189.0,0.785,13.41,270,21,7,14,249,166,83,1,0.0,0.0
1015,1021,2020-03-18 13:53:00,1,2818.0,2200.0,0.781,13.538,438,41,13,28,397,293,104,2,0.0,0.0
1015,1022,2020-03-18 13:56:00,1,2682.0,2042.0,0.761,12.83,704,16,1,15,688,585,103,0,0.0,0.0
1015,1023,2020-03-18 13:59:00,1,2482.0,1873.0,0.755,11.852,350,1,0,1,349,220,129,0,0.0,0.0
1015,1024,2020-03-18 14:02:00,1,2308.0,1753.0,0.76,11.034,215,18,0,18,197,90,107,0,0.0,0.0
1015,1025,2020-03-18 14:05:00,1,2330.0,1755.0,0.753,11.125,169,25,3,22,144,71,73,0,0.0,0.0
1015,1026,2020-03-18 14:08:00,1,2283.0,1670.0,0.732,10.846,102,3,2,1,99,83,16,0,0.0,0.0
1015,1027,2020-03-18 14:11:00,1,2270.0,1661.0,0.732,10.783,171,11,6,5,160,129,31,0,0.0,0.0
1015,1028,2020-03-18 14:14:00,1,2359.0,1684.0,0.714,11.157,175,2,0,2,173,119,54,0,0.0,0.0
1015,1029,2020-03-18 14:17:00,1,2409.0,1771.0,0.735,11.454,111,11,4,7,100,51,49,0,0.0,0.0
1015,1030,2020-03-18 14:20:00,1,2590.0,1862.0,0.719,12.269,35,1,1,0,34,6,28,0,0.0,0.0
1015,1031,2020-03-18 14:23:00,1,2602.0,1858.0,0.714,12.308,37,0,0,0,37,0,37,0,0.0,0.0
1015,1032,2020-03-18 14:26:00,1,2591.0,1817.0,0.701,12.219,33,0,0,0,33,0,33,0,0.0,0.0
1015,1033,2020-03-18 14:29:00,1,2580.0,1827.0,0.708,12.191,74,7,4,3,67,31,36,0,0.0,0.0
1015,1034,2020-03-18 14:32:00,1,2395.0,1676.0,0.699,11.293,60,1,0,1,59,31,28,0,0.0,0.0
1015,1035,2020-03-18 14:35:00,1,2210.0,1525.0,0.69,10.395,57,2,0,2,55,20,35,0,0.0,0.0
1015,1036,2020-03-18 14:38:00,1,2178.0,1503.0,0.69,10.246,50,0,0,0,50,26,24,0,0.0,0.0
1015,1037,2020-03-18 14:41:00,1,2208.0,1543.0,0.699,10.409,108,1,0,1,107,68,39,0,0.0,0.0
1015,1038,2020-03-18 14:44:00,1,2219.0,1520.0,0.685,10.425,155,17,9,8,138,111,27,0,0.0,0.0
1015,1039,2020-03-18 14:47:00,1,2362.0,1714.0,0.726,11.202,67,0,0,0,67,30,37,0,0.0,0.0
1015,1040,2020-03-18 14:50:00,1,2352.0,1679.0,0.714,11.129,111,5,3,2,106,58,48,0,0.0,0.0
1015,1041,2020-03-18 14:53:00,1,2178.0,1619.0,0.743,10.372,257,18,3,15,239,150,89,0,0.0,0.0
1015,1042,2020-03-18 14:56:00,1,2350.0,1676.0,0.713,11.116,615,101,48,53,514,385,129,0,0.0,0.0
1015,1043,2020-03-18 14:59:00,1,2558.0,1831.0,0.716,12.107,469,75,35,40,394,302,92,0,0.0,0.0
1015,1044,2020-03-18 15:02:00,1,2587.0,1880.0,0.727,12.276,348,37,14,23,311,219,92,0,0.0,0.0
1015,1045,2020-03-18 15:05:00,1,2682.0,1979.0,0.738,12.756,416,59,30,29,357,250,107,0,0.0,0.0
1015,1046,2020-03-18 15:08:00,1,2538.0,1907.0,0.751,12.111,263,49,25,24,214,147,67,7,0.0,0.0
1015,1047,2020-03-18 15:11:00,1,2701.0,2023.0,0.749,12.88,126,34,19,15,92,34,58,110,0.0,0.17
1015,1048,2020-03-18 15:14:00,1,2936.0,2213.0,0.754,14.018,668,259,208,51,409,310,99,41,0.0,0.0
1015,1049,2020-03-18 15:17:00,1,3058.0,2275.0,0.744,14.567,669,270,207,63,399,305,94,11,0.0,0.01
1015,1050,2020-03-18 15:20:00,1,2936.0,2248.0,0.766,14.057,865,358,290,68,507,392,115,56,0.0,0.0
1015,1051,2020-03-18 15:23:00,1,3097.0,2411.0,0.778,14.874,781,303,237,66,478,377,101,5,0.0,0.0
1015,1052,2020-03-18 15:26:00,1,3055.0,2457.0,0.804,14.758,582,183,130,53,399,303,96,6,0.0,0.0
1015,1053,2020-03-18 15:29:00,1,2861.0,2275.0,0.795,13.791,592,207,150,57,385,281,104,1,0.1,0.0
1015,1054,2020-03-18 15:32:00,1,2842.0,2385.0,0.839,13.837,344,122,84,38,222,152,70,0,0.0,0.0
1015,1055,2020-03-18 15:35:00,1,2733.0,2280.0,0.834,13.293,258,12,0,12,246,167,79,0,0.0,0.0
1015,1056,2020-03-18 15:38:00,1,2670.0,2144.0,0.803,12.895,110,0,0,0,110,64,46,0,0.0,0.0
1015,1057,2020-03-18 15:41:00,1,2533.0,2072.0,0.818,12.276,53,0,0,0,53,20,33,0,0.0,0.0
1015,1058,2020-03-18 15:44:00,1,2462.0,2011.0,0.817,11.928,42,0,0,0,42,15,27,0,0.0,0.0
1015,1059,2020-03-18 15:47:00,1,2528.0,2058.0,0.814,12.238,61,1,0,1,60,27,33,0,0.0,0.0
1015,1060,2020-03-18 15:50:00,1,2266.0,1934.0,0.853,11.069,80,0,0,0,80,43,37,0,0.0,0.0
1015,1061,2020-03-18 15:53:00,1,2287.0,1949.0,0.852,11.169,94,21,10,11,73,38,35,0,0.0,0.0
1015,1062,2020-03-18 15:56:00,1,2282.0,1902.0,0.833,11.098,36,0,0,0,36,7,29,0,0.0,0.0
1015,1063,2020-03-18 15:59:00,1,2302.0,1898.0,0.824,11.17,43,2,0,2,41,17,24,0,0.0,0.0
1015,1064,2020-03-18 16:02:00,1,2251.0,1935.0,0.859,11.013,31,0,0,0,31,9,22,0,0.0,0.0
1015,1065,2020-03-18 16:05:00,1,2271.0,1954.0,0.86,11.111,32,0,0,0,32,13,19,0,0.0,0.0
1015,1066,2020-03-18 16:08:00,1,2447.0,1988.0,0.813,11.844,37,0,0,0,37,8,29,0,0.0,0.0
1015,1067,2020-03-18 16:11:00,1,2546.0,2049.0,0.805,12.301,90,38,15,23,52,19,33,0,0.0,0.0
1015,1068,2020-03-18 16:14:00,1,2515.0,2121.0,0.843,12.258,51,8,4,4,43,10,33,0,0.0,0.0
1015,1069,2020-03-18 16:17:00,1,2461.0,2099.0,0.853,12.021,50,7,5,2,43,2,41,0,0.0,0.0
1015,1070,2020-03-18 16:20:00,1,2511.0,2074.0,0.826,12.19,43,7,5,2,36,0,36,0,0.0,0.0
1015,1071,2020-03-18 16:23:00,1,2551.0,2055.0,0.806,12.325,51,9,5,4,42,2,40,0,0.0,0.0
1015,1072,2020-03-18 16:26:00,1,2576.0,2050.0,0.796,12.421,72,4,2,2,68,24,44,0,0.01,0.0
1015,1073,2020-03-18 16:29:00,1,2473.0,2017.0,0.816,11.978,248,69,35,34,179,106,73,0,0.0,0.0
1015,1074,2020-03-18 16:32:00,1,2280.0,1912.0,0.839,11.1,51,3,0,3,48,2,46,0,0.0,0.0
1015,1075,2020-03-18 16:35:00,1,2319.0,1905.0,0.821,11.247,142,25,6,19,117,59,58,0,0.0,0.0
1015,1076,2020-03-18 16:38:00,1,2546.0,1997.0,0.784,12.242,193,44,22,22,149,101,48,0,0.0,0.0
1015,1077,2020-03-18 16:41:00,1,2539.0,1997.0,0.786,12.216,197,58,16,42,139,82,57,0,0.0,0.0
1015,1078,2020-03-18 16:44:00,1,2526.0,2037.0,0.806,12.208,271,64,29,35,207,141,66,0,0.0,0.0
1015,1079,2020-03-18 16:47:00,1,2650.0,2142.0,0.808,12.814,138,31,9,22,107,53,54,0,0.0,0.0
1015,1080,2020-03-18 16:50:00,1,2299.0,1904.0,0.828,11.166,98,13,6,7,85,60,25,0,0.0,0.0
1015,1081,2020-03-18 16:53:00,1,2311.0,1849.0,0.8,11.151,82,9,4,5,73,40,33,0,0.0,0.0
1015,1082,2020-03-18 16:56:00,1,2338.0,1803.0,0.771,11.207,87,17,2,15,70,35,35,0,0.0,0.0
1015,1083,2020-03-18 16:59:00,1,2244.0,1779.0,0.793,10.811,57,5,1,4,52,31,21,0,0.0,0.0
1015,1084,2020-03-18 17:02:00,1,2175.0,1739.0,0.8,10.495,85,24,15,9,61,34,27,21,0.0,0.0
1015,1085,2020-03-18 17:05:00,1,2766.0,2192.0,0.792,13.326,145,48,29,19,97,47,50,105,0.01,0.14
1015,1086,2020-03-18 17:08:00,1,2724.0,2260.0,0.83,13.233,479,189,139,50,290,215,75,39,0.15,0.0
1015,1087,2020-03-18 17:11:00,1,2907.0,2389.0,0.822,14.098,141,24,14,10,117,80,37,0,0.0,0.0
1015,1088,2020-03-18 17:14:00,1,2652.0,2288.0,0.863,12.982,52,11,6,5,41,18,23,0,0.0,0.0
1015,1089,2020-03-18 17:17:00,1,2669.0,2228.0,0.835,12.984,27,3,0,3,24,10,14,0,0.0,0.0
1015,1090,2020-03-18 17:20:00,1,2599.0,2146.0,0.826,12.616,41,17,1,16,24,14,10,0,0.0,0.0
1015,1091,2020-03-18 17:23:00,1,2520.0,2081.0,0.826,12.232,42,7,1,6,35,15,20,0,0.0,0.0
1015,1092,2020-03-18 17:26:00,1,2533.0,2151.0,0.849,12.359,57,7,1,6,50,22,28,0,0.0,0.03
1015,1093,2020-03-18 17:29:00,1,2666.0,2225.0,0.834,12.967,111,20,11,9,91,44,47,0,0.0,0.0
1015,1094,2020-03-18 17:32:00,1,2688.0,2255.0,0.8385,13.0865,454,32,21,11,422,367,55,2,0.0,0.0
1015,1095,2020-03-18 17:35:00,1,2710.0,2285.0,0.843,13.206,13,0,0,0,13,4,9,0,0.0,0.0
1015,1096,2020-03-18 17:38:00,1,2645.0,2202.0,0.832,12.859,27,4,2,2,23,15,8,0,0.0,0.0
1015,1097,2020-03-18 17:41:00,1,2592.0,2171.0,0.838,12.615,20,3,1,2,17,8,9,0,0.0,0.0
1015,1098,2020-03-18 17:44:00,1,2628.0,2161.0,0.822,12.745,27,1,0,1,26,0,26,0,0.0,0.0
1015,1099,2020-03-18 17:47:00,1,2753.0,2278.0,0.827,13.371,39,3,1,2,36,13,23,0,0.0,0.0
1015,1100,2020-03-18 17:50:00,1,2601.0,2191.0,0.842,12.673,217,63,40,23,154,95,59,54,0.0,0.05
1015,1101,2020-03-18 17:53:00,1,2913.0,2486.0,0.853,14.231,183,59,37,22,124,63,61,94,0.33,0.2
1015,1102,2020-03-18 17:56:00,1,2937.0,2460.0,0.838,14.295,123,32,4,28,91,42,49,0,0.0,0.0
1015,1103,2020-03-18 17:59:00,1,3062.0,2721.0,0.889,15.079,123,37,6,31,86,56,30,0,0.0,0.0
1015,1104,2020-03-18 18:02:00,0,3064.0,2720.0,0.888,15.086,64,16,7,9,48,22,26,0,0.0,0.0
1015,1105,2020-03-18 18:05:00,0,2942.0,2595.0,0.882,14.466,19,0,0,0,19,2,17,0,0.0,0.0
1015,1106,2020-03-18 18:08:00,0,2971.0,2565.0,0.864,14.544,28,14,2,12,14,2,12,0,0.0,0.0
1015,1107,2020-03-18 18:11:00,0,2913.0,2486.0,0.853,14.231,19,6,1,5,13,0,13,0,0.0,0.0
1015,1108,2020-03-18 18:14:00,0,2953.0,2529.0,0.856,14.435,14,3,0,3,11,2,9,0,0.0,0.0
1015,1109,2020-03-18 18:17:00,0,2723.0,2394.0,0.879,13.38,27,12,4,8,15,5,10,0,0.0,0.0
1015,1110,2020-03-18 18:20:00,0,2711.0,2405.0,0.887,13.343,114,58,23,35,56,28,28,0,0.0,0.0
1015,1111,2020-03-18 18:23:00,0,2935.0,2600.0,0.886,14.444,166,63,28,35,103,60,43,3,0.0,0.0
1015,1112,2020-03-18 18:26:00,0,2918.0,2646.0,0.907,14.425,153,92,44,48,61,33,28,2,0.0,0.0
1015,1113,2020-03-18 18:29:00,0,3073.0,2736.0,0.89,15.137,147,48,20,28,99,55,44,5,0.0,0.0
1015,1114,2020-03-18 18:32:00,0,3317.0,2902.0,0.875,16.281,665,301,249,52,364,295,69,167,0.01,0.04
1015,1115,2020-03-18 18:35:00,0,3400.0,3006.0,0.884,16.723,934,469,408,61,465,391,74,287,0.0,0.0
1015,1116,2020-03-18 18:38:00,0,3445.0,3041.0,0.883,16.938,520,278,241,37,242,197,45,248,0.31,0.0
1015,1117,2020-03-18 18:41:00,0,3581.0,3113.0,0.869,17.558,685,330,266,64,355,270,85,171,0.0,0.02
1015,1118,2020-03-18 18:44:00,0,3275.0,2921.0,0.892,16.139,535,304,255,49,231,185,46,128,0.05,0.0
1015,1119,2020-03-18 18:47:00,0,3269.0,2911.0,0.891,16.103,611,294,236,58,317,256,61,106,0.0,0.0
1015,1120,2020-03-18 18:50:00,0,3335.0,2930.0,0.879,16.382,297,96,60,36,201,137,64,12,0.0,0.0
1015,1121,2020-03-18 18:53:00,0,3476.0,2966.0,0.853,16.981,466,199,156,43,267,197,70,38,0.0,0.0
1015,1122,2020-03-18 18:56:00,0,3494.0,2921.0,0.836,16.999,525,199,148,51,326,248,78,62,0.0,0.0
1015,1123,2020-03-18 18:59:00,0,3202.0,2703.0,0.844,15.609,189,50,20,30,139,90,49,0,0.0,0.0
1015,1124,2020-03-18 19:02:00,0,3307.0,2772.0,0.838,16.1,112,54,28,26,58,30,28,1,0.0,0.0
1015,1125,2020-03-18 19:05:00,0,3290.0,2776.0,0.844,16.037,115,53,25,28,62,34,28,0,0.0,0.0
1015,1126,2020-03-18 19:08:00,0,2956.0,2492.0,0.843,14.407,42,31,7,24,11,0,11,0,0.0,0.0
1015,1127,2020-03-18 19:11:00,0,2948.0,2457.0,0.833,14.337,42,27,15,12,15,4,11,0,0.0,0.0
1015,1128,2020-03-18 19:14:00,0,2965.0,2466.0,0.832,14.41,76,25,13,12,51,27,24,0,0.0,0.0
1015,1129,2020-03-18 19:17:00,0,3031.0,2535.0,0.836,14.748,53,8,2,6,45,19,26,0,0.0,0.0
1015,1130,2020-03-18 19:20:00,0,3285.0,2728.0,0.83,15.964,156,39,22,17,117,59,58,130,0.0,0.41
1015,1131,2020-03-18 19:23:00,0,3461.0,3028.0,0.875,16.989,244,82,52,30,162,108,54,19,0.0,0.0
1015,1132,2020-03-18 19:26:00,0,3305.0,2840.0,0.859,16.167,721,304,253,51,417,334,83,160,0.0,0.41
1015,1133,2020-03-18 19:29:00,0,3480.0,3006.0,0.864,17.04,659,321,253,68,338,263,75,91,0.0,0.0
1015,1134,2020-03-18 19:32:00,0,3395.0,3042.0,0.896,16.745,713,309,248,61,404,313,91,164,0.11,0.0
1015,1135,2020-03-18 19:35:00,0,3604.0,3177.0,0.882,17.719,139,74,60,14,65,50,15,2,0.0,0.0
1015,1136,2020-03-18 19:38:00,0,3598.0,3192.0,0.887,17.709,2,1,1,0,1,1,0,0,0.0,0.0
1015,1137,2020-03-18 19:41:00,0,3450.0,3045.0,0.882,16.965,0,0,0,0,0,0,0,0,0.0,0.0
1015,1138,2020-03-18 19:44:00,0,3239.0,2901.0,0.896,15.973,44,24,21,3,20,15,5,0,0.0,0.0
1015,1139,2020-03-18 19:47:00,0,2707.0,2357.0,0.871,13.276,216,35,16,19,181,123,58,1,0.24,0.0
1015,1140,2020-03-18 19:50:00,0,2707.0,2407.0,0.889,13.333,75,18,4,14,57,46,11,0,0.0,0.0
1015,1141,2020-03-18 19:53:00,0,3061.0,2671.0,0.872,15.016,79,6,2,4,73,31,42,0,0.0,0.0
1015,1142,2020-03-18 19:56:00,0,2892.0,2629.0,0.909,14.305,24,1,0,1,23,9,14,0,0.0,0.0
1015,1143,2020-03-18 19:59:00,0,2914.0,2561.0,0.879,14.319,38,6,5,1,32,14,18,0,0.0,0.0
1015,1144,2020-03-18 20:02:00,0,2935.0,2641.0,0.9,14.488,33,14,1,13,19,8,11,0,0.0,0.0
1015,1145,2020-03-18 20:05:00,0,2690.0,2468.0,0.917,13.33,302,127,93,34,175,122,53,8,0.1,0.0
1015,1146,2020-03-18 20:08:00,0,3015.0,2667.0,0.885,14.833,124,62,22,40,62,24,38,2,0.0,0.0
1015,1147,2020-03-18 20:11:00,0,3061.0,2738.0,0.895,15.09,130,55,11,44,75,42,33,0,0.0,0.0
1015,1148,2020-03-18 20:14:00,0,2903.0,2682.0,0.924,14.407,44,7,2,5,37,18,19,0,0.0,0.0
1015,1149,2020-03-18 20:17:00,0,2854.0,2494.0,0.874,14.007,20,5,2,3,15,8,7,0,0.0,0.0
1015,1150,2020-03-18 20:20:00,0,2932.0,2565.0,0.875,14.391,22,0,0,0,22,6,16,0,0.0,0.0
1015,1151,2020-03-18 20:23:00,0,2906.0,2579.0,0.888,14.306,111,44,32,12,67,42,25,0,0.0,0.0
1015,1152,2020-03-18 20:26:00,0,3091.0,2701.0,0.874,15.17,20,3,0,3,17,7,10,0,0.0,0.0
1015,1153,2020-03-18 20:29:00,0,3092.0,2685.0,0.868,15.157,110,43,26,17,67,44,23,5,0.18,0.0
1015,1154,2020-03-18 20:32:00,0,3077.0,2703.0,0.8785,15.1155,202,100,47,53,102,59,43,0,0.01,0.0
1015,1155,2020-03-18 20:35:00,0,3062.0,2721.0,0.889,15.074,315,79,32,47,236,175,61,3,0.0,0.0
1015,1156,2020-03-18 20:38:00,0,3071.0,2777.0,0.904,15.175,33,20,1,19,13,6,7,0,0.0,0.0
1015,1157,2020-03-18 20:41:00,0,2919.0,2596.0,0.889,14.374,103,29,5,24,74,44,30,0,0.0,0.0
1015,1158,2020-03-18 20:44:00,0,3302.0,2889.0,0.875,16.207,295,106,71,35,189,133,56,19,0.0,0.0
1015,1159,2020-03-18 20:47:00,0,3315.0,2947.0,0.889,16.325,28,4,0,4,24,0,24,0,0.0,0.0
1015,1160,2020-03-18 20:50:00,0,3398.0,3039.0,0.894,16.751,133,60,47,13,73,42,31,12,0.0,0.0
1015,1161,2020-03-18 20:53:00,0,2633.0,2306.0,0.876,12.926,573,271,220,51,302,228,74,117,0.22,0.0
1015,1162,2020-03-18 20:56:00,0,2937.0,2592.0,0.883,14.44,749,342,287,55,407,334,73,258,0.0,0.0
1015,1163,2020-03-18 20:59:00,0,3581.0,3247.0,0.907,17.704,547,268,208,60,279,223,56,113,0.0,0.0
1015,1164,2020-03-18 21:02:00,0,2678.0,2353.0,0.878,13.156,649,262,213,49,387,301,86,99,0.01,0.0
1015,1165,2020-03-18 21:05:00,0,3957.0,3451.0,0.872,19.412,844,354,283,71,490,395,95,123,0.01,0.0
1015,1166,2020-03-18 21:08:00,0,3132.0,2785.0,0.889,15.422,434,208,177,31,226,170,56,232,0.27,0.07
1015,1167,2020-03-18 21:11:00,0,3397.0,2989.0,0.88,16.694,814,404,317,87,410,335,75,136,0.0,0.0
1015,1168,2020-03-18 21:14:00,0,3038.0,2599.0,0.855,14.848,575,213,164,49,362,285,77,206,0.0,0.0
1015,1169,2020-03-18 21:17:00,0,3806.0,3384.0,0.889,18.741,390,212,175,37,178,137,41,201,0.36,0.0
1015,1170,2020-03-18 21:20:00,0,3758.0,3353.0,0.892,18.518,244,114,70,44,130,75,55,5,0.0,0.0
1015,1171,2020-03-18 21:23:00,0,3776.0,3456.0,0.915,18.705,192,65,26,39,127,70,57,1,0.0,0.0
1015,1172,2020-03-18 21:26:00,0,3764.0,3341.0,0.888,18.529,78,36,11,25,42,18,24,0,0.0,0.0
1015,1173,2020-03-18 21:29:00,0,3475.0,2996.0,0.862,17.01,11,4,1,3,7,3,4,0,0.0,0.0
1015,1174,2020-03-18 21:32:00,0,3134.0,2727.0,0.87,15.368,11,1,0,1,10,4,6,0,0.0,0.0
1015,1175,2020-03-18 21:35:00,0,3137.0,2710.0,0.864,15.362,44,3,0,3,41,21,20,0,0.0,0.0
1015,1176,2020-03-18 21:38:00,0,3119.0,2691.0,0.863,15.269,54,6,2,4,48,38,10,0,0.0,0.0
1015,1177,2020-03-18 21:41:00,0,3043.0,2626.0,0.863,14.897,133,8,1,7,125,89,36,0,0.0,0.0
1015,1178,2020-03-18 21:44:00,0,3035.0,2703.0,0.891,14.949,440,28,20,8,412,336,76,59,0.0,0.0
1015,1179,2020-03-18 21:47:00,0,3442.0,3003.0,0.872,16.888,123,25,20,5,98,67,31,27,0.29,0.02
1015,1180,2020-03-18 21:50:00,0,3374.0,2928.0,0.868,16.535,586,226,169,57,360,281,79,126,0.0,0.01
1015,1181,2020-03-18 21:53:00,0,3432.0,3072.0,0.895,16.922,556,239,182,57,317,261,56,122,0.0,0.02
1015,1182,2020-03-18 21:56:00,0,3260.0,2929.0,0.899,16.087,645,319,274,45,326,265,61,240,0.0,0.0
1015,1183,2020-03-18 21:59:00,0,4175.0,3703.0,0.887,20.549,777,317,270,47,460,361,99,99,0.0,0.0
1015,1184,2020-03-18 22:02:00,0,3420.0,3008.0,0.88,16.807,421,195,147,48,226,179,47,73,0.52,0.0
1015,1185,2020-03-18 22:05:00,0,3919.0,3590.0,0.916,19.417,278,138,118,20,140,111,29,121,0.0,0.0
1015,1186,2020-03-18 22:08:00,0,3792.0,3397.0,0.896,18.701,886,425,367,58,461,387,74,372,0.0,0.0
1015,1187,2020-03-18 22:11:00,0,4061.0,3699.0,0.911,20.095,151,66,34,32,85,59,26,52,0.0,0.0
1015,1188,2020-03-18 22:14:00,0,3944.0,3527.0,0.894,19.444,29,7,3,4,22,5,17,2,0.0,0.0
1015,1189,2020-03-18 22:17:00,0,3774.0,3496.0,0.926,18.739,25,1,0,1,24,2,22,2,0.0,0.0
1015,1190,2020-03-18 22:20:00,0,3552.0,3317.0,0.934,17.667,21,0,0,0,21,0,21,1,0.0,0.0
1015,1191,2020-03-18 22:23:00,0,3389.0,3070.0,0.906,16.753,19,12,3,9,7,5,2,9,0.0,0.0
1015,1192,2020-03-18 22:26:00,0,3494.0,3090.0,0.884,17.186,115,60,47,13,55,42,13,5,0.0,0.0
1015,1193,2020-03-18 22:29:00,0,2576.0,2298.0,0.892,12.694,128,44,22,22,84,49,35,15,0.0,0.0
1015,1194,2020-03-18 22:32:00,0,2971.0,2680.0,0.902,14.675,101,42,12,30,59,32,27,0,0.0,0.0
1015,1195,2020-03-18 22:35:00,0,3168.0,2855.0,0.901,15.643,200,95,66,29,105,74,31,9,0.0,0.0
1015,1196,2020-03-18 22:38:00,0,3037.0,2833.0,0.933,15.104,375,186,143,43,189,141,48,62,0.0,0.0
1015,1197,2020-03-18 22:41:00,0,2916.0,2618.0,0.898,14.387,899,368,291,77,531,420,111,27,0.0,0.0
1015,1198,2020-03-18 22:44:00,0,3456.0,3051.0,0.883,16.996,576,275,224,51,301,231,70,126,0.0,0.01
1015,1199,2020-03-18 22:47:00,0,3046.0,2760.0,0.906,15.058,657,266,205,61,391,309,82,128,0.23,0.0
1015,1200,2020-03-18 22:50:00,0,3442.0,3080.0,0.895,16.971,636,256,202,54,380,297,83,165,0.02,0.0
1015,1201,2020-03-18 22:53:00,0,3076.0,2777.0,0.903,15.192,455,154,112,42,301,222,79,35,0.16,0.1
1015,1202,2020-03-18 22:56:00,0,3411.0,3152.0,0.924,16.93,108,41,30,11,67,47,20,18,0.0,0.0
1015,1203,2020-03-18 22:59:00,0,3584.0,3280.0,0.915,17.752,17,13,8,5,4,1,3,22,0.0,0.0
1015,1204,2020-03-18 23:02:00,0,2876.0,2631.0,0.915,14.245,432,192,148,44,240,187,53,106,0.07,0.0
1015,1205,2020-03-18 23:05:00,0,3336.0,2994.0,0.898,16.46,316,136,103,33,180,139,41,59,0.1,0.0
1015,1206,2020-03-18 23:08:00,0,3564.0,3245.0,0.91,17.636,0,0,0,0,0,0,0,0,0.0,0.0
1015,1207,2020-03-18 23:11:00,0,3429.0,3007.0,0.877,16.837,0,0,0,0,0,0,0,0,0.01,0.0
1015,1208,2020-03-18 23:14:00,0,3306.0,2891.0,0.874,16.228,0,0,0,0,0,0,0,0,0.0,0.0
1015,1209,2020-03-18 23:17:00,0,3038.0,2765.0,0.91,15.032,2,2,1,1,0,0,0,0,0.0,0.0
1015,1210,2020-03-18 23:20:00,0,2928.0,2538.0,0.867,14.345,1,0,0,0,1,1,0,0,0.0,0.0
1015,1211,2020-03-18 23:23:00,0,2774.0,2504.0,0.903,13.701,138,50,29,21,88,40,48,54,0.32,0.0
1015,1212,2020-03-18 23:26:00,0,2958.0,2537.0,0.858,14.464,366,155,109,46,211,130,81,92,0.0,0.0
1015,1213,2020-03-18 23:29:00,0,2896.0,2650.0,0.915,14.343,555,249,200,49,306,231,75,105,0.0,0.0
1015,1214,2020-03-18 23:32:00,0,3105.5,2811.5,0.906,15.348,504,221,166,55,283,218,65,38,0.0,0.0
1015,1215,2020-03-18 23:35:00,0,3315.0,2973.0,0.897,16.353,496,149,107,42,347,271,76,76,0.11,0.0
1015,1216,2020-03-18 23:38:00,0,3415.0,3043.0,0.891,16.826,238,87,38,49,151,92,59,22,0.0,0.0
1015,1217,2020-03-18 23:41:00,0,3398.0,3094.0,0.91,16.814,337,65,24,41,272,177,95,6,0.0,0.0
1015,1218,2020-03-18 23:44:00,0,3416.0,3039.0,0.89,16.825,130,34,20,14,96,55,41,0,0.0,0.0
1015,1219,2020-03-18 23:47:00,0,3076.0,2767.0,0.9,15.183,2,2,0,2,0,0,0,0,0.0,0.0
1015,1220,2020-03-18 23:50:00,0,2976.0,2629.0,0.884,14.634,4,1,0,1,3,2,1,0,0.0,0.0
1015,1221,2020-03-18 23:53:00,0,2985.0,2564.0,0.859,14.597,4,2,0,2,2,2,0,0,0.0,0.0
1015,1222,2020-03-18 23:56:00,0,2940.0,2632.0,0.895,14.496,31,4,0,4,27,17,10,0,0.0,0.0
1015,1223,2020-03-18 23:59:00,0,2768.0,2427.0,0.877,13.591,62,14,3,11,48,28,20,0,0.0,0.0
1015,1224,2020-03-19 00:02:00,0,2748.0,2299.0,0.837,13.371,38,3,0,3,35,3,32,0,0.0,0.0
1015,1225,2020-03-19 00:05:00,0,2550.0,2208.0,0.866,12.492,137,33,5,28,104,34,70,0,0.0,0.0
1015,1226,2020-03-19 00:08:00,0,3061.0,2660.0,0.869,15.003,305,118,89,29,187,89,98,97,0.0,0.0
1015,1227,2020-03-19 00:11:00,0,3350.0,2926.0,0.873,16.436,280,128,86,42,152,80,72,89,0.0,0.0
1015,1228,2020-03-19 00:14:00,0,3271.0,2908.0,0.889,16.108,479,210,175,35,269,216,53,144,0.33,0.0
1015,1229,2020-03-19 00:17:00,0,4063.0,3703.0,0.911,20.11,666,283,223,60,383,300,83,116,0.0,0.0
1015,1230,2020-03-19 00:20:00,0,3479.0,3065.0,0.881,17.1,694,350,282,68,344,271,73,241,0.0,0.0
1015,1231,2020-03-19 00:23:00,0,3480.0,3069.0,0.882,17.111,617,356,286,70,261,215,46,199,0.0,0.0
1015,1232,2020-03-19 00:26:00,0,3429.0,3040.0,0.887,16.874,562,231,168,63,331,259,72,70,0.27,0.06
1015,1233,2020-03-19 00:29:00,0,3459.0,3030.0,0.876,16.982,468,190,149,41,278,200,78,121,0.0,0.0
1015,1234,2020-03-19 00:32:00,0,3656.0,3330.0,0.911,18.089,1000,434,367,67,566,459,107,218,0.0,0.0
1015,1235,2020-03-19 00:35:00,0,3817.0,3372.0,0.883,18.771,716,280,216,64,436,333,103,113,0.0,0.0
1015,1236,2020-03-19 00:38:00,0,3195.0,2796.0,0.875,15.684,758,279,223,56,479,384,95,58,0.0,0.0
1015,1237,2020-03-19 00:41:00,0,3605.0,3138.0,0.87,17.679,643,261,202,59,382,306,76,157,0.0,0.0
1015,1238,2020-03-19 00:44:00,0,3530.0,3133.0,0.887,17.378,787,256,197,59,531,426,105,30,0.49,0.0
1015,1239,2020-03-19 00:47:00,0,3469.0,3063.0,0.883,17.061,432,128,81,47,304,225,79,10,0.0,0.23
1015,1240,2020-03-19 00:50:00,0,3433.0,3039.0,0.885,16.892,120,77,39,38,43,24,19,1,0.0,0.0
1015,1241,2020-03-19 00:53:00,0,3532.0,3052.0,0.864,17.296,603,267,224,43,336,260,76,35,0.0,0.0
1015,1242,2020-03-19 00:56:00,0,3461.0,3012.0,0.87,16.972,189,85,70,15,104,86,18,40,0.05,0.0
1015,1243,2020-03-19 00:59:00,0,3439.0,2926.0,0.851,16.788,0,0,0,0,0,0,0,0,0.0,0.0
1015,1244,2020-03-19 01:02:00,0,3308.0,2762.0,0.835,16.091,90,30,16,14,60,39,21,0,0.0,0.0
1015,1245,2020-03-19 01:05:00,0,2982.0,2459.0,0.825,14.473,205,77,43,34,128,76,52,1,0.0,0.0
1015,1246,2020-03-19 01:08:00,0,3115.0,2621.0,0.841,15.173,254,68,30,38,186,104,82,0,0.0,0.0
1015,1247,2020-03-19 01:11:00,0,3121.0,2608.0,0.836,15.186,35,27,1,26,8,2,6,0,0.0,0.0
1015,1248,2020-03-19 01:14:00,0,2942.0,2418.0,0.822,14.269,28,10,7,3,18,12,6,0,0.0,0.0
1015,1249,2020-03-19 01:17:00,0,2766.0,2334.0,0.844,13.481,12,3,1,2,9,2,7,0,0.0,0.0
1015,1250,2020-03-19 01:20:00,0,2967.0,2358.0,0.795,14.302,7,1,0,1,6,0,6,0,0.0,0.0
1015,1251,2020-03-19 01:23:00,0,2977.0,2329.0,0.782,14.307,11,2,2,0,9,4,5,0,0.0,0.0
1015,1252,2020-03-19 01:26:00,0,2908.0,2295.0,0.789,13.998,35,8,5,3,27,8,19,0,0.0,0.0
1015,1253,2020-03-19 01:29:00,0,2994.0,2353.0,0.786,14.404,213,101,52,49,112,24,88,72,0.0,0.0
1015,1254,2020-03-19 01:32:00,0,3112.0,2427.0,0.78,14.95,161,70,31,39,91,10,81,83,0.0,0.0
1015,1255,2020-03-19 01:35:00,0,3116.0,2504.0,0.803,15.051,297,110,68,42,187,108,79,105,0.0,0.0
1015,1256,2020-03-19 01:38:00,0,3116.0,2580.0,0.828,15.132,187,80,63,17,107,78,29,43,0.0,0.0
1015,1257,2020-03-19 01:41:00,0,3641.0,3040.0,0.835,17.712,0,0,0,0,0,0,0,1,0.0,0.0
1015,1258,2020-03-19 01:44:00,0,3798.0,3242.0,0.853,18.555,131,71,59,12,60,38,22,42,0.0,0.0
1015,1259,2020-03-19 01:47:00,0,2953.0,2428.0,0.822,14.324,617,300,239,61,317,248,69,100,0.13,0.0
1015,1260,2020-03-19 01:50:00,0,3185.0,2674.0,0.839,15.509,367,168,137,31,199,163,36,119,0.15,0.0
1015,1261,2020-03-19 01:53:00,0,3082.0,2682.0,0.87,15.113,996,462,380,82,534,425,109,31,0.0,0.0
1015,1262,2020-03-19 01:56:00,0,3513.0,2927.0,0.833,17.081,838,319,256,63,519,417,102,102,0.0,0.0
1015,1263,2020-03-19 01:59:00,0,3358.0,2781.0,0.828,16.311,195,114,60,54,81,8,73,109,0.0,0.0
1015,1264,2020-03-19 02:02:00,0,3382.0,2794.0,0.826,16.418,146,70,32,38,76,9,67,119,0.0,0.0
1015,1265,2020-03-19 02:05:00,0,3464.0,2880.0,0.831,16.839,120,54,37,17,66,29,37,75,0.0,0.06
1015,1266,2020-03-19 02:08:00,0,2735.0,2285.0,0.835,13.308,463,167,127,40,296,238,58,109,0.0,0.0
1015,1267,2020-03-19 02:11:00,0,3192.0,2733.0,0.856,15.604,664,264,211,53,400,294,106,73,0.0,0.0
1015,1268,2020-03-19 02:14:00,0,3437.0,2941.0,0.856,16.797,606,241,172,69,365,272,93,0,0.0,0.0
1015,1269,2020-03-19 02:17:00,0,3475.0,2989.0,0.86,17.002,943,325,250,75,618,501,117,7,0.0,0.06
1015,1270,2020-03-19 02:20:00,0,3456.0,2963.0,0.857,16.898,601,251,193,58,350,265,85,12,0.03,0.0
1015,1271,2020-03-19 02:23:00,0,3314.0,2903.0,0.876,16.273,543,210,161,49,333,246,87,18,0.0,0.0
1015,1272,2020-03-19 02:26:00,0,3266.0,2772.0,0.849,15.939,135,58,22,36,77,31,46,0,0.0,0.0
1015,1273,2020-03-19 02:29:00,0,3233.0,2755.0,0.852,15.788,110,68,17,51,42,15,27,0,0.0,0.0
1015,1274,2020-03-19 02:32:00,0,3098.5,2602.5,0.8395,15.0905,12,8,0,8,4,2,2,0,0.0,0.0
1015,1275,2020-03-19 02:35:00,0,2964.0,2450.0,0.827,14.393,31,4,1,3,27,8,19,0,0.0,0.0
1015,1276,2020-03-19 02:38:00,0,2703.0,2331.0,0.863,13.23,48,3,0,3,45,13,32,0,0.01,0.0
1015,1277,2020-03-19 02:41:00,0,2706.0,2329.0,0.861,13.241,50,23,0,23,27,7,20,0,0.0,0.0
1015,1278,2020-03-19 02:44:00,0,2743.0,2288.0,0.834,13.34,70,5,0,5,65,22,43,0,0.0,0.0
1015,1279,2020-03-19 02:47:00,0,2705.0,2305.0,0.852,13.208,65,2,0,2,63,28,35,0,0.0,0.0
1015,1280,2020-03-19 02:50:00,0,2574.0,2173.0,0.844,12.549,179,0,0,0,179,135,44,0,0.0,0.0
1015,1281,2020-03-19 02:53:00,0,2777.0,2345.0,0.844,13.538,132,23,14,9,109,57,52,0,0.0,0.0
1015,1282,2020-03-19 02:56:00,0,2621.0,2149.0,0.82,12.706,148,48,33,15,100,58,42,0,0.15,0.0
1015,1283,2020-03-19 02:59:00,0,2704.0,2298.0,0.85,13.199,95,65,27,38,30,8,22,0,0.0,0.0
1015,1284,2020-03-19 03:02:00,0,2950.0,2485.0,0.843,14.373,110,56,26,30,54,19,35,1,0.0,0.0
1015,1285,2020-03-19 03:05:00,0,2945.0,2553.0,0.867,14.431,97,25,10,15,72,39,33,0,0.0,0.0
1015,1286,2020-03-19 03:08:00,0,2706.0,2359.0,0.872,13.273,45,10,4,6,35,22,13,0,0.0,0.0
1015,1287,2020-03-19 03:11:00,0,2992.0,2435.0,0.814,14.485,47,9,0,9,38,7,31,0,0.0,0.0
1015,1288,2020-03-19 03:14:00,0,2946.0,2524.0,0.857,14.403,51,2,1,1,49,14,35,0,0.0,0.0
1015,1289,2020-03-19 03:17:00,0,2728.0,2324.0,0.852,13.322,406,111,75,36,295,206,89,20,0.0,0.0
1015,1290,2020-03-19 03:20:00,0,2961.0,2411.0,0.814,14.337,21,2,1,1,19,11,8,0,0.0,0.0
1015,1291,2020-03-19 03:23:00,0,2913.0,2403.0,0.825,14.137,24,4,1,3,20,2,18,0,0.0,0.0
1015,1292,2020-03-19 03:26:00,0,2936.0,2523.0,0.859,14.361,64,32,0,32,32,12,20,0,0.0,0.0
1015,1293,2020-03-19 03:29:00,0,2940.0,2463.0,0.838,14.31,85,37,24,13,48,29,19,3,0.0,0.0
1015,1294,2020-03-19 03:32:00,0,2772.0,2234.0,0.806,13.396,326,129,92,37,197,120,77,101,0.0,0.0
1015,1295,2020-03-19 03:35:00,0,2948.0,2473.0,0.839,14.354,138,73,45,28,65,18,47,95,0.0,0.18
1015,1296,2020-03-19 03:38:00,0,2946.0,2485.0,0.843,14.359,331,174,145,29,157,120,37,209,0.0,0.0
1015,1297,2020-03-19 03:41:00,0,3431.0,2932.0,0.855,16.764,718,333,281,52,385,317,68,268,0.35,0.0
1015,1298,2020-03-19 03:44:00,0,4001.0,3456.0,0.864,19.59,825,379,302,77,446,347,99,142,0.0,0.0
1015,1299,2020-03-19 03:47:00,0,3320.0,2890.0,0.871,16.28,948,316,252,64,632,513,119,64,0.0,0.0
1015,1300,2020-03-19 03:50:00,0,3254.0,2860.0,0.879,15.989,426,204,155,49,222,157,65,14,0.36,0.0
1015,1301,2020-03-19 03:53:00,0,3296.0,2832.0,0.859,16.124,240,42,7,35,198,144,54,0,0.0,0.0
1015,1302,2020-03-19 03:56:00,0,3306.0,2754.0,0.833,16.073,140,52,16,36,88,54,34,0,0.0,0.0
1015,1303,2020-03-19 03:59:00,0,2893.0,2503.0,0.865,14.171,92,11,2,9,81,63,18,0,0.0,0.0
1015,1304,2020-03-19 04:02:00,0,2960.0,2482.0,0.838,14.411,15,5,1,4,10,7,3,0,0.0,0.0
1015,1305,2020-03-19 04:05:00,0,2743.0,2396.0,0.873,13.459,19,14,5,9,5,2,3,0,0.0,0.0
1015,1306,2020-03-19 04:08:00,0,3115.0,2702.0,0.868,15.263,33,15,8,7,18,11,7,0,0.0,0.0
1015,1307,2020-03-19 04:11:00,0,3062.0,2681.0,0.875,15.034,14,4,3,1,10,3,7,0,0.0,0.0
1015,1308,2020-03-19 04:14:00,0,2848.0,2399.0,0.842,13.879,14,2,1,1,12,6,6,0,0.0,0.0
1015,1309,2020-03-19 04:17:00,0,2922.0,2521.0,0.863,14.305,88,25,19,6,63,36,27,1,0.0,0.0
1015,1310,2020-03-19 04:20:00,0,2691.0,2334.0,0.867,13.188,33,14,1,13,19,10,9,0,0.0,0.0
1015,1311,2020-03-19 04:23:00,0,2774.0,2337.0,0.843,13.518,35,19,2,17,16,9,7,0,0.0,0.0
1015,1312,2020-03-19 04:26:00,0,2948.0,2412.0,0.818,14.285,240,61,28,33,179,136,43,1,0.0,0.0
1015,1313,2020-03-19 04:29:00,0,3234.0,2730.0,0.844,15.764,421,77,31,46,344,244,100,0,0.0,0.0
1015,1314,2020-03-19 04:32:00,0,3293.0,2743.0,0.833,16.01,452,153,112,41,299,228,71,54,0.0,0.0
1015,1315,2020-03-19 04:35:00,0,2653.0,2344.0,0.883,13.049,12,1,0,1,11,2,9,2,0.0,0.0
1015,1316,2020-03-19 04:38:00,0,2618.0,2165.0,0.827,12.71,14,0,0,0,14,0,14,0,0.0,0.0
1015,1317,2020-03-19 04:41:00,0,2715.0,2335.0,0.86,13.282,118,38,23,15,80,31,49,3,0.0,0.0
1015,1318,2020-03-19 04:44:00,0,3024.0,2461.0,0.814,14.64,74,8,1,7,66,28,38,0,0.0,0.0
1015,1319,2020-03-19 04:47:00,0,3075.0,2536.0,0.825,14.924,40,0,0,0,40,19,21,0,0.0,0.0
1015,1320,2020-03-19 04:50:00,0,3131.0,2523.0,0.806,15.129,155,60,46,14,95,58,37,18,0.0,0.0
1015,1321,2020-03-19 04:53:00,0,3140.0,2490.0,0.793,15.128,149,56,36,20,93,15,78,118,0.0,0.09
1015,1322,2020-03-19 04:56:00,0,3326.0,2687.0,0.808,16.079,253,85,54,31,168,114,54,32,0.0,0.03
1015,1323,2020-03-19 04:59:00,0,3144.0,2557.0,0.813,15.216,806,324,269,55,482,387,95,163,0.0,0.0
1015,1324,2020-03-19 05:02:00,0,3322.0,2730.0,0.822,16.112,481,205,162,43,276,222,54,173,0.0,0.01
1015,1325,2020-03-19 05:05:00,0,3610.0,3089.0,0.856,17.642,618,284,226,58,334,252,82,146,0.0,0.0
1015,1326,2020-03-19 05:08:00,0,3394.0,2870.0,0.846,16.55,850,250,207,43,600,465,135,35,0.0,0.03
1015,1327,2020-03-19 05:11:00,0,3440.0,2975.0,0.865,16.848,361,157,118,39,204,155,49,129,0.0,0.0
1015,1328,2020-03-19 05:14:00,0,3409.0,2941.0,0.863,16.688,410,179,149,30,231,187,44,131,0.0,0.0
1015,1329,2020-03-19 05:17:00,0,3345.0,2797.0,0.836,16.275,445,198,154,44,247,191,56,97,0.0,0.0
1015,1330,2020-03-19 05:20:00,0,3330.0,2748.0,0.825,16.163,0,0,0,0,0,0,0,0,0.0,0.0
1015,1331,2020-03-19 05:23:00,0,3348.0,2810.0,0.839,16.301,152,61,49,12,91,69,22,2,0.0,0.0
1015,1332,2020-03-19 05:26:00,0,2589.0,2046.0,0.79,12.466,544,197,136,61,347,257,90,10,0.0,0.0
1015,1333,2020-03-19 05:29:00,0,2766.0,2224.0,0.804,13.361,325,140,94,46,185,125,60,15,0.0,0.0
1015,1334,2020-03-19 05:32:00,0,2953.0,2385.0,0.8075,14.275,364,140,102,38,224,156,68,5,0.0,0.0
1015,1335,2020-03-19 05:35:00,0,3140.0,2546.0,0.811,15.189,254,81,32,49,173,103,70,4,0.0,0.0
1015,1336,2020-03-19 05:38:00,0,3205.0,2651.0,0.827,15.561,192,72,41,31,120,58,62,0,0.0,0.0
1015,1337,2020-03-19 05:41:00,0,3105.0,2489.0,0.802,14.992,159,6,3,3,153,87,66,0,0.0,0.0
1015,1338,2020-03-19 05:44:00,0,2931.0,2351.0,0.802,14.152,56,20,9,11,36,22,14,0,0.0,0.0
1015,1339,2020-03-19 05:47:00,0,2757.0,2191.0,0.795,13.289,1,0,0,0,1,1,0,0,0.0,0.0
1015,1340,2020-03-19 05:50:00,0,2773.0,2175.0,0.785,13.333,53,24,11,13,29,16,13,0,0.0,0.0
1015,1341,2020-03-19 05:53:00,0,2630.0,2068.0,0.786,12.653,58,0,0,0,58,7,51,0,0.0,0.0
1015,1342,2020-03-19 05:56:00,0,2496.0,1908.0,0.764,11.948,61,0,0,0,61,12,49,0,0.0,0.0
1015,1343,2020-03-19 05:59:00,0,2486.0,1920.0,0.773,11.919,62,0,0,0,62,18,44,0,0.0,0.0
1015,1344,2020-03-19 06:02:00,1,2837.0,2117.0,0.746,13.521,148,48,32,16,100,50,50,64,0.0,0.04
1015,1345,2020-03-19 06:05:00,1,3140.0,2512.0,0.8,15.151,82,37,22,15,45,10,35,86,0.0,0.71
1015,1346,2020-03-19 06:08:00,1,3313.0,2636.0,0.795,15.973,233,89,65,24,144,103,41,58,0.0,0.0
1015,1347,2020-03-19 06:11:00,1,3283.0,2647.0,0.807,15.865,584,274,218,56,310,245,65,159,0.0,0.03
1015,1348,2020-03-19 06:14:00,1,3469.0,2916.0,0.841,16.896,296,124,103,21,172,134,38,174,0.17,0.0
1015,1349,2020-03-19 06:17:00,1,3343.0,2811.0,0.841,16.282,599,209,164,45,390,305,85,70,0.0,0.0
1015,1350,2020-03-19 06:20:00,1,3476.0,2883.0,0.829,16.889,790,321,245,76,469,359,110,0,0.0,0.0
1015,1351,2020-03-19 06:23:00,1,3478.0,2903.0,0.835,16.918,461,166,119,47,295,211,84,12,0.18,0.0
1015,1352,2020-03-19 06:26:00,1,3415.0,3035.0,0.889,16.816,534,248,199,49,286,215,71,5,0.0,0.06
1015,1353,2020-03-19 06:29:00,1,3313.0,2907.0,0.878,16.272,360,135,96,39,225,164,61,14,0.0,0.0
1015,1354,2020-03-19 06:32:00,1,3462.0,2980.0,0.861,16.94,128,77,33,44,51,25,26,2,0.0,0.0
1015,1355,2020-03-19 06:35:00,1,3424.0,2940.0,0.859,16.745,164,127,69,58,37,13,24,0,0.0,0.0
1015,1356,2020-03-19 06:38:00,1,3301.0,2901.0,0.879,16.218,45,24,13,11,21,8,13,0,0.0,0.0
1015,1357,2020-03-19 06:41:00,1,3049.0,2682.0,0.88,14.982,3,2,0,2,1,0,1,0,0.0,0.0
1015,1358,2020-03-19 06:44:00,1,2934.0,2539.0,0.865,14.371,84,32,18,14,52,32,20,0,0.0,0.0
1015,1359,2020-03-19 06:47:00,1,2817.0,2463.0,0.874,13.827,1,0,0,0,1,0,1,0,0.0,0.0
1015,1360,2020-03-19 06:50:00,1,2769.0,2479.0,0.895,13.654,3,0,0,0,3,1,2,0,0.0,0.0
1015,1361,2020-03-19 06:53:00,1,2693.0,2445.0,0.908,13.317,6,1,1,0,5,3,2,0,0.0,0.0
1015,1362,2020-03-19 06:56:00,1,2709.0,2429.0,0.897,13.362,30,12,7,5,18,12,6,0,0.0,0.0
1015,1363,2020-03-19 06:59:00,1,2672.0,2424.0,0.907,13.209,242,110,87,23,132,93,39,7,0.0,0.0
1015,1364,2020-03-19 07:02:00,1,2687.0,2409.0,0.897,13.254,0,0,0,0,0,0,0,0,0.0,0.0
1015,1365,2020-03-19 07:05:00,1,2702.0,2412.0,0.893,13.316,2,0,0,0,2,0,2,0,0.0,0.0
1015,1366,2020-03-19 07:08:00,1,2878.0,2471.0,0.858,14.075,145,75,53,22,70,48,22,0,0.0,0.0
1015,1367,2020-03-19 07:11:00,1,2793.0,2474.0,0.886,13.742,2,2,0,2,0,0,0,0,0.0,0.0
1015,1368,2020-03-19 07:14:00,1,2682.0,2361.0,0.88,13.182,5,2,0,2,3,2,1,0,0.0,0.0
1015,1369,2020-03-19 07:17:00,1,2681.0,2412.0,0.9,13.234,170,105,85,20,65,42,23,0,0.0,0.0
1015,1370,2020-03-19 07:20:00,1,2550.0,2267.0,0.889,12.559,356,340,321,19,16,4,12,0,0.0,0.0
1015,1371,2020-03-19 07:23:00,1,2544.0,2187.0,0.859,12.444,107,53,43,10,54,33,21,0,0.0,0.0
1015,1372,2020-03-19 07:26:00,1,2693.0,2323.0,0.863,13.181,16,3,0,3,13,0,13,0,0.0,0.0
1015,1373,2020-03-19 07:29:00,1,2742.0,2276.0,0.83,13.322,69,9,2,7,60,32,28,0,0.0,0.0
1015,1374,2020-03-19 07:32:00,1,2732.0,2317.0,0.848,13.328,12,1,0,1,11,5,6,0,0.0,0.0
1015,1375,2020-03-19 07:35:00,1,2691.0,2315.0,0.86,13.168,114,26,8,18,88,47,41,0,0.0,0.0
1015,1376,2020-03-19 07:38:00,1,2725.0,2313.0,0.849,13.296,55,41,26,15,14,0,14,0,0.0,0.0
1015,1377,2020-03-19 07:41:00,1,2789.0,2319.0,0.831,13.555,20,4,3,1,16,4,12,0,0.0,0.0
1015,1378,2020-03-19 07:44:00,1,2559.0,2159.0,0.843,12.473,4,0,0,0,4,1,3,0,0.0,0.0
1015,1379,2020-03-19 07:47:00,1,2432.0,2051.0,0.843,11.854,11,3,1,2,8,1,7,0,0.0,0.0
1015,1380,2020-03-19 07:50:00,1,2602.0,2117.0,0.814,12.596,24,3,3,0,21,10,11,0,0.0,0.0
1015,1381,2020-03-19 07:53:00,1,2608.0,2096.0,0.804,12.594,46,10,3,7,36,15,21,0,0.0,0.0
1015,1382,2020-03-19 07:56:00,1,2721.0,2279.0,0.838,13.243,289,86,43,43,203,124,79,6,0.0,0.0
1015,1383,2020-03-19 07:59:00,1,2706.0,2316.0,0.856,13.226,275,109,68,41,166,105,61,0,0.0,0.0
1015,1384,2020-03-19 08:02:00,1,2723.0,2346.0,0.862,13.324,113,51,36,15,62,24,38,2,0.0,0.0
1015,1385,2020-03-19 08:05:00,1,2727.0,2267.0,0.831,13.253,15,5,3,2,10,0,10,0,0.0,0.0
1015,1386,2020-03-19 08:08:00,1,2748.0,2240.0,0.815,13.309,164,72,60,12,92,55,37,4,0.0,0.0
1015,1387,2020-03-19 08:11:00,1,2744.0,2327.0,0.848,13.389,444,174,133,41,270,195,75,26,0.0,0.0
1015,1388,2020-03-19 08:14:00,1,2826.0,2392.0,0.846,13.783,430,181,127,54,249,179,70,10,0.0,0.0
1015,1389,2020-03-19 08:17:00,1,2980.0,2454.0,0.824,14.458,767,276,207,69,491,363,128,18,0.0,0.0
1015,1390,2020-03-19 08:20:00,1,2981.0,2409.0,0.808,14.411,470,241,168,73,229,166,63,0,0.0,0.0
1015,1391,2020-03-19 08:23:00,1,2947.0,2411.0,0.818,14.283,553,231,175,56,322,240,82,1,0.0,0.0
1015,1392,2020-03-19 08:26:00,1,2907.0,2410.0,0.829,14.122,595,264,201,63,331,244,87,2,0.0,0.0
1015,1393,2020-03-19 08:29:00,1,2831.0,2336.0,0.825,13.74,446,205,150,55,241,169,72,11,0.0,0.0
1015,1394,2020-03-19 08:32:00,1,2974.5,2442.5,0.8215,14.424,54,37,0,37,17,7,10,0,0.0,0.0
1015,1395,2020-03-19 08:35:00,1,3118.0,2549.0,0.818,15.108,425,126,78,48,299,219,80,0,0.0,0.0
1015,1396,2020-03-19 08:38:00,1,2986.0,2434.0,0.815,14.46,276,83,60,23,193,152,41,1,0.0,0.0
1015,1397,2020-03-19 08:41:00,1,2989.0,2452.0,0.821,14.491,611,241,175,66,370,278,92,3,0.0,0.0
1015,1398,2020-03-19 08:44:00,1,2947.0,2446.0,0.83,14.319,497,223,168,55,274,211,63,38,0.0,0.0
1015,1399,2020-03-19 08:47:00,1,2687.0,2364.0,0.88,13.204,531,230,177,53,301,231,70,43,0.0,0.0
1015,1400,2020-03-19 08:50:00,1,2949.0,2520.0,0.854,14.408,274,117,78,39,157,110,47,0,0.0,0.0
1015,1401,2020-03-19 08:53:00,1,2913.0,2464.0,0.846,14.205,40,16,5,11,24,6,18,0,0.0,0.0
1015,1402,2020-03-19 08:56:00,1,2975.0,2521.0,0.847,14.511,54,1,0,1,53,20,33,0,0.0,0.0
1015,1403,2020-03-19 08:59:00,1,2947.0,2517.0,0.854,14.396,24,7,2,5,17,4,13,0,0.0,0.0
1015,1404,2020-03-19 09:02:00,1,2695.0,2331.0,0.865,13.198,11,0,0,0,11,0,11,0,0.0,0.0
1015,1405,2020-03-19 09:05:00,1,2613.0,2217.0,0.848,12.75,59,5,0,5,54,16,38,0,0.0,0.0
1015,1406,2020-03-19 09:08:00,1,2589.0,2270.0,0.877,12.715,54,2,1,1,52,23,29,0,0.0,0.0
1015,1407,2020-03-19 09:11:00,1,2707.0,2471.0,0.913,13.401,10,0,0,0,10,1,9,0,0.0,0.0
1015,1408,2020-03-19 09:14:00,1,2711.0,2404.0,0.886,13.344,22,3,1,2,19,5,14,0,0.0,0.0
1015,1409,2020-03-19 09:17:00,1,2704.0,2341.0,0.866,13.246,16,0,0,0,16,10,6,0,0.0,0.0
1015,1410,2020-03-19 09:20:00,1,2538.0,2269.0,0.894,12.513,18,0,0,0,18,0,18,0,0.0,0.0
1015,1411,2020-03-19 09:23:00,1,2553.0,2267.0,0.888,12.57,0,0,0,0,0,0,0,0,0.0,0.0
1015,1412,2020-03-19 09:26:00,1,2590.0,2244.0,0.866,12.69,6,1,1,0,5,3,2,0,0.0,0.0
1015,1413,2020-03-19 09:29:00,1,2578.0,2209.0,0.857,12.605,45,23,14,9,22,12,10,0,0.0,0.0
1015,1414,2020-03-19 09:32:00,1,2574.0,2234.0,0.868,12.615,0,0,0,0,0,0,0,0,0.0,0.0
1015,1415,2020-03-19 09:35:00,1,2566.0,2234.0,0.87,12.585,18,10,2,8,8,2,6,0,0.0,0.0
1015,1416,2020-03-19 09:38:00,1,2666.0,2298.0,0.862,13.047,54,0,0,0,54,12,42,0,0.0,0.0
1015,1417,2020-03-19 09:41:00,1,2594.0,2170.0,0.837,12.621,33,0,0,0,33,2,31,0,0.0,0.0
1015,1418,2020-03-19 09:44:00,1,2511.0,2121.0,0.845,12.242,12,6,4,2,6,3,3,0,0.0,0.0
1015,1419,2020-03-19 09:47:00,1,2625.0,2166.0,0.825,12.74,24,9,0,9,15,6,9,0,0.0,0.0
1015,1420,2020-03-19 09:50:00,1,2594.0,2205.0,0.85,12.66,143,57,40,17,86,55,31,0,0.0,0.0
1015,1421,2020-03-19 09:53:00,1,2560.0,2154.0,0.841,12.474,11,3,0,3,8,4,4,0,0.0,0.0
1015,1422,2020-03-19 09:56:00,1,2603.0,2139.0,0.822,12.624,8,1,0,1,7,1,6,0,0.0,0.0
1015,1423,2020-03-19 09:59:00,1,2601.0,2116.0,0.814,12.59,4,0,0,0,4,0,4,0,0.0,0.0
1015,1424,2020-03-19 10:02:00,1,2387.0,2062.0,0.864,11.687,11,2,1,1,9,5,4,0,0.0,0.0
1015,1425,2020-03-19 10:05:00,1,2386.0,2016.0,0.845,11.635,67,18,10,8,49,34,15,0,0.0,0.0
1015,1426,2020-03-19 10:08:00,1,2577.0,2153.0,0.836,12.536,19,1,0,1,18,8,10,0,0.0,0.0
1015,1427,2020-03-19 10:11:00,1,2594.0,2211.0,0.853,12.667,32,10,1,9,22,8,14,0,0.0,0.0
1015,1428,2020-03-19 10:14:00,1,2637.0,2276.0,0.863,12.909,60,10,1,9,50,22,28,0,0.0,0.0
1015,1429,2020-03-19 10:17:00,1,2637.0,2285.0,0.867,12.922,60,3,1,2,57,35,22,0,0.0,0.0
1015,1430,2020-03-19 10:20:00,1,2591.0,2171.0,0.838,12.614,48,0,0,0,48,21,27,0,0.0,0.0
1015,1431,2020-03-19 10:23:00,1,2718.0,2280.0,0.839,13.233,163,53,29,24,110,77,33,0,0.0,0.0
1015,1432,2020-03-19 10:26:00,1,2356.0,2062.0,0.875,11.567,150,32,8,24,118,72,46,0,0.0,0.0
1015,1433,2020-03-19 10:29:00,1,2442.0,2042.0,0.836,11.881,187,64,27,37,123,77,46,0,0.0,0.0
1015,1434,2020-03-19 10:32:00,1,2602.0,2065.0,0.794,12.537,24,8,0,8,16,1,15,0,0.0,0.0
1015,1435,2020-03-19 10:35:00,1,2369.0,1985.0,0.838,11.531,32,5,0,5,27,6,21,0,0.0,0.0
1015,1436,2020-03-19 10:38:00,1,2392.0,1947.0,0.814,11.58,17,1,1,0,16,2,14,0,0.0,0.0
1015,1437,2020-03-19 10:41:00,1,2407.0,1947.0,0.809,11.638,12,2,0,2,10,4,6,0,0.0,0.0
1015,1438,2020-03-19 10:44:00,1,2364.0,1868.0,0.79,11.384,7,0,0,0,7,0,7,0,0.0,0.0
1015,1439,2020-03-19 10:47:00,1,2386.0,1894.0,0.794,11.499,12,0,0,0,12,2,10,0,0.0,0.0
1015,1440,2020-03-19 10:50:00,1,2243.0,1832.0,0.817,10.868,6,1,0,1,5,0,5,0,0.0,0.0
1015,1441,2020-03-19 10:53:00,1,2241.0,1835.0,0.819,10.863,24,22,2,20,2,0,2,0,0.0,0.0
1015,1442,2020-03-19 10:56:00,1,2295.0,1876.0,0.817,11.118,18,11,0,11,7,0,7,0,0.0,0.0
1015,1443,2020-03-19 10:59:00,1,2609.0,2119.0,0.812,12.624,625,30,10,20,595,540,55,0,0.0,0.0
1015,1444,2020-03-19 11:02:00,1,2609.0,2142.0,0.821,12.65,84,0,0,0,84,60,24,0,0.0,0.0
1015,1445,2020-03-19 11:05:00,1,2626.0,2146.0,0.817,12.723,14,0,0,0,14,8,6,0,0.0,0.0
1015,1446,2020-03-19 11:08:00,1,2621.0,2060.0,0.786,12.609,44,0,0,0,44,25,19,0,0.0,0.0
1015,1447,2020-03-19 11:11:00,1,2451.0,1975.0,0.806,11.845,35,0,0,0,35,18,17,0,0.0,0.0
1015,1448,2020-03-19 11:14:00,1,2579.0,2133.0,0.827,12.525,34,7,5,2,27,12,15,0,0.0,0.0
1015,1449,2020-03-19 11:17:00,1,2620.0,2053.0,0.784,12.596,209,67,52,15,142,91,51,10,0.0,0.0
1015,1450,2020-03-19 11:20:00,1,2599.0,2122.0,0.817,12.589,26,0,0,0,26,11,15,0,0.0,0.0
1015,1451,2020-03-19 11:23:00,1,2574.0,2014.0,0.783,12.372,136,0,0,0,136,73,63,0,0.0,0.0
1015,1452,2020-03-19 11:26:00,1,2636.0,2063.0,0.783,12.672,105,0,0,0,105,52,53,0,0.0,0.0
1015,1453,2020-03-19 11:29:00,1,2617.0,2097.0,0.801,12.633,29,0,0,0,29,7,22,0,0.0,0.0
1015,1454,2020-03-19 11:32:00,1,2492.0,2028.5,0.8145,12.064,25,2,1,1,23,10,13,0,0.0,0.0
1015,1455,2020-03-19 11:35:00,1,2367.0,1960.0,0.828,11.495,63,17,15,2,46,25,21,0,0.0,0.0
1015,1456,2020-03-19 11:38:00,1,2421.0,1878.0,0.776,11.618,30,3,0,3,27,17,10,0,0.0,0.0
1015,1457,2020-03-19 11:41:00,1,2377.0,1923.0,0.809,11.494,55,2,1,1,53,42,11,0,0.0,0.0
1015,1458,2020-03-19 11:44:00,1,2646.0,1995.0,0.754,12.635,87,16,3,13,71,22,49,0,0.0,0.0
1015,1459,2020-03-19 11:47:00,1,2451.0,1938.0,0.79,11.804,122,55,39,16,67,40,27,4,0.0,0.0
1015,1460,2020-03-19 11:50:00,1,2626.0,2024.0,0.771,12.586,213,58,20,38,155,101,54,1,0.0,0.0
1015,1461,2020-03-19 11:53:00,1,2611.0,2144.0,0.821,12.66,262,66,34,32,196,134,62,0,0.0,0.0
1015,1462,2020-03-19 11:56:00,1,2784.0,2229.0,0.801,13.438,76,37,14,23,39,20,19,0,0.0,0.0
1015,1463,2020-03-19 11:59:00,1,2715.0,2159.0,0.795,13.087,143,67,36,31,76,51,25,0,0.0,0.0
1015,1464,2020-03-19 12:02:00,1,2737.0,2220.0,0.811,13.241,692,270,218,52,422,310,112,27,0.0,0.0
1015,1465,2020-03-19 12:05:00,1,2720.0,2165.0,0.796,13.115,518,176,139,37,342,255,87,2,0.0,0.0
1015,1466,2020-03-19 12:08:00,1,2713.0,2179.0,0.803,13.102,622,261,201,60,361,277,84,3,0.0,0.0
1015,1467,2020-03-19 12:11:00,1,3029.0,2317.0,0.765,14.5,542,192,138,54,350,260,90,8,0.0,0.0
1015,1468,2020-03-19 12:14:00,1,2932.0,2286.0,0.78,14.083,239,90,54,36,149,94,55,1,0.0,0.0
1015,1469,2020-03-19 12:17:00,1,2999.0,2406.0,0.802,14.479,77,13,5,8,64,36,28,0,0.0,0.0
1015,1470,2020-03-19 12:20:00,1,2654.0,2059.0,0.776,12.735,8,0,0,0,8,6,2,0,0.0,0.0
1015,1471,2020-03-19 12:23:00,1,2578.0,1948.0,0.756,12.315,9,0,0,0,9,4,5,0,0.0,0.0
1015,1472,2020-03-19 12:26:00,1,2694.0,2093.0,0.777,12.932,25,6,4,2,19,10,9,0,0.0,0.0
1015,1473,2020-03-19 12:29:00,1,2668.0,2018.0,0.756,12.748,30,25,1,24,5,2,3,0,0.0,0.0
1015,1474,2020-03-19 12:32:00,1,2372.0,1843.0,0.777,11.386,119,25,12,13,94,49,45,0,0.0,0.0
1015,1475,2020-03-19 12:35:00,1,2387.0,1787.0,0.749,11.384,41,0,0,0,41,7,34,0,0.0,0.0
1015,1476,2020-03-19 12:38:00,1,2339.0,1786.0,0.764,11.192,55,6,3,3,49,10,39,0,0.0,0.0
1015,1477,2020-03-19 12:41:00,1,2236.0,1724.0,0.771,10.719,52,10,4,6,42,23,19,0,0.0,0.0
1015,1478,2020-03-19 12:44:00,1,2251.0,1648.0,0.732,10.696,8,0,0,0,8,6,2,0,0.0,0.0
1015,1479,2020-03-19 12:47:00,1,2277.0,1631.0,0.716,10.777,6,0,0,0,6,3,3,0,0.0,0.0
1015,1480,2020-03-19 12:50:00,1,2249.0,1621.0,0.721,10.656,10,6,4,2,4,2,2,0,0.0,0.0
1015,1481,2020-03-19 12:53:00,1,2297.0,1741.0,0.758,10.98,25,2,0,2,23,12,11,0,0.0,0.0
1015,1482,2020-03-19 12:56:00,1,2255.0,1720.0,0.763,10.79,5,0,0,0,5,2,3,0,0.0,0.0
1015,1483,2020-03-19 12:59:00,1,2267.0,1745.0,0.77,10.864,40,5,3,2,35,14,21,0,0.0,0.0
1015,1484,2020-03-19 13:02:00,1,2254.0,1669.0,0.74,10.727,32,0,0,0,32,6,26,0,0.0,0.0
1015,1485,2020-03-19 13:05:00,1,2256.0,1691.0,0.749,10.761,50,2,0,2,48,5,43,0,0.0,0.0
1015,1486,2020-03-19 13:08:00,1,2249.0,1716.0,0.763,10.76,64,0,0,0,64,6,58,0,0.0,0.0
1015,1487,2020-03-19 13:11:00,1,2486.0,1906.0,0.767,11.907,211,44,15,29,167,92,75,0,0.11,0.0
1015,1488,2020-03-19 13:14:00,1,2413.0,1954.0,0.81,11.67,211,58,22,36,153,89,64,3,0.0,0.0
1015,1489,2020-03-19 13:17:00,1,2485.0,1949.0,0.784,11.949,115,32,19,13,83,37,46,0,0.0,0.0
1015,1490,2020-03-19 13:20:00,1,2633.0,2060.0,0.782,12.657,72,7,2,5,65,35,30,0,0.0,0.0
1015,1491,2020-03-19 13:23:00,1,2380.0,1896.0,0.797,11.479,225,71,32,39,154,84,70,0,0.0,0.0
1015,1492,2020-03-19 13:26:00,1,2382.0,1864.0,0.783,11.451,178,7,1,6,171,106,65,0,0.07,0.0
1015,1493,2020-03-19 13:29:00,1,2244.0,1727.0,0.77,10.755,77,0,0,0,77,27,50,0,0.0,0.0
1015,1494,2020-03-19 13:32:00,1,2276.0,1711.0,0.752,10.862,92,5,0,5,87,35,52,0,0.0,0.0
1015,1495,2020-03-19 13:35:00,1,2485.0,1928.0,0.776,11.924,133,12,7,5,121,63,58,0,0.0,0.0
1015,1496,2020-03-19 13:38:00,1,2574.0,1987.0,0.772,12.341,69,2,1,1,67,22,45,0,0.0,0.0
1015,1497,2020-03-19 13:41:00,1,2544.0,1959.0,0.77,12.192,21,0,0,0,21,0,21,0,0.0,0.0
1015,1498,2020-03-19 13:44:00,1,2393.0,1832.0,0.766,11.458,15,1,0,1,14,2,12,0,0.0,0.0
1015,1499,2020-03-19 13:47:00,1,2414.0,1825.0,0.756,11.532,10,2,0,2,8,2,6,0,0.0,0.0
1015,1500,2020-03-19 13:50:00,1,2301.0,1645.0,0.715,10.887,15,11,0,11,4,0,4,0,0.0,0.0
1015,1501,2020-03-19 13:53:00,1,2264.0,1708.0,0.754,10.811,29,1,0,1,28,0,28,0,0.0,0.0
1015,1502,2020-03-19 13:56:00,1,2253.0,1721.0,0.764,10.781,26,5,0,5,21,2,19,0,0.0,0.0
1015,1503,2020-03-19 13:59:00,1,2235.0,1751.0,0.784,10.743,30,0,0,0,30,2,28,0,0.0,0.0
1015,1504,2020-03-19 14:02:00,1,2388.0,1866.0,0.781,11.473,49,10,3,7,39,15,24,0,0.0,0.0
1015,1505,2020-03-19 14:05:00,1,2555.0,1941.0,0.759,12.217,11,0,0,0,11,0,11,0,0.0,0.0
1015,1506,2020-03-19 14:08:00,1,2465.0,1923.0,0.78,11.841,51,1,1,0,50,20,30,0,0.0,0.0
1015,1507,2020-03-19 14:11:00,1,2415.0,1826.0,0.756,11.535,61,0,0,0,61,33,28,0,0.0,0.0
1015,1508,2020-03-19 14:14:00,1,2417.0,1864.0,0.771,11.585,76,7,4,3,69,29,40,0,0.0,0.0
1015,1509,2020-03-19 14:17:00,1,2251.0,1753.0,0.779,10.812,67,16,6,10,51,33,18,0,0.0,0.0
1015,1510,2020-03-19 14:20:00,1,2243.0,1720.0,0.767,10.743,97,39,26,13,58,30,28,0,0.0,0.0
1015,1511,2020-03-19 14:23:00,1,2395.0,1878.0,0.784,11.515,456,225,176,49,231,181,50,40,0.05,0.0
1015,1512,2020-03-19 14:26:00,1,2780.0,2119.0,0.762,13.301,346,175,123,52,171,121,50,65,0.01,0.0
1015,1513,2020-03-19 14:29:00,1,2761.0,2192.0,0.794,13.303,431,185,136,49,246,182,64,31,0.0,0.0
1015,1514,2020-03-19 14:32:00,1,2806.0,2180.0,0.777,13.468,433,147,110,37,286,218,68,36,0.0,0.0
1015,1515,2020-03-19 14:35:00,1,2851.0,2168.0,0.76,13.633,407,155,109,46,252,179,73,12,0.0,0.0
1015,1516,2020-03-19 14:38:00,1,2755.0,2145.0,0.779,13.229,652,295,237,58,357,272,85,9,0.0,0.0
1015,1517,2020-03-19 14:41:00,1,2837.0,2162.0,0.762,13.572,332,121,82,39,211,168,43,0,0.0,0.0
1015,1518,2020-03-19 14:44:00,1,2944.0,2168.0,0.737,14.0,582,233,174,59,349,261,88,2,0.0,0.0
1015,1519,2020-03-19 14:47:00,1,3012.0,2198.0,0.73,14.301,139,17,4,13,122,77,45,0,0.0,0.0
1015,1520,2020-03-19 14:50:00,1,2873.0,2172.0,0.756,13.724,176,81,54,27,95,65,30,0,0.0,0.0
1015,1521,2020-03-19 14:53:00,1,2841.0,2154.0,0.758,13.579,118,46,13,33,72,37,35,0,0.0,0.0
1015,1522,2020-03-19 14:56:00,1,3047.0,2237.0,0.734,14.481,129,44,21,23,85,53,32,0,0.0,0.0
1015,1523,2020-03-19 14:59:00,1,3061.0,2258.0,0.738,14.563,47,5,0,5,42,26,16,0,0.0,0.0
1015,1524,2020-03-19 15:02:00,1,2763.0,2094.0,0.758,13.205,51,3,0,3,48,27,21,0,0.0,0.0
1015,1525,2020-03-19 15:05:00,1,2797.0,2052.0,0.734,13.294,36,1,0,1,35,17,18,0,0.0,0.0
1015,1526,2020-03-19 15:08:00,1,2830.0,2003.0,0.708,13.368,10,0,0,0,10,4,6,0,0.0,0.0
1015,1527,2020-03-19 15:11:00,1,2629.0,1899.0,0.722,12.461,17,3,0,3,14,10,4,0,0.0,0.0
1015,1528,2020-03-19 15:14:00,1,2681.0,1868.0,0.697,12.632,15,6,1,5,9,3,6,0,0.0,0.0
1015,1529,2020-03-19 15:17:00,1,2670.0,1866.0,0.699,12.587,34,14,10,4,20,15,5,0,0.0,0.0
1015,1530,2020-03-19 15:20:00,1,2561.0,1797.0,0.701,12.082,6,0,0,0,6,3,3,0,0.0,0.0
1015,1531,2020-03-19 15:23:00,1,2516.0,1796.0,0.714,11.903,10,2,1,1,8,5,3,0,0.02,0.0
1015,1532,2020-03-19 15:26:00,1,2407.0,1757.0,0.73,11.428,1,0,0,0,1,0,1,0,0.02,0.0
1015,1533,2020-03-19 15:29:00,1,2433.0,1714.0,0.705,11.484,5,3,1,2,2,0,2,0,0.0,0.0
1015,1534,2020-03-19 15:32:00,1,2389.0,1749.0,0.732,11.35,136,102,61,41,34,14,20,0,0.0,0.0
1015,1535,2020-03-19 15:35:00,1,2495.0,1820.0,0.729,11.847,248,126,73,53,122,60,62,2,0.0,0.0
1015,1536,2020-03-19 15:38:00,1,2655.0,1963.0,0.739,12.634,203,76,52,24,127,62,65,102,0.02,0.05
1015,1537,2020-03-19 15:41:00,1,2746.0,2115.0,0.77,13.16,372,146,97,49,226,154,72,28,0.06,0.0
1015,1538,2020-03-19 15:44:00,1,2823.0,2107.0,0.746,13.456,585,228,163,65,357,264,93,5,0.0,0.0
1015,1539,2020-03-19 15:47:00,1,2835.0,2182.0,0.77,13.584,505,175,131,44,330,239,91,0,0.01,0.0
1015,1540,2020-03-19 15:50:00,1,2776.0,2244.0,0.808,13.424,125,30,19,11,95,53,42,0,0.0,0.0
1015,1541,2020-03-19 15:53:00,1,2884.0,2316.0,0.803,13.93,52,19,5,14,33,11,22,0,0.01,0.01
1015,1542,2020-03-19 15:56:00,1,2736.0,2226.0,0.814,13.246,0,0,0,0,0,0,0,0,0.02,0.03
1015,1543,2020-03-19 15:59:00,1,2594.0,2153.0,0.83,12.604,4,3,0,3,1,0,1,0,0.0,0.0
1015,1544,2020-03-19 16:02:00,1,2599.0,2089.0,0.804,12.555,0,0,0,0,0,0,0,0,0.0,0.0
1015,1545,2020-03-19 16:05:00,1,2604.0,2097.0,0.805,12.583,6,3,1,2,3,1,2,0,0.0,0.0
1015,1546,2020-03-19 16:08:00,1,2605.0,2094.0,0.804,12.583,46,11,4,7,35,12,23,0,0.08,0.0
1015,1547,2020-03-19 16:11:00,1,2351.0,2037.0,0.866,11.519,6,1,0,1,5,4,1,0,0.0,0.0
1015,1548,2020-03-19 16:14:00,1,2356.0,2057.0,0.873,11.561,26,4,1,3,22,7,15,0,0.0,0.0
1015,1549,2020-03-19 16:17:00,1,2526.0,2144.0,0.849,12.328,102,29,0,29,73,23,50,0,0.0,0.0
1015,1550,2020-03-19 16:20:00,1,2599.0,2135.0,0.822,12.603,107,12,2,10,95,43,52,0,0.01,0.0
1015,1551,2020-03-19 16:23:00,1,2570.0,2145.0,0.835,12.501,168,41,13,28,127,71,56,0,0.02,0.0
1015,1552,2020-03-19 16:26:00,1,2509.0,2136.0,0.851,12.249,40,6,2,4,34,13,21,0,0.0,0.0
1015,1553,2020-03-19 16:29:00,1,2572.0,2163.0,0.841,12.529,35,6,0,6,29,1,28,0,0.0,0.0
1015,1554,2020-03-19 16:32:00,1,2610.0,2141.0,0.82,12.655,72,14,9,5,58,41,17,0,0.01,0.0
1015,1555,2020-03-19 16:35:00,1,2354.0,2015.0,0.856,11.507,0,0,0,0,0,0,0,0,0.01,0.0
1015,1556,2020-03-19 16:38:00,1,2353.0,2022.0,0.859,11.509,0,0,0,0,0,0,0,0,0.05,0.0
1015,1557,2020-03-19 16:41:00,1,2526.0,2058.0,0.815,12.23,14,8,5,3,6,2,4,0,0.0,0.0
1015,1558,2020-03-19 16:44:00,1,2607.0,2130.0,0.817,12.629,33,11,5,6,22,10,12,0,0.01,0.0
1015,1559,2020-03-19 16:47:00,1,2359.0,1982.0,0.84,11.489,43,14,5,9,29,12,17,0,0.0,0.0
1015,1560,2020-03-19 16:50:00,1,2396.0,1971.0,0.822,11.624,7,7,4,3,0,0,0,0,0.02,0.0
1015,1561,2020-03-19 16:53:00,1,2405.0,1940.0,0.806,11.625,94,19,13,6,75,53,22,0,0.0,0.0
1015,1562,2020-03-19 16:56:00,1,2375.0,1861.0,0.784,11.417,36,3,0,3,33,19,14,0,0.0,0.0
1015,1563,2020-03-19 16:59:00,1,2622.0,2013.0,0.767,12.561,374,36,14,22,338,238,100,0,0.01,0.0
1015,1564,2020-03-19 17:02:00,1,2661.0,2177.0,0.818,12.896,285,80,38,42,205,141,64,21,0.0,0.0
1015,1565,2020-03-19 17:05:00,1,2748.0,2288.0,0.833,13.359,103,32,18,14,71,22,49,82,0.23,0.13
1015,1566,2020-03-19 17:08:00,1,2751.0,2258.0,0.821,13.339,369,148,103,45,221,169,52,87,0.0,0.01
1015,1567,2020-03-19 17:11:00,1,2676.0,2123.0,0.794,12.892,330,76,22,54,254,184,70,0,0.0,0.0
1015,1568,2020-03-19 17:14:00,1,2922.0,2369.0,0.811,14.135,50,35,10,25,15,9,6,0,0.0,0.0
1015,1569,2020-03-19 17:17:00,1,2930.0,2516.0,0.859,14.331,215,68,32,36,147,95,52,0,0.0,0.0
1015,1570,2020-03-19 17:20:00,1,2697.0,2360.0,0.875,13.239,27,23,10,13,4,0,4,0,0.0,0.0
1015,1571,2020-03-19 17:23:00,1,2705.0,2301.0,0.851,13.207,23,3,3,0,20,13,7,0,0.0,0.0
1015,1572,2020-03-19 17:26:00,1,2593.0,2251.0,0.868,12.708,33,3,1,2,30,16,14,0,0.0,0.0
1015,1573,2020-03-19 17:29:00,1,2565.0,2204.0,0.859,12.546,52,2,0,2,50,16,34,0,0.0,0.0
1015,1574,2020-03-19 17:32:00,1,2562.5,2177.0,0.8495,12.506,73,4,0,4,69,32,37,0,0.0,0.0
1015,1575,2020-03-19 17:35:00,1,2560.0,2150.0,0.84,12.466,63,0,0,0,63,8,55,0,0.0,0.0
1015,1576,2020-03-19 17:38:00,1,2629.0,2229.0,0.848,12.824,172,32,16,16,140,75,65,68,0.0,0.0
1015,1577,2020-03-19 17:41:00,1,3057.0,2650.0,0.867,14.978,156,60,42,18,96,44,52,50,0.11,0.11
1015,1578,2020-03-19 17:44:00,1,2746.0,2410.0,0.878,13.487,159,75,24,51,84,42,42,0,0.0,0.01
1015,1579,2020-03-19 17:47:00,1,2931.0,2610.0,0.89,14.438,110,35,13,22,75,42,33,0,0.0,0.01
1015,1580,2020-03-19 17:50:00,1,2942.0,2594.0,0.882,14.464,44,0,0,0,44,26,18,0,0.0,0.0
1015,1581,2020-03-19 17:53:00,1,2679.0,2492.0,0.93,13.314,324,1,1,0,323,270,53,0,0.0,0.0
1015,1582,2020-03-19 17:56:00,1,2776.0,2525.0,0.909,13.733,320,10,1,9,310,237,73,0,0.0,0.0
1015,1583,2020-03-19 17:59:00,1,2703.0,2494.0,0.923,13.409,68,4,0,4,64,39,25,0,0.0,0.0
1015,1584,2020-03-19 18:02:00,0,2922.0,2601.0,0.89,14.392,374,171,128,43,203,145,58,30,0.03,0.0
1015,1585,2020-03-19 18:05:00,0,3044.0,2759.0,0.906,15.048,394,138,93,45,256,178,78,28,0.0,0.01
1015,1586,2020-03-19 18:08:00,0,3113.0,2776.0,0.892,15.339,320,129,77,52,191,123,68,34,0.0,0.0
1015,1587,2020-03-19 18:11:00,0,3046.0,2730.0,0.896,15.021,246,134,83,51,112,59,53,0,0.0,0.0
1015,1588,2020-03-19 18:14:00,0,3068.0,2834.0,0.924,15.227,261,71,18,53,190,125,65,0,0.0,0.0
1015,1589,2020-03-19 18:17:00,0,3300.0,2901.0,0.879,16.214,106,33,19,14,73,39,34,0,0.0,0.0
1015,1590,2020-03-19 18:20:00,0,3029.0,2751.0,0.908,14.978,102,10,4,6,92,59,33,0,0.0,0.0
1015,1591,2020-03-19 18:23:00,0,3069.0,2811.0,0.916,15.205,98,0,0,0,98,74,24,0,0.0,0.0
1015,1592,2020-03-19 18:26:00,0,3168.0,2829.0,0.893,15.614,269,145,107,38,124,78,46,17,0.0,0.0
1015,1593,2020-03-19 18:29:00,0,3306.0,2874.0,0.869,16.208,485,238,179,59,247,185,62,75,0.0,0.0
1015,1594,2020-03-19 18:32:00,0,3456.0,2994.0,0.866,16.932,497,298,215,83,199,146,53,40,0.0,0.0
1015,1595,2020-03-19 18:35:00,0,3303.0,2799.0,0.847,16.114,283,123,80,43,160,118,42,34,0.09,0.04
1015,1596,2020-03-19 18:38:00,0,2750.0,2330.0,0.847,13.415,643,317,258,59,326,271,55,103,0.01,0.0
1015,1597,2020-03-19 18:41:00,0,3327.0,2860.0,0.86,16.273,507,170,127,43,337,229,108,42,0.0,0.0
1015,1598,2020-03-19 18:44:00,0,3319.0,2818.0,0.849,16.199,201,71,51,20,130,84,46,33,0.0,0.0
1015,1599,2020-03-19 18:47:00,0,3330.0,2707.0,0.813,16.118,637,286,222,64,351,265,86,36,0.18,0.0
1015,1600,2020-03-19 18:50:00,0,3177.0,2628.0,0.827,15.429,630,266,213,53,364,277,87,79,0.0,0.0
1015,1601,2020-03-19 18:53:00,0,3345.0,2664.0,0.796,16.127,224,123,94,29,101,77,24,121,0.0,0.0
1015,1602,2020-03-19 18:56:00,0,3439.0,2792.0,0.812,16.641,604,323,273,50,281,237,44,202,0.0,0.0
1015,1603,2020-03-19 18:59:00,0,3322.0,2658.0,0.8,16.034,383,187,124,63,196,126,70,28,0.0,0.0
1015,1604,2020-03-19 19:02:00,0,3249.0,2604.0,0.801,15.685,206,60,18,42,146,87,59,12,0.0,0.0
1015,1605,2020-03-19 19:05:00,0,3514.0,2755.0,0.784,16.897,223,67,34,33,156,97,59,1,0.0,0.0
1015,1606,2020-03-19 19:08:00,0,3352.0,2708.0,0.808,16.205,397,213,158,55,184,120,64,7,0.0,0.0
1015,1607,2020-03-19 19:11:00,0,3187.0,2537.0,0.796,15.364,124,71,53,18,53,35,18,10,0.0,0.0
1015,1608,2020-03-19 19:14:00,0,3160.0,2474.0,0.783,15.19,37,13,4,9,24,3,21,0,0.0,0.0
1015,1609,2020-03-19 19:17:00,0,3008.0,2291.0,0.762,14.389,42,3,1,2,39,0,39,0,0.0,0.0
1015,1610,2020-03-19 19:20:00,0,2792.0,2156.0,0.772,13.387,158,77,59,18,81,44,37,1,0.0,0.0
1015,1611,2020-03-19 19:23:00,0,2928.0,2232.0,0.762,14.009,206,68,31,37,138,79,59,14,0.0,0.0
1015,1612,2020-03-19 19:26:00,0,2996.0,2266.0,0.756,14.315,195,66,26,40,129,87,42,12,0.0,0.0
1015,1613,2020-03-19 19:29:00,0,3009.0,2237.0,0.743,14.334,231,133,99,34,98,72,26,58,0.0,0.0
1015,1614,2020-03-19 19:32:00,0,2915.0,2180.0,0.748,13.898,13,4,3,1,9,5,4,3,0.0,0.0
1015,1615,2020-03-19 19:35:00,0,2816.0,2055.0,0.73,13.37,4,0,0,0,4,0,4,0,0.0,0.0
1015,1616,2020-03-19 19:38:00,0,2666.0,1955.0,0.733,12.671,182,83,68,15,99,80,19,1,0.0,0.0
1015,1617,2020-03-19 19:41:00,0,2805.0,2001.0,0.713,13.268,195,6,3,3,189,164,25,0,0.0,0.0
1015,1618,2020-03-19 19:44:00,0,2626.0,1947.0,0.742,12.502,140,0,0,0,140,127,13,0,0.0,0.0
1015,1619,2020-03-19 19:47:00,0,2778.0,2061.0,0.742,13.225,506,182,120,62,324,244,80,30,0.0,0.0
1015,1620,2020-03-19 19:50:00,0,2849.0,2129.0,0.747,13.584,548,275,196,79,273,193,80,44,0.0,0.0
1015,1621,2020-03-19 19:53:00,0,3031.0,2196.0,0.725,14.373,488,248,184,64,240,172,68,60,0.11,0.0
1015,1622,2020-03-19 19:56:00,0,2983.0,2144.0,0.719,14.127,539,315,254,61,224,162,62,138,0.0,0.0
1015,1623,2020-03-19 19:59:00,0,3189.0,2336.0,0.732,15.15,488,221,162,59,267,197,70,74,0.03,0.01
1015,1624,2020-03-19 20:02:00,0,3143.0,2288.0,0.728,14.917,529,174,132,42,355,273,82,78,0.0,0.0
1015,1625,2020-03-19 20:05:00,0,3191.0,2295.0,0.719,15.115,804,379,327,52,425,337,88,214,0.0,0.0
1015,1626,2020-03-19 20:08:00,0,3139.0,2326.0,0.741,14.942,211,109,68,41,102,60,42,54,0.04,0.0
1015,1627,2020-03-19 20:11:00,0,2804.0,1983.0,0.707,13.244,378,171,128,43,207,143,64,26,0.0,0.0
1015,1628,2020-03-19 20:14:00,0,3611.0,2578.0,0.714,17.082,609,291,233,58,318,249,69,111,0.0,0.0
1015,1629,2020-03-19 20:17:00,0,3167.0,2352.0,0.743,15.084,812,360,295,65,452,361,91,134,0.0,0.0
1015,1630,2020-03-19 20:20:00,0,3406.0,2462.0,0.723,16.144,396,183,139,44,213,165,48,66,0.0,0.0
1015,1631,2020-03-19 20:23:00,0,3755.0,2786.0,0.742,17.882,364,206,133,73,158,119,39,52,0.02,0.03
1015,1632,2020-03-19 20:26:00,0,4057.0,2904.0,0.716,19.2,589,318,266,52,271,209,62,111,0.0,0.0
1015,1633,2020-03-19 20:29:00,0,3541.0,2596.0,0.733,16.828,294,145,104,41,149,110,39,55,0.0,0.0
1015,1634,2020-03-19 20:32:00,0,3470.5,2532.0,0.7295,16.4785,669,266,216,50,403,313,90,41,0.0,0.0
1015,1635,2020-03-19 20:35:00,0,3400.0,2468.0,0.726,16.129,122,89,54,35,33,17,16,52,0.0,0.0
1015,1636,2020-03-19 20:38:00,0,3526.0,2571.0,0.729,16.738,226,80,47,33,146,94,52,12,0.06,0.0
1015,1637,2020-03-19 20:41:00,0,3143.0,2321.0,0.738,14.955,288,79,24,55,209,143,66,4,0.0,0.0
1015,1638,2020-03-19 20:44:00,0,3393.0,2425.0,0.715,16.054,352,169,107,62,183,130,53,46,0.0,0.0
1015,1639,2020-03-19 20:47:00,0,3024.0,2200.0,0.728,14.352,657,261,210,51,396,317,79,278,0.0,0.0
1015,1640,2020-03-19 20:50:00,0,3407.0,2560.0,0.752,16.258,532,296,248,48,236,191,45,318,0.0,0.0
1015,1641,2020-03-19 20:53:00,0,3538.0,2593.0,0.733,16.81,552,264,202,62,288,218,70,88,0.1,0.0
1015,1642,2020-03-19 20:56:00,0,3371.0,2541.0,0.754,16.094,516,238,185,53,278,221,57,55,0.0,0.0
1015,1643,2020-03-19 20:59:00,0,3447.0,2475.0,0.718,16.324,322,141,112,29,181,133,48,111,0.0,0.0
1015,1644,2020-03-19 21:02:00,0,3577.0,2565.0,0.717,16.934,241,94,65,29,147,106,41,16,0.0,0.0
1015,1645,2020-03-19 21:05:00,0,3541.0,2553.0,0.721,16.778,277,98,62,36,179,124,55,14,0.0,0.0
1015,1646,2020-03-19 21:08:00,0,3205.0,2377.0,0.742,15.26,451,190,135,55,261,187,74,72,0.0,0.0
1015,1647,2020-03-19 21:11:00,0,3489.0,2506.0,0.718,16.52,90,34,22,12,56,43,13,24,0.0,0.0
1015,1648,2020-03-19 21:14:00,0,3223.0,2263.0,0.702,15.206,0,0,0,0,0,0,0,0,0.0,0.0
1015,1649,2020-03-19 21:17:00,0,2862.0,2072.0,0.724,13.571,2,2,1,1,0,0,0,0,0.0,0.0
1015,1650,2020-03-19 21:20:00,0,2683.0,1953.0,0.728,12.735,61,26,11,15,35,15,20,0,0.0,0.0
1015,1651,2020-03-19 21:23:00,0,2314.0,1637.0,0.707,10.929,228,109,60,49,119,79,40,4,0.0,0.0
1015,1652,2020-03-19 21:26:00,0,3012.0,2245.0,0.745,14.353,113,52,28,24,61,34,27,3,0.01,0.0
1015,1653,2020-03-19 21:29:00,0,2665.0,1931.0,0.725,12.64,173,70,33,37,103,57,46,12,0.0,0.0
1015,1654,2020-03-19 21:32:00,0,2780.0,2013.0,0.724,13.182,468,189,143,46,279,210,69,61,0.0,0.0
1015,1655,2020-03-19 21:35:00,0,2651.0,1947.0,0.735,12.601,261,196,129,67,65,30,35,18,0.0,0.0
1015,1656,2020-03-19 21:38:00,0,3034.0,2275.0,0.75,14.472,679,338,291,47,341,270,71,291,0.0,0.0
1015,1657,2020-03-19 21:41:00,0,3415.0,2469.0,0.723,16.19,537,261,203,58,276,215,61,138,0.0,0.0
1015,1658,2020-03-19 21:44:00,0,3389.0,2445.0,0.721,16.059,784,382,328,54,402,330,72,232,0.0,0.0
1015,1659,2020-03-19 21:47:00,0,3608.0,2589.0,0.717,17.083,274,88,56,32,186,130,56,10,0.0,0.0
1015,1660,2020-03-19 21:50:00,0,3423.0,2517.0,0.736,16.273,254,132,107,25,122,90,32,56,0.0,0.0
1015,1661,2020-03-19 21:53:00,0,3032.0,2241.0,0.739,14.426,753,359,292,67,394,295,99,22,0.0,0.0
1015,1662,2020-03-19 21:56:00,0,3153.0,2315.0,0.734,14.988,625,304,249,55,321,263,58,215,0.0,0.0
1015,1663,2020-03-19 21:59:00,0,3423.0,2517.0,0.735,16.275,548,289,241,48,259,189,70,89,0.0,0.0
1015,1664,2020-03-19 22:02:00,0,3210.0,2321.0,0.723,15.218,465,233,193,40,232,166,66,100,0.0,0.0
1015,1665,2020-03-19 22:05:00,0,3589.0,2495.0,0.695,16.903,59,47,24,23,12,6,6,12,0.0,0.0
1015,1666,2020-03-19 22:08:00,0,3189.0,2272.0,0.712,15.079,155,58,19,39,97,53,44,33,0.22,0.0
1015,1667,2020-03-19 22:11:00,0,3142.0,2311.0,0.736,14.938,265,99,64,35,166,122,44,54,0.0,0.0
1015,1668,2020-03-19 22:14:00,0,3176.0,2297.0,0.723,15.059,751,383,323,60,368,297,71,201,0.0,0.08
1015,1669,2020-03-19 22:17:00,0,3342.0,2339.0,0.7,15.757,365,154,109,45,211,145,66,21,0.0,0.0
1015,1670,2020-03-19 22:20:00,0,3432.0,2459.0,0.717,16.247,169,68,29,39,101,60,41,0,0.0,0.0
1015,1671,2020-03-19 22:23:00,0,3167.0,2233.0,0.705,14.953,129,35,17,18,94,57,37,4,0.0,0.0
1015,1672,2020-03-19 22:26:00,0,2891.0,2120.0,0.733,13.737,434,126,96,30,308,222,86,24,0.0,0.0
1015,1673,2020-03-19 22:29:00,0,3037.0,2152.0,0.709,14.351,0,0,0,0,0,0,0,0,0.0,0.0
1015,1674,2020-03-19 22:32:00,0,2810.0,2044.0,0.727,13.336,0,0,0,0,0,0,0,0,0.0,0.0
1015,1675,2020-03-19 22:35:00,0,2668.0,1901.0,0.713,12.617,0,0,0,0,0,0,0,0,0.0,0.0
1015,1676,2020-03-19 22:38:00,0,2403.0,1758.0,0.732,11.414,72,46,12,34,26,9,17,0,0.0,0.0
1015,1677,2020-03-19 22:41:00,0,2739.0,1961.0,0.716,12.962,147,86,44,42,61,38,23,8,0.0,0.0
1015,1678,2020-03-19 22:44:00,0,2277.0,1550.0,0.681,10.687,452,252,215,37,200,154,46,144,0.0,0.0
1015,1679,2020-03-19 22:47:00,0,2640.0,1934.0,0.733,12.546,394,131,95,36,263,190,73,98,0.0,0.0
1015,1680,2020-03-19 22:50:00,0,2665.0,1890.0,0.709,12.591,473,216,179,37,257,189,68,120,0.0,0.0
1015,1681,2020-03-19 22:53:00,0,2415.0,1677.0,0.694,11.371,282,78,45,33,204,145,59,31,0.0,0.0
1015,1682,2020-03-19 22:56:00,0,2642.0,1889.0,0.715,12.501,207,78,48,30,129,87,42,9,0.0,0.0
1015,1683,2020-03-19 22:59:00,0,2793.0,2052.0,0.735,13.279,206,97,63,34,109,71,38,27,0.0,0.0
1015,1684,2020-03-19 23:02:00,0,2811.0,2065.0,0.735,13.362,50,37,28,9,13,9,4,14,0.0,0.0
1015,1685,2020-03-19 23:05:00,0,2847.0,1984.0,0.697,13.415,0,0,0,0,0,0,0,0,0.0,0.0
1015,1686,2020-03-19 23:08:00,0,2669.0,1840.0,0.689,12.553,0,0,0,0,0,0,0,0,0.0,0.0
1015,1687,2020-03-19 23:11:00,0,2446.0,1708.0,0.698,11.531,0,0,0,0,0,0,0,0,0.0,0.0
1015,1688,2020-03-19 23:14:00,0,2284.0,1578.0,0.691,10.745,0,0,0,0,0,0,0,0,0.0,0.0
1015,1689,2020-03-19 23:17:00,0,2128.0,1496.0,0.703,10.042,0,0,0,0,0,0,0,0,0.0,0.0
1015,1690,2020-03-19 23:20:00,0,2052.0,1480.0,0.721,9.724,0,0,0,0,0,0,0,0,0.0,0.0
1015,1691,2020-03-19 23:23:00,0,2053.0,1431.0,0.697,9.673,1,1,0,1,0,0,0,0,0.0,0.0
1015,1692,2020-03-19 23:26:00,0,2055.0,1404.0,0.683,9.652,29,13,0,13,16,5,11,0,0.0,0.0
1015,1693,2020-03-19 23:29:00,0,2070.0,1390.0,0.671,9.696,71,0,0,0,71,33,38,0,0.0,0.0
1015,1694,2020-03-19 23:32:00,0,2183.5,1498.5,0.6855,10.263,24,3,0,3,21,4,17,0,0.0,0.0
1015,1695,2020-03-19 23:35:00,0,2297.0,1607.0,0.7,10.83,40,1,0,1,39,16,23,0,0.0,0.0
1015,1696,2020-03-19 23:38:00,0,2463.0,1735.0,0.705,11.625,153,30,16,14,123,78,45,4,0.0,0.0
1015,1697,2020-03-19 23:41:00,0,2015.0,1481.0,0.735,9.577,468,85,44,41,383,277,106,8,0.0,0.0
1015,1698,2020-03-19 23:44:00,0,2794.0,2051.0,0.734,13.281,345,200,167,33,145,111,34,70,0.15,0.0
1015,1699,2020-03-19 23:47:00,0,2485.0,1805.0,0.726,11.788,570,267,203,64,303,229,74,115,0.0,0.0
1015,1700,2020-03-19 23:50:00,0,3329.0,2350.0,0.706,15.718,476,231,181,50,245,188,57,80,0.0,0.0
1015,1701,2020-03-19 23:53:00,0,3272.0,2351.0,0.719,15.494,552,267,217,50,285,226,59,154,0.0,0.0
1015,1702,2020-03-19 23:56:00,0,2993.0,2101.0,0.702,14.121,526,290,220,70,236,185,51,69,0.0,0.0
1015,1703,2020-03-19 23:59:00,0,3025.0,2120.0,0.701,14.264,231,161,103,58,70,22,48,3,0.0,0.0
1015,1704,2020-03-20 00:02:00,0,3051.0,2128.0,0.698,14.377,230,156,95,61,74,39,35,7,0.0,0.0
1015,1705,2020-03-20 00:05:00,0,3062.0,2188.0,0.715,14.486,397,173,120,53,224,157,67,66,0.0,0.0
1015,1706,2020-03-20 00:08:00,0,3021.0,2151.0,0.712,14.286,361,185,123,62,176,134,42,31,0.0,0.0
1015,1707,2020-03-20 00:11:00,0,3196.0,2318.0,0.725,15.158,160,86,54,32,74,47,27,26,0.0,0.0
1015,1708,2020-03-20 00:14:00,0,3210.0,2288.0,0.713,15.183,511,238,171,67,273,204,69,74,0.0,0.0
1015,1709,2020-03-20 00:17:00,0,3056.0,2183.0,0.714,14.458,461,168,111,57,293,216,77,11,0.0,0.0
1015,1710,2020-03-20 00:20:00,0,3015.0,2093.0,0.694,14.195,423,223,160,63,200,141,59,18,0.0,0.0
1015,1711,2020-03-20 00:23:00,0,3019.0,2175.0,0.72,14.304,440,165,112,53,275,215,60,36,0.0,0.0
1015,1712,2020-03-20 00:26:00,0,3024.0,2235.0,0.739,14.39,46,10,5,5,36,21,15,5,0.02,0.0
1015,1713,2020-03-20 00:29:00,0,3052.0,2188.0,0.717,14.448,3,3,1,2,0,0,0,0,0.0,0.0
1015,1714,2020-03-20 00:32:00,0,2816.0,1979.0,0.703,13.286,9,7,0,7,2,1,1,0,0.0,0.0
1015,1715,2020-03-20 00:35:00,0,2650.0,1806.0,0.682,12.442,14,0,0,0,14,0,14,0,0.01,0.0
1015,1716,2020-03-20 00:38:00,0,2452.0,1705.0,0.695,11.549,15,2,0,2,13,3,10,0,0.0,0.0
1015,1717,2020-03-20 00:41:00,0,2292.0,1524.0,0.665,10.717,3,0,0,0,3,1,2,0,0.0,0.0
1015,1718,2020-03-20 00:44:00,0,2066.0,1467.0,0.71,9.764,0,0,0,0,0,0,0,0,0.0,0.0
1015,1719,2020-03-20 00:47:00,0,2089.0,1390.0,0.666,9.77,0,0,0,0,0,0,0,0,0.0,0.0
1015,1720,2020-03-20 00:50:00,0,1902.0,1316.0,0.692,8.953,19,15,2,13,4,1,3,0,0.0,0.0
1015,1721,2020-03-20 00:53:00,0,2287.0,1621.0,0.709,10.806,92,25,2,23,67,27,40,2,0.0,0.0
1015,1722,2020-03-20 00:56:00,0,2047.0,1488.0,0.727,9.712,194,96,60,36,98,63,35,11,0.0,0.0
1015,1723,2020-03-20 00:59:00,0,2275.0,1650.0,0.725,10.791,208,99,70,29,109,79,30,17,0.0,0.0
1015,1724,2020-03-20 01:02:00,0,2466.0,1703.0,0.691,11.603,16,16,0,16,0,0,0,0,0.01,0.0
1015,1725,2020-03-20 01:05:00,0,2271.0,1558.0,0.686,10.674,8,1,0,1,7,1,6,0,0.0,0.0
1015,1726,2020-03-20 01:08:00,0,2123.0,1490.0,0.702,10.014,13,0,0,0,13,6,7,0,0.0,0.0
1015,1727,2020-03-20 01:11:00,0,2043.0,1381.0,0.676,9.581,6,5,0,5,1,0,1,0,0.0,0.0
1015,1728,2020-03-20 01:14:00,0,1970.0,1368.0,0.694,9.277,4,0,0,0,4,2,2,0,0.0,0.0
1015,1729,2020-03-20 01:17:00,0,1913.0,1331.0,0.696,9.012,7,2,0,2,5,2,3,0,0.0,0.0
1015,1730,2020-03-20 01:20:00,0,1884.0,1235.0,0.656,8.79,0,0,0,0,0,0,0,0,0.0,0.0
1015,1731,2020-03-20 01:23:00,0,2313.0,1597.0,0.69,10.884,66,6,2,4,60,23,37,0,0.0,0.0
1015,1732,2020-03-20 01:26:00,0,2417.0,1747.0,0.723,11.456,326,142,98,44,184,138,46,30,0.0,0.0
1015,1733,2020-03-20 01:29:00,0,2561.0,1816.0,0.709,12.1,88,55,48,7,33,22,11,10,0.06,0.0
1015,1734,2020-03-20 01:32:00,0,2122.0,1543.0,0.727,10.069,345,173,124,49,172,124,48,15,0.0,0.0
1015,1735,2020-03-20 01:35:00,0,1907.0,1375.0,0.721,9.037,274,179,129,50,95,59,36,9,0.0,0.0
1015,1736,2020-03-20 01:38:00,0,2411.0,1684.0,0.699,11.363,228,137,71,66,91,46,45,3,0.0,0.0
1015,1737,2020-03-20 01:41:00,0,2649.0,1809.0,0.683,12.44,173,94,53,41,79,47,32,1,0.0,0.0
1015,1738,2020-03-20 01:44:00,0,3011.0,2183.0,0.725,14.279,644,371,306,65,273,217,56,148,0.0,0.0
1015,1739,2020-03-20 01:47:00,0,3038.0,2244.0,0.739,14.455,639,350,267,83,289,224,65,134,0.0,0.0
1015,1740,2020-03-20 01:50:00,0,3273.0,2341.0,0.715,15.487,152,90,61,29,62,39,23,44,0.12,0.0
1015,1741,2020-03-20 01:53:00,0,3139.0,2261.0,0.72,14.871,521,219,161,58,302,223,79,72,0.02,0.0
1015,1742,2020-03-20 01:56:00,0,2804.0,2043.0,0.728,13.312,242,135,91,44,107,66,41,17,0.0,0.0
1015,1743,2020-03-20 01:59:00,0,2787.0,2006.0,0.72,13.203,350,180,119,61,170,120,50,14,0.0,0.0
1015,1744,2020-03-20 02:02:00,0,3030.0,2223.0,0.734,14.402,296,142,96,46,154,113,41,38,0.0,0.0
1015,1745,2020-03-20 02:05:00,0,3029.0,2240.0,0.739,14.414,605,285,210,75,320,245,75,78,0.0,0.0
1015,1746,2020-03-20 02:08:00,0,3027.0,2180.0,0.72,14.341,306,117,91,26,189,135,54,98,0.0,0.0
1015,1747,2020-03-20 02:11:00,0,3029.0,2111.0,0.697,14.272,493,276,208,68,217,165,52,67,0.0,0.0
1015,1748,2020-03-20 02:14:00,0,3104.0,2215.0,0.714,14.684,166,91,48,43,75,48,27,11,0.0,0.0
1015,1749,2020-03-20 02:17:00,0,3092.0,2122.0,0.686,14.531,184,91,52,39,93,58,35,6,0.0,0.0
1015,1750,2020-03-20 02:20:00,0,2785.0,2058.0,0.739,13.252,238,151,102,49,87,59,28,33,0.0,0.0
1015,1751,2020-03-20 02:23:00,0,3045.0,2104.0,0.691,14.325,222,113,67,46,109,75,34,0,0.0,0.04
1015,1752,2020-03-20 02:26:00,0,2898.0,2073.0,0.715,13.713,342,118,74,44,224,148,76,0,0.0,0.0
1015,1753,2020-03-20 02:29:00,0,2822.0,1961.0,0.695,13.289,494,171,139,32,323,248,75,0,0.0,0.0
1015,1754,2020-03-20 02:32:00,0,2817.0,1947.5,0.6915,13.256,423,101,57,44,322,253,69,33,0.0,0.0
1015,1755,2020-03-20 02:35:00,0,2812.0,1934.0,0.688,13.223,356,52,20,32,304,218,86,0,0.0,0.0
1015,1756,2020-03-20 02:38:00,0,2663.0,1850.0,0.695,12.541,146,45,15,30,101,58,43,0,0.0,0.0
1015,1757,2020-03-20 02:41:00,0,2668.0,1911.0,0.716,12.627,79,63,27,36,16,10,6,0,0.0,0.0
1015,1758,2020-03-20 02:44:00,0,2437.0,1690.0,0.694,11.475,41,5,1,4,36,18,18,0,0.0,0.0
1015,1759,2020-03-20 02:47:00,0,2330.0,1616.0,0.693,10.971,56,4,1,3,52,24,28,0,0.0,0.0
1015,1760,2020-03-20 02:50:00,0,2249.0,1526.0,0.679,10.551,56,0,0,0,56,28,28,0,0.0,0.0
1015,1761,2020-03-20 02:53:00,0,2054.0,1404.0,0.684,9.646,112,9,3,6,103,54,49,0,0.0,0.0
1015,1762,2020-03-20 02:56:00,0,2332.0,1555.0,0.667,10.909,116,2,1,1,114,53,61,0,0.0,0.0
1015,1763,2020-03-20 02:59:00,0,2310.0,1526.0,0.66,10.793,166,0,0,0,166,106,60,0,0.0,0.0
1015,1764,2020-03-20 03:02:00,0,2028.0,1451.0,0.715,9.598,382,70,60,10,312,224,88,4,0.0,0.0
1015,1765,2020-03-20 03:05:00,0,2440.0,1723.0,0.706,11.522,179,91,71,20,88,67,21,22,0.0,0.0
1015,1766,2020-03-20 03:08:00,0,2309.0,1642.0,0.711,10.918,326,121,86,35,205,152,53,15,0.02,0.0
1015,1767,2020-03-20 03:11:00,0,2297.0,1634.0,0.712,10.859,438,188,146,42,250,190,60,113,0.0,0.0
1015,1768,2020-03-20 03:14:00,0,2270.0,1667.0,0.735,10.788,645,320,266,54,325,257,68,152,0.02,0.0
1015,1769,2020-03-20 03:17:00,0,2587.0,1826.0,0.706,12.214,466,211,172,39,255,202,53,62,0.0,0.0
1015,1770,2020-03-20 03:20:00,0,2272.0,1651.0,0.727,10.781,249,112,76,36,137,99,38,12,0.0,0.0
1015,1771,2020-03-20 03:23:00,0,2457.0,1736.0,0.706,11.605,0,0,0,0,0,0,0,0,0.0,0.0
1015,1772,2020-03-20 03:26:00,0,2272.0,1571.0,0.691,10.69,3,3,0,3,0,0,0,0,0.0,0.0
1015,1773,2020-03-20 03:29:00,0,2144.0,1469.0,0.685,10.074,15,13,0,13,2,2,0,0,0.0,0.0
1015,1774,2020-03-20 03:32:00,0,2084.0,1424.0,0.683,9.789,10,9,0,9,1,1,0,0,0.0,0.0
1015,1775,2020-03-20 03:35:00,0,2068.0,1409.0,0.681,9.708,3,3,0,3,0,0,0,0,0.0,0.0
1015,1776,2020-03-20 03:38:00,0,1984.0,1365.0,0.688,9.327,9,8,0,8,1,1,0,0,0.0,0.0
1015,1777,2020-03-20 03:41:00,0,1835.0,1259.0,0.686,8.623,19,16,0,16,3,1,2,0,0.0,0.0
1015,1778,2020-03-20 03:44:00,0,1767.0,1248.0,0.706,8.343,11,8,0,8,3,0,3,0,0.0,0.0
1015,1779,2020-03-20 03:47:00,0,1853.0,1264.0,0.682,8.702,3,3,0,3,0,0,0,0,0.0,0.0
1015,1780,2020-03-20 03:50:00,0,1901.0,1356.0,0.713,8.993,0,0,0,0,0,0,0,0,0.0,0.0
1015,1781,2020-03-20 03:53:00,0,1913.0,1329.0,0.695,9.009,0,0,0,0,0,0,0,0,0.0,0.0
1015,1782,2020-03-20 03:56:00,0,2053.0,1436.0,0.7,9.681,5,4,0,4,1,1,0,0,0.0,0.0
1015,1783,2020-03-20 03:59:00,0,2074.0,1419.0,0.684,9.743,5,4,0,4,1,1,0,0,0.0,0.0
1015,1784,2020-03-20 04:02:00,0,2117.0,1505.0,0.711,10.008,0,0,0,0,0,0,0,0,0.0,0.0
1015,1785,2020-03-20 04:05:00,0,2286.0,1557.0,0.681,10.732,9,9,0,9,0,0,0,0,0.0,0.0
1015,1786,2020-03-20 04:08:00,0,2428.0,1817.0,0.748,11.579,82,41,0,41,41,22,19,0,0.0,0.0
1015,1787,2020-03-20 04:11:00,0,2422.0,1751.0,0.723,11.48,328,160,118,42,168,126,42,68,0.1,0.0
1015,1788,2020-03-20 04:14:00,0,2590.0,1816.0,0.701,12.217,515,243,194,49,272,218,54,111,0.0,0.0
1015,1789,2020-03-20 04:17:00,0,2438.0,1794.0,0.736,11.591,496,204,156,48,292,210,82,23,0.0,0.0
1015,1790,2020-03-20 04:20:00,0,2496.0,1803.0,0.723,11.829,329,158,132,26,171,130,41,124,0.0,0.0
1015,1791,2020-03-20 04:23:00,0,2666.0,1894.0,0.711,12.602,589,314,245,69,275,202,73,42,0.0,0.0
1015,1792,2020-03-20 04:26:00,0,2629.0,1865.0,0.71,12.424,372,184,142,42,188,143,45,76,0.0,0.0
1015,1793,2020-03-20 04:29:00,0,2866.0,2011.0,0.701,13.52,429,165,128,37,264,191,73,43,0.0,0.0
1015,1794,2020-03-20 04:32:00,0,2820.0,1947.0,0.69,13.268,378,182,136,46,196,136,60,61,0.0,0.0
1015,1795,2020-03-20 04:35:00,0,2633.0,1882.0,0.715,12.457,142,69,41,28,73,62,11,22,0.0,0.0
1015,1796,2020-03-20 04:38:00,0,2647.0,1854.0,0.7,12.482,334,94,52,42,240,171,69,1,0.0,0.0
1015,1797,2020-03-20 04:41:00,0,2674.0,1854.0,0.693,12.59,286,115,63,52,171,114,57,1,0.0,0.0
1015,1798,2020-03-20 04:44:00,0,2640.0,1893.0,0.717,12.499,245,65,27,38,180,120,60,0,0.0,0.0
1015,1799,2020-03-20 04:47:00,0,2609.0,1805.0,0.692,12.278,221,43,16,27,178,111,67,0,0.0,0.0
1015,1800,2020-03-20 04:50:00,0,2524.0,1792.0,0.71,11.928,11,4,0,4,7,2,5,0,0.0,0.0
1015,1801,2020-03-20 04:53:00,0,2443.0,1692.0,0.692,11.501,4,1,0,1,3,0,3,0,0.0,0.0
1015,1802,2020-03-20 04:56:00,0,2314.0,1562.0,0.675,10.846,40,1,0,1,39,22,17,0,0.0,0.0
1015,1803,2020-03-20 04:59:00,0,2063.0,1434.0,0.695,9.717,419,6,4,2,413,362,51,0,0.0,0.0
1015,1804,2020-03-20 05:02:00,0,2044.0,1473.0,0.721,9.685,238,5,2,3,233,179,54,0,0.0,0.0
1015,1805,2020-03-20 05:05:00,0,2248.0,1533.0,0.682,10.555,41,0,0,0,41,10,31,0,0.0,0.0
1015,1806,2020-03-20 05:08:00,0,2076.0,1472.0,0.709,9.809,457,0,0,0,457,426,31,0,0.0,0.0
1015,1807,2020-03-20 05:11:00,0,2092.0,1428.0,0.683,9.824,76,12,7,5,64,41,23,0,0.0,0.0
1015,1808,2020-03-20 05:14:00,0,2079.0,1417.0,0.681,9.76,26,0,0,0,26,6,20,0,0.0,0.0
1015,1809,2020-03-20 05:17:00,0,1897.0,1334.0,0.703,8.95,35,3,0,3,32,15,17,0,0.0,0.0
1015,1810,2020-03-20 05:20:00,0,1897.0,1302.0,0.686,8.916,28,2,0,2,26,10,16,0,0.0,0.0
1015,1811,2020-03-20 05:23:00,0,1923.0,1269.0,0.66,8.983,42,5,4,1,37,20,17,0,0.0,0.0
1015,1812,2020-03-20 05:26:00,0,2061.0,1479.0,0.718,9.759,365,121,74,47,244,164,80,4,0.0,0.0
1015,1813,2020-03-20 05:29:00,0,2314.0,1613.0,0.697,10.903,322,70,35,35,252,172,80,1,0.0,0.0
1015,1814,2020-03-20 05:32:00,0,2476.0,1727.0,0.6975,11.669,378,72,23,49,306,215,91,2,0.0,0.0
1015,1815,2020-03-20 05:35:00,0,2638.0,1841.0,0.698,12.435,252,60,23,37,192,132,60,2,0.0,0.0
1015,1816,2020-03-20 05:38:00,0,2610.0,1907.0,0.731,12.395,298,131,104,27,167,117,50,40,0.0,0.0
1015,1817,2020-03-20 05:41:00,0,2715.0,1968.0,0.725,12.876,545,253,204,49,292,223,69,116,0.39,0.0
1015,1818,2020-03-20 05:44:00,0,2822.0,1981.0,0.702,13.313,482,217,172,45,265,200,65,37,0.0,0.0
1015,1819,2020-03-20 05:47:00,0,2620.0,1922.0,0.734,12.452,452,217,166,51,235,187,48,60,0.0,0.0
1015,1820,2020-03-20 05:50:00,0,2625.0,1910.0,0.728,12.455,399,112,54,58,287,205,82,9,0.0,0.0
1015,1821,2020-03-20 05:53:00,0,2639.0,1895.0,0.718,12.494,136,73,61,12,63,51,12,9,0.0,0.0
1015,1822,2020-03-20 05:56:00,0,2430.0,1761.0,0.725,11.525,6,6,0,6,0,0,0,0,0.0,0.0
1015,1823,2020-03-20 05:59:00,0,2307.0,1585.0,0.687,10.843,0,0,0,0,0,0,0,0,0.0,0.0
1015,1824,2020-03-20 06:02:00,1,2199.0,1593.0,0.724,10.43,116,49,32,17,67,19,48,79,0.0,0.0
1015,1825,2020-03-20 06:05:00,1,2660.0,1832.0,0.689,12.51,112,41,22,19,71,6,65,116,0.0,0.06
1015,1826,2020-03-20 06:08:00,1,3026.0,2177.0,0.719,14.334,86,42,21,21,44,6,38,110,0.0,0.47
1015,1827,2020-03-20 06:11:00,1,3164.0,2319.0,0.733,15.036,92,52,24,28,40,11,29,37,0.0,0.09
1015,1828,2020-03-20 06:14:00,1,3245.0,2518.0,0.776,15.572,423,217,176,41,206,156,50,121,0.0,0.0
1015,1829,2020-03-20 06:17:00,1,3532.0,2787.0,0.789,17.003,130,46,33,13,84,52,32,26,0.0,0.23
1015,1830,2020-03-20 06:20:00,1,3085.0,2480.0,0.804,14.901,194,85,68,17,109,80,29,24,0.28,0.0
1015,1831,2020-03-20 06:23:00,1,2739.0,2241.0,0.818,13.274,485,192,148,44,293,220,73,44,0.0,0.04
1015,1832,2020-03-20 06:26:00,1,3186.0,2687.0,0.843,15.526,6,3,1,2,3,2,1,2,0.0,0.0
1015,1833,2020-03-20 06:29:00,1,2969.0,2418.0,0.815,14.373,588,212,174,38,376,294,82,13,0.0,0.01
1015,1834,2020-03-20 06:32:00,1,2915.0,2494.0,0.856,14.245,444,181,142,39,263,202,61,21,0.0,0.0
1015,1835,2020-03-20 06:35:00,1,2614.0,2244.0,0.858,12.785,295,102,64,38,193,142,51,0,0.0,0.0
1015,1836,2020-03-20 06:38:00,1,2957.0,2528.0,0.855,14.45,381,165,115,50,216,153,63,56,0.0,0.0
1015,1837,2020-03-20 06:41:00,1,2917.0,2628.0,0.901,14.404,502,194,153,41,308,233,75,146,0.0,0.0
1015,1838,2020-03-20 06:44:00,1,2889.0,2593.0,0.898,14.254,410,194,165,29,216,171,45,189,0.0,0.0
1015,1839,2020-03-20 06:47:00,1,3084.0,2736.0,0.887,15.18,382,149,106,43,233,169,64,65,0.0,0.0
1015,1840,2020-03-20 06:50:00,1,2923.0,2616.0,0.895,14.413,112,38,25,13,74,13,61,139,0.0,0.03
1015,1841,2020-03-20 06:53:00,1,3007.0,2653.0,0.882,14.784,270,52,23,29,218,151,67,0,0.0,0.08
1015,1842,2020-03-20 06:56:00,1,3046.0,2753.0,0.904,15.05,378,56,24,32,322,232,90,0,0.0,0.0
1015,1843,2020-03-20 06:59:00,1,2933.0,2613.0,0.891,14.449,24,12,0,12,12,6,6,0,0.0,0.0
1015,1844,2020-03-20 07:02:00,1,2711.0,2436.0,0.899,13.377,18,5,1,4,13,8,5,0,0.0,0.0
1015,1845,2020-03-20 07:05:00,1,2574.0,2150.0,0.835,12.522,39,5,2,3,34,11,23,0,0.0,0.0
1015,1846,2020-03-20 07:08:00,1,2575.0,2167.0,0.842,12.545,23,4,1,3,19,3,16,0,0.0,0.01
1015,1847,2020-03-20 07:11:00,1,2347.0,2099.0,0.894,11.572,29,0,0,0,29,0,29,0,0.0,0.0
1015,1848,2020-03-20 07:14:00,1,2286.0,2014.0,0.881,11.235,62,0,0,0,62,13,49,0,0.0,0.0
1015,1849,2020-03-20 07:17:00,1,2226.0,1971.0,0.885,10.954,76,4,1,3,72,23,49,0,0.0,0.0
1015,1850,2020-03-20 07:20:00,1,2203.0,1906.0,0.865,10.791,18,3,1,2,15,3,12,0,0.0,0.0
1015,1851,2020-03-20 07:23:00,1,2225.0,1949.0,0.876,10.926,47,5,3,2,42,13,29,0,0.0,0.0
1015,1852,2020-03-20 07:26:00,1,2196.0,2013.0,0.917,10.879,136,1,1,0,135,79,56,0,0.0,0.0
1015,1853,2020-03-20 07:29:00,1,2036.0,1859.0,0.913,10.078,241,10,0,10,231,150,81,0,0.0,0.0
1015,1854,2020-03-20 07:32:00,1,1973.0,1795.0,0.91,9.763,117,3,0,3,114,44,70,0,0.0,0.0
1015,1855,2020-03-20 07:35:00,1,2262.0,2065.0,0.913,11.199,161,45,23,22,116,78,38,2,0.0,0.0
1015,1856,2020-03-20 07:38:00,1,2245.0,2075.0,0.924,11.143,13,13,0,13,0,0,0,0,0.0,0.0
1015,1857,2020-03-20 07:41:00,1,2184.0,2098.0,0.961,10.927,351,21,5,16,330,291,39,0,0.0,0.0
1015,1858,2020-03-20 07:44:00,1,2311.0,2114.0,0.915,11.445,106,27,16,11,79,11,68,144,0.0,0.1
1015,1859,2020-03-20 07:47:00,1,2642.0,2521.0,0.954,13.201,184,98,68,30,86,41,45,57,0.27,0.0
1015,1860,2020-03-20 07:50:00,1,2652.0,2538.0,0.957,13.259,114,34,21,13,80,3,77,142,0.0,0.05
1015,1861,2020-03-20 07:53:00,1,2914.0,2771.0,0.951,14.548,144,59,37,22,85,44,41,25,0.13,0.08
1015,1862,2020-03-20 07:56:00,1,2943.0,2680.0,0.91,14.564,361,82,41,41,279,194,85,18,0.0,0.0
1015,1863,2020-03-20 07:59:00,1,2914.0,2741.0,0.941,14.514,317,114,70,44,203,144,59,4,0.0,0.0
1015,1864,2020-03-20 08:02:00,1,2899.0,2743.0,0.946,14.459,4,2,2,0,2,1,1,0,0.0,0.0
1015,1865,2020-03-20 08:05:00,1,2656.0,2555.0,0.962,13.292,18,14,0,14,4,2,2,0,0.0,0.0
1015,1866,2020-03-20 08:08:00,1,2513.0,2336.0,0.93,12.489,33,16,8,8,17,11,6,0,0.0,0.0
1015,1867,2020-03-20 08:11:00,1,2352.0,2175.0,0.925,11.676,6,0,0,0,6,1,5,0,0.0,0.0
1015,1868,2020-03-20 08:14:00,1,2328.0,2195.0,0.943,11.603,78,19,12,7,59,18,41,87,0.0,0.07
1015,1869,2020-03-20 08:17:00,1,2678.0,2543.0,0.95,13.367,86,24,10,14,62,23,39,90,0.0,0.22
1015,1870,2020-03-20 08:20:00,1,2659.0,2548.0,0.958,13.297,299,90,54,36,209,137,72,33,0.0,0.0
1015,1871,2020-03-20 08:23:00,1,2596.0,2414.0,0.93,12.899,404,142,95,47,262,188,74,28,0.0,0.0
1015,1872,2020-03-20 08:26:00,1,2668.0,2546.0,0.954,13.329,144,38,9,29,106,65,41,0,0.0,0.0
1015,1873,2020-03-20 08:29:00,1,2651.0,2528.0,0.954,13.242,90,31,6,25,59,33,26,0,0.0,0.0
1015,1874,2020-03-20 08:32:00,1,2578.5,2417.0,0.937,12.8345,74,20,3,17,54,17,37,0,0.0,0.0
1015,1875,2020-03-20 08:35:00,1,2506.0,2306.0,0.92,12.427,85,13,1,12,72,26,46,0,0.0,0.0
1015,1876,2020-03-20 08:38:00,1,2433.0,2191.0,0.9,12.014,320,36,2,34,284,185,99,0,0.0,0.0
1015,1877,2020-03-20 08:41:00,1,2345.0,2079.0,0.887,11.541,834,15,1,14,819,698,121,0,0.0,0.0
1015,1878,2020-03-20 08:44:00,1,2255.0,2003.0,0.888,11.101,323,9,4,5,314,190,124,0,0.0,0.0
1015,1879,2020-03-20 08:47:00,1,2167.0,1943.0,0.897,10.689,168,23,15,8,145,67,78,14,0.0,0.0
1015,1880,2020-03-20 08:50:00,1,2759.0,2592.0,0.94,13.738,44,16,12,4,28,8,20,59,0.0,0.14
1015,1881,2020-03-20 08:53:00,1,2765.0,2611.0,0.944,13.786,150,39,20,19,111,56,55,2,0.19,0.0
1015,1882,2020-03-20 08:56:00,1,2662.0,2514.0,0.944,13.273,87,18,4,14,69,32,37,0,0.0,0.0
1015,1883,2020-03-20 08:59:00,1,2556.0,2314.0,0.905,12.631,38,0,0,0,38,5,33,0,0.0,0.0
1015,1884,2020-03-20 09:02:00,1,2398.0,2206.0,0.92,11.892,33,0,0,0,33,5,28,0,0.0,0.0
1015,1885,2020-03-20 09:05:00,1,2490.0,2209.0,0.887,12.255,120,13,9,4,107,71,36,0,0.0,0.0
1015,1886,2020-03-20 09:08:00,1,2312.0,2192.0,0.948,11.538,26,0,0,0,26,16,10,0,0.0,0.0
1015,1887,2020-03-20 09:11:00,1,2337.0,2135.0,0.914,11.569,32,0,0,0,32,14,18,0,0.0,0.0
1015,1888,2020-03-20 09:14:00,1,2237.0,2074.0,0.927,11.11,38,5,3,2,33,17,16,0,0.0,0.0
1015,1889,2020-03-20 09:17:00,1,2307.0,2120.0,0.919,11.435,29,1,0,1,28,10,18,0,0.0,0.0
1015,1890,2020-03-20 09:20:00,1,2320.0,2237.0,0.964,11.616,33,3,0,3,30,16,14,0,0.0,0.0
1015,1891,2020-03-20 09:23:00,1,2342.0,2189.0,0.935,11.652,119,0,0,0,119,62,57,0,0.0,0.0
1015,1892,2020-03-20 09:26:00,1,2378.0,2173.0,0.914,11.776,165,18,9,9,147,91,56,0,0.0,0.0
1015,1893,2020-03-20 09:29:00,1,2584.0,2298.0,0.889,12.726,244,86,37,49,158,83,75,2,0.0,0.0
1015,1894,2020-03-20 09:32:00,1,2527.0,2442.0,0.966,12.66,190,68,50,18,122,77,45,35,0.0,0.0
1015,1895,2020-03-20 09:35:00,1,2782.0,2626.0,0.944,13.868,166,64,30,34,102,48,54,22,0.0,0.0
1015,1896,2020-03-20 09:38:00,1,2624.0,2416.0,0.921,13.013,55,21,2,19,34,11,23,0,0.0,0.0
1015,1897,2020-03-20 09:41:00,1,2499.0,2245.0,0.898,12.333,35,4,0,4,31,4,27,0,0.0,0.0
1015,1898,2020-03-20 09:44:00,1,2329.0,2159.0,0.927,11.566,99,16,3,13,83,37,46,0,0.0,0.0
1015,1899,2020-03-20 09:47:00,1,2290.0,2151.0,0.939,11.402,95,2,0,2,93,58,35,0,0.0,0.0
1015,1900,2020-03-20 09:50:00,1,2488.0,2299.0,0.924,12.35,102,31,19,12,71,53,18,0,0.0,0.01
1015,1901,2020-03-20 09:53:00,1,2180.0,2051.0,0.941,10.86,22,1,0,1,21,1,20,0,0.0,0.0
1015,1902,2020-03-20 09:56:00,1,2163.0,1968.0,0.91,10.699,67,16,1,15,51,21,30,0,0.0,0.0
1015,1903,2020-03-20 09:59:00,1,2203.0,1950.0,0.885,10.836,82,0,0,0,82,50,32,0,0.0,0.0
1015,1904,2020-03-20 10:02:00,1,2209.0,2008.0,0.909,10.928,72,0,0,0,72,58,14,0,0.0,0.0
1015,1905,2020-03-20 10:05:00,1,2175.0,1961.0,0.902,10.739,233,25,14,11,208,156,52,0,0.0,0.0
1015,1906,2020-03-20 10:08:00,1,2347.0,2230.0,0.95,11.715,128,15,7,8,113,88,25,0,0.0,0.0
1015,1907,2020-03-20 10:11:00,1,2304.0,2208.0,0.958,11.52,117,10,5,5,107,53,54,0,0.0,0.0
1015,1908,2020-03-20 10:14:00,1,2279.0,2173.0,0.953,11.385,319,244,212,32,75,36,39,0,0.0,0.0
1015,1909,2020-03-20 10:17:00,1,2339.0,2243.0,0.959,11.699,101,28,5,23,73,19,54,0,0.0,0.0
1015,1910,2020-03-20 10:20:00,1,2208.0,2021.0,0.915,10.935,185,9,0,9,176,100,76,0,0.0,0.01
1015,1911,2020-03-20 10:23:00,1,2166.0,2036.0,0.94,10.789,85,19,10,9,66,20,46,0,0.0,0.0
1015,1912,2020-03-20 10:26:00,1,2391.0,2256.0,0.943,11.919,68,20,11,9,48,4,44,86,0.0,0.25
1015,1913,2020-03-20 10:29:00,1,2647.0,2470.0,0.933,13.164,348,152,109,43,196,146,50,20,0.0,0.0
1015,1914,2020-03-20 10:32:00,1,2686.0,2496.0,0.929,13.345,753,257,211,46,496,378,118,18,0.0,0.07
1015,1915,2020-03-20 10:35:00,1,2643.0,2625.0,0.993,13.32,481,211,161,50,270,190,80,22,0.0,0.0
1015,1916,2020-03-20 10:38:00,1,2668.0,2577.0,0.966,13.364,324,9,6,3,315,238,77,4,0.0,0.0
1015,1917,2020-03-20 10:41:00,1,2813.0,2651.0,0.943,14.017,250,34,6,28,216,156,60,2,0.0,0.0
1015,1918,2020-03-20 10:44:00,1,2948.0,2706.0,0.918,14.609,162,41,11,30,121,66,55,0,0.0,0.0
1015,1919,2020-03-20 10:47:00,1,2524.0,2394.0,0.948,12.596,76,0,0,0,76,20,56,0,0.0,0.0
1015,1920,2020-03-20 10:50:00,1,2451.0,2221.0,0.906,12.115,87,3,2,1,84,20,64,0,0.0,0.0
1015,1921,2020-03-20 10:53:00,1,2316.0,2175.0,0.939,11.533,77,0,0,0,77,12,65,0,0.0,0.0
1015,1922,2020-03-20 10:56:00,1,2334.0,2175.0,0.932,11.603,64,13,6,7,51,34,17,0,0.0,0.0
1015,1923,2020-03-20 10:59:00,1,2160.0,2040.0,0.945,10.768,65,12,3,9,53,16,37,0,0.0,0.0
1015,1924,2020-03-20 11:02:00,1,2188.0,2004.0,0.916,10.839,78,4,2,2,74,18,56,0,0.0,0.0
1015,1925,2020-03-20 11:05:00,1,2163.0,2005.0,0.927,10.742,103,6,5,1,97,20,77,0,0.0,0.0
1015,1926,2020-03-20 11:08:00,1,2156.0,2075.0,0.963,10.791,60,11,8,3,49,21,28,0,0.0,0.0
1015,1927,2020-03-20 11:11:00,1,2192.0,2005.0,0.915,10.856,128,11,4,7,117,45,72,0,0.0,0.0
1015,1928,2020-03-20 11:14:00,1,2138.0,2112.0,0.988,10.761,141,16,5,11,125,48,77,0,0.0,0.0
1015,1929,2020-03-20 11:17:00,1,2131.0,1968.0,0.924,10.576,91,12,0,12,79,5,74,0,0.0,0.0
1015,1930,2020-03-20 11:20:00,1,2190.0,1993.0,0.91,10.837,60,0,0,0,60,0,60,0,0.0,0.0
1015,1931,2020-03-20 11:23:00,1,2221.0,1973.0,0.888,10.934,84,6,0,6,78,15,63,0,0.0,0.0
1015,1932,2020-03-20 11:26:00,1,2171.0,1966.0,0.905,10.732,62,0,0,0,62,5,57,0,0.0,0.0
1015,1933,2020-03-20 11:29:00,1,2197.0,1996.0,0.909,10.866,86,1,0,1,85,19,66,0,0.0,0.0
1015,1934,2020-03-20 11:32:00,1,2183.5,2012.5,0.922,10.831,60,0,0,0,60,2,58,0,0.0,0.0
1015,1935,2020-03-20 11:35:00,1,2170.0,2029.0,0.935,10.796,138,25,14,11,113,54,59,0,0.0,0.0
1015,1936,2020-03-20 11:38:00,1,2318.0,2197.0,0.948,11.565,192,10,2,8,182,115,67,0,0.0,0.0
1015,1937,2020-03-20 11:41:00,1,2288.0,2176.0,0.951,11.424,188,19,10,9,169,103,66,0,0.0,0.0
1015,1938,2020-03-20 11:44:00,1,2644.0,2505.0,0.947,13.193,209,32,16,16,177,114,63,0,0.0,0.0
1015,1939,2020-03-20 11:47:00,1,2540.0,2351.0,0.926,12.611,82,5,2,3,77,31,46,0,0.0,0.0
1015,1940,2020-03-20 11:50:00,1,2581.0,2440.0,0.945,12.87,57,0,0,0,57,4,53,0,0.0,0.0
1015,1941,2020-03-20 11:53:00,1,2450.0,2363.0,0.964,12.269,87,9,9,0,78,26,52,0,0.0,0.0
1015,1942,2020-03-20 11:56:00,1,2042.0,1950.0,0.955,10.206,3,1,1,0,2,1,1,0,0.0,0.0
1015,1943,2020-03-20 11:59:00,1,1948.0,1834.0,0.941,9.706,1,1,0,1,0,0,0,0,0.0,0.0
1015,1944,2020-03-20 12:02:00,1,1947.0,1835.0,0.943,9.702,9,1,0,1,8,3,5,0,0.0,0.0
1015,1945,2020-03-20 12:05:00,1,1952.0,1787.0,0.916,9.67,10,1,0,1,9,0,9,0,0.0,0.0
1015,1946,2020-03-20 12:08:00,1,1968.0,1792.0,0.911,9.739,54,6,0,6,48,33,15,0,0.0,0.0
1016,1,2020-03-16 10:53:00,1,3413.0,2401.0,0.703,16.108,1123,507,407,100,616,503,113,217,0.0,0.0
1016,2,2020-03-16 10:56:00,1,3539.0,2544.0,0.719,16.761,922,477,403,74,445,349,96,237,0.06,0.0
1016,3,2020-03-16 10:59:00,1,3345.0,2391.0,0.715,15.826,834,448,362,86,386,302,84,159,0.0,0.01
1016,4,2020-03-16 11:02:00,1,3428.0,2396.0,0.699,16.161,910,445,360,85,465,367,98,172,0.0,0.0
1016,5,2020-03-16 11:05:00,1,3264.0,2344.0,0.718,15.458,940,426,349,77,514,413,101,122,0.0,0.0
1016,6,2020-03-16 11:08:00,1,3412.0,2402.0,0.704,16.104,1018,456,372,84,562,452,110,179,0.0,0.0
1016,7,2020-03-16 11:11:00,1,3218.0,2263.0,0.703,15.185,679,327,258,69,352,270,82,128,0.0,0.0
1016,8,2020-03-16 11:14:00,1,3203.0,2276.0,0.711,15.139,885,431,344,87,454,347,107,114,0.0,0.0
1016,9,2020-03-16 11:17:00,1,3275.0,2322.0,0.709,15.476,655,324,263,61,331,258,73,203,0.0,0.0
1016,10,2020-03-16 11:20:00,1,2912.0,2095.0,0.72,13.792,774,358,296,62,416,326,90,158,0.0,0.0
1016,11,2020-03-16 11:23:00,1,3200.0,2247.0,0.702,15.098,653,349,273,76,304,213,91,55,0.0,0.0
1016,12,2020-03-16 11:26:00,1,3192.0,2271.0,0.711,15.093,614,321,253,68,293,229,64,143,0.03,0.0
1016,13,2020-03-16 11:29:00,1,2958.0,2130.0,0.72,14.012,738,392,324,68,346,273,73,143,0.0,0.0
1016,14,2020-03-16 11:32:00,1,2903.0,2117.0,0.729,13.781,710,366,276,90,344,267,77,45,0.0,0.03
1016,15,2020-03-16 11:35:00,1,2911.0,2085.0,0.716,13.7785,649,404,321,83,245,187,58,122,0.0,0.0
1016,16,2020-03-16 11:38:00,1,2919.0,2053.0,0.703,13.776,558,293,233,60,265,189,76,152,0.0,0.0
1016,17,2020-03-16 11:41:00,1,2913.0,2117.0,0.727,13.82,752,331,266,65,421,330,91,135,0.01,0.0
1016,18,2020-03-16 11:44:00,1,2922.0,2037.0,0.697,13.767,509,231,177,54,278,197,81,170,0.03,0.0
1016,19,2020-03-16 11:47:00,1,2704.0,1927.0,0.713,12.787,355,195,153,42,160,125,35,170,0.0,0.0
1016,20,2020-03-16 11:50:00,1,2929.0,2077.0,0.709,13.84,555,295,230,65,260,192,68,175,0.0,0.0
1016,21,2020-03-16 11:53:00,1,2697.0,1951.0,0.723,12.785,842,412,318,94,430,349,81,32,0.0,0.0
1016,22,2020-03-16 11:56:00,1,2931.0,2063.0,0.704,13.833,665,286,224,62,379,302,77,152,0.0,0.0
1016,23,2020-03-16 11:59:00,1,2768.0,1974.0,0.713,13.092,795,390,314,76,405,321,84,121,0.0,0.0
1016,24,2020-03-16 12:02:00,1,2862.0,2011.0,0.703,13.502,513,257,185,72,256,186,70,125,0.0,0.0
1016,25,2020-03-16 12:05:00,1,2711.0,1904.0,0.702,12.789,463,254,177,77,209,138,71,185,0.0,0.0
1016,26,2020-03-16 12:08:00,1,2581.0,1794.0,0.695,12.154,631,331,257,74,300,231,69,166,0.0,0.0
1016,27,2020-03-16 12:11:00,1,2645.0,1860.0,0.703,12.482,439,174,116,58,265,184,81,112,0.0,0.0
1016,28,2020-03-16 12:14:00,1,2576.0,1827.0,0.709,12.17,385,192,132,60,193,137,56,27,0.2,0.0
1016,29,2020-03-16 12:17:00,1,2352.0,1692.0,0.719,11.141,472,239,184,55,233,169,64,96,0.0,0.0
1016,30,2020-03-16 12:20:00,1,2420.0,1726.0,0.713,11.447,503,290,234,56,213,159,54,215,0.0,0.0
1016,31,2020-03-16 12:23:00,1,2368.0,1636.0,0.691,11.141,420,201,158,43,219,174,45,201,0.0,0.0
1016,32,2020-03-16 12:26:00,1,2704.0,1938.0,0.717,12.801,208,124,73,51,84,59,25,25,0.0,0.0
1016,33,2020-03-16 12:29:00,1,2093.0,1466.0,0.7,9.871,113,47,18,29,66,26,40,8,0.0,0.0
1016,34,2020-03-16 12:32:00,1,2558.0,1833.0,0.717,12.108,423,224,170,54,199,140,59,61,0.0,0.0
1016,35,2020-03-16 12:35:00,1,2796.0,1962.0,0.702,13.19,381,179,138,41,202,144,58,118,0.0,0.0
1016,36,2020-03-16 12:38:00,1,2353.0,1707.0,0.726,11.161,503,213,158,55,290,232,58,37,0.0,0.0
1016,37,2020-03-16 12:41:00,1,2595.0,1770.0,0.682,12.183,451,218,161,57,233,175,58,60,0.0,0.0
1016,38,2020-03-16 12:44:00,1,2375.0,1662.0,0.7,11.199,470,239,182,57,231,176,55,166,0.0,0.0
1016,39,2020-03-16 12:47:00,1,2295.0,1611.0,0.702,10.827,399,186,153,33,213,156,57,37,0.0,0.0
1016,40,2020-03-16 12:50:00,1,2298.0,1610.0,0.701,10.837,441,222,164,58,219,162,57,76,0.0,0.0
1016,41,2020-03-16 12:53:00,1,2524.0,1733.0,0.687,11.865,168,49,16,33,119,68,51,3,0.0,0.0
1016,42,2020-03-16 12:56:00,1,2307.0,1607.0,0.697,10.868,211,113,67,46,98,50,48,0,0.0,0.0
1016,43,2020-03-16 12:59:00,1,2514.0,1761.0,0.701,11.854,105,48,15,33,57,23,34,0,0.0,0.0
1016,44,2020-03-16 13:02:00,1,2579.0,1815.0,0.704,12.171,118,53,15,38,65,31,34,0,0.0,0.0
1016,45,2020-03-16 13:05:00,1,2359.0,1668.0,0.707,11.143,36,4,1,3,32,11,21,0,0.0,0.0
1016,46,2020-03-16 13:08:00,1,2222.0,1599.0,0.72,10.524,389,220,173,47,169,120,49,8,0.0,0.0
1016,47,2020-03-16 13:11:00,1,2253.0,1491.0,0.662,10.529,52,18,15,3,34,16,18,0,0.0,0.0
1016,48,2020-03-16 13:14:00,1,2244.0,1505.0,0.671,10.509,33,8,7,1,25,9,16,0,0.0,0.0
1016,49,2020-03-16 13:17:00,1,1886.0,1290.0,0.684,8.86,20,2,0,2,18,0,18,0,0.0,0.0
1016,50,2020-03-16 13:20:00,1,1867.0,1317.0,0.705,8.816,26,0,0,0,26,3,23,0,0.0,0.0
1016,51,2020-03-16 13:23:00,1,2040.0,1367.0,0.67,9.55,245,4,2,2,241,174,67,0,0.0,0.0
1016,52,2020-03-16 13:26:00,1,1892.0,1249.0,0.66,8.839,48,3,1,2,45,12,33,0,0.0,0.0
1016,53,2020-03-16 13:29:00,1,2014.0,1407.0,0.698,9.495,128,41,18,23,87,45,42,0,0.0,0.0
1016,54,2020-03-16 13:32:00,1,1891.0,1263.0,0.668,8.85,37,11,0,11,26,4,22,0,0.0,0.0
1016,55,2020-03-16 13:35:00,1,1889.0,1261.0,0.668,8.841,30,7,2,5,23,4,19,0,0.0,0.0
1016,56,2020-03-16 13:38:00,1,2022.0,1412.0,0.699,9.53,51,11,5,6,40,3,37,0,0.0,0.0
1016,57,2020-03-16 13:41:00,1,2225.0,1571.0,0.706,10.506,465,224,176,48,241,196,45,174,0.0,0.0
1016,58,2020-03-16 13:44:00,1,2362.0,1730.0,0.733,11.222,513,254,195,59,259,190,69,167,0.0,0.0
1016,59,2020-03-16 13:47:00,1,2342.0,1752.0,0.748,11.169,370,193,139,54,177,133,44,170,0.0,0.0
1016,60,2020-03-16 13:50:00,1,2424.0,1761.0,0.726,11.5,293,172,119,53,121,70,51,167,0.0,0.0
1016,61,2020-03-16 13:53:00,1,2372.0,1643.0,0.693,11.165,309,170,128,42,139,91,48,134,0.0,0.0
1016,62,2020-03-16 13:56:00,1,2439.0,1737.0,0.712,11.533,403,210,152,58,193,129,64,103,0.0,0.0
1016,63,2020-03-16 13:59:00,1,2347.0,1687.0,0.719,11.113,455,242,182,60,213,151,62,132,0.0,0.0
1016,64,2020-03-16 14:02:00,1,2370.0,1695.0,0.715,11.216,414,175,133,42,239,166,73,65,0.0,0.0
1016,65,2020-03-16 14:05:00,1,2001.0,1460.0,0.73,9.503,345,194,150,44,151,110,41,199,0.0,0.0
1016,66,2020-03-16 14:08:00,1,2366.0,1656.0,0.7,11.157,423,216,166,50,207,140,67,127,0.0,0.0
1016,67,2020-03-16 14:11:00,1,2152.0,1490.0,0.692,10.129,154,98,49,49,56,33,23,9,0.0,0.0
1016,68,2020-03-16 14:14:00,1,2161.0,1502.0,0.695,10.177,171,91,71,20,80,56,24,10,0.0,0.0
1016,69,2020-03-16 14:17:00,1,2169.0,1505.0,0.694,10.214,106,32,5,27,74,32,42,0,0.0,0.0
1016,70,2020-03-16 14:20:00,1,2344.0,1706.0,0.728,11.123,123,20,0,20,103,64,39,0,0.0,0.0
1016,71,2020-03-16 14:23:00,1,2348.0,1708.0,0.727,11.143,105,16,10,6,89,45,44,0,0.0,0.0
1016,72,2020-03-16 14:26:00,1,1816.0,1240.0,0.682,8.53,12,0,0,0,12,6,6,0,0.0,0.0
1016,73,2020-03-16 14:29:00,1,1737.0,1229.0,0.708,8.203,44,7,2,5,37,6,31,0,0.0,0.0
1016,74,2020-03-16 14:32:00,1,1543.0,1029.0,0.667,7.217,84,61,40,21,23,13,10,0,0.0,0.0
1016,75,2020-03-16 14:35:00,1,1642.0,1127.5,0.6855,7.7175,4,4,0,4,0,0,0,0,0.0,0.0
1016,76,2020-03-16 14:38:00,1,1741.0,1226.0,0.704,8.218,9,7,0,7,2,0,2,0,0.0,0.0
1016,77,2020-03-16 14:41:00,1,1665.0,1204.0,0.723,7.894,4,1,0,1,3,1,2,0,0.0,0.0
1016,78,2020-03-16 14:44:00,1,1679.0,1149.0,0.684,7.89,24,18,0,18,6,1,5,0,0.0,0.0
1016,79,2020-03-16 14:47:00,1,1527.0,1083.0,0.709,7.216,11,6,0,6,5,1,4,0,0.0,0.0
1016,80,2020-03-16 14:50:00,1,1548.0,1017.0,0.657,7.226,4,1,0,1,3,1,2,0,0.0,0.0
1016,81,2020-03-16 14:53:00,1,2157.0,1541.0,0.714,10.207,15,8,2,6,7,4,3,0,0.0,0.0
1016,82,2020-03-16 14:56:00,1,1870.0,1339.0,0.716,8.851,12,6,3,3,6,3,3,0,0.0,0.0
1016,83,2020-03-16 14:59:00,1,1670.0,1214.0,0.727,7.925,8,3,0,3,5,1,4,0,0.0,0.0
1016,84,2020-03-16 15:02:00,1,1891.0,1301.0,0.688,8.89,8,2,2,0,6,4,2,0,0.0,0.0
1016,85,2020-03-16 15:05:00,1,1889.0,1307.0,0.692,8.888,11,4,2,2,7,3,4,0,0.0,0.0
1016,86,2020-03-16 15:08:00,1,2015.0,1453.0,0.721,9.548,390,185,138,47,205,158,47,151,0.0,0.0
1016,87,2020-03-16 15:11:00,1,2009.0,1460.0,0.727,9.533,196,100,72,28,96,62,34,51,0.0,0.0
1016,88,2020-03-16 15:14:00,1,1881.0,1353.0,0.719,8.908,244,131,101,30,113,75,38,55,0.0,0.0
1016,89,2020-03-16 15:17:00,1,2007.0,1480.0,0.738,9.546,209,125,103,22,84,54,30,18,0.0,0.06
1016,90,2020-03-16 15:20:00,1,1864.0,1379.0,0.74,8.871,293,144,107,37,149,117,32,146,0.0,0.0
1016,91,2020-03-16 15:23:00,1,1871.0,1300.0,0.695,8.81,390,157,126,31,233,170,63,25,0.04,0.0
1016,92,2020-03-16 15:26:00,1,1806.0,1314.0,0.727,8.572,422,201,159,42,221,155,66,74,0.0,0.0
1016,93,2020-03-16 15:29:00,1,2074.0,1508.0,0.727,9.841,40,7,4,3,33,18,15,5,0.0,0.0
1016,94,2020-03-16 15:32:00,1,2216.0,1619.0,0.73,10.525,57,9,2,7,48,4,44,0,0.0,0.0
1016,95,2020-03-16 15:35:00,1,2006.0,1462.0,0.729,9.524,75,33,5,28,42,12,30,0,0.0,0.0
1016,96,2020-03-16 15:38:00,1,2001.0,1428.0,0.714,9.465,276,175,146,29,101,62,39,2,0.0,0.0
1016,97,2020-03-16 15:41:00,1,2227.0,1550.0,0.696,10.492,0,0,0,0,0,0,0,0,0.0,0.0
1016,98,2020-03-16 15:44:00,1,2296.0,1661.0,0.724,10.886,0,0,0,0,0,0,0,0,0.0,0.0
1016,99,2020-03-16 15:47:00,1,2150.0,1521.0,0.708,10.155,0,0,0,0,0,0,0,0,0.0,0.0
1016,100,2020-03-16 15:50:00,1,2024.0,1369.0,0.676,9.493,8,4,2,2,4,2,2,0,0.0,0.0
1016,101,2020-03-16 15:53:00,1,1540.0,1063.0,0.69,7.242,8,4,0,4,4,1,3,0,0.0,0.0
1016,102,2020-03-16 15:56:00,1,1545.0,1036.0,0.67,7.233,3,3,0,3,0,0,0,0,0.0,0.0
1016,103,2020-03-16 15:59:00,1,1516.0,1081.0,0.713,7.17,10,10,0,10,0,0,0,0,0.0,0.0
1016,104,2020-03-16 16:02:00,1,1528.0,1112.0,0.728,7.254,23,10,2,8,13,3,10,0,0.0,0.0
1016,105,2020-03-16 16:05:00,1,1892.0,1283.0,0.678,8.875,16,0,0,0,16,0,16,0,0.0,0.0
1016,106,2020-03-16 16:08:00,1,1884.0,1295.0,0.687,8.859,3,0,0,0,3,0,3,0,0.0,0.0
1016,107,2020-03-16 16:11:00,1,1885.0,1351.0,0.716,8.924,16,5,2,3,11,4,7,0,0.0,0.0
1016,108,2020-03-16 16:14:00,1,1887.0,1326.0,0.702,8.905,0,0,0,0,0,0,0,0,0.0,0.0
1016,109,2020-03-16 16:17:00,1,1662.0,1209.0,0.727,7.888,0,0,0,0,0,0,0,0,0.0,0.0
1016,110,2020-03-16 16:20:00,1,1650.0,1216.0,0.737,7.846,48,21,12,9,27,14,13,0,0.0,0.0
1016,111,2020-03-16 16:23:00,1,1516.0,1122.0,0.74,7.216,5,0,0,0,5,0,5,0,0.0,0.0
1016,112,2020-03-16 16:26:00,1,1528.0,1102.0,0.721,7.242,10,2,1,1,8,0,8,0,0.0,0.0
1016,113,2020-03-16 16:29:00,1,1661.0,1217.0,0.733,7.892,25,8,3,5,17,6,11,0,0.0,0.0
1016,114,2020-03-16 16:32:00,1,1868.0,1389.0,0.744,8.897,7,0,0,0,7,0,7,0,0.0,0.0
1016,115,2020-03-16 16:35:00,1,1717.0,1245.0,0.725,8.143,4,2,0,2,2,0,2,0,0.0,0.0
1016,116,2020-03-16 16:38:00,1,1390.0,1007.0,0.724,6.591,31,15,9,6,16,9,7,0,0.0,0.0
1016,117,2020-03-16 16:41:00,1,1249.0,852.0,0.682,5.865,0,0,0,0,0,0,0,0,0.0,0.0
1016,118,2020-03-16 16:44:00,1,1254.0,845.0,0.674,5.876,0,0,0,0,0,0,0,0,0.0,0.0
1016,119,2020-03-16 16:47:00,1,1417.0,926.0,0.653,6.61,20,12,0,12,8,3,5,0,0.0,0.0
1016,120,2020-03-16 16:50:00,1,1371.0,1008.0,0.735,6.519,17,17,0,17,0,0,0,0,0.0,0.0
1016,121,2020-03-16 16:53:00,1,1397.0,998.0,0.714,6.611,2,2,0,2,0,0,0,0,0.0,0.0
1016,122,2020-03-16 16:56:00,1,1885.0,1335.0,0.708,8.905,215,107,69,38,108,69,39,37,0.0,0.0
1016,123,2020-03-16 16:59:00,1,2000.0,1478.0,0.739,9.516,75,27,2,25,48,18,30,0,0.0,0.0
1016,124,2020-03-16 17:02:00,1,1709.0,1318.0,0.771,8.192,379,170,136,34,209,152,57,79,0.0,0.0
1016,125,2020-03-16 17:05:00,1,2063.0,1508.0,0.731,9.797,214,109,78,31,105,67,38,13,0.0,0.0
1016,126,2020-03-16 17:08:00,1,1795.0,1329.0,0.74,8.543,142,61,47,14,81,51,30,38,0.0,0.0
1016,127,2020-03-16 17:11:00,1,1736.0,1267.0,0.73,8.241,151,16,4,12,135,79,56,2,0.0,0.0
1016,128,2020-03-16 17:14:00,1,2070.0,1545.0,0.746,9.868,103,27,5,22,76,24,52,1,0.0,0.0
1016,129,2020-03-16 17:17:00,1,2015.0,1445.0,0.717,9.54,23,0,0,0,23,4,19,0,0.0,0.0
1016,130,2020-03-16 17:20:00,1,1879.0,1298.0,0.691,8.842,10,0,0,0,10,0,10,0,0.0,0.0
1016,131,2020-03-16 17:23:00,1,1670.0,1179.0,0.706,7.884,21,0,0,0,21,0,21,0,0.0,0.0
1016,132,2020-03-16 17:26:00,1,1658.0,1172.0,0.707,7.832,2,0,0,0,2,1,1,0,0.0,0.0
1016,133,2020-03-16 17:29:00,1,1667.0,1192.0,0.715,7.889,54,1,0,1,53,39,14,0,0.0,0.0
1016,134,2020-03-16 17:32:00,1,1520.0,1132.0,0.745,7.243,19,0,0,0,19,3,16,0,0.0,0.0
1016,135,2020-03-16 17:35:00,1,1523.5,1121.5,0.736,7.2455,42,0,0,0,42,34,8,0,0.0,0.0
1016,136,2020-03-16 17:38:00,1,1527.0,1111.0,0.727,7.248,75,2,0,2,73,16,57,0,0.0,0.0
1016,137,2020-03-16 17:41:00,1,1511.0,1097.0,0.726,7.167,80,3,0,3,77,5,72,0,0.0,0.0
1016,138,2020-03-16 17:44:00,1,1532.0,1085.0,0.708,7.237,35,3,0,3,32,9,23,0,0.0,0.0
1016,139,2020-03-16 17:47:00,1,1512.0,1108.0,0.732,7.184,20,0,0,0,20,4,16,0,0.0,0.0
1016,140,2020-03-16 17:50:00,1,1514.0,1137.0,0.751,7.223,15,0,0,0,15,0,15,0,0.0,0.0
1016,141,2020-03-16 17:53:00,1,1525.0,1125.0,0.738,7.253,9,2,0,2,7,3,4,0,0.0,0.0
1016,142,2020-03-16 17:56:00,1,1505.0,1113.0,0.74,7.164,168,43,22,21,125,56,69,3,0.0,0.0
1016,143,2020-03-16 17:59:00,1,1587.0,1183.0,0.745,7.563,68,3,1,2,65,12,53,0,0.0,0.0
1016,144,2020-03-16 18:02:00,0,1579.0,1167.0,0.739,7.513,25,0,0,0,25,0,25,0,0.0,0.0
1016,145,2020-03-16 18:05:00,0,1668.0,1187.0,0.711,7.885,38,13,2,11,25,5,20,0,0.0,0.0
1016,146,2020-03-16 18:08:00,0,1662.0,1216.0,0.731,7.896,32,6,0,6,26,13,13,0,0.0,0.0
1016,147,2020-03-16 18:11:00,0,1669.0,1175.0,0.704,7.878,21,2,0,2,19,6,13,0,0.0,0.0
1016,148,2020-03-16 18:14:00,0,1677.0,1166.0,0.695,7.9,50,6,0,6,44,31,13,0,0.0,0.0
1016,149,2020-03-16 18:17:00,0,1583.0,1168.0,0.738,7.529,13,6,0,6,7,4,3,0,0.0,0.0
1016,150,2020-03-16 18:20:00,0,1584.0,1179.0,0.744,7.548,21,4,1,3,17,2,15,0,0.0,0.0
1016,151,2020-03-16 18:23:00,0,1665.0,1223.0,0.735,7.915,246,112,75,37,134,87,47,30,0.0,0.0
1016,152,2020-03-16 18:26:00,0,1852.0,1415.0,0.764,8.862,247,111,87,24,136,85,51,67,0.0,0.0
1016,153,2020-03-16 18:29:00,0,2001.0,1471.0,0.735,9.511,150,88,70,18,62,46,16,71,0.0,0.0
1016,154,2020-03-16 18:32:00,0,1880.0,1355.0,0.721,8.907,9,3,0,3,6,0,6,0,0.0,0.0
1016,155,2020-03-16 18:35:00,0,1865.0,1368.0,0.734,8.865,139,63,26,37,76,34,42,0,0.0,0.0
1016,156,2020-03-16 18:38:00,0,1851.0,1433.0,0.774,8.879,139,38,7,31,101,52,49,1,0.0,0.0
1016,157,2020-03-16 18:41:00,0,1992.0,1465.0,0.735,9.471,311,141,98,43,170,111,59,62,0.0,0.0
1016,158,2020-03-16 18:44:00,0,2210.0,1661.0,0.752,10.546,371,212,173,39,159,124,35,177,0.0,0.0
1016,159,2020-03-16 18:47:00,0,2210.0,1620.0,0.733,10.501,381,206,150,56,175,120,55,163,0.0,0.0
1016,160,2020-03-16 18:50:00,0,2200.0,1680.0,0.764,10.526,362,209,149,60,153,99,54,82,0.0,0.0
1016,161,2020-03-16 18:53:00,0,1870.0,1400.0,0.749,8.916,277,146,105,41,131,84,47,77,0.0,0.0
1016,162,2020-03-16 18:56:00,0,1855.0,1387.0,0.747,8.846,229,113,63,50,116,73,43,12,0.0,0.0
1016,163,2020-03-16 18:59:00,0,1876.0,1360.0,0.725,8.896,158,48,14,34,110,58,52,14,0.0,0.0
1016,164,2020-03-16 19:02:00,0,2008.0,1515.0,0.755,9.59,208,87,47,40,121,57,64,1,0.0,0.0
1016,165,2020-03-16 19:05:00,0,2058.0,1529.0,0.743,9.803,105,29,1,28,76,9,67,0,0.0,0.0
1016,166,2020-03-16 19:08:00,0,2148.0,1550.0,0.722,10.178,87,19,2,17,68,2,66,0,0.0,0.0
1016,167,2020-03-16 19:11:00,0,2009.0,1475.0,0.734,9.55,57,14,4,10,43,8,35,0,0.0,0.0
1016,168,2020-03-16 19:14:00,0,1941.0,1401.0,0.722,9.2,3,3,1,2,0,0,0,0,0.0,0.0
1016,169,2020-03-16 19:17:00,0,1873.0,1363.0,0.727,8.889,0,0,0,0,0,0,0,0,0.0,0.0
1016,170,2020-03-16 19:20:00,0,1869.0,1314.0,0.703,8.819,5,5,1,4,0,0,0,0,0.0,0.0
1016,171,2020-03-16 19:23:00,0,1720.0,1252.0,0.728,8.163,25,24,6,18,1,1,0,0,0.0,0.0
1016,172,2020-03-16 19:26:00,0,1734.0,1267.0,0.731,8.235,3,2,0,2,1,0,1,0,0.0,0.0
1016,173,2020-03-16 19:29:00,0,1647.0,1265.0,0.768,7.89,4,0,0,0,4,0,4,0,0.0,0.0
1016,174,2020-03-16 19:32:00,0,1649.0,1260.0,0.764,7.893,17,10,2,8,7,0,7,0,0.0,0.0
1016,175,2020-03-16 19:35:00,0,1651.0,1264.0,0.766,7.904,40,19,10,9,21,13,8,6,0.0,0.0
1016,176,2020-03-16 19:38:00,0,1791.0,1321.0,0.738,8.52,307,171,125,46,136,95,41,49,0.0,0.0
1016,177,2020-03-16 19:41:00,0,1722.0,1314.0,0.763,8.241,113,51,26,25,62,30,32,0,0.0,0.0
1016,178,2020-03-16 19:44:00,0,1860.0,1402.0,0.754,8.882,181,118,73,45,63,31,32,3,0.0,0.0
1016,179,2020-03-16 19:47:00,0,1986.0,1530.0,0.77,9.52,448,244,197,47,204,155,49,156,0.0,0.0
1016,180,2020-03-16 19:50:00,0,2140.0,1564.0,0.731,10.164,462,237,186,51,225,173,52,228,0.0,0.0
1016,181,2020-03-16 19:53:00,0,2219.0,1633.0,0.736,10.552,463,265,211,54,198,152,46,245,0.0,0.0
1016,182,2020-03-16 19:56:00,0,2366.0,1692.0,0.715,11.198,294,166,116,50,128,77,51,136,0.0,0.0
1016,183,2020-03-16 19:59:00,0,2228.0,1580.0,0.709,10.526,466,219,173,46,247,178,69,96,0.0,0.0
1016,184,2020-03-16 20:02:00,0,2230.0,1588.0,0.712,10.543,309,149,98,51,160,121,39,68,0.0,0.0
1016,185,2020-03-16 20:05:00,0,2138.0,1557.0,0.728,10.147,246,118,86,32,128,94,34,186,0.0,0.0
1016,186,2020-03-16 20:08:00,0,2144.0,1571.0,0.733,10.185,391,188,146,42,203,138,65,100,0.03,0.0
1016,187,2020-03-16 20:11:00,0,2199.0,1661.0,0.755,10.503,370,187,139,48,183,126,57,209,0.03,0.0
1016,188,2020-03-16 20:14:00,0,2208.0,1648.0,0.746,10.526,691,350,267,83,341,256,85,136,0.0,0.0
1016,189,2020-03-16 20:17:00,0,2223.0,1642.0,0.739,10.575,555,318,251,67,237,169,68,168,0.0,0.0
1016,190,2020-03-16 20:20:00,0,2132.0,1557.0,0.731,10.123,407,242,197,45,165,124,41,186,0.31,0.0
1016,191,2020-03-16 20:23:00,0,1864.0,1375.0,0.738,8.867,306,186,138,48,120,86,34,186,0.0,0.0
1016,192,2020-03-16 20:26:00,0,2209.0,1619.0,0.733,10.497,558,303,237,66,255,197,58,146,0.0,0.0
1016,193,2020-03-16 20:29:00,0,2006.0,1440.0,0.718,9.499,520,243,174,69,277,218,59,186,0.0,0.0
1016,194,2020-03-16 20:32:00,0,2198.0,1631.0,0.742,10.468,510,253,200,53,257,201,56,111,0.0,0.0
1016,195,2020-03-16 20:35:00,0,2039.0,1471.5,0.72,9.6645,446,213,168,45,233,179,54,146,0.01,0.0
1016,196,2020-03-16 20:38:00,0,1880.0,1312.0,0.698,8.861,396,199,145,54,197,144,53,128,0.0,0.0
1016,197,2020-03-16 20:41:00,0,2227.0,1568.0,0.704,10.512,367,200,151,49,167,116,51,178,0.0,0.0
1016,198,2020-03-16 20:44:00,0,2348.0,1682.0,0.717,11.112,418,211,169,42,207,151,56,126,0.0,0.0
1016,199,2020-03-16 20:47:00,0,2215.0,1620.0,0.731,10.522,528,286,227,59,242,178,64,164,0.08,0.0
1016,200,2020-03-16 20:50:00,0,2235.0,1578.0,0.706,10.551,365,186,130,56,179,139,40,66,0.0,0.0
1016,201,2020-03-16 20:53:00,0,2206.0,1616.0,0.733,10.48,407,217,169,48,190,146,44,223,0.0,0.0
1016,202,2020-03-16 20:56:00,0,2026.0,1427.0,0.705,9.562,109,68,38,30,41,7,34,33,0.0,0.0
1016,203,2020-03-16 20:59:00,0,2220.0,1625.0,0.732,10.545,100,80,35,45,20,2,18,16,0.0,0.0
1016,204,2020-03-16 21:02:00,0,2068.0,1541.0,0.745,9.856,288,179,126,53,109,78,31,50,0.0,0.0
1016,205,2020-03-16 21:05:00,0,2001.0,1488.0,0.743,9.532,419,219,165,54,200,156,44,209,0.0,0.0
1016,206,2020-03-16 21:08:00,0,1940.0,1435.0,0.739,9.234,582,325,249,76,257,190,67,147,0.0,0.0
1016,207,2020-03-16 21:11:00,0,2227.0,1563.0,0.702,10.503,316,178,135,43,138,104,34,172,0.13,0.0
1016,208,2020-03-16 21:14:00,0,2358.0,1683.0,0.714,11.153,528,250,198,52,278,208,70,132,0.0,0.0
1016,209,2020-03-16 21:17:00,0,2009.0,1485.0,0.739,9.561,451,237,185,52,214,158,56,166,0.0,0.0
1016,210,2020-03-16 21:20:00,0,2212.0,1630.0,0.737,10.52,505,229,176,53,276,203,73,204,0.0,0.0
1016,211,2020-03-16 21:23:00,0,2268.0,1716.0,0.756,10.835,345,178,129,49,167,116,51,61,0.29,0.0
1016,212,2020-03-16 21:26:00,0,2073.0,1544.0,0.744,9.879,220,113,85,28,107,71,36,88,0.0,0.0
1016,213,2020-03-16 21:29:00,0,1977.0,1562.0,0.79,9.519,401,201,156,45,200,154,46,143,0.0,0.0
1016,214,2020-03-16 21:32:00,0,2336.0,1747.0,0.748,11.138,269,161,112,49,108,78,30,25,0.0,0.0
1016,215,2020-03-16 21:35:00,0,2223.0,1616.0,0.727,10.548,471,274,206,68,197,144,53,154,0.0,0.0
1016,216,2020-03-16 21:38:00,0,2230.0,1610.0,0.722,10.568,205,136,92,44,69,46,23,154,0.0,0.0
1016,217,2020-03-16 21:41:00,0,2204.0,1656.0,0.751,10.516,404,231,182,49,173,120,53,110,0.0,0.0
1016,218,2020-03-16 21:44:00,0,1939.0,1436.0,0.741,9.232,59,37,6,31,22,5,17,19,0.0,0.0
1016,219,2020-03-16 21:47:00,0,1839.0,1412.0,0.768,8.811,87,45,14,31,42,5,37,14,0.0,0.0
1016,220,2020-03-16 21:50:00,0,1971.0,1590.0,0.807,9.527,280,146,107,39,134,91,43,81,0.0,0.0
1016,221,2020-03-16 21:53:00,0,2136.0,1629.0,0.763,10.22,41,10,6,4,31,12,19,3,0.0,0.0
1016,222,2020-03-16 21:56:00,0,2044.0,1594.0,0.78,9.817,9,5,0,5,4,1,3,0,0.0,0.0
1016,223,2020-03-16 21:59:00,0,2216.0,1612.0,0.727,10.518,23,9,0,9,14,2,12,0,0.0,0.0
1016,224,2020-03-16 22:02:00,0,1989.0,1553.0,0.78,9.557,16,4,2,2,12,8,4,0,0.0,0.0
1016,225,2020-03-16 22:05:00,0,1993.0,1479.0,0.742,9.489,6,0,0,0,6,1,5,0,0.0,0.0
1016,226,2020-03-16 22:08:00,0,1941.0,1426.0,0.735,9.226,17,3,1,2,14,7,7,0,0.0,0.0
1016,227,2020-03-16 22:11:00,0,1865.0,1356.0,0.727,8.848,1,0,0,0,1,1,0,0,0.0,0.0
1016,228,2020-03-16 22:14:00,0,1864.0,1345.0,0.721,8.834,111,71,48,23,40,23,17,45,0.0,0.0
1016,229,2020-03-16 22:17:00,0,2282.0,1684.0,0.738,10.857,653,374,298,76,279,213,66,149,0.0,0.01
1016,230,2020-03-16 22:20:00,0,1991.0,1549.0,0.778,9.561,408,217,174,43,191,151,40,215,0.0,0.02
1016,231,2020-03-16 22:23:00,0,2175.0,1728.0,0.794,10.483,252,148,107,41,104,83,21,64,0.0,0.0
1016,232,2020-03-16 22:26:00,0,2178.0,1739.0,0.798,10.506,595,329,260,69,266,192,74,160,0.0,0.0
1016,233,2020-03-16 22:29:00,0,2196.0,1703.0,0.776,10.536,159,99,54,45,60,16,44,110,0.0,0.0
1016,234,2020-03-16 22:32:00,0,2201.0,1659.0,0.754,10.51,383,234,190,44,149,117,32,125,0.0,0.02
1016,235,2020-03-16 22:35:00,0,1848.0,1470.0,0.795,8.911,47,24,5,19,23,6,17,27,0.0,0.0
1016,236,2020-03-16 22:38:00,0,2193.0,1723.0,0.785,10.55,304,169,123,46,135,93,42,58,0.0,0.01
1016,237,2020-03-16 22:41:00,0,1902.0,1543.0,0.811,9.202,282,149,126,23,133,102,31,195,0.0,0.0
1016,238,2020-03-16 22:44:00,0,2197.0,1690.0,0.769,10.527,375,158,123,35,217,170,47,63,0.02,0.0
1016,239,2020-03-16 22:47:00,0,2339.0,1810.0,0.774,11.219,262,138,105,33,124,94,30,114,0.0,0.0
1016,240,2020-03-16 22:50:00,0,2336.0,1808.0,0.774,11.207,267,145,118,27,122,90,32,136,0.0,0.0
1016,241,2020-03-16 22:53:00,0,2198.0,1666.0,0.758,10.504,254,160,118,42,94,43,51,96,0.0,0.0
1016,242,2020-03-16 22:56:00,0,1993.0,1500.0,0.753,9.513,345,222,161,61,123,80,43,7,0.0,0.03
1016,243,2020-03-16 22:59:00,0,1630.0,1302.0,0.798,7.865,150,91,61,30,59,34,25,24,0.0,0.0
1016,244,2020-03-16 23:02:00,0,2207.0,1626.0,0.737,10.496,71,38,9,29,33,8,25,3,0.0,0.0
1016,245,2020-03-16 23:05:00,0,2191.0,1733.0,0.791,10.552,98,64,33,31,34,12,22,2,0.0,0.0
1016,246,2020-03-16 23:08:00,0,2177.0,1769.0,0.813,10.537,299,170,136,34,129,85,44,20,0.0,0.0
1016,247,2020-03-16 23:11:00,0,2044.0,1622.0,0.794,9.851,595,372,308,64,223,162,61,96,0.0,0.01
1016,248,2020-03-16 23:14:00,0,2345.0,1763.0,0.752,11.19,275,151,112,39,124,76,48,108,0.1,0.0
1016,249,2020-03-16 23:17:00,0,2343.0,1770.0,0.756,11.19,44,20,10,10,24,12,12,2,0.0,0.0
1016,250,2020-03-16 23:20:00,0,2140.0,1599.0,0.747,10.202,5,4,1,3,1,1,0,0,0.0,0.0
1016,251,2020-03-16 23:23:00,0,1848.0,1397.0,0.756,8.828,1,1,0,1,0,0,0,0,0.0,0.0
1016,252,2020-03-16 23:26:00,0,1649.0,1272.0,0.772,7.906,115,71,50,21,44,32,12,33,0.0,0.0
1016,253,2020-03-16 23:29:00,0,2072.0,1560.0,0.753,9.89,121,66,36,30,55,32,23,39,0.0,0.03
1016,254,2020-03-16 23:32:00,0,1505.0,1137.0,0.756,7.187,5,5,0,5,0,0,0,0,0.0,0.0
1016,255,2020-03-16 23:35:00,0,1680.0,1278.0,0.7605,8.034,0,0,0,0,0,0,0,0,0.0,0.0
1016,256,2020-03-16 23:38:00,0,1855.0,1419.0,0.765,8.881,0,0,0,0,0,0,0,0,0.0,0.0
1016,257,2020-03-16 23:41:00,0,1921.0,1476.0,0.768,9.201,47,38,4,34,9,4,5,7,0.0,0.0
1016,258,2020-03-16 23:44:00,0,1998.0,1518.0,0.76,9.552,188,127,90,37,61,39,22,18,0.05,0.0
1016,259,2020-03-16 23:47:00,0,1883.0,1548.0,0.822,9.132,370,211,161,50,159,113,46,109,0.0,0.05
1016,260,2020-03-16 23:50:00,0,2241.0,1804.0,0.805,10.829,400,216,183,33,184,136,48,203,0.0,0.0
1016,261,2020-03-16 23:53:00,0,2191.0,1731.0,0.79,10.55,305,197,161,36,108,85,23,210,0.0,0.0
1016,262,2020-03-16 23:56:00,0,2173.0,1727.0,0.795,10.474,290,164,121,43,126,89,37,212,0.0,0.0
1016,263,2020-03-16 23:59:00,0,2481.0,1930.0,0.778,11.912,278,143,94,49,135,85,50,53,0.0,0.04
1016,264,2020-03-17 00:02:00,0,2195.0,1678.0,0.764,10.505,488,201,148,53,287,208,79,26,0.11,0.11
1016,265,2020-03-17 00:05:00,0,2191.0,1697.0,0.775,10.513,272,161,112,49,111,67,44,118,0.0,0.03
1016,266,2020-03-17 00:08:00,0,1778.0,1413.0,0.795,8.569,301,149,118,31,152,102,50,58,0.0,0.0
1016,267,2020-03-17 00:11:00,0,2143.0,1832.0,0.855,10.471,261,119,97,22,142,113,29,174,0.0,0.0
1016,268,2020-03-17 00:14:00,0,2155.0,1843.0,0.855,10.533,194,118,87,31,76,50,26,152,0.0,0.0
1016,269,2020-03-17 00:17:00,0,1968.0,1589.0,0.807,9.515,103,68,27,41,35,4,31,13,0.0,0.0
1016,270,2020-03-17 00:20:00,0,2102.0,1748.0,0.831,10.218,54,22,3,19,32,0,32,6,0.0,0.0
1016,271,2020-03-17 00:23:00,0,2274.0,2001.0,0.88,11.174,48,26,7,19,22,2,20,1,0.0,0.0
1016,272,2020-03-17 00:26:00,0,2209.0,1858.0,0.841,10.76,12,8,0,8,4,0,4,0,0.0,0.0
1016,273,2020-03-17 00:29:00,0,2165.0,1833.0,0.847,10.558,7,6,0,6,1,0,1,0,0.0,0.0
1016,274,2020-03-17 00:32:00,0,2167.0,1812.0,0.836,10.542,11,5,0,5,6,3,3,2,0.0,0.0
1016,275,2020-03-17 00:35:00,0,2174.0,1720.0,0.791,10.471,0,0,0,0,0,0,0,0,0.0,0.0
1016,276,2020-03-17 00:38:00,0,2038.0,1673.0,0.821,9.883,48,36,27,9,12,3,9,16,0.0,0.0
1016,277,2020-03-17 00:41:00,0,2174.0,1782.0,0.82,10.537,142,63,41,22,79,31,48,64,0.19,0.04
1016,278,2020-03-17 00:44:00,0,1958.0,1654.0,0.845,9.547,375,218,165,53,157,105,52,60,0.12,0.03
1016,279,2020-03-17 00:47:00,0,2100.0,1751.0,0.834,10.213,298,169,137,32,129,99,30,231,0.0,0.0
1016,280,2020-03-17 00:50:00,0,2076.0,1781.0,0.858,10.152,516,294,226,68,222,175,47,148,0.0,0.0
1016,281,2020-03-17 00:53:00,0,2291.0,1963.0,0.857,11.199,349,170,124,46,179,107,72,103,0.0,0.02
1016,282,2020-03-17 00:56:00,0,1963.0,1656.0,0.843,9.566,413,220,172,48,193,139,54,58,0.03,0.08
1016,283,2020-03-17 00:59:00,0,1473.0,1258.0,0.854,7.195,1106,554,423,131,552,431,121,13,0.0,0.0
1016,284,2020-03-17 01:02:00,0,2291.0,1980.0,0.864,11.22,645,421,326,95,224,170,54,44,0.0,0.0
1016,285,2020-03-17 01:05:00,0,1930.0,1760.0,0.912,9.553,210,143,102,41,67,35,32,146,0.0,0.0
1016,286,2020-03-17 01:08:00,0,2159.0,1781.0,0.825,10.477,77,43,14,29,34,8,26,8,0.0,0.0
1016,287,2020-03-17 01:11:00,0,2410.0,2108.0,0.875,11.831,674,470,381,89,204,145,59,5,0.0,0.0
1016,288,2020-03-17 01:14:00,0,2331.0,2058.0,0.883,11.462,583,283,210,73,300,240,60,200,0.0,0.0
1016,289,2020-03-17 01:17:00,0,2283.0,1944.0,0.852,11.149,364,218,170,48,146,94,52,122,0.0,0.0
1016,290,2020-03-17 01:20:00,0,2295.0,1979.0,0.862,11.232,349,208,170,38,141,116,25,206,0.08,0.0
1016,291,2020-03-17 01:23:00,0,2005.0,1729.0,0.862,9.813,432,249,182,67,183,118,65,75,0.0,0.0
1016,292,2020-03-17 01:26:00,0,1946.0,1688.0,0.867,9.538,377,225,164,61,152,104,48,17,0.0,0.0
1016,293,2020-03-17 01:29:00,0,2234.0,1879.0,0.841,10.881,428,285,220,65,143,98,45,73,0.0,0.0
1016,294,2020-03-17 01:32:00,0,1818.0,1554.0,0.855,8.881,167,100,75,25,67,45,22,47,0.0,0.0
1016,295,2020-03-17 01:35:00,0,2114.0,1729.0,0.818,10.242,90,64,16,48,26,0,26,7,0.0,0.0
1016,296,2020-03-17 01:38:00,0,2174.0,1774.0,0.816,10.53,103,102,48,54,1,0,1,3,0.0,0.0
1016,297,2020-03-17 01:41:00,0,2172.0,1742.0,0.802,10.488,87,66,35,31,21,2,19,2,0.0,0.0
1016,298,2020-03-17 01:44:00,0,2052.0,1658.0,0.808,9.92,21,11,4,7,10,1,9,0,0.0,0.0
1016,299,2020-03-17 01:47:00,0,1985.0,1560.0,0.786,9.55,11,7,1,6,4,0,4,0,0.0,0.0
1016,300,2020-03-17 01:50:00,0,1988.0,1552.0,0.781,9.551,7,3,0,3,4,0,4,0,0.0,0.0
1016,301,2020-03-17 01:53:00,0,1783.0,1372.0,0.769,8.544,16,5,0,5,11,3,8,0,0.0,0.0
1016,302,2020-03-17 01:56:00,0,1623.0,1313.0,0.809,7.851,10,1,0,1,9,0,9,0,0.0,0.0
1016,303,2020-03-17 01:59:00,0,1860.0,1416.0,0.761,8.896,26,0,0,0,26,6,20,0,0.0,0.0
1016,304,2020-03-17 02:02:00,0,2009.0,1483.0,0.738,9.558,23,3,0,3,20,1,19,0,0.0,0.0
1016,305,2020-03-17 02:05:00,0,1980.0,1476.0,0.746,9.435,0,0,0,0,0,0,0,0,0.0,0.0
1016,306,2020-03-17 02:08:00,0,1860.0,1424.0,0.766,8.903,2,2,0,2,0,0,0,0,0.0,0.0
1016,307,2020-03-17 02:11:00,0,1866.0,1394.0,0.747,8.895,6,3,0,3,3,1,2,0,0.0,0.0
1016,308,2020-03-17 02:14:00,0,1862.0,1396.0,0.75,8.884,6,0,0,0,6,1,5,0,0.0,0.0
1016,309,2020-03-17 02:17:00,0,1876.0,1343.0,0.716,8.878,140,103,70,33,37,21,16,29,0.0,0.0
1016,310,2020-03-17 02:20:00,0,1855.0,1416.0,0.763,8.877,20,12,4,8,8,0,8,0,0.0,0.0
1016,311,2020-03-17 02:23:00,0,1872.0,1352.0,0.722,8.873,8,5,1,4,3,1,2,0,0.0,0.0
1016,312,2020-03-17 02:26:00,0,1881.0,1349.0,0.717,8.904,38,20,5,15,18,6,12,0,0.0,0.0
1016,313,2020-03-17 02:29:00,0,1877.0,1353.0,0.721,8.895,21,2,1,1,19,0,19,0,0.0,0.0
1016,314,2020-03-17 02:32:00,0,1871.0,1371.0,0.733,8.889,29,12,4,8,17,0,17,0,0.0,0.0
1016,315,2020-03-17 02:35:00,0,1830.5,1337.0,0.7305,8.6925,3,0,0,0,3,0,3,0,0.0,0.0
1016,316,2020-03-17 02:38:00,0,1790.0,1303.0,0.728,8.496,9,4,1,3,5,0,5,0,0.0,0.0
1016,317,2020-03-17 02:41:00,0,1728.0,1288.0,0.745,8.234,6,2,1,1,4,0,4,0,0.0,0.0
1016,318,2020-03-17 02:44:00,0,1657.0,1248.0,0.753,7.91,85,56,42,14,29,4,25,27,0.0,0.0
1016,319,2020-03-17 02:47:00,0,1981.0,1494.0,0.754,9.46,159,59,24,35,100,43,57,81,0.0,0.0
1016,320,2020-03-17 02:50:00,0,2005.0,1490.0,0.743,9.549,360,222,180,42,138,94,44,165,0.0,0.07
1016,321,2020-03-17 02:53:00,0,1645.0,1229.0,0.747,7.841,132,100,55,45,32,4,28,124,0.0,0.0
1016,322,2020-03-17 02:56:00,0,1998.0,1494.0,0.748,9.527,31,25,6,19,6,1,5,0,0.0,0.0
1016,323,2020-03-17 02:59:00,0,2044.0,1652.0,0.808,9.882,270,170,128,42,100,62,38,4,0.0,0.08
1016,324,2020-03-17 03:02:00,0,2192.0,1707.0,0.779,10.528,748,511,422,89,237,160,77,150,0.0,0.0
1016,325,2020-03-17 03:05:00,0,2192.0,1712.0,0.781,10.532,325,211,155,56,114,74,40,26,0.0,0.0
1016,326,2020-03-17 03:08:00,0,2200.0,1717.0,0.781,10.569,284,186,144,42,98,74,24,221,0.0,0.0
1016,327,2020-03-17 03:11:00,0,2198.0,1691.0,0.769,10.532,180,138,105,33,42,23,19,151,0.0,0.0
1016,328,2020-03-17 03:14:00,0,2109.0,1663.0,0.789,10.152,63,47,21,26,16,0,16,13,0.0,0.0
1016,329,2020-03-17 03:17:00,0,1972.0,1643.0,0.833,9.589,77,59,29,30,18,0,18,1,0.0,0.0
1016,330,2020-03-17 03:20:00,0,1941.0,1644.0,0.847,9.468,44,33,7,26,11,2,9,0,0.0,0.0
1016,331,2020-03-17 03:23:00,0,1986.0,1565.0,0.788,9.557,16,13,5,8,3,0,3,0,0.0,0.0
1016,332,2020-03-17 03:26:00,0,1853.0,1454.0,0.785,8.913,5,4,2,2,1,0,1,0,0.0,0.0
1016,333,2020-03-17 03:29:00,0,1850.0,1418.0,0.766,8.861,0,0,0,0,0,0,0,0,0.0,0.0
1016,334,2020-03-17 03:32:00,0,1849.0,1468.0,0.794,8.91,202,124,91,33,78,51,27,26,0.0,0.0
1016,335,2020-03-17 03:35:00,0,1820.0,1489.0,0.818,8.819,641,443,358,85,198,136,62,21,0.0,0.0
1016,336,2020-03-17 03:38:00,0,1972.0,1596.0,0.809,9.535,144,100,60,40,44,7,37,96,0.0,0.0
1016,337,2020-03-17 03:41:00,0,1858.0,1435.0,0.772,8.909,91,58,42,16,33,16,17,60,0.0,0.0
1016,338,2020-03-17 03:44:00,0,1985.0,1550.0,0.781,9.537,56,31,1,30,25,1,24,3,0.0,0.0
1016,339,2020-03-17 03:47:00,0,1984.0,1552.0,0.782,9.535,29,6,1,5,23,0,23,0,0.0,0.0
1016,340,2020-03-17 03:50:00,0,1838.0,1503.0,0.818,8.906,1,1,1,0,0,0,0,0,0.0,0.0
1016,341,2020-03-17 03:53:00,0,1832.0,1446.0,0.789,8.82,2,2,0,2,0,0,0,0,0.0,0.0
1016,342,2020-03-17 03:56:00,0,1838.0,1460.0,0.794,8.859,0,0,0,0,0,0,0,0,0.0,0.0
1016,343,2020-03-17 03:59:00,0,1839.0,1416.0,0.77,8.812,2,0,0,0,2,1,1,0,0.0,0.0
1016,344,2020-03-17 04:02:00,0,1851.0,1455.0,0.786,8.905,2,2,1,1,0,0,0,0,0.0,0.0
1016,345,2020-03-17 04:05:00,0,1636.0,1331.0,0.814,7.919,1,0,0,0,1,0,1,0,0.0,0.0
1016,346,2020-03-17 04:08:00,0,1773.0,1367.0,0.771,8.5,4,0,0,0,4,0,4,0,0.0,0.0
1016,347,2020-03-17 04:11:00,0,1868.0,1371.0,0.734,8.877,2,0,0,0,2,0,2,0,0.0,0.0
1016,348,2020-03-17 04:14:00,0,1862.0,1428.0,0.767,8.92,0,0,0,0,0,0,0,0,0.0,0.0
1016,349,2020-03-17 04:17:00,0,1845.0,1374.0,0.745,8.79,1,0,0,0,1,0,1,0,0.0,0.0
1016,350,2020-03-17 04:20:00,0,1856.0,1367.0,0.736,8.828,0,0,0,0,0,0,0,0,0.0,0.0
1016,351,2020-03-17 04:23:00,0,1873.0,1350.0,0.721,8.876,3,0,0,0,3,0,3,0,0.0,0.0
1016,352,2020-03-17 04:26:00,0,1794.0,1349.0,0.752,8.56,18,9,6,3,9,2,7,0,0.0,0.0
1016,353,2020-03-17 04:29:00,0,1870.0,1346.0,0.72,8.859,0,0,0,0,0,0,0,0,0.0,0.0
1016,354,2020-03-17 04:32:00,0,1655.0,1254.0,0.758,7.909,0,0,0,0,0,0,0,0,0.0,0.0
1016,355,2020-03-17 04:35:00,0,1504.0,1172.0,0.779,7.224,4,2,2,0,2,0,2,0,0.0,0.0
1016,356,2020-03-17 04:38:00,0,1578.0,1213.0,0.769,7.559,1,0,0,0,1,0,1,0,0.0,0.0
1016,357,2020-03-17 04:41:00,0,1793.0,1330.0,0.742,8.538,4,2,0,2,2,0,2,0,0.0,0.0
1016,358,2020-03-17 04:44:00,0,1644.0,1280.0,0.778,7.895,3,0,0,0,3,0,3,0,0.0,0.0
1016,359,2020-03-17 04:47:00,0,1644.0,1272.0,0.774,7.887,15,2,1,1,13,0,13,0,0.0,0.0
1016,360,2020-03-17 04:50:00,0,1642.0,1242.0,0.756,7.846,12,12,0,12,0,0,0,0,0.0,0.0
1016,361,2020-03-17 04:53:00,0,1660.0,1207.0,0.727,7.876,112,75,58,17,37,17,20,17,0.0,0.0
1016,362,2020-03-17 04:56:00,0,1725.0,1297.0,0.751,8.234,7,7,0,7,0,0,0,0,0.0,0.0
1016,363,2020-03-17 04:59:00,0,1641.0,1253.0,0.764,7.855,8,7,0,7,1,1,0,0,0.0,0.0
1016,364,2020-03-17 05:02:00,0,1654.0,1247.0,0.754,7.896,0,0,0,0,0,0,0,0,0.0,0.0
1016,365,2020-03-17 05:05:00,0,1643.0,1267.0,0.771,7.877,7,5,2,3,2,2,0,0,0.0,0.0
1016,366,2020-03-17 05:08:00,0,1664.0,1191.0,0.716,7.877,17,14,0,14,3,1,2,0,0.0,0.0
1016,367,2020-03-17 05:11:00,0,1596.0,1171.0,0.734,7.585,2,1,1,0,1,0,1,0,0.0,0.0
1016,368,2020-03-17 05:14:00,0,1506.0,1164.0,0.773,7.225,7,2,2,0,5,1,4,0,0.0,0.0
1016,369,2020-03-17 05:17:00,0,1502.0,1164.0,0.775,7.208,3,3,0,3,0,0,0,0,0.0,0.0
1016,370,2020-03-17 05:20:00,0,1658.0,1251.0,0.755,7.918,143,88,48,40,55,24,31,43,0.0,0.0
1016,371,2020-03-17 05:23:00,0,1836.0,1414.0,0.77,8.798,133,90,39,51,43,12,31,33,0.0,0.0
1016,372,2020-03-17 05:26:00,0,1864.0,1420.0,0.762,8.917,48,21,7,14,27,2,25,10,0.0,0.0
1016,373,2020-03-17 05:29:00,0,2126.0,1652.0,0.777,10.207,318,194,141,53,124,87,37,88,0.0,0.0
1016,374,2020-03-17 05:32:00,0,1965.0,1545.0,0.786,9.454,356,242,198,44,114,82,32,257,0.0,0.0
1016,375,2020-03-17 05:35:00,0,1968.0,1547.5,0.7865,9.4675,308,181,135,46,127,83,44,62,0.0,0.0
1016,376,2020-03-17 05:38:00,0,1971.0,1550.0,0.787,9.481,299,167,132,35,132,92,40,101,0.0,0.0
1016,377,2020-03-17 05:41:00,0,2141.0,1591.0,0.743,10.198,207,150,100,50,57,26,31,109,0.0,0.0
1016,378,2020-03-17 05:44:00,0,1852.0,1422.0,0.767,8.872,341,247,178,69,94,54,40,0,0.0,0.0
1016,379,2020-03-17 05:47:00,0,2198.0,1653.0,0.752,10.489,638,422,338,84,216,158,58,128,0.0,0.08
1016,380,2020-03-17 05:50:00,0,2000.0,1490.0,0.745,9.531,106,88,56,32,18,5,13,50,0.0,0.0
1016,381,2020-03-17 05:53:00,0,1992.0,1531.0,0.768,9.544,55,53,24,29,2,0,2,0,0.0,0.0
1016,382,2020-03-17 05:56:00,0,2001.0,1504.0,0.752,9.549,48,30,8,22,18,0,18,5,0.0,0.0
1016,383,2020-03-17 05:59:00,0,1856.0,1410.0,0.76,8.872,9,1,1,0,8,1,7,0,0.0,0.0
1016,384,2020-03-17 06:02:00,1,1570.0,1191.0,0.759,7.506,57,23,10,13,34,3,31,0,0.0,0.0
1016,385,2020-03-17 06:05:00,1,1527.0,1096.0,0.718,7.231,20,15,5,10,5,1,4,0,0.0,0.0
1016,386,2020-03-17 06:08:00,1,1722.0,1310.0,0.76,8.237,26,19,11,8,7,3,4,0,0.0,0.0
1016,387,2020-03-17 06:11:00,1,1794.0,1323.0,0.737,8.533,20,16,7,9,4,3,1,0,0.0,0.0
1016,388,2020-03-17 06:14:00,1,1867.0,1366.0,0.732,8.868,77,42,27,15,35,22,13,3,0.0,0.0
1016,389,2020-03-17 06:17:00,1,1866.0,1374.0,0.737,8.873,474,274,214,60,200,159,41,145,0.0,0.0
1016,390,2020-03-17 06:20:00,1,1990.0,1521.0,0.764,9.527,280,189,149,40,91,63,28,157,0.0,0.0
1016,391,2020-03-17 06:23:00,1,2083.0,1538.0,0.738,9.91,110,56,21,35,54,10,44,64,0.09,0.0
1016,392,2020-03-17 06:26:00,1,1873.0,1337.0,0.714,8.86,158,93,60,33,65,41,24,16,0.0,0.0
1016,393,2020-03-17 06:29:00,1,1994.0,1499.0,0.752,9.515,154,93,57,36,61,37,24,21,0.0,0.0
1016,394,2020-03-17 06:32:00,1,1866.0,1405.0,0.753,8.906,304,182,144,38,122,89,33,129,0.0,0.0
1016,395,2020-03-17 06:35:00,1,1983.0,1549.0,0.781,9.527,405,269,202,67,136,94,42,233,0.0,0.0
1016,396,2020-03-17 06:38:00,1,2046.0,1606.0,0.785,9.839,134,82,57,25,52,30,22,100,0.0,0.0
1016,397,2020-03-17 06:41:00,1,2132.0,1648.0,0.773,10.226,333,189,145,44,144,110,34,96,0.0,0.0
1016,398,2020-03-17 06:44:00,1,1991.0,1542.0,0.774,9.552,173,64,41,23,109,53,56,35,0.11,0.0
1016,399,2020-03-17 06:47:00,1,1993.0,1508.0,0.757,9.522,64,28,4,24,36,7,29,4,0.0,0.0
1016,400,2020-03-17 06:50:00,1,1642.0,1300.0,0.792,7.908,26,8,5,3,18,5,13,0,0.0,0.0
1016,401,2020-03-17 06:53:00,1,1637.0,1285.0,0.785,7.871,26,0,0,0,26,0,26,0,0.0,0.0
1016,402,2020-03-17 06:56:00,1,1667.0,1208.0,0.725,7.904,3,2,1,1,1,0,1,0,0.0,0.0
1016,403,2020-03-17 06:59:00,1,1652.0,1205.0,0.73,7.842,4,1,0,1,3,0,3,0,0.0,0.0
1016,404,2020-03-17 07:02:00,1,1647.0,1206.0,0.732,7.822,0,0,0,0,0,0,0,0,0.0,0.0
1016,405,2020-03-17 07:05:00,1,1668.0,1197.0,0.717,7.899,0,0,0,0,0,0,0,0,0.0,0.0
1016,406,2020-03-17 07:08:00,1,1659.0,1203.0,0.725,7.867,4,0,0,0,4,0,4,0,0.0,0.0
1016,407,2020-03-17 07:11:00,1,1510.0,1152.0,0.763,7.224,13,10,6,4,3,0,3,0,0.0,0.0
1016,408,2020-03-17 07:14:00,1,1514.0,1155.0,0.763,7.243,0,0,0,0,0,0,0,0,0.0,0.0
1016,409,2020-03-17 07:17:00,1,1514.0,1140.0,0.753,7.229,0,0,0,0,0,0,0,0,0.0,0.0
1016,410,2020-03-17 07:20:00,1,1585.0,1169.0,0.737,7.54,38,34,11,23,4,0,4,0,0.0,0.0
1016,411,2020-03-17 07:23:00,1,1510.0,1156.0,0.766,7.231,7,3,0,3,4,0,4,0,0.0,0.0
1016,412,2020-03-17 07:26:00,1,1523.0,1063.0,0.698,7.18,10,3,0,3,7,0,7,0,0.0,0.0
1016,413,2020-03-17 07:29:00,1,1373.0,1040.0,0.758,6.56,13,4,0,4,9,0,9,0,0.0,0.0
1016,414,2020-03-17 07:32:00,1,1458.0,1081.0,0.741,6.942,27,14,0,14,13,0,13,0,0.0,0.0
1016,415,2020-03-17 07:35:00,1,1525.0,1095.0,0.718,7.222,6,1,0,1,5,0,5,0,0.0,0.0
1016,416,2020-03-17 07:38:00,1,1525.0,1092.0,0.716,7.218,13,11,5,6,2,0,2,0,0.0,0.0
1016,417,2020-03-17 07:41:00,1,1530.0,1105.0,0.722,7.252,0,0,0,0,0,0,0,0,0.0,0.0
1016,418,2020-03-17 07:44:00,1,1369.0,1020.0,0.746,6.523,5,5,1,4,0,0,0,0,0.0,0.0
1016,419,2020-03-17 07:47:00,1,1520.0,1109.0,0.73,7.217,75,75,44,31,0,0,0,0,0.0,0.0
1016,420,2020-03-17 07:50:00,1,1510.0,1160.0,0.768,7.232,24,18,9,9,6,2,4,0,0.0,0.0
1016,421,2020-03-17 07:53:00,1,1659.0,1183.0,0.713,7.847,0,0,0,0,0,0,0,0,0.0,0.0
1016,422,2020-03-17 07:56:00,1,1660.0,1240.0,0.747,7.915,13,11,0,11,2,0,2,0,0.0,0.0
1016,423,2020-03-17 07:59:00,1,1668.0,1234.0,0.74,7.94,4,2,0,2,2,0,2,0,0.0,0.0
1016,424,2020-03-17 08:02:00,1,1577.0,1180.0,0.748,7.521,2,1,0,1,1,0,1,0,0.0,0.0
1016,425,2020-03-17 08:05:00,1,1658.0,1221.0,0.736,7.884,1,1,0,1,0,0,0,0,0.0,0.0
1016,426,2020-03-17 08:08:00,1,1587.0,1198.0,0.755,7.579,0,0,0,0,0,0,0,0,0.0,0.0
1016,427,2020-03-17 08:11:00,1,1499.0,1177.0,0.785,7.21,98,73,39,34,25,3,22,1,0.0,0.0
1016,428,2020-03-17 08:14:00,1,1651.0,1257.0,0.761,7.895,61,40,13,27,21,0,21,1,0.0,0.0
1016,429,2020-03-17 08:17:00,1,1635.0,1293.0,0.791,7.874,270,186,135,51,84,52,32,56,0.0,0.0
1016,430,2020-03-17 08:20:00,1,1843.0,1453.0,0.788,8.872,401,200,154,46,201,152,49,50,0.0,0.0
1016,431,2020-03-17 08:23:00,1,1989.0,1511.0,0.76,9.509,465,227,189,38,238,194,44,148,0.0,0.0
1016,432,2020-03-17 08:26:00,1,2130.0,1606.0,0.754,10.171,181,138,93,45,43,27,16,35,0.0,0.0
1016,433,2020-03-17 08:29:00,1,2344.0,1750.0,0.747,11.173,392,230,168,62,162,112,50,168,0.0,0.0
1016,434,2020-03-17 08:32:00,1,1450.0,1089.0,0.751,6.92,427,268,220,48,159,122,37,168,0.0,0.0
1016,435,2020-03-17 08:35:00,1,1656.0,1253.0,0.756,7.913,249,134,92,42,115,75,40,6,0.0,0.0
1016,436,2020-03-17 08:38:00,1,1862.0,1417.0,0.761,8.906,754,557,451,106,197,122,75,8,0.0,0.08
1016,437,2020-03-17 08:41:00,1,1999.0,1475.0,0.738,9.509,452,260,209,51,192,148,44,219,0.0,0.0
1016,438,2020-03-17 08:44:00,1,2207.0,1627.0,0.737,10.499,293,176,131,45,117,80,37,121,0.0,0.0
1016,439,2020-03-17 08:47:00,1,2066.0,1565.0,0.758,9.874,96,46,20,26,50,25,25,1,0.0,0.0
1016,440,2020-03-17 08:50:00,1,1998.0,1518.0,0.76,9.555,465,334,254,80,131,82,49,9,0.0,0.0
1016,441,2020-03-17 08:53:00,1,1856.0,1425.0,0.768,8.893,616,345,272,73,271,198,73,34,0.0,0.0
1016,442,2020-03-17 08:56:00,1,1535.0,1103.0,0.718,7.27,453,290,217,73,163,108,55,1,0.0,0.0
1016,443,2020-03-17 08:59:00,1,1779.0,1333.0,0.749,8.486,766,466,366,100,300,212,88,0,0.0,0.0
1016,444,2020-03-17 09:02:00,1,1856.0,1426.0,0.769,8.89,869,603,494,109,266,184,82,9,0.0,0.0
1016,445,2020-03-17 09:05:00,1,2001.0,1499.0,0.749,9.544,398,228,181,47,170,121,49,146,0.0,0.0
1016,446,2020-03-17 09:08:00,1,2003.0,1483.0,0.74,9.534,107,80,34,46,27,1,26,5,0.0,0.0
1016,447,2020-03-17 09:11:00,1,1862.0,1422.0,0.764,8.909,48,12,3,9,36,2,34,0,0.0,0.0
1016,448,2020-03-17 09:14:00,1,1860.0,1368.0,0.736,8.843,8,0,0,0,8,0,8,0,0.0,0.0
1016,449,2020-03-17 09:17:00,1,1508.0,1169.0,0.775,7.236,5,4,1,3,1,0,1,0,0.0,0.0
1016,450,2020-03-17 09:20:00,1,1526.0,1099.0,0.72,7.229,15,1,0,1,14,0,14,0,0.0,0.0
1016,451,2020-03-17 09:23:00,1,1508.0,1110.0,0.736,7.171,14,0,0,0,14,0,14,0,0.0,0.0
1016,452,2020-03-17 09:26:00,1,1507.0,1145.0,0.76,7.205,2,2,1,1,0,0,0,0,0.0,0.0
1016,453,2020-03-17 09:29:00,1,1664.0,1191.0,0.716,7.876,3,2,0,2,1,1,0,0,0.0,0.0
1016,454,2020-03-17 09:32:00,1,1662.0,1170.0,0.704,7.843,163,84,68,16,79,64,15,1,0.0,0.0
1016,455,2020-03-17 09:35:00,1,2194.0,1706.0,0.778,10.534,338,218,155,63,120,82,38,4,0.0,0.0
1016,456,2020-03-17 09:38:00,1,2203.0,1690.0,0.767,10.55,28,12,5,7,16,2,14,0,0.0,0.0
1016,457,2020-03-17 09:41:00,1,1994.0,1514.0,0.759,9.531,2,1,0,1,1,0,1,0,0.0,0.0
1016,458,2020-03-17 09:44:00,1,1849.0,1419.0,0.768,8.855,12,9,4,5,3,0,3,0,0.0,0.0
1016,459,2020-03-17 09:47:00,1,1858.0,1414.0,0.761,8.887,161,81,46,35,80,52,28,2,0.0,0.0
1016,460,2020-03-17 09:50:00,1,1866.0,1345.0,0.721,8.843,1,0,0,0,1,0,1,0,0.0,0.0
1016,461,2020-03-17 09:53:00,1,1658.0,1253.0,0.756,7.919,32,16,12,4,16,11,5,0,0.0,0.0
1016,462,2020-03-17 09:56:00,1,1657.0,1228.0,0.741,7.887,34,1,1,0,33,0,33,0,0.0,0.0
1016,463,2020-03-17 09:59:00,1,1508.0,1171.0,0.777,7.238,43,1,0,1,42,5,37,0,0.0,0.0
1016,464,2020-03-17 10:02:00,1,1667.0,1234.0,0.74,7.935,30,12,4,8,18,9,9,0,0.0,0.0
1016,465,2020-03-17 10:05:00,1,1646.0,1199.0,0.728,7.814,24,0,0,0,24,0,24,0,0.0,0.0
1016,466,2020-03-17 10:08:00,1,1655.0,1239.0,0.749,7.894,5,1,0,1,4,2,2,0,0.0,0.0
1016,467,2020-03-17 10:11:00,1,1511.0,1174.0,0.777,7.253,47,24,17,7,23,16,7,0,0.0,0.0
1016,468,2020-03-17 10:14:00,1,1506.0,1169.0,0.777,7.228,12,3,1,2,9,1,8,0,0.0,0.0
1016,469,2020-03-17 10:17:00,1,1513.0,1145.0,0.756,7.229,11,3,0,3,8,5,3,0,0.0,0.0
1016,470,2020-03-17 10:20:00,1,1656.0,1225.0,0.74,7.882,580,292,223,69,288,212,76,24,0.0,0.0
1016,471,2020-03-17 10:23:00,1,1871.0,1351.0,0.722,8.867,700,470,376,94,230,161,69,30,0.0,0.0
1016,472,2020-03-17 10:26:00,1,1859.0,1453.0,0.782,8.932,381,236,179,57,145,94,51,60,0.0,0.0
1016,473,2020-03-17 10:29:00,1,2061.0,1537.0,0.746,9.822,154,87,47,40,67,37,30,52,0.0,0.0
1016,474,2020-03-17 10:32:00,1,1714.0,1310.0,0.764,8.203,169,81,27,54,88,37,51,7,0.0,0.0
1016,475,2020-03-17 10:35:00,1,1986.0,1489.0,0.75,9.474,217,78,26,52,139,66,73,1,0.0,0.0
1016,476,2020-03-17 10:38:00,1,1854.0,1417.0,0.764,8.873,99,34,9,25,65,24,41,1,0.0,0.0
1016,477,2020-03-17 10:41:00,1,1427.0,1146.0,0.803,6.893,27,4,2,2,23,4,19,0,0.0,0.0
1016,478,2020-03-17 10:44:00,1,1498.0,1223.0,0.817,7.256,23,13,5,8,10,7,3,0,0.0,0.0
1016,479,2020-03-17 10:47:00,1,1617.0,1367.0,0.845,7.885,419,220,162,58,199,136,63,0,0.0,0.0
1016,480,2020-03-17 10:50:00,1,1968.0,1600.0,0.813,9.523,720,411,322,89,309,224,85,3,0.0,0.0
1016,481,2020-03-17 10:53:00,1,2310.0,1851.0,0.801,11.151,581,352,283,69,229,157,72,109,0.06,0.01
1016,482,2020-03-17 10:56:00,1,1958.0,1641.0,0.838,9.532,642,426,354,72,216,149,67,67,0.0,0.0
1016,483,2020-03-17 10:59:00,1,1895.0,1500.0,0.792,9.126,898,552,453,99,346,257,89,18,0.0,0.0
1016,484,2020-03-17 11:02:00,1,1969.0,1582.0,0.803,9.509,837,569,488,81,268,189,79,14,0.0,0.0
1016,485,2020-03-17 11:05:00,1,1994.0,1525.0,0.765,9.545,118,31,11,20,87,45,42,39,0.0,0.0
1016,486,2020-03-17 11:08:00,1,1910.0,1490.0,0.78,9.174,102,46,17,29,56,27,29,8,0.0,0.0
1016,487,2020-03-17 11:11:00,1,1841.0,1488.0,0.808,8.902,193,84,45,39,109,69,40,0,0.0,0.0
1016,488,2020-03-17 11:14:00,1,1643.0,1284.0,0.782,7.894,9,0,0,0,9,0,9,0,0.0,0.0
1016,489,2020-03-17 11:17:00,1,1501.0,1191.0,0.794,7.233,10,1,0,1,9,3,6,0,0.0,0.0
1016,490,2020-03-17 11:20:00,1,1577.0,1212.0,0.769,7.556,16,0,0,0,16,1,15,0,0.0,0.0
1016,491,2020-03-17 11:23:00,1,1659.0,1242.0,0.749,7.913,10,2,1,1,8,1,7,0,0.0,0.0
1016,492,2020-03-17 11:26:00,1,1645.0,1219.0,0.741,7.83,5,0,0,0,5,0,5,0,0.0,0.0
1016,493,2020-03-17 11:29:00,1,1589.0,1190.0,0.749,7.577,17,0,0,0,17,1,16,0,0.0,0.0
1016,494,2020-03-17 11:32:00,1,1514.0,1183.0,0.781,7.274,0,0,0,0,0,0,0,0,0.0,0.0
1016,495,2020-03-17 11:35:00,1,1548.0,1185.5,0.766,7.4105,1,0,0,0,1,0,1,0,0.0,0.0
1016,496,2020-03-17 11:38:00,1,1582.0,1188.0,0.751,7.547,34,17,12,5,17,11,6,0,0.0,0.0
1016,497,2020-03-17 11:41:00,1,1518.0,1139.0,0.751,7.241,14,12,5,7,2,1,1,0,0.0,0.0
1016,498,2020-03-17 11:44:00,1,1529.0,1089.0,0.712,7.231,21,12,0,12,9,2,7,0,0.0,0.0
1016,499,2020-03-17 11:47:00,1,1456.0,1061.0,0.728,6.912,1,1,0,1,0,0,0,0,0.0,0.0
1016,500,2020-03-17 11:50:00,1,1387.0,1035.0,0.746,6.609,19,11,1,10,8,4,4,0,0.0,0.0
1016,501,2020-03-17 11:53:00,1,1520.0,1106.0,0.727,7.215,0,0,0,0,0,0,0,0,0.0,0.0
1016,502,2020-03-17 11:56:00,1,1521.0,1122.0,0.738,7.235,4,1,1,0,3,1,2,0,0.0,0.0
1016,503,2020-03-17 11:59:00,1,1509.0,1122.0,0.744,7.189,5,1,1,0,4,2,2,0,0.0,0.0
1016,504,2020-03-17 12:02:00,1,1522.0,1118.0,0.734,7.236,10,2,0,2,8,1,7,0,0.0,0.0
1016,505,2020-03-17 12:05:00,1,1533.0,1101.0,0.718,7.258,2,1,0,1,1,0,1,0,0.0,0.0
1016,506,2020-03-17 12:08:00,1,1508.0,1103.0,0.731,7.164,19,0,0,0,19,2,17,0,0.0,0.0
1016,507,2020-03-17 12:11:00,1,1510.0,1153.0,0.764,7.227,69,0,0,0,69,0,69,0,0.0,0.0
1016,508,2020-03-17 12:14:00,1,1514.0,1178.0,0.778,7.268,54,0,0,0,54,3,51,0,0.0,0.0
1016,509,2020-03-17 12:17:00,1,1497.0,1183.0,0.79,7.207,62,27,16,11,35,18,17,0,0.0,0.0
1016,510,2020-03-17 12:20:00,1,1530.0,1098.0,0.717,7.245,2,0,0,0,2,0,2,0,0.0,0.0
1016,511,2020-03-17 12:23:00,1,1457.0,1078.0,0.74,6.933,54,26,0,26,28,1,27,0,0.0,0.0
1016,512,2020-03-17 12:26:00,1,1369.0,1032.0,0.753,6.537,133,0,0,0,133,80,53,0,0.0,0.0
1016,513,2020-03-17 12:29:00,1,1388.0,1014.0,0.731,6.591,57,4,0,4,53,37,16,0,0.0,0.0
1016,514,2020-03-17 12:32:00,1,1382.0,1013.0,0.733,6.568,16,3,0,3,13,6,7,0,0.0,0.0
1016,515,2020-03-17 12:35:00,1,1372.0,1056.0,0.77,6.575,18,7,0,7,11,6,5,0,0.0,0.0
1016,516,2020-03-17 12:38:00,1,1175.0,882.0,0.75,5.606,29,3,2,1,26,3,23,0,0.0,0.0
1016,517,2020-03-17 12:41:00,1,1017.0,818.0,0.805,4.912,23,12,1,11,11,5,6,0,0.0,0.0
1016,518,2020-03-17 12:44:00,1,1392.0,982.0,0.706,6.57,43,0,0,0,43,15,28,0,0.0,0.0
1016,519,2020-03-17 12:47:00,1,1454.0,1075.0,0.739,6.92,10,1,0,1,9,4,5,0,0.0,0.0
1016,520,2020-03-17 12:50:00,1,1531.0,1113.0,0.727,7.262,19,4,0,4,15,8,7,0,0.0,0.0
1016,521,2020-03-17 12:53:00,1,1445.0,1072.0,0.742,6.882,20,2,1,1,18,9,9,0,0.0,0.0
1016,522,2020-03-17 12:56:00,1,1374.0,1032.0,0.751,6.556,47,17,1,16,30,5,25,0,0.0,0.0
1016,523,2020-03-17 12:59:00,1,1366.0,1080.0,0.791,6.577,253,102,59,43,151,84,67,17,0.0,0.0
1016,524,2020-03-17 13:02:00,1,1637.0,1282.0,0.783,7.869,411,287,221,66,124,74,50,83,0.0,0.01
1016,525,2020-03-17 13:05:00,1,1365.0,1081.0,0.792,6.577,803,440,351,89,363,271,92,81,0.0,0.0
1016,526,2020-03-17 13:08:00,1,1791.0,1371.0,0.766,8.573,569,362,294,68,207,148,59,29,0.17,0.0
1016,527,2020-03-17 13:11:00,1,1828.0,1467.0,0.803,8.825,1040,636,523,113,404,299,105,16,0.0,0.01
1016,528,2020-03-17 13:14:00,1,1984.0,1564.0,0.788,9.549,682,373,295,78,309,236,73,24,0.0,0.0
1016,529,2020-03-17 13:17:00,1,1984.0,1546.0,0.779,9.53,703,431,351,80,272,207,65,77,0.02,0.0
1016,530,2020-03-17 13:20:00,1,1972.0,1599.0,0.811,9.542,190,83,46,37,107,65,42,39,0.0,0.0
1016,531,2020-03-17 13:23:00,1,1973.0,1608.0,0.815,9.552,165,106,58,48,59,24,35,12,0.0,0.0
1016,532,2020-03-17 13:26:00,1,1835.0,1501.0,0.818,8.893,28,14,5,9,14,6,8,0,0.0,0.0
1016,533,2020-03-17 13:29:00,1,1618.0,1342.0,0.83,7.862,81,25,6,19,56,30,26,2,0.0,0.0
1016,534,2020-03-17 13:32:00,1,1510.0,1158.0,0.767,7.23,13,8,0,8,5,2,3,0,0.0,0.0
1016,535,2020-03-17 13:35:00,1,1521.0,1131.0,0.743,7.246,11,9,0,9,2,0,2,0,0.0,0.0
1016,536,2020-03-17 13:38:00,1,1524.0,1123.0,0.737,7.247,106,36,2,34,70,50,20,0,0.0,0.0
1016,537,2020-03-17 13:41:00,1,1505.0,1136.0,0.755,7.189,9,5,2,3,4,1,3,0,0.0,0.0
1016,538,2020-03-17 13:44:00,1,1529.0,1111.0,0.726,7.254,24,7,0,7,17,7,10,0,0.0,0.0
1016,539,2020-03-17 13:47:00,1,1529.0,1125.0,0.736,7.269,42,2,0,2,40,6,34,0,0.0,0.0
1016,540,2020-03-17 13:50:00,1,1509.0,1155.0,0.766,7.224,33,9,2,7,24,13,11,0,0.0,0.0
1016,541,2020-03-17 13:53:00,1,1511.0,1161.0,0.768,7.241,0,0,0,0,0,0,0,0,0.0,0.0
1016,542,2020-03-17 13:56:00,1,1513.0,1171.0,0.774,7.257,1,1,0,1,0,0,0,0,0.0,0.0
1016,543,2020-03-17 13:59:00,1,1502.0,1168.0,0.778,7.21,5,5,0,5,0,0,0,0,0.0,0.0
1016,544,2020-03-17 14:02:00,1,1507.0,1161.0,0.771,7.222,0,0,0,0,0,0,0,0,0.0,0.0
1016,545,2020-03-17 14:05:00,1,1528.0,1108.0,0.725,7.248,2,0,0,0,2,1,1,0,0.0,0.0
1016,546,2020-03-17 14:08:00,1,1508.0,1121.0,0.743,7.185,0,0,0,0,0,0,0,0,0.0,0.0
1016,547,2020-03-17 14:11:00,1,1513.0,1144.0,0.756,7.229,15,1,0,1,14,0,14,0,0.0,0.0
1016,548,2020-03-17 14:14:00,1,1512.0,1158.0,0.766,7.239,43,0,0,0,43,2,41,0,0.0,0.0
1016,549,2020-03-17 14:17:00,1,1648.0,1207.0,0.733,7.83,100,46,12,34,54,31,23,1,0.0,0.0
1016,550,2020-03-17 14:20:00,1,1584.0,1192.0,0.752,7.562,16,6,0,6,10,2,8,0,0.0,0.0
1016,551,2020-03-17 14:23:00,1,1521.0,1113.0,0.732,7.224,17,2,0,2,15,3,12,0,0.0,0.0
1016,552,2020-03-17 14:26:00,1,1520.0,1119.0,0.737,7.227,58,4,2,2,54,9,45,0,0.0,0.0
1016,553,2020-03-17 14:29:00,1,1507.0,1133.0,0.752,7.191,62,7,2,5,55,21,34,0,0.0,0.0
1016,554,2020-03-17 14:32:00,1,1521.0,1124.0,0.739,7.239,45,0,0,0,45,9,36,0,0.0,0.0
1016,555,2020-03-17 14:35:00,1,1509.5,1132.0,0.75,7.201,102,28,15,13,74,40,34,0,0.0,0.0
1016,556,2020-03-17 14:38:00,1,1498.0,1140.0,0.761,7.163,67,12,4,8,55,4,51,0,0.0,0.0
1016,557,2020-03-17 14:41:00,1,1511.0,1174.0,0.777,7.252,60,11,7,4,49,4,45,0,0.0,0.0
1016,558,2020-03-17 14:44:00,1,1496.0,1160.0,0.775,7.179,134,55,39,16,79,23,56,14,0.0,0.0
1016,559,2020-03-17 14:47:00,1,1702.0,1301.0,0.764,8.148,570,342,274,68,228,160,68,105,0.0,0.07
1016,560,2020-03-17 14:50:00,1,1657.0,1231.0,0.743,7.892,438,256,188,68,182,131,51,32,0.0,0.0
1016,561,2020-03-17 14:53:00,1,2048.0,1624.0,0.793,9.867,312,179,131,48,133,88,45,130,0.0,0.0
1016,562,2020-03-17 14:56:00,1,1774.0,1425.0,0.803,8.568,78,34,25,9,44,28,16,8,0.0,0.26
1016,563,2020-03-17 14:59:00,1,1183.0,863.0,0.73,5.615,105,15,9,6,90,43,47,26,0.0,0.0
1016,564,2020-03-17 15:02:00,1,1912.0,1541.0,0.806,9.237,498,270,189,81,228,140,88,37,0.0,0.0
1016,565,2020-03-17 15:05:00,1,2290.0,1955.0,0.854,11.186,599,342,270,72,257,189,68,50,0.0,0.0
1016,566,2020-03-17 15:08:00,1,1930.0,1721.0,0.892,9.51,611,314,238,76,297,209,88,2,0.0,0.01
1016,567,2020-03-17 15:11:00,1,1933.0,1748.0,0.905,9.55,537,346,273,73,191,134,57,40,0.06,0.0
1016,568,2020-03-17 15:14:00,1,2153.0,1856.0,0.862,10.537,278,160,125,35,118,82,36,183,0.0,0.01
1016,569,2020-03-17 15:17:00,1,2130.0,1930.0,0.906,10.527,441,285,228,57,156,109,47,176,0.01,0.0
1016,570,2020-03-17 15:20:00,1,2135.0,1930.0,0.904,10.55,465,237,174,63,228,162,66,31,0.0,0.0
1016,571,2020-03-17 15:23:00,1,1954.0,1694.0,0.867,9.573,715,411,316,95,304,222,82,2,0.0,0.0
1016,572,2020-03-17 15:26:00,1,1793.0,1643.0,0.917,8.883,294,153,113,40,141,100,41,47,0.0,0.0
1016,573,2020-03-17 15:29:00,1,1788.0,1616.0,0.904,8.835,160,33,8,25,127,76,51,2,0.0,0.0
1016,574,2020-03-17 15:32:00,1,1936.0,1765.0,0.912,9.583,134,21,8,13,113,61,52,3,0.0,0.0
1016,575,2020-03-17 15:35:00,1,2005.0,1801.0,0.898,9.894,145,14,2,12,131,63,68,2,0.0,0.0
1016,576,2020-03-17 15:38:00,1,1935.0,1712.0,0.885,9.518,60,23,14,9,37,16,21,1,0.0,0.0
1016,577,2020-03-17 15:41:00,1,1808.0,1593.0,0.881,8.887,44,19,8,11,25,11,14,0,0.0,0.0
1016,578,2020-03-17 15:44:00,1,1748.0,1545.0,0.883,8.599,2,2,0,2,0,0,0,0,0.0,0.0
1016,579,2020-03-17 15:47:00,1,1800.0,1553.0,0.863,8.812,39,7,2,5,32,8,24,0,0.0,0.0
1016,580,2020-03-17 15:50:00,1,1818.0,1570.0,0.864,8.9,5,2,0,2,3,1,2,0,0.0,0.0
1016,581,2020-03-17 15:53:00,1,1744.0,1520.0,0.872,8.555,15,13,0,13,2,1,1,0,0.0,0.0
1016,582,2020-03-17 15:56:00,1,1753.0,1519.0,0.867,8.587,12,10,1,9,2,0,2,0,0.0,0.0
1016,583,2020-03-17 15:59:00,1,1796.0,1553.0,0.865,8.797,18,5,2,3,13,5,8,0,0.0,0.0
1016,584,2020-03-17 16:02:00,1,1751.0,1487.0,0.849,8.544,23,8,4,4,15,5,10,0,0.0,0.0
1016,585,2020-03-17 16:05:00,1,1610.0,1430.0,0.888,7.928,17,1,0,1,16,4,12,0,0.0,0.0
1016,586,2020-03-17 16:08:00,1,1596.0,1435.0,0.9,7.876,17,2,0,2,15,6,9,0,0.0,0.0
1016,587,2020-03-17 16:11:00,1,1677.0,1462.0,0.872,8.227,22,0,0,0,22,1,21,0,0.0,0.0
1016,588,2020-03-17 16:14:00,1,1679.0,1466.0,0.873,8.24,19,5,3,2,14,7,7,0,0.0,0.0
1016,589,2020-03-17 16:17:00,1,1611.0,1417.0,0.879,7.918,16,0,0,0,16,0,16,0,0.0,0.0
1016,590,2020-03-17 16:20:00,1,1618.0,1365.0,0.844,7.885,12,11,1,10,1,0,1,0,0.0,0.0
1016,591,2020-03-17 16:23:00,1,1545.0,1322.0,0.856,7.552,12,1,0,1,11,4,7,0,0.0,0.0
1016,592,2020-03-17 16:26:00,1,1619.0,1367.0,0.844,7.892,12,9,3,6,3,0,3,0,0.0,0.0
1016,593,2020-03-17 16:29:00,1,1549.0,1331.0,0.86,7.576,19,15,4,11,4,0,4,0,0.0,0.0
1016,594,2020-03-17 16:32:00,1,1547.0,1335.0,0.863,7.572,15,14,0,14,1,0,1,0,0.0,0.0
1016,595,2020-03-17 16:35:00,1,1629.0,1362.0,0.836,7.927,54,27,14,13,27,17,10,0,0.0,0.0
1016,596,2020-03-17 16:38:00,1,1690.0,1429.0,0.846,8.241,11,4,0,4,7,2,5,0,0.0,0.0
1016,597,2020-03-17 16:41:00,1,1685.0,1433.0,0.85,8.227,1,0,0,0,1,0,1,0,0.0,0.0
1016,598,2020-03-17 16:44:00,1,1769.0,1446.0,0.817,8.571,10,5,1,4,5,0,5,0,0.0,0.0
1016,599,2020-03-17 16:47:00,1,1833.0,1476.0,0.806,8.856,42,40,11,29,2,1,1,0,0.0,0.0
1016,600,2020-03-17 16:50:00,1,1766.0,1443.0,0.817,8.554,181,179,163,16,2,0,2,0,0.0,0.0
1016,601,2020-03-17 16:53:00,1,1626.0,1364.0,0.839,7.919,23,14,7,7,9,7,2,0,0.0,0.0
1016,602,2020-03-17 16:56:00,1,1694.0,1438.0,0.849,8.265,93,53,10,43,40,9,31,1,0.0,0.0
1016,603,2020-03-17 16:59:00,1,1821.0,1538.0,0.845,8.876,253,94,61,33,159,91,68,8,0.0,0.0
1016,604,2020-03-17 17:02:00,1,1833.0,1494.0,0.815,8.876,255,105,78,27,150,90,60,22,0.0,0.0
1016,605,2020-03-17 17:05:00,1,1981.0,1593.0,0.804,9.569,85,9,5,4,76,32,44,0,0.0,0.0
1016,606,2020-03-17 17:08:00,1,1827.0,1563.0,0.856,8.929,54,0,0,0,54,31,23,0,0.0,0.0
1016,607,2020-03-17 17:11:00,1,1816.0,1534.0,0.845,8.855,97,34,12,22,63,27,36,1,0.0,0.0
1016,608,2020-03-17 17:14:00,1,1976.0,1586.0,0.803,9.544,75,35,13,22,40,20,20,0,0.0,0.0
1016,609,2020-03-17 17:17:00,1,1833.0,1482.0,0.809,8.862,18,9,0,9,9,2,7,0,0.0,0.0
1016,610,2020-03-17 17:20:00,1,1691.0,1396.0,0.826,8.208,27,9,1,8,18,5,13,0,0.0,0.0
1016,611,2020-03-17 17:23:00,1,1696.0,1379.0,0.813,8.207,3,3,1,2,0,0,0,0,0.0,0.0
1016,612,2020-03-17 17:26:00,1,1707.0,1371.0,0.803,8.242,17,7,2,5,10,2,8,0,0.0,0.0
1016,613,2020-03-17 17:29:00,1,1632.0,1309.0,0.802,7.881,7,6,3,3,1,0,1,0,0.0,0.0
1016,614,2020-03-17 17:32:00,1,1631.0,1289.0,0.79,7.854,6,4,0,4,2,1,1,0,0.0,0.0
1016,615,2020-03-17 17:35:00,1,1642.5,1268.5,0.7725,7.8755,10,8,2,6,2,1,1,0,0.0,0.0
1016,616,2020-03-17 17:38:00,1,1654.0,1248.0,0.755,7.897,4,2,0,2,2,0,2,0,0.0,0.0
1016,617,2020-03-17 17:41:00,1,1578.0,1226.0,0.777,7.574,3,0,0,0,3,1,2,0,0.0,0.0
1016,618,2020-03-17 17:44:00,1,1651.0,1254.0,0.759,7.895,0,0,0,0,0,0,0,0,0.0,0.0
1016,619,2020-03-17 17:47:00,1,1581.0,1227.0,0.776,7.589,35,24,17,7,11,1,10,0,0.0,0.0
1016,620,2020-03-17 17:50:00,1,1642.0,1322.0,0.805,7.932,57,14,6,8,43,24,19,1,0.0,0.0
1016,621,2020-03-17 17:53:00,1,1646.0,1251.0,0.76,7.869,18,9,3,6,9,4,5,0,0.0,0.0
1016,622,2020-03-17 17:56:00,1,1654.0,1249.0,0.755,7.9,13,8,1,7,5,1,4,0,0.0,0.0
1016,623,2020-03-17 17:59:00,1,1641.0,1237.0,0.754,7.837,5,1,0,1,4,1,3,0,0.0,0.0
1016,624,2020-03-17 18:02:00,0,1652.0,1239.0,0.75,7.879,8,6,0,6,2,0,2,0,0.0,0.0
1016,625,2020-03-17 18:05:00,0,1659.0,1230.0,0.742,7.899,12,3,0,3,9,3,6,0,0.0,0.0
1016,626,2020-03-17 18:08:00,0,1662.0,1230.0,0.74,7.91,67,27,4,23,40,19,21,0,0.0,0.0
1016,627,2020-03-17 18:11:00,0,1706.0,1338.0,0.784,8.204,103,44,13,31,59,30,29,9,0.0,0.0
1016,628,2020-03-17 18:14:00,0,1834.0,1469.0,0.801,8.851,269,123,83,40,146,85,61,18,0.0,0.0
1016,629,2020-03-17 18:17:00,0,2123.0,1639.0,0.772,10.181,480,307,262,45,173,126,47,272,0.0,0.0
1016,630,2020-03-17 18:20:00,0,1988.0,1554.0,0.782,9.555,76,16,10,6,60,24,36,0,0.0,0.0
1016,631,2020-03-17 18:23:00,0,1863.0,1391.0,0.747,8.882,37,6,1,5,31,18,13,0,0.0,0.0
1016,632,2020-03-17 18:26:00,0,1840.0,1435.0,0.78,8.838,300,103,47,56,197,115,82,21,0.0,0.0
1016,633,2020-03-17 18:29:00,0,2003.0,1482.0,0.74,9.534,321,83,40,43,238,164,74,9,0.0,0.0
1016,634,2020-03-17 18:32:00,0,1926.0,1472.0,0.764,9.218,418,254,207,47,164,118,46,216,0.0,0.0
1016,635,2020-03-17 18:35:00,0,2208.0,1666.0,0.755,10.544,156,98,50,48,58,20,38,97,0.0,0.0
1016,636,2020-03-17 18:38:00,0,2143.0,1580.0,0.737,10.193,302,199,152,47,103,70,33,100,0.29,0.03
1016,637,2020-03-17 18:41:00,0,1656.0,1241.0,0.75,7.899,141,63,30,33,78,45,33,14,0.0,0.0
1016,638,2020-03-17 18:44:00,0,1863.0,1386.0,0.744,8.877,123,33,4,29,90,44,46,5,0.0,0.0
1016,639,2020-03-17 18:47:00,0,2030.0,1619.0,0.797,9.793,162,16,3,13,146,81,65,3,0.0,0.0
1016,640,2020-03-17 18:50:00,0,2187.0,1720.0,0.786,10.519,39,18,4,14,21,1,20,0,0.0,0.0
1016,641,2020-03-17 18:53:00,0,1910.0,1542.0,0.808,9.231,4,0,0,0,4,2,2,0,0.0,0.0
1016,642,2020-03-17 18:56:00,0,1894.0,1516.0,0.801,9.141,0,0,0,0,0,0,0,0,0.0,0.0
1016,643,2020-03-17 18:59:00,0,1992.0,1555.0,0.78,9.57,19,10,3,7,9,2,7,0,0.0,0.01
1016,644,2020-03-17 19:02:00,0,1933.0,1469.0,0.76,9.242,192,110,69,41,82,41,41,89,0.0,0.0
1016,645,2020-03-17 19:05:00,0,2326.0,1794.0,0.771,11.152,376,190,130,60,186,117,69,138,0.0,0.04
1016,646,2020-03-17 19:08:00,0,2131.0,1656.0,0.777,10.229,320,199,150,49,121,86,35,151,0.19,0.01
1016,647,2020-03-17 19:11:00,0,1503.0,1178.0,0.784,7.226,224,94,58,36,130,86,44,38,0.0,0.0
1016,648,2020-03-17 19:14:00,0,1161.0,927.0,0.798,5.602,243,50,21,29,193,123,70,10,0.0,0.0
1016,649,2020-03-17 19:17:00,0,1513.0,1151.0,0.761,7.234,154,40,10,30,114,54,60,5,0.0,0.0
1016,650,2020-03-17 19:20:00,0,2113.0,1704.0,0.806,10.211,181,122,76,46,59,36,23,52,0.0,0.0
1016,651,2020-03-17 19:23:00,0,2525.0,1996.0,0.791,12.158,196,83,39,44,113,54,59,88,0.07,0.05
1016,652,2020-03-17 19:26:00,0,2300.0,1889.0,0.821,11.152,547,293,215,78,254,192,62,241,0.0,0.01
1016,653,2020-03-17 19:29:00,0,1893.0,1609.0,0.85,9.239,483,265,198,67,218,172,46,177,0.0,0.07
1016,654,2020-03-17 19:32:00,0,1815.0,1518.0,0.836,8.832,355,216,173,43,139,99,40,147,0.0,0.0
1016,655,2020-03-17 19:35:00,0,2368.0,1989.0,0.84,11.534,460,304,250,54,156,113,43,213,0.06,0.0
1016,656,2020-03-17 19:38:00,0,2291.0,2024.0,0.884,11.265,451,297,221,76,154,111,43,254,0.0,0.0
1016,657,2020-03-17 19:41:00,0,1882.0,1575.0,0.837,9.158,383,222,162,60,161,111,50,57,0.0,0.0
1016,658,2020-03-17 19:44:00,0,1141.0,965.0,0.846,5.564,571,287,217,70,284,212,72,129,0.0,0.0
1016,659,2020-03-17 19:47:00,0,1826.0,1511.0,0.827,8.869,299,174,109,65,125,91,34,144,0.0,0.0
1016,660,2020-03-17 19:50:00,0,2505.0,2057.0,0.821,12.148,229,133,87,46,96,66,30,148,0.02,0.0
1016,661,2020-03-17 19:53:00,0,2301.0,1886.0,0.82,11.153,374,206,161,45,168,123,45,175,0.0,0.0
1016,662,2020-03-17 19:56:00,0,2629.0,2244.0,0.854,12.844,430,253,190,63,177,138,39,168,0.0,0.03
1016,663,2020-03-17 19:59:00,0,2644.0,2184.0,0.826,12.837,381,227,166,61,154,97,57,126,0.0,0.0
1016,664,2020-03-17 20:02:00,0,2046.0,1643.0,0.803,9.879,497,272,202,70,225,171,54,154,0.24,0.0
1016,665,2020-03-17 20:05:00,0,2501.0,2118.0,0.847,12.198,394,217,161,56,177,137,40,164,0.0,0.0
1016,666,2020-03-17 20:08:00,0,2162.0,1815.0,0.839,10.529,411,227,170,57,184,140,44,147,0.0,0.0
1016,667,2020-03-17 20:11:00,0,2523.0,2014.0,0.798,12.17,459,297,225,72,162,124,38,184,0.0,0.0
1016,668,2020-03-17 20:14:00,0,2300.0,1907.0,0.829,11.173,161,102,43,59,59,18,41,94,0.0,0.0
1016,669,2020-03-17 20:17:00,0,2649.0,2182.0,0.824,12.854,250,131,82,49,119,61,58,103,0.0,0.13
1016,670,2020-03-17 20:20:00,0,1296.0,1031.0,0.796,6.248,558,299,224,75,259,183,76,88,0.0,0.0
1016,671,2020-03-17 20:23:00,0,1966.0,1618.0,0.823,9.538,495,263,219,44,232,179,53,116,0.1,0.0
1016,672,2020-03-17 20:26:00,0,2166.0,1741.0,0.804,10.461,519,230,158,72,289,225,64,196,0.0,0.0
1016,673,2020-03-17 20:29:00,0,2634.0,2239.0,0.85,12.857,396,219,149,70,177,124,53,154,0.1,0.0
1016,674,2020-03-17 20:32:00,0,2562.0,2188.0,0.854,12.517,585,310,230,80,275,197,78,126,0.0,0.0
1016,675,2020-03-17 20:35:00,0,2495.0,2111.5,0.846,12.1685,165,108,55,53,57,29,28,106,0.0,0.0
1016,676,2020-03-17 20:38:00,0,2428.0,2035.0,0.838,11.82,608,336,272,64,272,207,65,151,0.0,0.0
1016,677,2020-03-17 20:41:00,0,2188.0,1775.0,0.811,10.588,409,270,212,58,139,105,34,239,0.0,0.0
1016,678,2020-03-17 20:44:00,0,2101.0,1760.0,0.838,10.226,292,158,111,47,134,86,48,109,0.0,0.0
1016,679,2020-03-17 20:47:00,0,1959.0,1639.0,0.837,9.532,480,253,185,68,227,171,56,197,0.0,0.0
1016,680,2020-03-17 20:50:00,0,2278.0,1974.0,0.866,11.16,511,259,199,60,252,195,57,150,0.0,0.0
1016,681,2020-03-17 20:53:00,0,2145.0,1893.0,0.882,10.549,610,342,267,75,268,202,66,70,0.0,0.0
1016,682,2020-03-17 20:56:00,0,2177.0,1761.0,0.809,10.528,326,190,137,53,136,92,44,25,0.0,0.0
1016,683,2020-03-17 20:59:00,0,2278.0,1942.0,0.853,11.125,214,131,85,46,83,33,50,132,0.0,0.0
1016,684,2020-03-17 21:02:00,0,1830.0,1528.0,0.835,8.901,96,73,27,46,23,1,22,51,0.0,0.0
1016,685,2020-03-17 21:05:00,0,1977.0,1601.0,0.81,9.561,203,172,113,59,31,1,30,18,0.0,0.0
1016,686,2020-03-17 21:08:00,0,2161.0,1798.0,0.832,10.506,454,250,189,61,204,152,52,112,0.0,0.0
1016,687,2020-03-17 21:11:00,0,2275.0,1957.0,0.86,11.131,403,196,146,50,207,162,45,200,0.0,0.0
1016,688,2020-03-17 21:14:00,0,2534.0,1992.0,0.786,12.189,332,197,135,62,135,89,46,140,0.1,0.1
1016,689,2020-03-17 21:17:00,0,2314.0,1873.0,0.809,11.191,352,211,147,64,141,93,48,180,0.0,0.0
1016,690,2020-03-17 21:20:00,0,2514.0,2040.0,0.811,12.164,101,65,33,32,36,21,15,62,0.0,0.0
1016,691,2020-03-17 21:23:00,0,1775.0,1402.0,0.79,8.547,64,22,11,11,42,21,21,24,0.0,0.0
1016,692,2020-03-17 21:26:00,0,2041.0,1607.0,0.787,9.821,671,305,235,70,366,289,77,121,0.0,0.0
1016,693,2020-03-17 21:29:00,0,2245.0,1784.0,0.794,10.821,397,222,177,45,175,132,43,223,0.0,0.0
1016,694,2020-03-17 21:32:00,0,2327.0,1835.0,0.788,11.2,232,130,71,59,102,57,45,127,0.0,0.0
1016,695,2020-03-17 21:35:00,0,1980.0,1583.0,0.799,9.556,232,131,98,33,101,56,45,71,0.0,0.0
1016,696,2020-03-17 21:38:00,0,2171.0,1721.0,0.792,10.46,523,279,217,62,244,197,47,196,0.0,0.0
1016,697,2020-03-17 21:41:00,0,2051.0,1615.0,0.788,9.87,223,102,62,40,121,75,46,33,0.0,0.0
1016,698,2020-03-17 21:44:00,0,2340.0,1837.0,0.785,11.255,468,229,173,56,239,198,41,200,0.0,0.0
1016,699,2020-03-17 21:47:00,0,2195.0,1688.0,0.769,10.517,208,122,73,49,86,39,47,102,0.0,0.0
1016,700,2020-03-17 21:50:00,0,1954.0,1612.0,0.825,9.486,261,139,91,48,122,77,45,29,0.0,0.01
1016,701,2020-03-17 21:53:00,0,2117.0,1646.0,0.778,10.165,583,376,310,66,207,142,65,3,0.0,0.0
1016,702,2020-03-17 21:56:00,0,2175.0,1756.0,0.807,10.515,388,247,194,53,141,104,37,169,0.0,0.04
1016,703,2020-03-17 21:59:00,0,2030.0,1631.0,0.804,9.804,259,167,120,47,92,52,40,119,0.16,0.0
1016,704,2020-03-17 22:02:00,0,2571.0,2072.0,0.806,12.423,444,261,193,68,183,129,54,125,0.0,0.0
1016,705,2020-03-17 22:05:00,0,2184.0,1709.0,0.782,10.497,347,190,146,44,157,119,38,144,0.0,0.0
1016,706,2020-03-17 22:08:00,0,2178.0,1773.0,0.814,10.546,562,293,233,60,269,209,60,184,0.0,0.0
1016,707,2020-03-17 22:11:00,0,2187.0,1726.0,0.789,10.527,368,219,178,41,149,102,47,162,0.0,0.03
1016,708,2020-03-17 22:14:00,0,2185.0,1717.0,0.786,10.51,272,152,111,41,120,84,36,140,0.11,0.0
1016,709,2020-03-17 22:17:00,0,1976.0,1583.0,0.801,9.538,108,67,24,43,41,10,31,32,0.0,0.0
1016,710,2020-03-17 22:20:00,0,2264.0,1753.0,0.774,10.861,133,82,45,37,51,15,36,3,0.0,0.0
1016,711,2020-03-17 22:23:00,0,2199.0,1650.0,0.75,10.49,471,257,195,62,214,154,60,0,0.0,0.0
1016,712,2020-03-17 22:26:00,0,1977.0,1534.0,0.776,9.487,463,267,203,64,196,146,50,77,0.0,0.02
1016,713,2020-03-17 22:29:00,0,2216.0,1648.0,0.744,10.556,152,85,44,41,67,27,40,76,0.08,0.0
1016,714,2020-03-17 22:32:00,0,2006.0,1456.0,0.726,9.516,70,17,7,10,53,15,38,15,0.0,0.0
1016,715,2020-03-17 22:35:00,0,2218.0,1638.0,0.739,10.551,53,16,8,8,37,9,28,3,0.0,0.0
1016,716,2020-03-17 22:38:00,0,2198.0,1634.0,0.743,10.471,147,82,54,28,65,42,23,0,0.0,0.0
1016,717,2020-03-17 22:41:00,0,2194.0,1710.0,0.779,10.539,689,399,327,72,290,214,76,71,0.0,0.0
1016,718,2020-03-17 22:44:00,0,2002.0,1525.0,0.762,9.574,321,213,162,51,108,68,40,91,0.0,0.0
1016,719,2020-03-17 22:47:00,0,2149.0,1578.0,0.734,10.215,150,98,36,62,52,19,33,92,0.0,0.0
1016,720,2020-03-17 22:50:00,0,2189.0,1711.0,0.782,10.52,208,139,94,45,69,41,28,80,0.0,0.0
1016,721,2020-03-17 22:53:00,0,1984.0,1566.0,0.789,9.55,414,244,194,50,170,125,45,49,0.0,0.01
1016,722,2020-03-17 22:56:00,0,1870.0,1407.0,0.753,8.924,313,160,115,45,153,110,43,23,0.15,0.01
1016,723,2020-03-17 22:59:00,0,1989.0,1532.0,0.77,9.534,654,426,339,87,228,156,72,81,0.0,0.02
1016,724,2020-03-17 23:02:00,0,2175.0,1786.0,0.821,10.545,133,79,52,27,54,24,30,70,0.0,0.0
1016,725,2020-03-17 23:05:00,0,1919.0,1502.0,0.783,9.223,53,36,12,24,17,4,13,8,0.0,0.0
1016,726,2020-03-17 23:08:00,0,2033.0,1679.0,0.826,9.867,51,22,10,12,29,11,18,0,0.0,0.0
1016,727,2020-03-17 23:11:00,0,1961.0,1643.0,0.838,9.548,20,0,0,0,20,11,9,0,0.0,0.0
1016,728,2020-03-17 23:14:00,0,1963.0,1660.0,0.846,9.571,6,0,0,0,6,1,5,0,0.0,0.0
1016,729,2020-03-17 23:17:00,0,1974.0,1586.0,0.803,9.532,3,0,0,0,3,0,3,0,0.0,0.0
1016,730,2020-03-17 23:20:00,0,1895.0,1506.0,0.795,9.134,3,3,2,1,0,0,0,0,0.0,0.0
1016,731,2020-03-17 23:23:00,0,1857.0,1426.0,0.768,8.894,7,6,4,2,1,1,0,0,0.0,0.0
1016,732,2020-03-17 23:26:00,0,1849.0,1449.0,0.783,8.891,40,28,16,12,12,5,7,0,0.0,0.0
1016,733,2020-03-17 23:29:00,0,1843.0,1385.0,0.752,8.793,0,0,0,0,0,0,0,0,0.0,0.0
1016,734,2020-03-17 23:32:00,0,1633.0,1323.0,0.81,7.898,5,5,0,5,0,0,0,0,0.0,0.0
1016,735,2020-03-17 23:35:00,0,1817.0,1423.5,0.786,8.7355,284,170,119,51,114,74,40,37,0.0,0.0
1016,736,2020-03-17 23:38:00,0,2001.0,1524.0,0.762,9.573,312,200,137,63,112,64,48,111,0.0,0.0
1016,737,2020-03-17 23:41:00,0,2203.0,1663.0,0.755,10.521,179,104,62,42,75,38,37,71,0.0,0.07
1016,738,2020-03-17 23:44:00,0,1643.0,1254.0,0.763,7.86,273,146,108,38,127,89,38,67,0.0,0.0
1016,739,2020-03-17 23:47:00,0,1974.0,1594.0,0.807,9.541,271,141,88,53,130,69,61,114,0.0,0.0
1016,740,2020-03-17 23:50:00,0,2182.0,1684.0,0.772,10.46,275,154,118,36,121,90,31,46,0.0,0.0
1016,741,2020-03-17 23:53:00,0,1979.0,1588.0,0.802,9.555,435,265,195,70,170,126,44,158,0.0,0.03
1016,742,2020-03-17 23:56:00,0,1918.0,1542.0,0.804,9.265,295,201,145,56,94,59,35,173,0.0,0.0
1016,743,2020-03-17 23:59:00,0,2312.0,1873.0,0.81,11.182,150,93,63,30,57,20,37,45,0.0,0.02
1016,744,2020-03-18 00:02:00,0,1977.0,1590.0,0.804,9.552,115,56,30,26,59,11,48,17,0.0,0.01
1016,745,2020-03-18 00:05:00,0,1825.0,1546.0,0.847,8.902,452,240,185,55,212,149,63,12,0.0,0.01
1016,746,2020-03-18 00:08:00,0,1814.0,1504.0,0.829,8.814,208,125,94,31,83,60,23,88,0.0,0.0
1016,747,2020-03-18 00:11:00,0,2168.0,1771.0,0.817,10.501,68,43,18,25,25,10,15,3,0.0,0.0
1016,748,2020-03-18 00:14:00,0,2153.0,1864.0,0.866,10.548,66,49,20,29,17,4,13,16,0.0,0.0
1016,749,2020-03-18 00:17:00,0,2172.0,1745.0,0.804,10.489,0,0,0,0,0,0,0,0,0.0,0.0
1016,750,2020-03-18 00:20:00,0,1972.0,1629.0,0.826,9.574,2,0,0,0,2,0,2,0,0.0,0.0
1016,751,2020-03-18 00:23:00,0,1830.0,1518.0,0.829,8.892,5,0,0,0,5,1,4,0,0.0,0.0
1016,752,2020-03-18 00:26:00,0,1835.0,1490.0,0.812,8.881,4,0,0,0,4,0,4,0,0.0,0.0
1016,753,2020-03-18 00:29:00,0,1850.0,1446.0,0.782,8.891,9,3,1,2,6,0,6,0,0.0,0.0
1016,754,2020-03-18 00:32:00,0,1849.0,1440.0,0.779,8.882,27,27,0,27,0,0,0,0,0.0,0.0
1016,755,2020-03-18 00:35:00,0,1928.0,1458.0,0.756,9.21,0,0,0,0,0,0,0,0,0.0,0.0
1016,756,2020-03-18 00:38:00,0,1860.0,1390.0,0.747,8.865,4,3,1,2,1,0,1,0,0.0,0.0
1016,757,2020-03-18 00:41:00,0,1716.0,1343.0,0.782,8.249,4,3,0,3,1,0,1,0,0.0,0.0
1016,758,2020-03-18 00:44:00,0,1709.0,1335.0,0.781,8.212,2,2,1,1,0,0,0,0,0.0,0.0
1016,759,2020-03-18 00:47:00,0,1646.0,1258.0,0.764,7.88,19,10,5,5,9,3,6,2,0.0,0.0
1016,760,2020-03-18 00:50:00,0,1720.0,1306.0,0.759,8.222,15,15,1,14,0,0,0,0,0.0,0.0
1016,761,2020-03-18 00:53:00,0,1646.0,1269.0,0.771,7.892,8,6,0,6,2,0,2,0,0.0,0.0
1016,762,2020-03-18 00:56:00,0,1642.0,1278.0,0.778,7.884,30,20,7,13,10,2,8,1,0.0,0.0
1016,763,2020-03-18 00:59:00,0,1638.0,1294.0,0.79,7.886,41,30,6,24,11,0,11,0,0.0,0.0
1016,764,2020-03-18 01:02:00,0,1724.0,1294.0,0.751,8.225,25,13,7,6,12,8,4,0,0.0,0.0
1016,765,2020-03-18 01:05:00,0,1715.0,1293.0,0.754,8.19,27,6,2,4,21,15,6,0,0.0,0.0
1016,766,2020-03-18 01:08:00,0,1884.0,1339.0,0.711,8.905,0,0,0,0,0,0,0,0,0.0,0.0
1016,767,2020-03-18 01:11:00,0,1944.0,1419.0,0.73,9.229,151,108,53,55,43,14,29,7,0.0,0.0
1016,768,2020-03-18 01:14:00,0,1870.0,1421.0,0.76,8.942,32,14,6,8,18,0,18,0,0.0,0.0
1016,769,2020-03-18 01:17:00,0,1790.0,1342.0,0.75,8.537,17,1,0,1,16,0,16,0,0.0,0.0
1016,770,2020-03-18 01:20:00,0,1645.0,1288.0,0.783,7.905,10,8,2,6,2,1,1,0,0.0,0.0
1016,771,2020-03-18 01:23:00,0,1661.0,1242.0,0.748,7.921,2,2,0,2,0,0,0,0,0.0,0.0
1016,772,2020-03-18 01:26:00,0,1652.0,1240.0,0.75,7.881,3,3,0,3,0,0,0,0,0.0,0.0
1016,773,2020-03-18 01:29:00,0,1647.0,1245.0,0.756,7.869,36,28,10,18,8,7,1,0,0.0,0.0
1016,774,2020-03-18 01:32:00,0,1665.0,1202.0,0.722,7.892,77,72,20,52,5,2,3,8,0.0,0.0
1016,775,2020-03-18 01:35:00,0,1872.0,1317.0,0.704,8.836,160,85,49,36,75,29,46,64,0.0,0.02
1016,776,2020-03-18 01:38:00,0,2012.0,1477.0,0.734,9.561,284,165,111,54,119,65,54,74,0.0,0.0
1016,777,2020-03-18 01:41:00,0,1985.0,1556.0,0.784,9.544,230,125,90,35,105,61,44,44,0.0,0.04
1016,778,2020-03-18 01:44:00,0,2193.0,1749.0,0.797,10.577,592,337,265,72,255,194,61,171,0.0,0.01
1016,779,2020-03-18 01:47:00,0,1955.0,1616.0,0.827,9.491,356,237,170,67,119,76,43,174,0.15,0.02
1016,780,2020-03-18 01:50:00,0,1611.0,1387.0,0.86,7.884,221,109,72,37,112,74,38,49,0.0,0.0
1016,781,2020-03-18 01:53:00,0,2052.0,1645.0,0.801,9.907,78,49,23,26,29,0,29,18,0.0,0.0
1016,782,2020-03-18 01:56:00,0,2153.0,1796.0,0.834,10.47,150,132,87,45,18,0,18,10,0.0,0.01
1016,783,2020-03-18 01:59:00,0,2183.0,1761.0,0.806,10.552,188,113,76,37,75,41,34,10,0.0,0.0
1016,784,2020-03-18 02:02:00,0,1956.0,1657.0,0.847,9.541,462,251,196,55,211,139,72,110,0.0,0.01
1016,785,2020-03-18 02:05:00,0,1973.0,1546.0,0.783,9.487,500,239,196,43,261,207,54,57,0.08,0.0
1016,786,2020-03-18 02:08:00,0,1919.0,1492.0,0.778,9.213,37,16,4,12,21,0,21,2,0.0,0.0
1016,787,2020-03-18 02:11:00,0,1982.0,1522.0,0.768,9.495,0,0,0,0,0,0,0,0,0.0,0.0
1016,788,2020-03-18 02:14:00,0,1863.0,1398.0,0.751,8.887,3,3,1,2,0,0,0,0,0.0,0.0
1016,789,2020-03-18 02:17:00,0,1627.0,1333.0,0.819,7.887,0,0,0,0,0,0,0,0,0.0,0.0
1016,790,2020-03-18 02:20:00,0,1868.0,1365.0,0.731,8.872,5,4,2,2,1,0,1,0,0.0,0.0
1016,791,2020-03-18 02:23:00,0,1874.0,1378.0,0.735,8.91,13,8,3,5,5,2,3,0,0.0,0.0
1016,792,2020-03-18 02:26:00,0,1779.0,1324.0,0.744,8.475,25,25,3,22,0,0,0,0,0.0,0.0
1016,793,2020-03-18 02:29:00,0,1871.0,1341.0,0.717,8.858,12,12,8,4,0,0,0,0,0.0,0.0
1016,794,2020-03-18 02:32:00,0,1650.0,1247.0,0.756,7.882,1,1,0,1,0,0,0,0,0.0,0.0
1016,795,2020-03-18 02:35:00,0,1619.0,1208.5,0.7465,7.717,17,15,3,12,2,0,2,0,0.0,0.0
1016,796,2020-03-18 02:38:00,0,1588.0,1170.0,0.737,7.552,9,9,1,8,0,0,0,0,0.0,0.0
1016,797,2020-03-18 02:41:00,0,1670.0,1189.0,0.712,7.896,11,6,3,3,5,0,5,0,0.0,0.0
1016,798,2020-03-18 02:44:00,0,1663.0,1197.0,0.72,7.877,9,6,3,3,3,1,2,0,0.0,0.0
1016,799,2020-03-18 02:47:00,0,1664.0,1194.0,0.717,7.878,33,23,12,11,10,2,8,0,0.0,0.0
1016,800,2020-03-18 02:50:00,0,1514.0,1143.0,0.755,7.23,10,8,5,3,2,0,2,0,0.0,0.0
1016,801,2020-03-18 02:53:00,0,1589.0,1168.0,0.735,7.552,1071,562,442,120,509,378,131,1,0.0,0.0
1016,802,2020-03-18 02:56:00,0,1876.0,1334.0,0.711,8.87,1312,772,618,154,540,411,129,50,0.0,0.0
1016,803,2020-03-18 02:59:00,0,2014.0,1450.0,0.72,9.539,1501,765,615,150,736,586,150,21,0.0,0.0
1016,804,2020-03-18 03:02:00,0,2006.0,1460.0,0.728,9.521,924,571,474,97,353,274,79,86,0.0,0.0
1016,805,2020-03-18 03:05:00,0,1990.0,1508.0,0.757,9.512,487,293,233,60,194,147,47,168,0.0,0.0
1016,806,2020-03-18 03:08:00,0,2218.0,1637.0,0.738,10.55,315,193,133,60,122,96,26,161,0.0,0.0
1016,807,2020-03-18 03:11:00,0,2212.0,1652.0,0.747,10.545,225,137,93,44,88,53,35,80,0.0,0.0
1016,808,2020-03-18 03:14:00,0,2071.0,1535.0,0.741,9.86,548,354,279,75,194,128,66,90,0.04,0.03
1016,809,2020-03-18 03:17:00,0,1869.0,1373.0,0.735,8.883,408,212,152,60,196,141,55,78,0.0,0.0
1016,810,2020-03-18 03:20:00,0,1982.0,1544.0,0.779,9.518,546,303,240,63,243,191,52,258,0.0,0.0
1016,811,2020-03-18 03:23:00,0,2328.0,1815.0,0.78,11.18,113,77,39,38,36,9,27,93,0.0,0.0
1016,812,2020-03-18 03:26:00,0,2218.0,1606.0,0.724,10.52,58,44,14,30,14,0,14,23,0.0,0.0
1016,813,2020-03-18 03:29:00,0,1997.0,1533.0,0.768,9.567,117,86,48,38,31,2,29,20,0.0,0.0
1016,814,2020-03-18 03:32:00,0,1982.0,1555.0,0.785,9.529,369,268,209,59,101,62,39,19,0.0,0.0
1016,815,2020-03-18 03:35:00,0,1979.0,1567.0,0.792,9.531,338,162,115,47,176,129,47,65,0.0,0.02
1016,816,2020-03-18 03:38:00,0,1991.0,1571.0,0.789,9.584,574,309,250,59,265,197,68,56,0.0,0.0
1016,817,2020-03-18 03:41:00,0,2209.0,1613.0,0.73,10.491,186,110,62,48,76,43,33,111,0.0,0.0
1016,818,2020-03-18 03:44:00,0,1924.0,1419.0,0.737,9.151,64,38,4,34,26,7,19,10,0.0,0.0
1016,819,2020-03-18 03:47:00,0,1994.0,1490.0,0.747,9.508,22,3,1,2,19,1,18,0,0.0,0.0
1016,820,2020-03-18 03:50:00,0,1864.0,1392.0,0.747,8.886,8,3,0,3,5,0,5,0,0.0,0.0
1016,821,2020-03-18 03:53:00,0,1870.0,1392.0,0.744,8.909,22,15,9,6,7,3,4,0,0.0,0.0
1016,822,2020-03-18 03:56:00,0,1720.0,1308.0,0.76,8.226,1,1,0,1,0,0,0,0,0.0,0.0
1016,823,2020-03-18 03:59:00,0,1650.0,1228.0,0.744,7.861,396,221,168,53,175,128,47,3,0.0,0.0
1016,824,2020-03-18 04:02:00,0,1792.0,1343.0,0.749,8.548,520,304,247,57,216,168,48,196,0.0,0.0
1016,825,2020-03-18 04:05:00,0,1635.0,1308.0,0.8,7.889,382,231,193,38,151,112,39,171,0.0,0.02
1016,826,2020-03-18 04:08:00,0,1998.0,1494.0,0.748,9.527,265,165,107,58,100,51,49,91,0.0,0.0
1016,827,2020-03-18 04:11:00,0,2353.0,1700.0,0.722,11.155,181,85,42,43,96,36,60,70,0.0,0.0
1016,828,2020-03-18 04:14:00,0,1863.0,1350.0,0.725,8.837,475,300,225,75,175,113,62,7,0.0,0.0
1016,829,2020-03-18 04:17:00,0,1981.0,1501.0,0.758,9.467,482,289,225,64,193,121,72,109,0.13,0.01
1016,830,2020-03-18 04:20:00,0,1638.0,1277.0,0.78,7.867,84,52,31,21,32,2,30,29,0.0,0.0
1016,831,2020-03-18 04:23:00,0,1997.0,1500.0,0.751,9.53,52,23,4,19,29,11,18,17,0.0,0.0
1016,832,2020-03-18 04:26:00,0,1968.0,1561.0,0.793,9.484,19,19,1,18,0,0,0,1,0.0,0.0
1016,833,2020-03-18 04:29:00,0,1877.0,1370.0,0.73,8.912,0,0,0,0,0,0,0,0,0.0,0.0
1016,834,2020-03-18 04:32:00,0,1649.0,1272.0,0.771,7.906,14,9,3,6,5,1,4,0,0.0,0.0
1016,835,2020-03-18 04:35:00,0,1707.0,1301.0,0.762,8.164,500,311,237,74,189,131,58,11,0.0,0.0
1016,836,2020-03-18 04:38:00,0,1863.0,1384.0,0.743,8.874,409,202,149,53,207,147,60,45,0.0,0.0
1016,837,2020-03-18 04:41:00,0,1857.0,1404.0,0.756,8.869,421,246,186,60,175,126,49,9,0.0,0.0
1016,838,2020-03-18 04:44:00,0,1992.0,1469.0,0.737,9.475,524,321,257,64,203,146,57,116,0.0,0.0
1016,839,2020-03-18 04:47:00,0,1996.0,1485.0,0.744,9.507,174,98,62,36,76,37,39,84,0.0,0.0
1016,840,2020-03-18 04:50:00,0,1656.0,1242.0,0.75,7.899,58,21,7,14,37,4,33,8,0.0,0.0
1016,841,2020-03-18 04:53:00,0,1873.0,1338.0,0.715,8.861,15,0,0,0,15,0,15,6,0.0,0.0
1016,842,2020-03-18 04:56:00,0,1649.0,1256.0,0.761,7.889,3,0,0,0,3,0,3,0,0.0,0.01
1016,843,2020-03-18 04:59:00,0,1511.0,1160.0,0.768,7.236,6,4,1,3,2,1,1,0,0.0,0.0
1016,844,2020-03-18 05:02:00,0,1533.0,1072.0,0.699,7.227,0,0,0,0,0,0,0,0,0.0,0.0
1016,845,2020-03-18 05:05:00,0,1517.0,1124.0,0.741,7.22,0,0,0,0,0,0,0,0,0.0,0.0
1016,846,2020-03-18 05:08:00,0,1510.0,1104.0,0.731,7.17,0,0,0,0,0,0,0,0,0.0,0.0
1016,847,2020-03-18 05:11:00,0,1514.0,1135.0,0.749,7.222,0,0,0,0,0,0,0,0,0.0,0.0
1016,848,2020-03-18 05:14:00,0,1525.0,1109.0,0.727,7.238,21,13,8,5,8,0,8,0,0.0,0.0
1016,849,2020-03-18 05:17:00,0,1518.0,1140.0,0.751,7.245,6,6,2,4,0,0,0,0,0.0,0.0
1016,850,2020-03-18 05:20:00,0,1535.0,1064.0,0.693,7.225,3,1,0,1,2,1,1,0,0.0,0.0
1016,851,2020-03-18 05:23:00,0,1383.0,1025.0,0.741,6.585,3,0,0,0,3,0,3,0,0.0,0.0
1016,852,2020-03-18 05:26:00,0,1537.0,1068.0,0.695,7.237,6,6,1,5,0,0,0,0,0.0,0.0
1016,853,2020-03-18 05:29:00,0,1532.0,1035.0,0.675,7.182,2,1,0,1,1,0,1,0,0.0,0.0
1016,854,2020-03-18 05:32:00,0,1541.0,1032.0,0.67,7.216,22,17,10,7,5,0,5,0,0.0,0.0
1016,855,2020-03-18 05:35:00,0,1532.5,1042.5,0.6805,7.194,7,7,0,7,0,0,0,0,0.0,0.0
1016,856,2020-03-18 05:38:00,0,1524.0,1053.0,0.691,7.172,4,4,0,4,0,0,0,0,0.0,0.0
1016,857,2020-03-18 05:41:00,0,1539.0,1048.0,0.681,7.225,6,6,0,6,0,0,0,0,0.0,0.0
1016,858,2020-03-18 05:44:00,0,1539.0,1068.0,0.694,7.246,7,7,0,7,0,0,0,0,0.0,0.0
1016,859,2020-03-18 05:47:00,0,1535.0,1039.0,0.677,7.2,11,11,0,11,0,0,0,0,0.0,0.0
1016,860,2020-03-18 05:50:00,0,1529.0,1076.0,0.704,7.218,1,1,0,1,0,0,0,0,0.0,0.0
1016,861,2020-03-18 05:53:00,0,1530.0,1071.0,0.7,7.216,0,0,0,0,0,0,0,0,0.0,0.0
1016,862,2020-03-18 05:56:00,0,1379.0,1049.0,0.761,6.593,32,26,15,11,6,2,4,0,0.0,0.0
1016,863,2020-03-18 05:59:00,0,1443.0,1051.0,0.728,6.85,21,19,7,12,2,0,2,0,0.0,0.0
1016,864,2020-03-18 06:02:00,1,1526.0,1088.0,0.713,7.217,28,12,7,5,16,7,9,0,0.0,0.0
1016,865,2020-03-18 06:05:00,1,1526.0,1118.0,0.732,7.249,0,0,0,0,0,0,0,0,0.0,0.0
1016,866,2020-03-18 06:08:00,1,1524.0,1112.0,0.73,7.237,2,0,0,0,2,0,2,0,0.0,0.0
1016,867,2020-03-18 06:11:00,1,1531.0,1097.0,0.717,7.246,38,19,3,16,19,1,18,0,0.0,0.0
1016,868,2020-03-18 06:14:00,1,1533.0,1064.0,0.694,7.219,231,134,97,37,97,67,30,35,0.0,0.0
1016,869,2020-03-18 06:17:00,1,1798.0,1295.0,0.72,8.519,216,116,76,40,100,53,47,77,0.0,0.0
1016,870,2020-03-18 06:20:00,1,1862.0,1406.0,0.755,8.891,368,196,145,51,172,135,37,138,0.0,0.0
1016,871,2020-03-18 06:23:00,1,2003.0,1511.0,0.754,9.565,367,218,177,41,149,112,37,276,0.0,0.01
1016,872,2020-03-18 06:26:00,1,2219.0,1608.0,0.725,10.522,452,304,251,53,148,116,32,248,0.0,0.0
1016,873,2020-03-18 06:29:00,1,2049.0,1546.0,0.755,9.784,315,192,140,52,123,87,36,100,0.0,0.0
1016,874,2020-03-18 06:32:00,1,1802.0,1308.0,0.726,8.548,407,226,171,55,181,129,52,90,0.0,0.0
1016,875,2020-03-18 06:35:00,1,2139.0,1598.0,0.747,10.197,385,240,183,57,145,109,36,174,0.0,0.01
1016,876,2020-03-18 06:38:00,1,2014.0,1470.0,0.73,9.562,411,201,146,55,210,153,57,25,0.0,0.02
1016,877,2020-03-18 06:41:00,1,2135.0,1581.0,0.74,10.162,316,191,152,39,125,99,26,109,0.12,0.0
1016,878,2020-03-18 06:44:00,1,1668.0,1213.0,0.727,7.916,70,48,26,22,22,8,14,45,0.0,0.0
1016,879,2020-03-18 06:47:00,1,1797.0,1318.0,0.734,8.538,163,100,52,48,63,39,24,10,0.0,0.0
1016,880,2020-03-18 06:50:00,1,2009.0,1458.0,0.726,9.529,430,226,192,34,204,152,52,78,0.0,0.02
1016,881,2020-03-18 06:53:00,1,1835.0,1412.0,0.77,8.793,486,327,266,61,159,100,59,1,0.0,0.0
1016,882,2020-03-18 06:56:00,1,2008.0,1461.0,0.728,9.529,286,146,94,52,140,99,41,25,0.0,0.0
1016,883,2020-03-18 06:59:00,1,1932.0,1428.0,0.739,9.192,508,278,218,60,230,164,66,35,0.0,0.0
1016,884,2020-03-18 07:02:00,1,1946.0,1449.0,0.745,9.27,91,52,31,21,39,23,16,50,0.0,0.0
1016,885,2020-03-18 07:05:00,1,1855.0,1362.0,0.734,8.816,37,23,11,12,14,4,10,22,0.0,0.0
1016,886,2020-03-18 07:08:00,1,1792.0,1325.0,0.739,8.529,36,26,0,26,10,2,8,6,0.0,0.0
1016,887,2020-03-18 07:11:00,1,1651.0,1267.0,0.767,7.907,227,145,101,44,82,47,35,3,0.0,0.0
1016,888,2020-03-18 07:14:00,1,1657.0,1259.0,0.76,7.924,236,121,84,37,115,81,34,0,0.0,0.0
1016,889,2020-03-18 07:17:00,1,1660.0,1219.0,0.735,7.891,5,4,0,4,1,0,1,0,0.0,0.0
1016,890,2020-03-18 07:20:00,1,1538.0,1056.0,0.687,7.23,0,0,0,0,0,0,0,0,0.0,0.0
1016,891,2020-03-18 07:23:00,1,1390.0,979.0,0.704,6.561,0,0,0,0,0,0,0,0,0.0,0.0
1016,892,2020-03-18 07:26:00,1,1395.0,974.0,0.698,6.573,0,0,0,0,0,0,0,0,0.0,0.0
1016,893,2020-03-18 07:29:00,1,1386.0,1007.0,0.726,6.577,2,0,0,0,2,1,1,0,0.0,0.0
1016,894,2020-03-18 07:32:00,1,1526.0,1082.0,0.709,7.212,0,0,0,0,0,0,0,0,0.0,0.0
1016,895,2020-03-18 07:35:00,1,1526.0,1093.0,0.716,7.224,0,0,0,0,0,0,0,0,0.0,0.0
1016,896,2020-03-18 07:38:00,1,1529.0,1102.0,0.721,7.246,22,18,1,17,4,2,2,0,0.0,0.0
1016,897,2020-03-18 07:41:00,1,1517.0,1124.0,0.741,7.222,3,3,0,3,0,0,0,0,0.0,0.0
1016,898,2020-03-18 07:44:00,1,1518.0,1124.0,0.741,7.224,4,4,0,4,0,0,0,0,0.0,0.0
1016,899,2020-03-18 07:47:00,1,1527.0,1103.0,0.722,7.239,0,0,0,0,0,0,0,0,0.0,0.0
1016,900,2020-03-18 07:50:00,1,1666.0,1203.0,0.722,7.897,2,2,1,1,0,0,0,0,0.0,0.0
1016,901,2020-03-18 07:53:00,1,1596.0,1159.0,0.726,7.573,0,0,0,0,0,0,0,0,0.0,0.0
1016,902,2020-03-18 07:56:00,1,1527.0,1113.0,0.729,7.248,0,0,0,0,0,0,0,0,0.0,0.0
1016,903,2020-03-18 07:59:00,1,1534.0,1071.0,0.698,7.23,5,4,0,4,1,0,1,0,0.0,0.0
1016,904,2020-03-18 08:02:00,1,1523.0,1092.0,0.717,7.21,14,14,0,14,0,0,0,0,0.0,0.0
1016,905,2020-03-18 08:05:00,1,1530.0,1118.0,0.73,7.267,14,11,1,10,3,0,3,0,0.0,0.0
1016,906,2020-03-18 08:08:00,1,1520.0,1120.0,0.737,7.229,9,2,0,2,7,0,7,0,0.0,0.0
1016,907,2020-03-18 08:11:00,1,1518.0,1094.0,0.721,7.193,20,13,4,9,7,5,2,0,0.0,0.0
1016,908,2020-03-18 08:14:00,1,1544.0,1086.0,0.703,7.287,11,11,0,11,0,0,0,0,0.0,0.0
1016,909,2020-03-18 08:17:00,1,1445.0,1048.0,0.726,6.853,23,23,0,23,0,0,0,0,0.0,0.0
1016,910,2020-03-18 08:20:00,1,1525.0,1113.0,0.73,7.242,0,0,0,0,0,0,0,0,0.0,0.0
1016,911,2020-03-18 08:23:00,1,1531.0,1120.0,0.731,7.273,2,2,0,2,0,0,0,0,0.0,0.0
1016,912,2020-03-18 08:26:00,1,1855.0,1387.0,0.748,8.842,419,228,180,48,191,134,57,29,0.37,0.0
1016,913,2020-03-18 08:29:00,1,2194.0,1700.0,0.775,10.526,277,168,113,55,109,83,26,55,0.0,0.0
1016,914,2020-03-18 08:32:00,1,2282.0,1709.0,0.749,10.883,196,141,95,46,55,29,26,27,0.01,0.01
1016,915,2020-03-18 08:35:00,1,2072.5,1539.5,0.742,9.8705,12,6,0,6,6,3,3,0,0.0,0.01
1016,916,2020-03-18 08:38:00,1,1863.0,1370.0,0.735,8.858,7,4,0,4,3,1,2,0,0.0,0.0
1016,917,2020-03-18 08:41:00,1,1663.0,1213.0,0.729,7.894,0,0,0,0,0,0,0,0,0.01,0.04
1016,918,2020-03-18 08:44:00,1,1722.0,1240.0,0.72,8.156,22,14,5,9,8,3,5,0,0.0,0.0
1016,919,2020-03-18 08:47:00,1,1642.0,1218.0,0.742,7.817,2,2,0,2,0,0,0,0,0.0,0.0
1016,920,2020-03-18 08:50:00,1,1646.0,1239.0,0.753,7.857,1,1,0,1,0,0,0,0,0.0,0.0
1016,921,2020-03-18 08:53:00,1,1662.0,1180.0,0.71,7.855,6,6,1,5,0,0,0,0,0.0,0.0
1016,922,2020-03-18 08:56:00,1,1521.0,1113.0,0.732,7.225,3,2,1,1,1,0,1,0,0.0,0.0
1016,923,2020-03-18 08:59:00,1,1545.0,1051.0,0.68,7.251,4,0,0,0,4,0,4,0,0.01,0.0
1016,924,2020-03-18 09:02:00,1,1508.0,1118.0,0.741,7.181,8,2,1,1,6,0,6,0,0.01,0.0
1016,925,2020-03-18 09:05:00,1,1507.0,1114.0,0.739,7.173,81,68,53,15,13,2,11,0,0.0,0.0
1016,926,2020-03-18 09:08:00,1,1671.0,1195.0,0.715,7.905,0,0,0,0,0,0,0,0,0.0,0.0
1016,927,2020-03-18 09:11:00,1,1521.0,1122.0,0.738,7.236,0,0,0,0,0,0,0,0,0.0,0.0
1016,928,2020-03-18 09:14:00,1,1540.0,1048.0,0.68,7.23,2,2,0,2,0,0,0,0,0.0,0.0
1016,929,2020-03-18 09:17:00,1,1530.0,1058.0,0.692,7.198,0,0,0,0,0,0,0,0,0.0,0.0
1016,930,2020-03-18 09:20:00,1,1549.0,1021.0,0.659,7.233,2,2,0,2,0,0,0,0,0.0,0.0
1016,931,2020-03-18 09:23:00,1,1398.0,991.0,0.709,6.606,55,32,12,20,23,5,18,13,0.0,0.0
1016,932,2020-03-18 09:26:00,1,1660.0,1226.0,0.738,7.898,102,75,46,29,27,15,12,63,0.0,0.0
1016,933,2020-03-18 09:29:00,1,2073.0,1517.0,0.732,9.849,223,125,93,32,98,66,32,89,0.0,0.16
1016,934,2020-03-18 09:32:00,1,2225.0,1624.0,0.73,10.564,363,172,135,37,191,138,53,131,0.14,0.04
1016,935,2020-03-18 09:35:00,1,1979.0,1543.0,0.78,9.505,182,106,76,30,76,46,30,46,0.0,0.0
1016,936,2020-03-18 09:38:00,1,2131.0,1606.0,0.753,10.174,448,252,189,63,196,141,55,93,0.0,0.0
1016,937,2020-03-18 09:41:00,1,2134.0,1631.0,0.764,10.214,90,79,48,31,11,2,9,26,0.0,0.0
1016,938,2020-03-18 09:44:00,1,1978.0,1612.0,0.815,9.579,66,46,28,18,20,1,19,6,0.0,0.0
1016,939,2020-03-18 09:47:00,1,1976.0,1549.0,0.784,9.501,26,18,8,10,8,0,8,0,0.0,0.0
1016,940,2020-03-18 09:50:00,1,1772.0,1414.0,0.798,8.546,5,0,0,0,5,0,5,0,0.0,0.0
1016,941,2020-03-18 09:53:00,1,1632.0,1320.0,0.809,7.891,0,0,0,0,0,0,0,0,0.0,0.0
1016,942,2020-03-18 09:56:00,1,1648.0,1278.0,0.776,7.907,0,0,0,0,0,0,0,0,0.0,0.0
1016,943,2020-03-18 09:59:00,1,1490.0,1262.0,0.847,7.267,4,1,1,0,3,0,3,0,0.0,0.0
1016,944,2020-03-18 10:02:00,1,1479.0,1270.0,0.859,7.235,5,2,1,1,3,1,2,0,0.0,0.0
1016,945,2020-03-18 10:05:00,1,1562.0,1267.0,0.811,7.558,0,0,0,0,0,0,0,0,0.0,0.0
1016,946,2020-03-18 10:08:00,1,1625.0,1325.0,0.816,7.869,0,0,0,0,0,0,0,0,0.0,0.0
1016,947,2020-03-18 10:11:00,1,1566.0,1289.0,0.823,7.598,2,2,1,1,0,0,0,0,0.0,0.0
1016,948,2020-03-18 10:14:00,1,1633.0,1334.0,0.817,7.91,4,4,0,4,0,0,0,0,0.0,0.0
1016,949,2020-03-18 10:17:00,1,1623.0,1343.0,0.827,7.881,0,0,0,0,0,0,0,0,0.0,0.0
1016,950,2020-03-18 10:20:00,1,1631.0,1350.0,0.827,7.922,10,5,4,1,5,2,3,0,0.0,0.0
1016,951,2020-03-18 10:23:00,1,1631.0,1324.0,0.811,7.894,0,0,0,0,0,0,0,0,0.0,0.0
1016,952,2020-03-18 10:26:00,1,1641.0,1281.0,0.781,7.883,2,2,0,2,0,0,0,0,0.0,0.0
1016,953,2020-03-18 10:29:00,1,1642.0,1274.0,0.776,7.879,21,10,3,7,11,4,7,0,0.0,0.0
1016,954,2020-03-18 10:32:00,1,1518.0,1166.0,0.768,7.273,13,5,1,4,8,0,8,0,0.0,0.0
1016,955,2020-03-18 10:35:00,1,1503.0,1139.0,0.758,7.181,4,1,0,1,3,0,3,0,0.0,0.0
1016,956,2020-03-18 10:38:00,1,1507.0,1165.0,0.773,7.226,4,0,0,0,4,0,4,0,0.0,0.0
1016,957,2020-03-18 10:41:00,1,1530.0,1117.0,0.73,7.265,6,3,0,3,3,0,3,0,0.0,0.0
1016,958,2020-03-18 10:44:00,1,1507.0,1195.0,0.793,7.259,18,13,0,13,5,0,5,0,0.0,0.0
1016,959,2020-03-18 10:47:00,1,1568.0,1201.0,0.766,7.507,9,4,3,1,5,4,1,0,0.0,0.0
1016,960,2020-03-18 10:50:00,1,1504.0,1176.0,0.782,7.227,2,2,1,1,0,0,0,0,0.0,0.0
1016,961,2020-03-18 10:53:00,1,1648.0,1253.0,0.76,7.88,2,1,1,0,1,1,0,0,0.0,0.0
1016,962,2020-03-18 10:56:00,1,1648.0,1258.0,0.763,7.886,25,20,7,13,5,0,5,2,0.0,0.0
1016,963,2020-03-18 10:59:00,1,1778.0,1338.0,0.753,8.486,152,77,52,25,75,48,27,13,0.0,0.0
1016,964,2020-03-18 11:02:00,1,1988.0,1520.0,0.764,9.517,287,156,113,43,131,91,40,114,0.0,0.08
1016,965,2020-03-18 11:05:00,1,2342.0,1789.0,0.764,11.207,634,344,268,76,290,217,73,52,0.1,0.0
1016,966,2020-03-18 11:08:00,1,1981.0,1589.0,0.802,9.565,277,163,126,37,114,83,31,133,0.0,0.0
1016,967,2020-03-18 11:11:00,1,1977.0,1614.0,0.817,9.577,471,233,179,54,238,175,63,24,0.13,0.0
1016,968,2020-03-18 11:14:00,1,1976.0,1632.0,0.826,9.592,572,336,271,65,236,161,75,69,0.0,0.02
1016,969,2020-03-18 11:17:00,1,2169.0,1705.0,0.786,10.434,201,123,82,41,78,57,21,43,0.07,0.03
1016,970,2020-03-18 11:20:00,1,2034.0,1660.0,0.816,9.851,486,294,220,74,192,128,64,3,0.0,0.0
1016,971,2020-03-18 11:23:00,1,1957.0,1671.0,0.854,9.56,339,172,117,55,167,131,36,63,0.0,0.0
1016,972,2020-03-18 11:26:00,1,1968.0,1628.0,0.827,9.557,48,32,2,30,16,8,8,22,0.0,0.0
1016,973,2020-03-18 11:29:00,1,1953.0,1617.0,0.828,9.484,39,22,10,12,17,0,17,0,0.0,0.0
1016,974,2020-03-18 11:32:00,1,1830.0,1517.0,0.829,8.891,2,0,0,0,2,0,2,0,0.0,0.0
1016,975,2020-03-18 11:35:00,1,1656.0,1386.5,0.8385,8.06,0,0,0,0,0,0,0,0,0.0,0.0
1016,976,2020-03-18 11:38:00,1,1482.0,1256.0,0.848,7.229,14,10,4,6,4,2,2,0,0.0,0.0
1016,977,2020-03-18 11:41:00,1,1636.0,1288.0,0.787,7.873,0,0,0,0,0,0,0,0,0.0,0.0
1016,978,2020-03-18 11:44:00,1,1506.0,1215.0,0.807,7.278,0,0,0,0,0,0,0,0,0.0,0.0
1016,979,2020-03-18 11:47:00,1,1484.0,1259.0,0.849,7.242,0,0,0,0,0,0,0,0,0.0,0.0
1016,980,2020-03-18 11:50:00,1,1640.0,1277.0,0.779,7.877,5,3,1,2,2,0,2,0,0.0,0.0
1016,981,2020-03-18 11:53:00,1,1643.0,1280.0,0.779,7.889,3,2,0,2,1,0,1,0,0.0,0.0
1016,982,2020-03-18 11:56:00,1,1640.0,1285.0,0.784,7.886,4,3,0,3,1,0,1,0,0.0,0.0
1016,983,2020-03-18 11:59:00,1,1647.0,1287.0,0.782,7.914,3,1,0,1,2,1,1,0,0.0,0.0
1016,984,2020-03-18 12:02:00,1,1642.0,1271.0,0.774,7.875,22,12,1,11,10,0,10,0,0.0,0.0
1016,985,2020-03-18 12:05:00,1,1641.0,1272.0,0.775,7.873,27,10,0,10,17,0,17,0,0.0,0.0
1016,986,2020-03-18 12:08:00,1,1626.0,1345.0,0.827,7.896,16,9,3,6,7,1,6,0,0.0,0.0
1016,987,2020-03-18 12:11:00,1,1493.0,1203.0,0.806,7.213,4,3,2,1,1,0,1,0,0.0,0.0
1016,988,2020-03-18 12:14:00,1,1495.0,1247.0,0.834,7.269,1,0,0,0,1,0,1,0,0.0,0.0
1016,989,2020-03-18 12:17:00,1,1645.0,1292.0,0.785,7.914,2,0,0,0,2,0,2,0,0.0,0.0
1016,990,2020-03-18 12:20:00,1,1642.0,1240.0,0.755,7.841,19,0,0,0,19,0,19,0,0.0,0.0
1016,991,2020-03-18 12:23:00,1,1646.0,1283.0,0.779,7.906,6,4,1,3,2,0,2,0,0.0,0.0
1016,992,2020-03-18 12:26:00,1,1648.0,1265.0,0.767,7.893,2,2,0,2,0,0,0,0,0.0,0.0
1016,993,2020-03-18 12:29:00,1,1653.0,1213.0,0.734,7.857,49,44,4,40,5,0,5,0,0.0,0.0
1016,994,2020-03-18 12:32:00,1,1639.0,1275.0,0.778,7.871,150,123,72,51,27,9,18,7,0.0,0.0
1016,995,2020-03-18 12:35:00,1,1861.0,1381.0,0.742,8.861,12,12,8,4,0,0,0,0,0.0,0.0
1016,996,2020-03-18 12:38:00,1,1632.0,1327.0,0.813,7.901,85,49,17,32,36,8,28,4,0.0,0.0
1016,997,2020-03-18 12:41:00,1,1857.0,1388.0,0.747,8.852,167,115,67,48,52,18,34,50,0.0,0.0
1016,998,2020-03-18 12:44:00,1,2053.0,1595.0,0.777,9.853,389,215,173,42,174,126,48,67,0.1,0.07
1016,999,2020-03-18 12:47:00,1,1991.0,1498.0,0.752,9.505,540,334,264,70,206,141,65,11,0.0,0.02
1016,1000,2020-03-18 12:50:00,1,1973.0,1585.0,0.803,9.528,433,260,210,50,173,126,47,108,0.0,0.01
1016,1001,2020-03-18 12:53:00,1,1962.0,1636.0,0.834,9.541,162,90,61,29,72,43,29,26,0.0,0.0
1016,1002,2020-03-18 12:56:00,1,1957.0,1621.0,0.829,9.505,527,307,236,71,220,164,56,116,0.02,0.04
1016,1003,2020-03-18 12:59:00,1,2166.0,1730.0,0.799,10.45,400,226,169,57,174,123,51,125,0.0,0.0
1016,1004,2020-03-18 13:02:00,1,2032.0,1698.0,0.835,9.887,294,169,118,51,125,82,43,11,0.0,0.0
1016,1005,2020-03-18 13:05:00,1,1962.0,1649.0,0.841,9.556,496,273,209,64,223,159,64,2,0.0,0.0
1016,1006,2020-03-18 13:08:00,1,1810.0,1539.0,0.85,8.836,451,232,169,63,219,166,53,5,0.0,0.0
1016,1007,2020-03-18 13:11:00,1,1964.0,1603.0,0.816,9.515,13,9,4,5,4,0,4,1,0.0,0.0
1016,1008,2020-03-18 13:14:00,1,1968.0,1593.0,0.809,9.517,33,26,5,21,7,4,3,4,0.0,0.0
1016,1009,2020-03-18 13:17:00,1,1825.0,1546.0,0.847,8.904,2,2,1,1,0,0,0,0,0.0,0.0
1016,1010,2020-03-18 13:20:00,1,1691.0,1410.0,0.834,8.222,2,2,0,2,0,0,0,0,0.0,0.0
1016,1011,2020-03-18 13:23:00,1,1629.0,1328.0,0.815,7.89,12,7,2,5,5,0,5,0,0.0,0.0
1016,1012,2020-03-18 13:26:00,1,1623.0,1349.0,0.831,7.887,5,0,0,0,5,0,5,0,0.0,0.0
1016,1013,2020-03-18 13:29:00,1,1635.0,1343.0,0.821,7.928,8,7,5,2,1,0,1,0,0.0,0.0
1016,1014,2020-03-18 13:32:00,1,1640.0,1312.0,0.8,7.915,0,0,0,0,0,0,0,0,0.0,0.0
1016,1015,2020-03-18 13:35:00,1,1646.0,1288.0,0.783,7.911,4,2,0,2,2,2,0,0,0.0,0.0
1016,1016,2020-03-18 13:38:00,1,1575.0,1259.0,0.799,7.598,19,18,8,10,1,1,0,0,0.0,0.0
1016,1017,2020-03-18 13:41:00,1,1644.0,1264.0,0.769,7.875,24,24,3,21,0,0,0,0,0.0,0.0
1016,1018,2020-03-18 13:44:00,1,1569.0,1250.0,0.796,7.566,51,47,12,35,4,1,3,0,0.0,0.0
1016,1019,2020-03-18 13:47:00,1,1651.0,1258.0,0.762,7.898,0,0,0,0,0,0,0,0,0.0,0.0
1016,1020,2020-03-18 13:50:00,1,1642.0,1302.0,0.793,7.911,0,0,0,0,0,0,0,0,0.0,0.0
1016,1021,2020-03-18 13:53:00,1,1645.0,1286.0,0.782,7.904,1,1,1,0,0,0,0,0,0.0,0.0
1016,1022,2020-03-18 13:56:00,1,1628.0,1302.0,0.8,7.855,7,5,0,5,2,1,1,0,0.0,0.0
1016,1023,2020-03-18 13:59:00,1,1649.0,1258.0,0.763,7.89,0,0,0,0,0,0,0,0,0.0,0.0
1016,1024,2020-03-18 14:02:00,1,1658.0,1244.0,0.75,7.909,0,0,0,0,0,0,0,0,0.0,0.0
1016,1025,2020-03-18 14:05:00,1,1654.0,1211.0,0.732,7.857,4,0,0,0,4,0,4,0,0.0,0.0
1016,1026,2020-03-18 14:08:00,1,1662.0,1223.0,0.736,7.901,20,16,9,7,4,2,2,0,0.0,0.0
1016,1027,2020-03-18 14:11:00,1,1659.0,1236.0,0.745,7.907,28,28,0,28,0,0,0,0,0.0,0.0
1016,1028,2020-03-18 14:14:00,1,1644.0,1277.0,0.776,7.893,14,13,0,13,1,0,1,0,0.0,0.0
1016,1029,2020-03-18 14:17:00,1,1655.0,1241.0,0.75,7.894,1,1,0,1,0,0,0,0,0.0,0.0
1016,1030,2020-03-18 14:20:00,1,1664.0,1230.0,0.739,7.919,20,20,0,20,0,0,0,0,0.0,0.0
1016,1031,2020-03-18 14:23:00,1,1669.0,1210.0,0.725,7.915,5,5,0,5,0,0,0,0,0.0,0.0
1016,1032,2020-03-18 14:26:00,1,1659.0,1240.0,0.747,7.909,6,6,0,6,0,0,0,0,0.0,0.0
1016,1033,2020-03-18 14:29:00,1,1636.0,1285.0,0.786,7.868,85,68,21,47,17,4,13,13,0.0,0.0
1016,1034,2020-03-18 14:32:00,1,1857.0,1428.0,0.769,8.897,160,123,79,44,37,20,17,68,0.0,0.02
1016,1035,2020-03-18 14:35:00,1,1862.5,1411.0,0.7575,8.9005,318,179,141,38,139,110,29,54,0.0,0.08
1016,1036,2020-03-18 14:38:00,1,1868.0,1394.0,0.746,8.904,123,106,79,27,17,4,13,11,0.0,0.0
1016,1037,2020-03-18 14:41:00,1,1992.0,1563.0,0.785,9.58,120,97,61,36,23,5,18,7,0.0,0.0
1016,1038,2020-03-18 14:44:00,1,2035.0,1675.0,0.823,9.871,29,23,5,18,6,0,6,2,0.0,0.0
1016,1039,2020-03-18 14:47:00,1,1950.0,1663.0,0.853,9.523,43,36,13,23,7,1,6,0,0.0,0.0
1016,1040,2020-03-18 14:50:00,1,1964.0,1646.0,0.838,9.561,20,16,5,11,4,0,4,0,0.0,0.0
1016,1041,2020-03-18 14:53:00,1,1834.0,1521.0,0.83,8.911,5,5,2,3,0,0,0,0,0.0,0.0
1016,1042,2020-03-18 14:56:00,1,1840.0,1474.0,0.801,8.881,7,0,0,0,7,0,7,0,0.0,0.0
1016,1043,2020-03-18 14:59:00,1,1761.0,1445.0,0.821,8.541,20,9,3,6,11,0,11,0,0.0,0.0
1016,1044,2020-03-18 15:02:00,1,1837.0,1492.0,0.812,8.89,5,4,0,4,1,0,1,0,0.0,0.0
1016,1045,2020-03-18 15:05:00,1,1603.0,1406.0,0.877,7.872,1,1,0,1,0,0,0,0,0.0,0.0
1016,1046,2020-03-18 15:08:00,1,1623.0,1337.0,0.824,7.873,10,10,1,9,0,0,0,0,0.0,0.0
1016,1047,2020-03-18 15:11:00,1,1493.0,1239.0,0.83,7.256,3,3,0,3,0,0,0,0,0.0,0.0
1016,1048,2020-03-18 15:14:00,1,1624.0,1397.0,0.86,7.947,1,1,0,1,0,0,0,0,0.0,0.0
1016,1049,2020-03-18 15:17:00,1,1834.0,1455.0,0.793,8.838,1,1,0,1,0,0,0,0,0.0,0.0
1016,1050,2020-03-18 15:20:00,1,1837.0,1477.0,0.804,8.874,96,62,41,21,34,21,13,4,0.0,0.0
1016,1051,2020-03-18 15:23:00,1,2113.0,1675.0,0.793,10.181,132,86,50,36,46,28,18,41,0.09,0.09
1016,1052,2020-03-18 15:26:00,1,1990.0,1558.0,0.783,9.566,116,65,33,32,51,27,24,5,0.0,0.01
1016,1053,2020-03-18 15:29:00,1,1946.0,1636.0,0.841,9.478,46,22,7,15,24,4,20,1,0.0,0.01
1016,1054,2020-03-18 15:32:00,1,1956.0,1675.0,0.856,9.562,35,29,3,26,6,0,6,0,0.0,0.0
1016,1055,2020-03-18 15:35:00,1,1950.0,1694.0,0.869,9.56,22,10,6,4,12,2,10,0,0.0,0.0
1016,1056,2020-03-18 15:38:00,1,1814.0,1564.0,0.862,8.877,2,0,0,0,2,0,2,0,0.0,0.0
1016,1057,2020-03-18 15:41:00,1,1751.0,1493.0,0.853,8.552,7,2,0,2,5,0,5,0,0.0,0.0
1016,1058,2020-03-18 15:44:00,1,1823.0,1529.0,0.839,8.876,2,0,0,0,2,0,2,0,0.0,0.0
1016,1059,2020-03-18 15:47:00,1,1804.0,1557.0,0.863,8.83,11,3,1,2,8,3,5,0,0.0,0.0
1016,1060,2020-03-18 15:50:00,1,1821.0,1549.0,0.85,8.891,0,0,0,0,0,0,0,0,0.0,0.0
1016,1061,2020-03-18 15:53:00,1,1826.0,1506.0,0.825,8.863,12,12,2,10,0,0,0,0,0.0,0.0
1016,1062,2020-03-18 15:56:00,1,1753.0,1483.0,0.846,8.548,25,11,0,11,14,1,13,0,0.0,0.0
1016,1063,2020-03-18 15:59:00,1,1824.0,1481.0,0.812,8.825,28,9,6,3,19,6,13,0,0.0,0.0
1016,1064,2020-03-18 16:02:00,1,1840.0,1501.0,0.815,8.913,3,0,0,0,3,0,3,0,0.0,0.0
1016,1065,2020-03-18 16:05:00,1,1682.0,1465.0,0.871,8.248,1,0,0,0,1,0,1,0,0.0,0.0
1016,1066,2020-03-18 16:08:00,1,1832.0,1538.0,0.84,8.921,29,27,12,15,2,0,2,0,0.0,0.0
1016,1067,2020-03-18 16:11:00,1,1839.0,1477.0,0.803,8.882,22,22,9,13,0,0,0,0,0.0,0.0
1016,1068,2020-03-18 16:14:00,1,1847.0,1456.0,0.788,8.891,9,9,3,6,0,0,0,0,0.0,0.0
1016,1069,2020-03-18 16:17:00,1,1765.0,1433.0,0.812,8.542,158,89,65,24,69,47,22,11,0.0,0.0
1016,1070,2020-03-18 16:20:00,1,1827.0,1473.0,0.806,8.829,16,4,1,3,12,1,11,0,0.0,0.0
1016,1071,2020-03-18 16:23:00,1,1698.0,1417.0,0.835,8.258,2,2,0,2,0,0,0,0,0.0,0.0
1016,1072,2020-03-18 16:26:00,1,1690.0,1382.0,0.818,8.187,2,2,1,1,0,0,0,0,0.0,0.0
1016,1073,2020-03-18 16:29:00,1,1839.0,1480.0,0.805,8.884,151,113,64,49,38,5,33,16,0.0,0.0
1016,1074,2020-03-18 16:32:00,1,2049.0,1653.0,0.807,9.905,120,63,18,45,57,14,43,68,0.0,0.14
1016,1075,2020-03-18 16:35:00,1,2169.0,1755.0,0.809,10.49,407,246,186,60,161,115,46,84,0.12,0.09
1016,1076,2020-03-18 16:38:00,1,1983.0,1562.0,0.788,9.541,370,230,182,48,140,105,35,159,0.0,0.01
1016,1077,2020-03-18 16:41:00,1,2446.0,2029.0,0.829,11.883,364,243,196,47,121,89,32,199,0.0,0.0
1016,1078,2020-03-18 16:44:00,1,2150.0,1843.0,0.857,10.509,333,188,145,43,145,98,47,139,0.0,0.0
1016,1079,2020-03-18 16:47:00,1,1849.0,1435.0,0.776,8.874,18,11,4,7,7,1,6,72,0.0,0.0
1016,1080,2020-03-18 16:50:00,1,2302.0,1923.0,0.835,11.2,41,24,3,21,17,2,15,76,0.0,0.0
1016,1081,2020-03-18 16:53:00,1,2146.0,1877.0,0.875,10.532,78,44,20,24,34,0,34,93,0.0,0.0
1016,1082,2020-03-18 16:56:00,1,2160.0,1849.0,0.856,10.558,63,41,18,23,22,0,22,66,0.0,0.0
1016,1083,2020-03-18 16:59:00,1,1939.0,1661.0,0.856,9.477,3,2,1,1,1,0,1,76,0.0,0.0
1016,1084,2020-03-18 17:02:00,1,1819.0,1532.0,0.842,8.864,3,0,0,0,3,0,3,73,0.0,0.0
1016,1085,2020-03-18 17:05:00,1,1607.0,1414.0,0.88,7.899,0,0,0,0,0,0,0,79,0.0,0.0
1016,1086,2020-03-18 17:08:00,1,1625.0,1357.0,0.835,7.906,9,9,0,9,0,0,0,57,0.0,0.0
1016,1087,2020-03-18 17:11:00,1,1537.0,1351.0,0.879,7.551,0,0,0,0,0,0,0,81,0.0,0.0
1016,1088,2020-03-18 17:14:00,1,1673.0,1465.0,0.875,8.215,0,0,0,0,0,0,0,67,0.0,0.0
1016,1089,2020-03-18 17:17:00,1,1682.0,1469.0,0.874,8.255,0,0,0,0,0,0,0,53,0.0,0.0
1016,1090,2020-03-18 17:20:00,1,1678.0,1466.0,0.874,8.237,6,3,1,2,3,1,2,54,0.0,0.0
1016,1091,2020-03-18 17:23:00,1,1611.0,1432.0,0.889,7.933,3,1,0,1,2,0,2,59,0.0,0.0
1016,1092,2020-03-18 17:26:00,1,1601.0,1393.0,0.87,7.849,21,3,1,2,18,0,18,53,0.0,0.0
1016,1093,2020-03-18 17:29:00,1,1681.0,1442.0,0.857,8.221,5,4,3,1,1,0,1,45,0.0,0.0
1016,1094,2020-03-18 17:32:00,1,1503.0,1202.0,0.8,7.253,1,1,0,1,0,0,0,68,0.0,0.0
1016,1095,2020-03-18 17:35:00,1,1595.0,1327.5,0.8305,7.754,0,0,0,0,0,0,0,83,0.0,0.0
1016,1096,2020-03-18 17:38:00,1,1687.0,1453.0,0.861,8.255,0,0,0,0,0,0,0,77,0.0,0.0
1016,1097,2020-03-18 17:41:00,1,1840.0,1472.0,0.8,8.881,5,5,1,4,0,0,0,73,0.0,0.0
1016,1098,2020-03-18 17:44:00,1,1687.0,1431.0,0.848,8.23,7,7,1,6,0,0,0,70,0.0,0.0
1016,1099,2020-03-18 17:47:00,1,1838.0,1488.0,0.81,8.888,83,42,11,31,41,8,33,73,0.0,0.0
1016,1100,2020-03-18 17:50:00,1,1814.0,1573.0,0.867,8.891,91,60,25,35,31,1,30,79,0.0,0.0
1016,1101,2020-03-18 17:53:00,1,1970.0,1600.0,0.813,9.532,53,36,14,22,17,3,14,67,0.0,0.0
1016,1102,2020-03-18 17:56:00,1,1609.0,1418.0,0.881,7.91,12,7,3,4,5,1,4,81,0.0,0.0
1016,1103,2020-03-18 17:59:00,1,1616.0,1337.0,0.828,7.846,44,35,5,30,9,2,7,79,0.0,0.0
1016,1104,2020-03-18 18:02:00,0,1823.0,1478.0,0.811,8.818,2,2,0,2,0,0,0,81,0.0,0.0
1016,1105,2020-03-18 18:05:00,0,1839.0,1465.0,0.797,8.867,1,1,0,1,0,0,0,79,0.0,0.0
1016,1106,2020-03-18 18:08:00,0,1851.0,1444.0,0.78,8.893,1,1,0,1,0,0,0,64,0.0,0.0
1016,1107,2020-03-18 18:11:00,0,1849.0,1443.0,0.78,8.882,1,1,0,1,0,0,0,72,0.0,0.0
1016,1108,2020-03-18 18:14:00,0,1858.0,1380.0,0.742,8.85,3,0,0,0,3,1,2,55,0.0,0.0
1016,1109,2020-03-18 18:17:00,0,1862.0,1402.0,0.753,8.89,70,50,25,25,20,1,19,46,0.0,0.0
1016,1110,2020-03-18 18:20:00,0,1838.0,1469.0,0.799,8.869,235,140,103,37,95,63,32,209,0.0,0.08
1016,1111,2020-03-18 18:23:00,0,2177.0,1743.0,0.8,10.508,145,115,59,56,30,12,18,151,0.0,0.14
1016,1112,2020-03-18 18:26:00,0,1979.0,1548.0,0.782,9.511,206,153,99,54,53,35,18,86,0.0,0.0
1016,1113,2020-03-18 18:29:00,0,2168.0,1816.0,0.838,10.552,229,138,96,42,91,64,27,158,0.0,0.0
1016,1114,2020-03-18 18:32:00,0,2182.0,1780.0,0.816,10.569,86,71,27,44,15,3,12,125,0.0,0.0
1016,1115,2020-03-18 18:35:00,0,2299.0,1870.0,0.813,11.127,116,111,62,49,5,3,2,44,0.0,0.01
1016,1116,2020-03-18 18:38:00,0,2161.0,1819.0,0.841,10.529,0,0,0,0,0,0,0,46,0.0,0.0
1016,1117,2020-03-18 18:41:00,0,1809.0,1582.0,0.874,8.877,7,1,0,1,6,0,6,8,0.0,0.0
1016,1118,2020-03-18 18:44:00,0,1957.0,1690.0,0.864,9.581,0,0,0,0,0,0,0,8,0.0,0.0
1016,1119,2020-03-18 18:47:00,0,2108.0,1748.0,0.829,10.239,22,17,2,15,5,0,5,3,0.0,0.0
1016,1120,2020-03-18 18:50:00,0,1946.0,1654.0,0.85,9.499,13,11,1,10,2,0,2,18,0.0,0.0
1016,1121,2020-03-18 18:53:00,0,1952.0,1663.0,0.852,9.53,15,9,3,6,6,1,5,16,0.0,0.0
1016,1122,2020-03-18 18:56:00,0,1947.0,1707.0,0.877,9.559,82,51,18,33,31,2,29,25,0.0,0.0
1016,1123,2020-03-18 18:59:00,0,2170.0,1809.0,0.834,10.555,92,64,35,29,28,2,26,37,0.0,0.0
1016,1124,2020-03-18 19:02:00,0,2151.0,1879.0,0.873,10.554,113,93,52,41,20,4,16,29,0.0,0.0
1016,1125,2020-03-18 19:05:00,0,2125.0,1914.0,0.9,10.493,381,259,198,61,122,93,29,188,0.0,0.0
1016,1126,2020-03-18 19:08:00,0,2286.0,1977.0,0.865,11.195,197,136,94,42,61,38,23,285,0.0,0.08
1016,1127,2020-03-18 19:11:00,0,2481.0,2174.0,0.876,12.18,325,168,126,42,157,119,38,138,0.15,0.09
1016,1128,2020-03-18 19:14:00,0,2217.0,1955.0,0.882,10.897,449,261,181,80,188,140,48,387,0.0,0.0
1016,1129,2020-03-18 19:17:00,0,1488.0,1205.0,0.81,7.199,489,290,228,62,199,164,35,279,0.0,0.04
1016,1130,2020-03-18 19:20:00,0,1885.0,1617.0,0.858,9.217,145,98,61,37,47,25,22,203,0.0,0.0
1016,1131,2020-03-18 19:23:00,0,2098.0,1752.0,0.835,10.207,241,111,77,34,130,81,49,137,0.0,0.0
1016,1132,2020-03-18 19:26:00,0,2487.0,2155.0,0.867,12.186,164,94,58,36,70,47,23,289,0.18,0.07
1016,1133,2020-03-18 19:29:00,0,2147.0,1830.0,0.852,10.486,99,57,44,13,42,30,12,214,0.0,0.02
1016,1134,2020-03-18 19:32:00,0,2125.0,1897.0,0.893,10.474,50,32,16,16,18,3,15,13,0.0,0.0
1016,1135,2020-03-18 19:35:00,0,2201.0,1923.0,0.874,10.799,44,28,14,14,16,7,9,6,0.0,0.0
1016,1136,2020-03-18 19:38:00,0,2164.0,1841.0,0.851,10.563,11,8,0,8,3,0,3,0,0.0,0.0
1016,1137,2020-03-18 19:41:00,0,2147.0,1883.0,0.877,10.544,16,11,0,11,5,0,5,0,0.0,0.0
1016,1138,2020-03-18 19:44:00,0,2136.0,1903.0,0.891,10.522,30,18,12,6,12,5,7,0,0.0,0.0
1016,1139,2020-03-18 19:47:00,0,2186.0,1941.0,0.888,10.764,265,165,125,40,100,65,35,32,0.09,0.01
1016,1140,2020-03-18 19:50:00,0,2273.0,2010.0,0.884,11.18,153,117,84,33,36,17,19,182,0.0,0.0
1016,1141,2020-03-18 19:53:00,0,2137.0,1934.0,0.905,10.56,123,58,39,19,65,37,28,233,0.08,0.08
1016,1142,2020-03-18 19:56:00,0,2129.0,1962.0,0.922,10.561,419,235,185,50,184,132,52,195,0.0,0.03
1016,1143,2020-03-18 19:59:00,0,1796.0,1658.0,0.923,8.911,287,135,99,36,152,109,43,190,0.0,0.0
1016,1144,2020-03-18 20:02:00,0,2250.0,2060.0,0.915,11.145,368,181,145,36,187,130,57,177,0.0,0.0
1016,1145,2020-03-18 20:05:00,0,2130.0,1944.0,0.912,10.545,155,118,83,35,37,22,15,197,0.0,0.0
1016,1146,2020-03-18 20:08:00,0,2278.0,2002.0,0.879,11.191,60,36,13,23,24,1,23,17,0.0,0.0
1016,1147,2020-03-18 20:11:00,0,2274.0,2007.0,0.883,11.18,78,65,41,24,13,5,8,5,0.0,0.0
1016,1148,2020-03-18 20:14:00,0,2143.0,1884.0,0.879,10.529,9,8,0,8,1,0,1,0,0.0,0.0
1016,1149,2020-03-18 20:17:00,0,1923.0,1727.0,0.898,9.489,9,9,0,9,0,0,0,0,0.0,0.0
1016,1150,2020-03-18 20:20:00,0,1809.0,1542.0,0.853,8.835,11,8,0,8,3,1,2,0,0.0,0.0
1016,1151,2020-03-18 20:23:00,0,1824.0,1560.0,0.855,8.915,8,3,0,3,5,0,5,0,0.0,0.0
1016,1152,2020-03-18 20:26:00,0,1798.0,1655.0,0.92,8.916,16,12,12,0,4,3,1,0,0.0,0.0
1016,1153,2020-03-18 20:29:00,0,1944.0,1714.0,0.882,9.557,22,4,2,2,18,2,16,0,0.0,0.0
1016,1154,2020-03-18 20:32:00,0,1930.0,1717.0,0.89,9.504,120,85,57,28,35,3,32,61,0.0,0.08
1016,1155,2020-03-18 20:35:00,0,2031.5,1826.5,0.899,10.0265,314,190,149,41,124,75,49,134,0.1,0.13
1016,1156,2020-03-18 20:38:00,0,2133.0,1936.0,0.908,10.549,489,257,193,64,232,187,45,258,0.0,0.0
1016,1157,2020-03-18 20:41:00,0,2289.0,1986.0,0.868,11.217,537,328,263,65,209,160,49,218,0.0,0.0
1016,1158,2020-03-18 20:44:00,0,2546.0,2275.0,0.894,12.551,394,221,186,35,173,133,40,161,0.0,0.0
1016,1159,2020-03-18 20:47:00,0,2458.0,2249.0,0.915,12.176,265,142,103,39,123,86,37,209,0.0,0.0
1016,1160,2020-03-18 20:50:00,0,2273.0,1990.0,0.876,11.157,391,214,169,45,177,133,44,261,0.0,0.0
1016,1161,2020-03-18 20:53:00,0,1878.0,1627.0,0.866,9.202,291,170,126,44,121,91,30,180,0.04,0.0
1016,1162,2020-03-18 20:56:00,0,2280.0,1980.0,0.869,11.175,360,225,171,54,135,97,38,111,0.0,0.01
1016,1163,2020-03-18 20:59:00,0,2289.0,1986.0,0.868,11.216,242,176,119,57,66,42,24,218,0.0,0.08
1016,1164,2020-03-18 21:02:00,0,2496.0,2134.0,0.855,12.196,82,55,35,20,27,4,23,79,0.0,0.16
1016,1165,2020-03-18 21:05:00,0,1339.0,1169.0,0.873,6.57,64,32,14,18,32,11,21,47,0.0,0.0
1016,1166,2020-03-18 21:08:00,0,1485.0,1245.0,0.838,7.23,98,59,27,32,39,10,29,37,0.0,0.0
1016,1167,2020-03-18 21:11:00,0,2261.0,2063.0,0.913,11.19,452,230,173,57,222,165,57,167,0.0,0.0
1016,1168,2020-03-18 21:14:00,0,2620.0,2311.0,0.882,12.882,176,131,106,25,45,25,20,200,0.0,0.0
1016,1169,2020-03-18 21:17:00,0,2257.0,2059.0,0.912,11.172,162,129,102,27,33,16,17,141,0.1,0.0
1016,1170,2020-03-18 21:20:00,0,2452.0,2181.0,0.89,12.075,70,40,19,21,30,10,20,244,0.0,0.0
1016,1171,2020-03-18 21:23:00,0,2481.0,2184.0,0.88,12.193,166,126,92,34,40,23,17,127,0.0,0.05
1016,1172,2020-03-18 21:26:00,0,1938.0,1729.0,0.892,9.548,10,10,3,7,0,0,0,33,0.0,0.0
1016,1173,2020-03-18 21:29:00,0,1924.0,1785.0,0.927,9.557,4,4,0,4,0,0,0,0,0.0,0.0
1016,1174,2020-03-18 21:32:00,0,2121.0,1913.0,0.902,10.474,10,7,0,7,3,1,2,0,0.0,0.0
1016,1175,2020-03-18 21:35:00,0,2107.0,1943.0,0.922,10.45,14,12,0,12,2,0,2,1,0.0,0.0
1016,1176,2020-03-18 21:38:00,0,2140.0,1901.0,0.889,10.535,65,38,14,24,27,0,27,16,0.0,0.0
1016,1177,2020-03-18 21:41:00,0,1995.0,1818.0,0.911,9.872,200,124,100,24,76,42,34,37,0.11,0.0
1016,1178,2020-03-18 21:44:00,0,2150.0,1881.0,0.875,10.554,73,39,29,10,34,12,22,12,0.0,0.1
1016,1179,2020-03-18 21:47:00,0,2143.0,1899.0,0.886,10.547,231,142,104,38,89,58,31,5,0.0,0.0
1016,1180,2020-03-18 21:50:00,0,2124.0,1968.0,0.927,10.548,581,330,258,72,251,199,52,281,0.0,0.0
1016,1181,2020-03-18 21:53:00,0,2188.0,2052.0,0.938,10.893,304,171,133,38,133,97,36,163,0.0,0.02
1016,1182,2020-03-18 21:56:00,0,1795.0,1608.0,0.896,8.854,283,181,139,42,102,81,21,269,0.0,0.0
1016,1183,2020-03-18 21:59:00,0,2261.0,2109.0,0.933,11.243,308,189,136,53,119,84,35,229,0.0,0.02
1016,1184,2020-03-18 22:02:00,0,2280.0,2032.0,0.891,11.235,372,165,127,38,207,153,54,316,0.0,0.0
1016,1185,2020-03-18 22:05:00,0,2455.0,2181.0,0.888,12.086,379,286,230,56,93,62,31,215,0.19,0.0
1016,1186,2020-03-18 22:08:00,0,2259.0,2067.0,0.915,11.188,232,160,118,42,72,46,26,156,0.0,0.0
1016,1187,2020-03-18 22:11:00,0,2272.0,1991.0,0.876,11.154,151,133,80,53,18,2,16,22,0.0,0.0
1016,1188,2020-03-18 22:14:00,0,2250.0,2104.0,0.935,11.195,41,14,3,11,27,0,27,1,0.0,0.0
1016,1189,2020-03-18 22:17:00,0,2285.0,2006.0,0.878,11.225,21,6,0,6,15,1,14,1,0.0,0.0
1016,1190,2020-03-18 22:20:00,0,2079.0,1842.0,0.886,10.23,14,0,0,0,14,0,14,10,0.0,0.0
1016,1191,2020-03-18 22:23:00,0,1939.0,1689.0,0.871,9.51,0,0,0,0,0,0,0,8,0.0,0.0
1016,1192,2020-03-18 22:26:00,0,1788.0,1665.0,0.931,8.887,0,0,0,0,0,0,0,4,0.0,0.0
1016,1193,2020-03-18 22:29:00,0,2009.0,1776.0,0.884,9.882,20,7,5,2,13,4,9,5,0.0,0.0
1016,1194,2020-03-18 22:32:00,0,1936.0,1763.0,0.91,9.58,6,6,2,4,0,0,0,6,0.0,0.0
1016,1195,2020-03-18 22:35:00,0,1876.0,1639.0,0.874,9.205,22,22,13,9,0,0,0,7,0.0,0.0
1016,1196,2020-03-18 22:38:00,0,1801.0,1575.0,0.874,8.842,64,64,43,21,0,0,0,10,0.0,0.0
1016,1197,2020-03-18 22:41:00,0,1795.0,1632.0,0.909,8.878,8,8,4,4,0,0,0,4,0.0,0.0
1016,1198,2020-03-18 22:44:00,0,1814.0,1607.0,0.885,8.928,11,11,2,9,0,0,0,3,0.0,0.0
1016,1199,2020-03-18 22:47:00,0,1801.0,1611.0,0.894,8.881,18,15,7,8,3,1,2,3,0.0,0.0
1016,1200,2020-03-18 22:50:00,0,1956.0,1646.0,0.841,9.531,13,10,7,3,3,0,3,6,0.0,0.0
1016,1201,2020-03-18 22:53:00,0,1812.0,1603.0,0.885,8.912,4,2,2,0,2,1,1,1,0.0,0.0
1016,1202,2020-03-18 22:56:00,0,1806.0,1585.0,0.878,8.87,3,2,0,2,1,1,0,1,0.0,0.0
1016,1203,2020-03-18 22:59:00,0,1958.0,1653.0,0.844,9.547,4,3,3,0,1,1,0,1,0.0,0.0
1016,1204,2020-03-18 23:02:00,0,1802.0,1577.0,0.875,8.845,20,14,8,6,6,4,2,5,0.0,0.0
1016,1205,2020-03-18 23:05:00,0,1811.0,1570.0,0.867,8.873,6,1,0,1,5,0,5,1,0.0,0.0
1016,1206,2020-03-18 23:08:00,0,1809.0,1572.0,0.869,8.869,5,4,1,3,1,0,1,3,0.0,0.0
1016,1207,2020-03-18 23:11:00,0,1829.0,1534.0,0.839,8.903,8,6,3,3,2,1,1,5,0.0,0.0
1016,1208,2020-03-18 23:14:00,0,1947.0,1634.0,0.839,9.482,25,9,2,7,16,9,7,3,0.0,0.0
1016,1209,2020-03-18 23:17:00,0,1963.0,1641.0,0.836,9.552,4,2,1,1,2,1,1,2,0.0,0.0
1016,1210,2020-03-18 23:20:00,0,1819.0,1566.0,0.861,8.9,5,3,1,2,2,1,1,1,0.0,0.0
1016,1211,2020-03-18 23:23:00,0,1961.0,1666.0,0.85,9.569,1,1,0,1,0,0,0,0,0.0,0.0
1016,1212,2020-03-18 23:26:00,0,1939.0,1655.0,0.853,9.473,1,1,0,1,0,0,0,0,0.0,0.0
1016,1213,2020-03-18 23:29:00,0,1945.0,1695.0,0.871,9.54,100,54,20,34,46,9,37,13,0.0,0.0
1016,1214,2020-03-18 23:32:00,0,2091.0,1753.0,0.839,10.178,225,155,102,53,70,43,27,90,0.0,0.0
1016,1215,2020-03-18 23:35:00,0,2020.0,1720.5,0.8525,9.8635,302,195,153,42,107,69,38,259,0.0,0.08
1016,1216,2020-03-18 23:38:00,0,1949.0,1688.0,0.866,9.549,426,225,173,52,201,152,49,339,0.0,0.08
1016,1217,2020-03-18 23:41:00,0,1882.0,1630.0,0.866,9.221,361,220,174,46,141,114,27,261,0.01,0.0
1016,1218,2020-03-18 23:44:00,0,2213.0,1936.0,0.875,10.864,611,328,246,82,283,203,80,260,0.0,0.0
1016,1219,2020-03-18 23:47:00,0,2275.0,2009.0,0.883,11.188,245,146,109,37,99,60,39,283,0.0,0.08
1016,1220,2020-03-18 23:50:00,0,2126.0,1850.0,0.87,10.425,266,179,135,44,87,47,40,236,0.0,0.0
1016,1221,2020-03-18 23:53:00,0,1603.0,1438.0,0.897,7.906,122,72,31,41,50,15,35,296,0.0,0.0
1016,1222,2020-03-18 23:56:00,0,2284.0,1967.0,0.861,11.178,215,136,106,30,79,34,45,101,0.0,0.0
1016,1223,2020-03-18 23:59:00,0,2493.0,2153.0,0.864,12.207,534,370,307,63,164,105,59,105,0.0,0.08
1016,1224,2020-03-19 00:02:00,0,2336.0,2119.0,0.907,11.548,344,193,155,38,151,114,37,233,0.0,0.0
1016,1225,2020-03-19 00:05:00,0,2321.0,2088.0,0.9,11.458,200,134,112,22,66,44,22,183,0.17,0.0
1016,1226,2020-03-19 00:08:00,0,2477.0,2163.0,0.873,12.155,436,213,150,63,223,164,59,203,0.0,0.0
1016,1227,2020-03-19 00:11:00,0,2643.0,2261.0,0.856,12.916,253,150,113,37,103,70,33,265,0.0,0.0
1016,1228,2020-03-19 00:14:00,0,2426.0,2119.0,0.873,11.906,268,125,88,37,143,100,43,79,0.0,0.0
1016,1229,2020-03-19 00:17:00,0,2318.0,2060.0,0.889,11.415,103,74,40,34,29,3,26,36,0.0,0.0
1016,1230,2020-03-19 00:20:00,0,2276.0,2006.0,0.881,11.187,43,36,6,30,7,1,6,26,0.0,0.0
1016,1231,2020-03-19 00:23:00,0,2209.0,1943.0,0.88,10.854,520,336,252,84,184,114,70,16,0.0,0.0
1016,1232,2020-03-19 00:26:00,0,2167.0,1840.0,0.849,10.575,277,164,127,37,113,77,36,212,0.0,0.0
1016,1233,2020-03-19 00:29:00,0,2160.0,1827.0,0.846,10.533,20,7,0,7,13,1,12,87,0.0,0.0
1016,1234,2020-03-19 00:32:00,0,1957.0,1638.0,0.837,9.526,7,4,0,4,3,0,3,16,0.0,0.0
1016,1235,2020-03-19 00:35:00,0,1874.0,1634.0,0.872,9.193,0,0,0,0,0,0,0,17,0.0,0.0
1016,1236,2020-03-19 00:38:00,0,1947.0,1656.0,0.85,9.504,1,0,0,0,1,0,1,26,0.0,0.0
1016,1237,2020-03-19 00:41:00,0,1817.0,1578.0,0.868,8.908,0,0,0,0,0,0,0,19,0.0,0.0
1016,1238,2020-03-19 00:44:00,0,1820.0,1547.0,0.85,8.885,0,0,0,0,0,0,0,26,0.0,0.0
1016,1239,2020-03-19 00:47:00,0,1834.0,1501.0,0.818,8.886,47,42,5,37,5,2,3,26,0.0,0.0
1016,1240,2020-03-19 00:50:00,0,1826.0,1531.0,0.838,8.89,2,0,0,0,2,0,2,20,0.0,0.0
1016,1241,2020-03-19 00:53:00,0,1975.0,1621.0,0.821,9.576,50,22,7,15,28,2,26,26,0.0,0.0
1016,1242,2020-03-19 00:56:00,0,1963.0,1661.0,0.846,9.574,64,39,15,24,25,0,25,25,0.0,0.0
1016,1243,2020-03-19 00:59:00,0,1968.0,1643.0,0.835,9.574,110,64,39,25,46,23,23,48,0.0,0.0
1016,1244,2020-03-19 01:02:00,0,1815.0,1599.0,0.881,8.92,31,26,8,18,5,3,2,7,0.0,0.0
1016,1245,2020-03-19 01:05:00,0,1814.0,1583.0,0.873,8.902,0,0,0,0,0,0,0,1,0.0,0.01
1016,1246,2020-03-19 01:08:00,0,1811.0,1583.0,0.874,8.889,2,0,0,0,2,1,1,1,0.0,0.0
1016,1247,2020-03-19 01:11:00,0,1793.0,1600.0,0.892,8.836,25,15,7,8,10,4,6,1,0.0,0.0
1016,1248,2020-03-19 01:14:00,0,1960.0,1651.0,0.843,9.549,16,14,8,6,2,0,2,0,0.0,0.0
1016,1249,2020-03-19 01:17:00,0,1967.0,1635.0,0.831,9.562,21,19,6,13,2,0,2,6,0.0,0.0
1016,1250,2020-03-19 01:20:00,0,1969.0,1648.0,0.837,9.584,91,15,7,8,76,55,21,7,0.0,0.0
1016,1251,2020-03-19 01:23:00,0,1943.0,1649.0,0.849,9.482,37,33,12,21,4,1,3,3,0.0,0.0
1016,1252,2020-03-19 01:26:00,0,1947.0,1672.0,0.858,9.522,38,27,15,12,11,6,5,12,0.0,0.0
1016,1253,2020-03-19 01:29:00,0,2016.0,1755.0,0.871,9.887,30,3,1,2,27,2,25,6,0.0,0.02
1016,1254,2020-03-19 01:32:00,0,1942.0,1763.0,0.908,9.601,222,133,85,48,89,58,31,51,0.0,0.0
1016,1255,2020-03-19 01:35:00,0,1944.0,1760.0,0.905,9.609,379,253,200,53,126,86,40,347,0.0,0.0
1016,1256,2020-03-19 01:38:00,0,2152.0,1853.0,0.861,10.529,151,70,45,25,81,60,21,93,0.0,0.13
1016,1257,2020-03-19 01:41:00,0,2127.0,1920.0,0.903,10.504,63,25,13,12,38,11,27,7,0.0,0.0
1016,1258,2020-03-19 01:44:00,0,2286.0,1947.0,0.852,11.162,43,23,8,15,20,5,15,4,0.0,0.0
1016,1259,2020-03-19 01:47:00,0,2132.0,1953.0,0.916,10.563,149,91,70,21,58,25,33,15,0.12,0.02
1016,1260,2020-03-19 01:50:00,0,2014.0,1794.0,0.891,9.921,653,435,353,82,218,161,57,115,0.0,0.0
1016,1261,2020-03-19 01:53:00,0,2166.0,1865.0,0.861,10.599,232,185,132,53,47,33,14,220,0.0,0.0
1016,1262,2020-03-19 01:56:00,0,2279.0,1960.0,0.86,11.149,404,233,185,48,171,127,44,240,0.1,0.0
1016,1263,2020-03-19 01:59:00,0,2558.0,2186.0,0.854,12.501,336,195,143,52,141,102,39,314,0.0,0.04
1016,1264,2020-03-19 02:02:00,0,2348.0,2093.0,0.892,11.568,193,141,99,42,52,19,33,51,0.0,0.04
1016,1265,2020-03-19 02:05:00,0,1945.0,1735.0,0.892,9.584,32,8,1,7,24,0,24,4,0.0,0.01
1016,1266,2020-03-19 02:08:00,0,2150.0,1805.0,0.84,10.47,340,205,152,53,135,89,46,12,0.0,0.0
1016,1267,2020-03-19 02:11:00,0,2156.0,1833.0,0.85,10.525,702,500,414,86,202,136,66,35,0.08,0.0
1016,1268,2020-03-19 02:14:00,0,2158.0,1880.0,0.871,10.585,605,319,244,75,286,207,79,47,0.0,0.0
1016,1269,2020-03-19 02:17:00,0,2130.0,1955.0,0.918,10.557,387,217,162,55,170,137,33,280,0.0,0.0
1016,1270,2020-03-19 02:20:00,0,2116.0,1933.0,0.914,10.477,367,218,167,51,149,115,34,283,0.0,0.0
1016,1271,2020-03-19 02:23:00,0,2483.0,2132.0,0.859,12.144,282,191,131,60,91,50,41,233,0.0,0.0
1016,1272,2020-03-19 02:26:00,0,1830.0,1499.0,0.819,8.87,83,71,29,42,12,6,6,12,0.0,0.0
1016,1273,2020-03-19 02:29:00,0,2137.0,1916.0,0.897,10.541,50,26,6,20,24,3,21,2,0.0,0.0
1016,1274,2020-03-19 02:32:00,0,2131.0,1911.0,0.897,10.51,84,46,17,29,38,13,25,2,0.0,0.0
1016,1275,2020-03-19 02:35:00,0,2027.5,1821.5,0.8985,10.004,536,335,270,65,201,143,58,19,0.0,0.0
1016,1276,2020-03-19 02:38:00,0,1924.0,1732.0,0.9,9.498,266,172,124,48,94,57,37,183,0.0,0.02
1016,1277,2020-03-19 02:41:00,0,1943.0,1703.0,0.876,9.542,8,8,2,6,0,0,0,174,0.0,0.0
1016,1278,2020-03-19 02:44:00,0,1972.0,1638.0,0.831,9.585,4,4,2,2,0,0,0,13,0.0,0.0
1016,1279,2020-03-19 02:47:00,0,1825.0,1523.0,0.835,8.877,1,1,0,1,0,0,0,0,0.0,0.0
1016,1280,2020-03-19 02:50:00,0,1755.0,1493.0,0.851,8.567,0,0,0,0,0,0,0,0,0.0,0.0
1016,1281,2020-03-19 02:53:00,0,1599.0,1438.0,0.899,7.893,0,0,0,0,0,0,0,0,0.0,0.0
1016,1282,2020-03-19 02:56:00,0,1608.0,1417.0,0.881,7.904,24,1,1,0,23,0,23,1,0.0,0.0
1016,1283,2020-03-19 02:59:00,0,1620.0,1418.0,0.875,7.953,12,2,0,2,10,0,10,0,0.0,0.0
1016,1284,2020-03-19 03:02:00,0,1615.0,1379.0,0.854,7.891,14,6,1,5,8,0,8,0,0.0,0.0
1016,1285,2020-03-19 03:05:00,0,1627.0,1382.0,0.849,7.941,9,0,0,0,9,3,6,0,0.0,0.0
1016,1286,2020-03-19 03:08:00,0,1625.0,1349.0,0.83,7.897,0,0,0,0,0,0,0,0,0.0,0.0
1016,1287,2020-03-19 03:11:00,0,1826.0,1502.0,0.823,8.858,36,11,4,7,25,9,16,0,0.0,0.0
1016,1288,2020-03-19 03:14:00,0,1765.0,1447.0,0.82,8.556,1,1,0,1,0,0,0,0,0.0,0.0
1016,1289,2020-03-19 03:17:00,0,1611.0,1384.0,0.859,7.881,4,2,0,2,2,0,2,0,0.0,0.0
1016,1290,2020-03-19 03:20:00,0,1629.0,1342.0,0.824,7.903,0,0,0,0,0,0,0,0,0.0,0.0
1016,1291,2020-03-19 03:23:00,0,1623.0,1332.0,0.82,7.87,6,5,0,5,1,0,1,0,0.0,0.0
1016,1292,2020-03-19 03:26:00,0,1754.0,1402.0,0.799,8.464,0,0,0,0,0,0,0,0,0.0,0.0
1016,1293,2020-03-19 03:29:00,0,1636.0,1347.0,0.823,7.939,1,1,0,1,0,0,0,0,0.0,0.0
1016,1294,2020-03-19 03:32:00,0,1648.0,1302.0,0.79,7.934,3,0,0,0,3,1,2,0,0.0,0.0
1016,1295,2020-03-19 03:35:00,0,1560.0,1292.0,0.829,7.576,33,5,1,4,28,0,28,0,0.0,0.0
1016,1296,2020-03-19 03:38:00,0,1495.0,1246.0,0.834,7.269,16,10,0,10,6,2,4,0,0.0,0.0
1016,1297,2020-03-19 03:41:00,0,1612.0,1369.0,0.849,7.869,52,14,8,6,38,9,29,6,0.0,0.0
1016,1298,2020-03-19 03:44:00,0,1837.0,1452.0,0.79,8.845,49,29,9,20,20,4,16,0,0.0,0.0
1016,1299,2020-03-19 03:47:00,0,1839.0,1508.0,0.82,8.916,157,125,82,43,32,12,20,29,0.0,0.0
1016,1300,2020-03-19 03:50:00,0,1979.0,1602.0,0.809,9.571,283,185,137,48,98,61,37,140,0.0,0.1
1016,1301,2020-03-19 03:53:00,0,1971.0,1563.0,0.793,9.497,223,151,105,46,72,37,35,217,0.0,0.0
1016,1302,2020-03-19 03:56:00,0,1895.0,1560.0,0.823,9.192,402,280,229,51,122,86,36,282,0.0,0.0
1016,1303,2020-03-19 03:59:00,0,2282.0,1963.0,0.86,11.162,241,149,113,36,92,67,25,197,0.0,0.0
1016,1304,2020-03-19 04:02:00,0,2173.0,1803.0,0.83,10.558,554,286,231,55,268,194,74,15,0.0,0.0
1016,1305,2020-03-19 04:05:00,0,2165.0,1836.0,0.848,10.562,282,184,124,60,98,68,30,82,0.0,0.0
1016,1306,2020-03-19 04:08:00,0,1895.0,1597.0,0.843,9.236,142,106,48,58,36,9,27,39,0.0,0.03
1016,1307,2020-03-19 04:11:00,0,2178.0,1768.0,0.812,10.537,77,68,31,37,9,0,9,17,0.0,0.0
1016,1308,2020-03-19 04:14:00,0,2173.0,1790.0,0.824,10.542,50,17,6,11,33,2,31,5,0.0,0.0
1016,1309,2020-03-19 04:17:00,0,2015.0,1761.0,0.874,9.888,25,22,10,12,3,1,2,1,0.0,0.0
1016,1310,2020-03-19 04:20:00,0,1959.0,1642.0,0.838,9.535,16,16,1,15,0,0,0,0,0.0,0.0
1016,1311,2020-03-19 04:23:00,0,1822.0,1501.0,0.824,8.842,29,28,1,27,1,0,1,0,0.0,0.01
1016,1312,2020-03-19 04:26:00,0,1610.0,1434.0,0.891,7.929,5,2,1,1,3,0,3,0,0.0,0.0
1016,1313,2020-03-19 04:29:00,0,1678.0,1481.0,0.883,8.253,9,6,1,5,3,0,3,0,0.0,0.0
1016,1314,2020-03-19 04:32:00,0,1807.0,1544.0,0.854,8.83,5,1,1,0,4,2,2,0,0.0,0.0
1016,1315,2020-03-19 04:35:00,0,1874.0,1599.0,0.853,9.152,1,0,0,0,1,0,1,0,0.0,0.0
1016,1316,2020-03-19 04:38:00,0,1821.0,1541.0,0.846,8.88,3,1,1,0,2,1,1,0,0.0,0.0
1016,1317,2020-03-19 04:41:00,0,1828.0,1526.0,0.835,8.893,14,14,4,10,0,0,0,1,0.0,0.0
1016,1318,2020-03-19 04:44:00,0,1835.0,1514.0,0.825,8.906,24,23,0,23,1,0,1,0,0.0,0.0
1016,1319,2020-03-19 04:47:00,0,1844.0,1480.0,0.803,8.904,12,9,5,4,3,1,2,0,0.0,0.0
1016,1320,2020-03-19 04:50:00,0,1831.0,1511.0,0.825,8.888,11,9,3,6,2,0,2,0,0.0,0.0
1016,1321,2020-03-19 04:53:00,0,1829.0,1508.0,0.825,8.875,9,9,2,7,0,0,0,0,0.0,0.0
1016,1322,2020-03-19 04:56:00,0,1617.0,1409.0,0.871,7.932,104,63,29,34,41,15,26,10,0.0,0.0
1016,1323,2020-03-19 04:59:00,0,1824.0,1530.0,0.839,8.882,63,27,4,23,36,5,31,12,0.0,0.0
1016,1324,2020-03-19 05:02:00,0,1804.0,1542.0,0.855,8.813,414,243,194,49,171,133,38,132,0.0,0.0
1016,1325,2020-03-19 05:05:00,0,1819.0,1537.0,0.845,8.868,384,246,181,65,138,104,34,271,0.0,0.02
1016,1326,2020-03-19 05:08:00,0,2662.0,2120.0,0.796,12.838,244,134,97,37,110,67,43,130,0.16,0.02
1016,1327,2020-03-19 05:11:00,0,1974.0,1603.0,0.812,9.553,274,183,139,44,91,45,46,137,0.0,0.01
1016,1328,2020-03-19 05:14:00,0,2168.0,1739.0,0.802,10.468,90,70,38,32,20,2,18,55,0.0,0.0
1016,1329,2020-03-19 05:17:00,0,2106.0,1718.0,0.816,10.199,72,58,31,27,14,2,12,35,0.0,0.0
1016,1330,2020-03-19 05:20:00,0,1954.0,1668.0,0.854,9.547,110,61,37,24,49,26,23,2,0.0,0.0
1016,1331,2020-03-19 05:23:00,0,1893.0,1591.0,0.841,9.219,423,259,200,59,164,117,47,154,0.0,0.04
1016,1332,2020-03-19 05:26:00,0,1937.0,1713.0,0.884,9.529,430,271,216,55,159,121,38,159,0.06,0.0
1016,1333,2020-03-19 05:29:00,0,1825.0,1502.0,0.823,8.854,120,81,50,31,39,25,14,34,0.0,0.0
1016,1334,2020-03-19 05:32:00,0,1954.0,1641.0,0.84,9.516,52,23,2,21,29,2,27,1,0.0,0.0
1016,1335,2020-03-19 05:35:00,0,1963.0,1619.0,0.825,9.5265,26,17,5,12,9,2,7,3,0.0,0.0
1016,1336,2020-03-19 05:38:00,0,1972.0,1597.0,0.81,9.537,4,4,0,4,0,0,0,0,0.0,0.0
1016,1337,2020-03-19 05:41:00,0,1852.0,1458.0,0.787,8.91,1,0,0,0,1,0,1,0,0.0,0.0
1016,1338,2020-03-19 05:44:00,0,1626.0,1346.0,0.828,7.896,0,0,0,0,0,0,0,0,0.0,0.0
1016,1339,2020-03-19 05:47:00,0,1635.0,1343.0,0.821,7.93,0,0,0,0,0,0,0,0,0.0,0.0
1016,1340,2020-03-19 05:50:00,0,1634.0,1296.0,0.793,7.873,0,0,0,0,0,0,0,0,0.0,0.0
1016,1341,2020-03-19 05:53:00,0,1632.0,1306.0,0.801,7.875,0,0,0,0,0,0,0,0,0.0,0.0
1016,1342,2020-03-19 05:56:00,0,1626.0,1332.0,0.82,7.882,8,4,1,3,4,0,4,0,0.0,0.0
1016,1343,2020-03-19 05:59:00,0,1637.0,1297.0,0.792,7.886,9,9,0,9,0,0,0,0,0.0,0.0
1016,1344,2020-03-19 06:02:00,1,1637.0,1308.0,0.799,7.898,21,16,9,7,5,3,2,1,0.0,0.0
1016,1345,2020-03-19 06:05:00,1,1637.0,1270.0,0.776,7.857,14,6,3,3,8,2,6,1,0.0,0.0
1016,1346,2020-03-19 06:08:00,1,1629.0,1340.0,0.822,7.901,1,0,0,0,1,0,1,0,0.0,0.0
1016,1347,2020-03-19 06:11:00,1,1702.0,1369.0,0.804,8.222,3,0,0,0,3,0,3,0,0.0,0.0
1016,1348,2020-03-19 06:14:00,1,1864.0,1380.0,0.74,8.874,98,52,31,21,46,15,31,14,0.0,0.0
1016,1349,2020-03-19 06:17:00,1,2201.0,1677.0,0.762,10.528,253,152,118,34,101,62,39,178,0.0,0.05
1016,1350,2020-03-19 06:20:00,1,2205.0,1686.0,0.765,10.553,301,214,182,32,87,63,24,254,0.1,0.0
1016,1351,2020-03-19 06:23:00,1,2439.0,1990.0,0.816,11.815,124,84,47,37,40,29,11,22,0.0,0.0
1016,1352,2020-03-19 06:26:00,1,2099.0,1725.0,0.822,10.179,379,210,162,48,169,126,43,152,0.0,0.0
1016,1353,2020-03-19 06:29:00,1,2176.0,1801.0,0.827,10.568,413,206,164,42,207,158,49,165,0.0,0.0
1016,1354,2020-03-19 06:32:00,1,2240.0,1885.0,0.841,10.914,494,251,184,67,243,182,61,133,0.0,0.0
1016,1355,2020-03-19 06:35:00,1,2227.0,1902.0,0.854,10.881,445,260,198,62,185,135,50,38,0.0,0.0
1016,1356,2020-03-19 06:38:00,1,2159.0,1818.0,0.842,10.517,314,89,58,31,225,172,53,82,0.0,0.0
1016,1357,2020-03-19 06:41:00,1,2177.0,1760.0,0.808,10.525,304,120,85,35,184,134,50,66,0.0,0.02
1016,1358,2020-03-19 06:44:00,1,2089.0,1739.0,0.832,10.158,135,109,83,26,26,14,12,142,0.0,0.0
1016,1359,2020-03-19 06:47:00,1,2175.0,1781.0,0.819,10.543,61,45,26,19,16,2,14,7,0.0,0.0
1016,1360,2020-03-19 06:50:00,1,2006.0,1743.0,0.869,9.834,562,287,226,61,275,204,71,30,0.0,0.0
1016,1361,2020-03-19 06:53:00,1,1953.0,1709.0,0.875,9.587,279,186,132,54,93,54,39,43,0.0,0.05
1016,1362,2020-03-19 06:56:00,1,2173.0,1799.0,0.828,10.552,286,189,141,48,97,67,30,150,0.0,0.0
1016,1363,2020-03-19 06:59:00,1,1951.0,1690.0,0.866,9.56,215,168,134,34,47,35,12,185,0.03,0.0
1016,1364,2020-03-19 07:02:00,1,1815.0,1576.0,0.868,8.897,154,93,58,35,61,26,35,17,0.0,0.0
1016,1365,2020-03-19 07:05:00,1,2162.0,1821.0,0.842,10.533,50,24,9,15,26,0,26,6,0.0,0.0
1016,1366,2020-03-19 07:08:00,1,2184.0,1753.0,0.803,10.545,40,40,25,15,0,0,0,0,0.0,0.0
1016,1367,2020-03-19 07:11:00,1,1834.0,1536.0,0.838,8.925,0,0,0,0,0,0,0,0,0.0,0.0
1016,1368,2020-03-19 07:14:00,1,1618.0,1347.0,0.833,7.868,0,0,0,0,0,0,0,0,0.0,0.0
1016,1369,2020-03-19 07:17:00,1,1620.0,1339.0,0.827,7.866,1,0,0,0,1,1,0,0,0.0,0.0
1016,1370,2020-03-19 07:20:00,1,1481.0,1246.0,0.842,7.214,14,0,0,0,14,0,14,0,0.0,0.0
1016,1371,2020-03-19 07:23:00,1,1642.0,1271.0,0.774,7.875,0,0,0,0,0,0,0,0,0.0,0.0
1016,1372,2020-03-19 07:26:00,1,1496.0,1179.0,0.788,7.2,1,1,1,0,0,0,0,0,0.0,0.0
1016,1373,2020-03-19 07:29:00,1,1498.0,1219.0,0.814,7.254,0,0,0,0,0,0,0,0,0.0,0.0
1016,1374,2020-03-19 07:32:00,1,1490.0,1218.0,0.818,7.218,21,0,0,0,21,0,21,0,0.0,0.0
1016,1375,2020-03-19 07:35:00,1,1509.0,1167.0,0.773,7.239,28,10,5,5,18,0,18,0,0.0,0.0
1016,1376,2020-03-19 07:38:00,1,1657.0,1246.0,0.752,7.91,1,0,0,0,1,0,1,0,0.0,0.0
1016,1377,2020-03-19 07:41:00,1,1566.0,1225.0,0.782,7.527,0,0,0,0,0,0,0,0,0.0,0.0
1016,1378,2020-03-19 07:44:00,1,1508.0,1173.0,0.778,7.241,2,2,0,2,0,0,0,0,0.0,0.0
1016,1379,2020-03-19 07:47:00,1,1498.0,1211.0,0.808,7.244,4,2,1,1,2,0,2,0,0.0,0.0
1016,1380,2020-03-19 07:50:00,1,1632.0,1331.0,0.816,7.903,15,12,9,3,3,0,3,0,0.0,0.0
1016,1381,2020-03-19 07:53:00,1,1637.0,1307.0,0.798,7.896,5,3,3,0,2,0,2,0,0.0,0.0
1016,1382,2020-03-19 07:56:00,1,1637.0,1278.0,0.781,7.864,7,6,2,4,1,0,1,0,0.0,0.0
1016,1383,2020-03-19 07:59:00,1,1577.0,1223.0,0.775,7.569,11,7,4,3,4,2,2,0,0.0,0.0
1016,1384,2020-03-19 08:02:00,1,1501.0,1206.0,0.804,7.247,13,0,0,0,13,0,13,0,0.0,0.0
1016,1385,2020-03-19 08:05:00,1,1651.0,1263.0,0.765,7.905,9,3,1,2,6,0,6,0,0.0,0.0
1016,1386,2020-03-19 08:08:00,1,1636.0,1289.0,0.788,7.873,19,10,0,10,9,0,9,0,0.0,0.0
1016,1387,2020-03-19 08:11:00,1,1709.0,1333.0,0.78,8.209,6,6,0,6,0,0,0,0,0.0,0.0
1016,1388,2020-03-19 08:14:00,1,1788.0,1351.0,0.755,8.541,8,4,0,4,4,0,4,0,0.0,0.0
1016,1389,2020-03-19 08:17:00,1,1715.0,1335.0,0.779,8.234,0,0,0,0,0,0,0,0,0.0,0.0
1016,1390,2020-03-19 08:20:00,1,1641.0,1304.0,0.795,7.908,3,3,0,3,0,0,0,0,0.0,0.0
1016,1391,2020-03-19 08:23:00,1,1619.0,1295.0,0.8,7.815,84,60,22,38,24,7,17,3,0.0,0.0
1016,1392,2020-03-19 08:26:00,1,1837.0,1478.0,0.805,8.872,434,243,193,50,191,138,53,78,0.0,0.0
1016,1393,2020-03-19 08:29:00,1,1852.0,1450.0,0.783,8.9,269,178,134,44,91,66,25,59,0.0,0.04
1016,1394,2020-03-19 08:32:00,1,1987.0,1546.0,0.778,9.541,314,195,138,57,119,89,30,162,0.0,0.04
1016,1395,2020-03-19 08:35:00,1,2083.5,1648.5,0.7905,10.035,387,206,167,39,181,146,35,180,0.0,0.0
1016,1396,2020-03-19 08:38:00,1,2180.0,1751.0,0.803,10.529,325,185,144,41,140,93,47,55,0.0,0.04
1016,1397,2020-03-19 08:41:00,1,2185.0,1731.0,0.792,10.527,399,235,190,45,164,115,49,68,0.0,0.0
1016,1398,2020-03-19 08:44:00,1,2035.0,1693.0,0.832,9.893,500,249,179,70,251,187,64,18,0.0,0.0
1016,1399,2020-03-19 08:47:00,1,1958.0,1655.0,0.845,9.548,294,159,114,45,135,93,42,3,0.0,0.0
1016,1400,2020-03-19 08:50:00,1,1956.0,1646.0,0.841,9.53,589,331,253,78,258,179,79,8,0.0,0.0
1016,1401,2020-03-19 08:53:00,1,2021.0,1720.0,0.851,9.867,580,337,258,79,243,171,72,18,0.0,0.0
1016,1402,2020-03-19 08:56:00,1,1949.0,1667.0,0.855,9.524,351,197,163,34,154,117,37,140,0.2,0.02
1016,1403,2020-03-19 08:59:00,1,1939.0,1701.0,0.877,9.524,95,80,39,41,15,7,8,20,0.0,0.0
1016,1404,2020-03-19 09:02:00,1,1968.0,1638.0,0.832,9.57,37,21,3,18,16,0,16,0,0.0,0.0
1016,1405,2020-03-19 09:05:00,1,1881.0,1601.0,0.851,9.182,67,62,28,34,5,1,4,10,0.0,0.0
1016,1406,2020-03-19 09:08:00,1,1964.0,1643.0,0.836,9.558,39,33,13,20,6,1,5,0,0.0,0.0
1016,1407,2020-03-19 09:11:00,1,1823.0,1562.0,0.857,8.91,7,6,2,4,1,0,1,0,0.0,0.0
1016,1408,2020-03-19 09:14:00,1,1607.0,1425.0,0.887,7.908,10,9,0,9,1,0,1,0,0.0,0.0
1016,1409,2020-03-19 09:17:00,1,1621.0,1332.0,0.822,7.861,1,1,0,1,0,0,0,0,0.0,0.0
1016,1410,2020-03-19 09:20:00,1,1553.0,1304.0,0.84,7.564,1,0,0,0,1,0,1,0,0.0,0.0
1016,1411,2020-03-19 09:23:00,1,1558.0,1297.0,0.832,7.575,10,2,1,1,8,0,8,0,0.0,0.0
1016,1412,2020-03-19 09:26:00,1,1622.0,1359.0,0.838,7.897,35,2,0,2,33,0,33,0,0.0,0.0
1016,1413,2020-03-19 09:29:00,1,1614.0,1388.0,0.86,7.898,0,0,0,0,0,0,0,0,0.0,0.0
1016,1414,2020-03-19 09:32:00,1,1613.0,1388.0,0.86,7.891,6,1,1,0,5,0,5,0,0.0,0.0
1016,1415,2020-03-19 09:35:00,1,1633.0,1343.0,0.822,7.921,0,0,0,0,0,0,0,0,0.0,0.0
1016,1416,2020-03-19 09:38:00,1,1632.0,1344.0,0.823,7.917,25,11,0,11,14,0,14,0,0.0,0.0
1016,1417,2020-03-19 09:41:00,1,1706.0,1383.0,0.811,8.255,35,17,9,8,18,7,11,0,0.0,0.0
1016,1418,2020-03-19 09:44:00,1,1648.0,1286.0,0.78,7.916,2,2,0,2,0,0,0,0,0.0,0.0
1016,1419,2020-03-19 09:47:00,1,1494.0,1186.0,0.794,7.198,3,3,0,3,0,0,0,0,0.0,0.0
1016,1420,2020-03-19 09:50:00,1,1502.0,1223.0,0.814,7.274,3,3,0,3,0,0,0,0,0.0,0.0
1016,1421,2020-03-19 09:53:00,1,1643.0,1318.0,0.803,7.932,11,7,0,7,4,0,4,0,0.0,0.0
1016,1422,2020-03-19 09:56:00,1,1643.0,1289.0,0.784,7.899,0,0,0,0,0,0,0,0,0.0,0.0
1016,1423,2020-03-19 09:59:00,1,1630.0,1338.0,0.821,7.904,20,14,7,7,6,3,3,0,0.0,0.0
1016,1424,2020-03-19 10:02:00,1,1701.0,1382.0,0.813,8.233,5,4,1,3,1,0,1,0,0.0,0.0
1016,1425,2020-03-19 10:05:00,1,1698.0,1401.0,0.825,8.242,8,8,0,8,0,0,0,0,0.0,0.0
1016,1426,2020-03-19 10:08:00,1,1847.0,1412.0,0.764,8.842,23,17,2,15,6,2,4,2,0.0,0.0
1016,1427,2020-03-19 10:11:00,1,1979.0,1577.0,0.797,9.545,137,106,53,53,31,8,23,12,0.0,0.0
1016,1428,2020-03-19 10:14:00,1,1973.0,1627.0,0.825,9.575,268,141,85,56,127,82,45,57,0.0,0.0
1016,1429,2020-03-19 10:17:00,1,2178.0,1763.0,0.809,10.533,117,78,52,26,39,14,25,50,0.0,0.05
1016,1430,2020-03-19 10:20:00,1,1984.0,1590.0,0.801,9.578,17,14,3,11,3,0,3,0,0.0,0.02
1016,1431,2020-03-19 10:23:00,1,1827.0,1517.0,0.83,8.878,45,27,14,13,18,6,12,1,0.0,0.01
1016,1432,2020-03-19 10:26:00,1,1760.0,1477.0,0.839,8.568,514,330,256,74,184,126,58,14,0.04,0.0
1016,1433,2020-03-19 10:29:00,1,1802.0,1585.0,0.879,8.855,314,200,161,39,114,83,31,184,0.0,0.0
1016,1434,2020-03-19 10:32:00,1,1897.0,1625.0,0.857,9.272,371,224,159,65,147,98,49,25,0.0,0.0
1016,1435,2020-03-19 10:35:00,1,1931.0,1755.0,0.909,9.552,470,264,196,68,206,133,73,16,0.0,0.05
1016,1436,2020-03-19 10:38:00,1,1929.0,1745.0,0.905,9.532,404,246,183,63,158,100,58,2,0.0,0.0
1016,1437,2020-03-19 10:41:00,1,1811.0,1599.0,0.883,8.905,472,227,181,46,245,181,64,21,0.13,0.0
1016,1438,2020-03-19 10:44:00,1,1943.0,1719.0,0.885,9.559,316,171,121,50,145,89,56,8,0.0,0.0
1016,1439,2020-03-19 10:47:00,1,1857.0,1660.0,0.894,9.154,492,275,205,70,217,155,62,8,0.0,0.0
1016,1440,2020-03-19 10:50:00,1,1805.0,1621.0,0.898,8.907,503,243,198,45,260,194,66,14,0.03,0.0
1016,1441,2020-03-19 10:53:00,1,1945.0,1680.0,0.864,9.521,50,34,9,25,16,1,15,6,0.0,0.0
1016,1442,2020-03-19 10:56:00,1,1795.0,1664.0,0.927,8.916,72,43,18,25,29,1,28,5,0.0,0.0
1016,1443,2020-03-19 10:59:00,1,1802.0,1604.0,0.89,8.875,32,32,3,29,0,0,0,0,0.0,0.0
1016,1444,2020-03-19 11:02:00,1,1530.0,1392.0,0.91,7.569,19,19,1,18,0,0,0,0,0.0,0.0
1016,1445,2020-03-19 11:05:00,1,1455.0,1356.0,0.932,7.234,10,10,3,7,0,0,0,0,0.0,0.0
1016,1446,2020-03-19 11:08:00,1,1467.0,1348.0,0.919,7.271,4,1,1,0,3,1,2,0,0.0,0.0
1016,1447,2020-03-19 11:11:00,1,1451.0,1337.0,0.922,7.197,1,1,1,0,0,0,0,0,0.0,0.0
1016,1448,2020-03-19 11:14:00,1,1471.0,1298.0,0.882,7.234,10,10,0,10,0,0,0,0,0.0,0.0
1016,1449,2020-03-19 11:17:00,1,1627.0,1335.0,0.821,7.887,30,13,7,6,17,1,16,0,0.0,0.0
1016,1450,2020-03-19 11:20:00,1,1625.0,1346.0,0.828,7.894,0,0,0,0,0,0,0,0,0.0,0.0
1016,1451,2020-03-19 11:23:00,1,1618.0,1374.0,0.849,7.896,5,0,0,0,5,1,4,0,0.0,0.0
1016,1452,2020-03-19 11:26:00,1,1623.0,1358.0,0.836,7.897,16,0,0,0,16,0,16,0,0.0,0.0
1016,1453,2020-03-19 11:29:00,1,1632.0,1314.0,0.805,7.883,41,32,3,29,9,0,9,0,0.0,0.0
1016,1454,2020-03-19 11:32:00,1,1627.0,1355.0,0.833,7.911,6,0,0,0,6,0,6,0,0.0,0.0
1016,1455,2020-03-19 11:35:00,1,1554.5,1313.0,0.8455,7.5775,3,2,1,1,1,0,1,0,0.0,0.0
1016,1456,2020-03-19 11:38:00,1,1482.0,1271.0,0.858,7.244,15,8,5,3,7,0,7,1,0.0,0.0
1016,1457,2020-03-19 11:41:00,1,1623.0,1359.0,0.837,7.9,29,17,14,3,12,2,10,1,0.0,0.0
1016,1458,2020-03-19 11:44:00,1,1493.0,1256.0,0.841,7.273,1,1,1,0,0,0,0,0,0.0,0.0
1016,1459,2020-03-19 11:47:00,1,1504.0,1195.0,0.794,7.249,2,0,0,0,2,1,1,0,0.0,0.0
1016,1460,2020-03-19 11:50:00,1,1492.0,1196.0,0.802,7.205,2,0,0,0,2,0,2,0,0.0,0.0
1016,1461,2020-03-19 11:53:00,1,1506.0,1190.0,0.791,7.25,6,5,1,4,1,1,0,0,0.0,0.0
1016,1462,2020-03-19 11:56:00,1,1489.0,1264.0,0.849,7.265,9,8,0,8,1,0,1,0,0.0,0.0
1016,1463,2020-03-19 11:59:00,1,1487.0,1215.0,0.817,7.202,18,16,6,10,2,1,1,0,0.0,0.0
1016,1464,2020-03-19 12:02:00,1,1488.0,1248.0,0.838,7.244,5,3,0,3,2,0,2,0,0.0,0.0
1016,1465,2020-03-19 12:05:00,1,1363.0,1128.0,0.828,6.617,7,7,0,7,0,0,0,0,0.0,0.0
1016,1466,2020-03-19 12:08:00,1,1508.0,1191.0,0.79,7.259,6,6,0,6,0,0,0,0,0.0,0.0
1016,1467,2020-03-19 12:11:00,1,1484.0,1252.0,0.843,7.234,5,5,0,5,0,0,0,0,0.0,0.0
1016,1468,2020-03-19 12:14:00,1,1631.0,1318.0,0.808,7.885,1,1,0,1,0,0,0,0,0.0,0.0
1016,1469,2020-03-19 12:17:00,1,1642.0,1283.0,0.781,7.891,129,110,73,37,19,0,19,26,0.0,0.0
1016,1470,2020-03-19 12:20:00,1,1700.0,1385.0,0.814,8.232,366,220,155,65,146,109,37,62,0.0,0.0
1016,1471,2020-03-19 12:23:00,1,1843.0,1456.0,0.79,8.873,92,68,32,36,24,4,20,10,0.0,0.0
1016,1472,2020-03-19 12:26:00,1,1837.0,1427.0,0.777,8.818,56,22,1,21,34,6,28,1,0.0,0.0
1016,1473,2020-03-19 12:29:00,1,1695.0,1384.0,0.816,8.21,46,39,20,19,7,1,6,3,0.0,0.0
1016,1474,2020-03-19 12:32:00,1,1645.0,1295.0,0.787,7.913,2,1,0,1,1,0,1,0,0.0,0.0
1016,1475,2020-03-19 12:35:00,1,1497.0,1215.0,0.811,7.242,0,0,0,0,0,0,0,0,0.0,0.0
1016,1476,2020-03-19 12:38:00,1,1510.0,1142.0,0.756,7.215,1,0,0,0,1,0,1,0,0.0,0.0
1016,1477,2020-03-19 12:41:00,1,1518.0,1121.0,0.738,7.223,4,2,0,2,2,0,2,0,0.0,0.0
1016,1478,2020-03-19 12:44:00,1,1519.0,1129.0,0.744,7.235,0,0,0,0,0,0,0,0,0.0,0.0
1016,1479,2020-03-19 12:47:00,1,1378.0,1033.0,0.75,6.573,13,4,0,4,9,0,9,0,0.0,0.0
1016,1480,2020-03-19 12:50:00,1,1384.0,1033.0,0.747,6.598,24,7,7,0,17,2,15,0,0.0,0.0
1016,1481,2020-03-19 12:53:00,1,1517.0,1145.0,0.755,7.246,4,0,0,0,4,0,4,0,0.0,0.0
1016,1482,2020-03-19 12:56:00,1,1492.0,1211.0,0.811,7.221,2,0,0,0,2,0,2,0,0.0,0.0
1016,1483,2020-03-19 12:59:00,1,1506.0,1204.0,0.799,7.269,1,0,0,0,1,0,1,0,0.0,0.0
1016,1484,2020-03-19 13:02:00,1,1513.0,1143.0,0.755,7.227,27,24,6,18,3,0,3,0,0.0,0.0
1016,1485,2020-03-19 13:05:00,1,1516.0,1149.0,0.758,7.246,5,5,0,5,0,0,0,0,0.0,0.0
1016,1486,2020-03-19 13:08:00,1,1499.0,1123.0,0.749,7.15,6,6,1,5,0,0,0,0,0.0,0.0
1016,1487,2020-03-19 13:11:00,1,1504.0,1182.0,0.786,7.234,54,43,21,22,11,4,7,0,0.0,0.0
1016,1488,2020-03-19 13:14:00,1,1502.0,1218.0,0.811,7.265,5,0,0,0,5,0,5,0,0.0,0.0
1016,1489,2020-03-19 13:17:00,1,1631.0,1346.0,0.825,7.918,196,158,112,46,38,14,24,14,0.0,0.0
1016,1490,2020-03-19 13:20:00,1,1989.0,1540.0,0.774,9.541,161,86,53,33,75,38,37,78,0.0,0.02
1016,1491,2020-03-19 13:23:00,1,1691.0,1379.0,0.815,8.191,327,199,125,74,128,82,46,26,0.11,0.03
1016,1492,2020-03-19 13:26:00,1,1834.0,1474.0,0.804,8.858,481,292,229,63,189,121,68,17,0.0,0.04
1016,1493,2020-03-19 13:29:00,1,1835.0,1506.0,0.821,8.898,275,165,107,58,110,68,42,25,0.0,0.0
1016,1494,2020-03-19 13:32:00,1,1978.0,1603.0,0.811,9.569,175,122,72,50,53,17,36,18,0.0,0.0
1016,1495,2020-03-19 13:35:00,1,1878.0,1589.0,0.846,9.16,32,13,8,5,19,0,19,3,0.0,0.0
1016,1496,2020-03-19 13:38:00,1,1804.0,1608.0,0.891,8.888,131,122,79,43,9,1,8,9,0.0,0.0
1016,1497,2020-03-19 13:41:00,1,1807.0,1600.0,0.885,8.889,274,259,191,68,15,3,12,0,0.0,0.0
1016,1498,2020-03-19 13:44:00,1,1824.0,1573.0,0.862,8.928,144,135,55,80,9,4,5,0,0.0,0.0
1016,1499,2020-03-19 13:47:00,1,1599.0,1433.0,0.896,7.887,24,22,4,18,2,0,2,0,0.0,0.0
1016,1500,2020-03-19 13:50:00,1,1462.0,1318.0,0.901,7.22,90,60,12,48,30,22,8,0,0.0,0.0
1016,1501,2020-03-19 13:53:00,1,1491.0,1249.0,0.837,7.258,70,69,6,63,1,1,0,0,0.0,0.0
1016,1502,2020-03-19 13:56:00,1,1485.0,1257.0,0.846,7.242,69,67,1,66,2,2,0,0,0.0,0.0
1016,1503,2020-03-19 13:59:00,1,1483.0,1253.0,0.845,7.231,66,66,0,66,0,0,0,0,0.0,0.0
1016,1504,2020-03-19 14:02:00,1,1478.0,1260.0,0.853,7.217,58,57,0,57,1,0,1,0,0.0,0.0
1016,1505,2020-03-19 14:05:00,1,1481.0,1263.0,0.853,7.235,46,38,0,38,8,0,8,0,0.0,0.0
1016,1506,2020-03-19 14:08:00,1,1485.0,1252.0,0.843,7.238,68,68,0,68,0,0,0,0,0.0,0.0
1016,1507,2020-03-19 14:11:00,1,1478.0,1299.0,0.879,7.261,81,67,4,63,14,0,14,0,0.0,0.0
1016,1508,2020-03-19 14:14:00,1,1628.0,1358.0,0.835,7.916,58,21,7,14,37,20,17,0,0.0,0.0
1016,1509,2020-03-19 14:17:00,1,1615.0,1317.0,0.815,7.822,26,24,5,19,2,0,2,0,0.0,0.0
1016,1510,2020-03-19 14:20:00,1,1606.0,1412.0,0.879,7.893,63,40,19,21,23,0,23,0,0.0,0.0
1016,1511,2020-03-19 14:23:00,1,1890.0,1600.0,0.846,9.217,330,188,130,58,142,96,46,67,0.09,0.0
1016,1512,2020-03-19 14:26:00,1,2179.0,1733.0,0.796,10.503,459,270,214,56,189,137,52,106,0.0,0.0
1016,1513,2020-03-19 14:29:00,1,1827.0,1516.0,0.83,8.876,41,22,18,4,19,10,9,17,0.0,0.31
1016,1514,2020-03-19 14:32:00,1,1817.0,1532.0,0.843,8.854,30,19,4,15,11,6,5,2,0.0,0.0
1016,1515,2020-03-19 14:35:00,1,1653.5,1391.0,0.841,8.0535,10,8,6,2,2,1,1,0,0.03,0.01
1016,1516,2020-03-19 14:38:00,1,1490.0,1250.0,0.839,7.253,8,0,0,0,8,0,8,0,0.0,0.0
1016,1517,2020-03-19 14:41:00,1,1471.0,1264.0,0.859,7.194,6,1,1,0,5,0,5,0,0.0,0.0
1016,1518,2020-03-19 14:44:00,1,1544.0,1321.0,0.856,7.544,1,0,0,0,1,0,1,0,0.0,0.0
1016,1519,2020-03-19 14:47:00,1,1462.0,1340.0,0.916,7.244,62,38,34,4,24,16,8,0,0.02,0.0
1016,1520,2020-03-19 14:50:00,1,1477.0,1245.0,0.843,7.196,0,0,0,0,0,0,0,0,0.01,0.0
1016,1521,2020-03-19 14:53:00,1,1327.0,1217.0,0.917,6.574,0,0,0,0,0,0,0,0,0.0,0.0
1016,1522,2020-03-19 14:56:00,1,1465.0,1320.0,0.9,7.235,19,13,5,8,6,0,6,0,0.01,0.0
1016,1523,2020-03-19 14:59:00,1,1532.0,1395.0,0.91,7.581,10,8,2,6,2,0,2,0,0.0,0.0
1016,1524,2020-03-19 15:02:00,1,1455.0,1359.0,0.934,7.236,3,3,0,3,0,0,0,0,0.01,0.0
1016,1525,2020-03-19 15:05:00,1,1461.0,1338.0,0.916,7.237,5,5,0,5,0,0,0,0,0.01,0.0
1016,1526,2020-03-19 15:08:00,1,1477.0,1298.0,0.879,7.258,47,35,20,15,12,3,9,0,0.07,0.0
1016,1527,2020-03-19 15:11:00,1,1603.0,1450.0,0.905,7.92,135,97,35,62,38,9,29,12,0.0,0.0
1016,1528,2020-03-19 15:14:00,1,2272.0,2104.0,0.926,11.28,325,196,164,32,129,92,37,120,0.25,0.03
1016,1529,2020-03-19 15:17:00,1,1942.0,1702.0,0.876,9.538,339,188,134,54,151,105,46,102,0.0,0.0
1016,1530,2020-03-19 15:20:00,1,2062.0,1877.0,0.91,10.204,511,237,181,56,274,206,68,6,0.17,0.0
1016,1531,2020-03-19 15:23:00,1,1933.0,1742.0,0.901,9.546,12,7,3,4,5,0,5,5,0.0,0.0
1016,1532,2020-03-19 15:26:00,1,1927.0,1745.0,0.905,9.525,43,26,14,12,17,0,17,4,0.0,0.0
1016,1533,2020-03-19 15:29:00,1,1949.0,1732.0,0.889,9.598,87,41,15,26,46,2,44,1,0.0,0.0
1016,1534,2020-03-19 15:32:00,1,1946.0,1705.0,0.876,9.554,37,24,5,19,13,0,13,0,0.0,0.0
1016,1535,2020-03-19 15:35:00,1,1723.0,1549.0,0.9,8.502,2,2,0,2,0,0,0,0,0.0,0.0
1016,1536,2020-03-19 15:38:00,1,1591.0,1471.0,0.925,7.898,15,15,0,15,0,0,0,0,0.0,0.0
1016,1537,2020-03-19 15:41:00,1,1581.0,1503.0,0.951,7.894,3,2,0,2,1,0,1,0,0.0,0.0
1016,1538,2020-03-19 15:44:00,1,1605.0,1434.0,0.893,7.913,3,0,0,0,3,0,3,0,0.0,0.0
1016,1539,2020-03-19 15:47:00,1,1608.0,1437.0,0.894,7.928,9,5,3,2,4,0,4,0,0.0,0.0
1016,1540,2020-03-19 15:50:00,1,1592.0,1434.0,0.901,7.859,15,13,8,5,2,0,2,0,0.0,0.0
1016,1541,2020-03-19 15:53:00,1,1604.0,1401.0,0.874,7.87,4,4,1,3,0,0,0,0,0.0,0.0
1016,1542,2020-03-19 15:56:00,1,1597.0,1446.0,0.906,7.894,8,7,2,5,1,0,1,0,0.0,0.0
1016,1543,2020-03-19 15:59:00,1,1600.0,1450.0,0.906,7.911,5,4,1,3,1,0,1,0,0.0,0.0
1016,1544,2020-03-19 16:02:00,1,1601.0,1441.0,0.9,7.904,6,3,2,1,3,0,3,0,0.0,0.0
1016,1545,2020-03-19 16:05:00,1,1592.0,1411.0,0.886,7.834,0,0,0,0,0,0,0,0,0.0,0.0
1016,1546,2020-03-19 16:08:00,1,1589.0,1460.0,0.919,7.876,4,0,0,0,4,0,4,0,0.0,0.0
1016,1547,2020-03-19 16:11:00,1,1614.0,1388.0,0.86,7.894,76,49,22,27,27,4,23,0,0.0,0.0
1016,1548,2020-03-19 16:14:00,1,1748.0,1521.0,0.871,8.57,60,47,16,31,13,0,13,10,0.0,0.0
1016,1549,2020-03-19 16:17:00,1,1819.0,1594.0,0.876,8.933,30,13,5,8,17,0,17,4,0.0,0.0
1016,1550,2020-03-19 16:20:00,1,1827.0,1571.0,0.86,8.938,78,49,27,22,29,0,29,5,0.0,0.0
1016,1551,2020-03-19 16:23:00,1,1753.0,1506.0,0.859,8.576,24,12,1,11,12,0,12,0,0.0,0.0
1016,1552,2020-03-19 16:26:00,1,1610.0,1397.0,0.867,7.891,20,17,0,17,3,0,3,0,0.0,0.0
1016,1553,2020-03-19 16:29:00,1,1618.0,1389.0,0.859,7.914,5,5,0,5,0,0,0,0,0.0,0.0
1016,1554,2020-03-19 16:32:00,1,1628.0,1339.0,0.822,7.895,4,4,1,3,0,0,0,0,0.0,0.0
1016,1555,2020-03-19 16:35:00,1,1629.0,1330.0,0.817,7.891,0,0,0,0,0,0,0,0,0.0,0.0
1016,1556,2020-03-19 16:38:00,1,1629.0,1358.0,0.834,7.923,19,9,2,7,10,0,10,0,0.0,0.0
1016,1557,2020-03-19 16:41:00,1,1620.0,1408.0,0.869,7.944,46,41,33,8,5,3,2,7,0.0,0.0
1016,1558,2020-03-19 16:44:00,1,1615.0,1394.0,0.863,7.907,4,4,2,2,0,0,0,0,0.0,0.0
1016,1559,2020-03-19 16:47:00,1,1609.0,1384.0,0.86,7.87,3,3,1,2,0,0,0,0,0.0,0.0
1016,1560,2020-03-19 16:50:00,1,1621.0,1348.0,0.832,7.88,0,0,0,0,0,0,0,0,0.0,0.0
1016,1561,2020-03-19 16:53:00,1,1618.0,1346.0,0.832,7.864,99,69,41,28,30,7,23,41,0.0,0.04
1016,1562,2020-03-19 16:56:00,1,1840.0,1508.0,0.819,8.92,126,67,39,28,59,37,22,16,0.0,0.05
1016,1563,2020-03-19 16:59:00,1,1836.0,1496.0,0.815,8.888,67,53,31,22,14,0,14,14,0.03,0.01
1016,1564,2020-03-19 17:02:00,1,1981.0,1619.0,0.817,9.598,67,39,16,23,28,2,26,3,0.02,0.02
1016,1565,2020-03-19 17:05:00,1,1809.0,1517.0,0.838,8.808,1,0,0,0,1,0,1,0,0.0,0.0
1016,1566,2020-03-19 17:08:00,1,1748.0,1476.0,0.844,8.52,2,0,0,0,2,0,2,0,0.0,0.0
1016,1567,2020-03-19 17:11:00,1,1750.0,1493.0,0.853,8.548,12,6,2,4,6,0,6,0,0.0,0.0
1016,1568,2020-03-19 17:14:00,1,1824.0,1534.0,0.841,8.885,2,0,0,0,2,0,2,0,0.0,0.0
1016,1569,2020-03-19 17:17:00,1,1746.0,1514.0,0.867,8.555,1,1,0,1,0,0,0,0,0.0,0.0
1016,1570,2020-03-19 17:20:00,1,1743.0,1519.0,0.871,8.551,1,1,0,1,0,0,0,0,0.06,0.0
1016,1571,2020-03-19 17:23:00,1,1742.0,1523.0,0.874,8.548,96,61,42,19,35,9,26,48,0.09,0.03
1016,1572,2020-03-19 17:26:00,1,1824.0,1534.0,0.841,8.885,138,104,60,44,34,15,19,18,0.08,0.01
1016,1573,2020-03-19 17:29:00,1,1927.0,1770.0,0.919,9.553,103,82,32,50,21,0,21,1,0.0,0.02
1016,1574,2020-03-19 17:32:00,1,1937.0,1759.0,0.908,9.577,132,131,108,23,1,0,1,0,0.0,0.0
1016,1575,2020-03-19 17:35:00,1,1867.0,1680.5,0.9,9.2145,61,44,23,21,17,5,12,0,0.0,0.0
1016,1576,2020-03-19 17:38:00,1,1797.0,1602.0,0.892,8.852,26,22,3,19,4,1,3,0,0.0,0.0
1016,1577,2020-03-19 17:41:00,1,1646.0,1551.0,0.942,8.204,2,2,0,2,0,0,0,0,0.0,0.0
1016,1578,2020-03-19 17:44:00,1,1587.0,1502.0,0.947,7.915,6,6,0,6,0,0,0,0,0.0,0.0
1016,1579,2020-03-19 17:47:00,1,1600.0,1481.0,0.925,7.944,0,0,0,0,0,0,0,0,0.0,0.0
1016,1580,2020-03-19 17:50:00,1,1573.0,1475.0,0.937,7.831,3,3,0,3,0,0,0,0,0.0,0.0
1016,1581,2020-03-19 17:53:00,1,1582.0,1515.0,0.957,7.91,17,17,4,13,0,0,0,0,0.0,0.0
1016,1582,2020-03-19 17:56:00,1,1659.0,1538.0,0.927,8.24,10,10,0,10,0,0,0,0,0.0,0.0
1016,1583,2020-03-19 17:59:00,1,1658.0,1542.0,0.93,8.239,0,0,0,0,0,0,0,0,0.0,0.01
1016,1584,2020-03-19 18:02:00,0,1932.0,1744.0,0.902,9.544,343,225,164,61,118,76,42,28,0.0,0.0
1016,1585,2020-03-19 18:05:00,0,1939.0,1769.0,0.912,9.597,144,128,83,45,16,2,14,49,0.0,0.0
1016,1586,2020-03-19 18:08:00,0,2150.0,1858.0,0.864,10.526,73,58,21,37,15,2,13,10,0.0,0.0
1016,1587,2020-03-19 18:11:00,0,2137.0,1914.0,0.896,10.54,251,164,114,50,87,59,28,32,0.0,0.03
1016,1588,2020-03-19 18:14:00,0,2152.0,1884.0,0.875,10.566,9,5,1,4,4,0,4,0,0.0,0.0
1016,1589,2020-03-19 18:17:00,0,2028.0,1762.0,0.869,9.939,33,27,5,22,6,2,4,0,0.0,0.0
1016,1590,2020-03-19 18:20:00,0,1957.0,1685.0,0.861,9.575,0,0,0,0,0,0,0,0,0.0,0.0
1016,1591,2020-03-19 18:23:00,0,2014.0,1703.0,0.846,9.819,42,9,4,5,33,0,33,1,0.0,0.0
1016,1592,2020-03-19 18:26:00,0,2148.0,1807.0,0.841,10.465,74,41,16,25,33,0,33,24,0.0,0.0
1016,1593,2020-03-19 18:29:00,0,2287.0,1947.0,0.851,11.166,153,126,70,56,27,0,27,16,0.0,0.0
1016,1594,2020-03-19 18:32:00,0,2303.0,1968.0,0.855,11.254,95,76,34,42,19,2,17,13,0.0,0.0
1016,1595,2020-03-19 18:35:00,0,2452.0,2007.0,0.819,11.883,339,233,180,53,106,58,48,95,0.0,0.0
1016,1596,2020-03-19 18:38:00,0,2536.0,1992.0,0.785,12.196,566,339,273,66,227,179,48,171,0.0,0.0
1016,1597,2020-03-19 18:41:00,0,2650.0,2156.0,0.814,12.826,472,317,248,69,155,120,35,156,0.0,0.0
1016,1598,2020-03-19 18:44:00,0,2589.0,2025.0,0.782,12.442,493,293,214,79,200,143,57,62,0.0,0.0
1016,1599,2020-03-19 18:47:00,0,2593.0,2015.0,0.777,12.446,377,241,194,47,136,104,32,180,0.0,0.12
1016,1600,2020-03-19 18:50:00,0,2746.0,2146.0,0.781,13.197,429,249,190,59,180,131,49,125,0.0,0.0
1016,1601,2020-03-19 18:53:00,0,2677.0,2107.0,0.787,12.88,430,287,219,68,143,108,35,196,0.01,0.0
1016,1602,2020-03-19 18:56:00,0,2538.0,1892.0,0.746,12.094,171,126,86,40,45,19,26,111,0.0,0.0
1016,1603,2020-03-19 18:59:00,0,2683.0,2013.0,0.75,12.798,365,140,99,41,225,172,53,10,0.03,0.0
1016,1604,2020-03-19 19:02:00,0,2544.0,1905.0,0.749,12.134,354,244,195,49,110,84,26,250,0.0,0.0
1016,1605,2020-03-19 19:05:00,0,2692.0,2040.0,0.758,12.867,405,236,197,39,169,129,40,158,0.34,0.0
1016,1606,2020-03-19 19:08:00,0,2889.0,2218.0,0.768,13.838,535,391,292,99,144,104,40,77,0.0,0.0
1016,1607,2020-03-19 19:11:00,0,3027.0,2211.0,0.731,14.374,516,315,243,72,201,143,58,37,0.0,0.0
1016,1608,2020-03-19 19:14:00,0,2689.0,1971.0,0.733,12.779,444,271,205,66,173,127,46,171,0.0,0.0
1016,1609,2020-03-19 19:17:00,0,2687.0,1996.0,0.743,12.795,367,220,167,53,147,98,49,127,0.04,0.0
1016,1610,2020-03-19 19:20:00,0,2919.0,2129.0,0.729,13.857,442,241,169,72,201,145,56,143,0.0,0.0
1016,1611,2020-03-19 19:23:00,0,2668.0,2013.0,0.755,12.74,314,214,168,46,100,71,29,137,0.0,0.0
1016,1612,2020-03-19 19:26:00,0,2705.0,1992.0,0.737,12.864,355,220,166,54,135,98,37,111,0.0,0.0
1016,1613,2020-03-19 19:29:00,0,2824.0,2124.0,0.752,13.479,527,328,257,71,199,156,43,108,0.0,0.0
1016,1614,2020-03-19 19:32:00,0,2551.0,1889.0,0.74,12.144,497,298,232,66,199,154,45,127,0.0,0.0
1016,1615,2020-03-19 19:35:00,0,2549.0,1910.0,0.749,12.159,433,252,192,60,181,124,57,97,0.0,0.0
1016,1616,2020-03-19 19:38:00,0,2358.0,1688.0,0.716,11.159,298,156,124,32,142,85,57,85,0.03,0.0
1016,1617,2020-03-19 19:41:00,0,2835.0,2070.0,0.73,13.464,716,391,287,104,325,231,94,80,0.0,0.0
1016,1618,2020-03-19 19:44:00,0,2749.0,2115.0,0.77,13.173,138,77,55,22,61,39,22,41,0.0,0.0
1016,1619,2020-03-19 19:47:00,0,2029.0,1417.0,0.699,9.562,79,57,21,36,22,2,20,2,0.0,0.0
1016,1620,2020-03-19 19:50:00,0,2680.0,1950.0,0.728,12.719,182,94,74,20,88,46,42,12,0.0,0.0
1016,1621,2020-03-19 19:53:00,0,2541.0,1841.0,0.724,12.051,159,85,57,28,74,40,34,1,0.0,0.0
1016,1622,2020-03-19 19:56:00,0,2494.0,1819.0,0.729,11.839,393,234,173,61,159,113,46,28,0.0,0.0
1016,1623,2020-03-19 19:59:00,0,2418.0,1790.0,0.74,11.51,67,52,27,25,15,3,12,13,0.0,0.0
1016,1624,2020-03-19 20:02:00,0,2393.0,1772.0,0.74,11.389,109,87,41,46,22,0,22,8,0.0,0.0
1016,1625,2020-03-19 20:05:00,0,2338.0,1697.0,0.726,11.09,65,15,7,8,50,7,43,3,0.0,0.0
1016,1626,2020-03-19 20:08:00,0,2346.0,1734.0,0.739,11.162,84,30,8,22,54,4,50,0,0.0,0.0
1016,1627,2020-03-19 20:11:00,0,2342.0,1801.0,0.769,11.221,192,90,49,41,102,61,41,20,0.0,0.0
1016,1628,2020-03-19 20:14:00,0,2628.0,1927.0,0.733,12.488,134,101,69,32,33,18,15,5,0.0,0.0
1016,1629,2020-03-19 20:17:00,0,2544.0,1899.0,0.746,12.127,82,56,32,24,26,19,7,6,0.0,0.0
1016,1630,2020-03-19 20:20:00,0,2410.0,1823.0,0.756,11.515,128,52,23,29,76,51,25,12,0.0,0.0
1016,1631,2020-03-19 20:23:00,0,2342.0,1717.0,0.733,11.13,68,34,20,14,34,26,8,3,0.0,0.0
1016,1632,2020-03-19 20:26:00,0,2230.0,1569.0,0.704,10.524,5,5,2,3,0,0,0,0,0.0,0.0
1016,1633,2020-03-19 20:29:00,0,2238.0,1565.0,0.699,10.55,137,109,71,38,28,11,17,60,0.0,0.0
1016,1634,2020-03-19 20:32:00,0,2475.0,1799.0,0.727,11.744,202,135,89,46,67,39,28,49,0.0,0.0
1016,1635,2020-03-19 20:35:00,0,2511.5,1839.0,0.732,11.931,259,134,116,18,125,101,24,71,0.0,0.0
1016,1636,2020-03-19 20:38:00,0,2548.0,1879.0,0.737,12.118,278,141,85,56,137,83,54,69,0.0,0.0
1016,1637,2020-03-19 20:41:00,0,2568.0,1871.0,0.728,12.192,210,109,75,34,101,66,35,41,0.0,0.0
1016,1638,2020-03-19 20:44:00,0,2560.0,1869.0,0.73,12.155,16,15,0,15,1,0,1,0,0.0,0.0
1016,1639,2020-03-19 20:47:00,0,2335.0,1775.0,0.76,11.166,92,70,28,42,22,5,17,31,0.0,0.0
1016,1640,2020-03-19 20:50:00,0,2554.0,1870.0,0.732,12.135,427,208,167,41,219,155,64,132,0.0,0.0
1016,1641,2020-03-19 20:53:00,0,2487.0,1855.0,0.746,11.852,166,121,93,28,45,28,17,141,0.0,0.0
1016,1642,2020-03-19 20:56:00,0,2328.0,1823.0,0.783,11.193,475,258,211,47,217,167,50,78,0.0,0.0
1016,1643,2020-03-19 20:59:00,0,2341.0,1774.0,0.758,11.187,74,50,32,18,24,10,14,7,0.0,0.0
1016,1644,2020-03-19 21:02:00,0,2218.0,1641.0,0.74,10.555,3,1,1,0,2,0,2,0,0.0,0.0
1016,1645,2020-03-19 21:05:00,0,2212.0,1606.0,0.726,10.494,4,1,1,0,3,0,3,0,0.0,0.0
1016,1646,2020-03-19 21:08:00,0,1995.0,1518.0,0.761,9.543,4,3,2,1,1,0,1,0,0.0,0.0
1016,1647,2020-03-19 21:11:00,0,2010.0,1476.0,0.735,9.553,16,13,2,11,3,2,1,4,0.0,0.0
1016,1648,2020-03-19 21:14:00,0,2022.0,1436.0,0.71,9.556,6,4,1,3,2,0,2,45,0.0,0.0
1016,1649,2020-03-19 21:17:00,0,1858.0,1393.0,0.749,8.864,14,8,6,2,6,4,2,45,0.0,0.0
1016,1650,2020-03-19 21:20:00,0,1859.0,1402.0,0.754,8.876,5,5,2,3,0,0,0,61,0.0,0.0
1016,1651,2020-03-19 21:23:00,0,1885.0,1306.0,0.693,8.872,194,101,59,42,93,60,33,70,0.0,0.0
1016,1652,2020-03-19 21:26:00,0,2022.0,1434.0,0.709,9.556,367,203,159,44,164,114,50,111,0.04,0.0
1016,1653,2020-03-19 21:29:00,0,1998.0,1511.0,0.756,9.547,150,60,40,20,90,53,37,18,0.0,0.0
1016,1654,2020-03-19 21:32:00,0,2006.0,1458.0,0.727,9.52,6,4,1,3,2,0,2,41,0.0,0.0
1016,1655,2020-03-19 21:35:00,0,1878.0,1339.0,0.713,8.883,0,0,0,0,0,0,0,23,0.0,0.0
1016,1656,2020-03-19 21:38:00,0,1797.0,1320.0,0.735,8.54,3,3,0,3,0,0,0,0,0.0,0.0
1016,1657,2020-03-19 21:41:00,0,1655.0,1243.0,0.751,7.896,3,1,1,0,2,0,2,0,0.0,0.0
1016,1658,2020-03-19 21:44:00,0,1663.0,1229.0,0.739,7.915,15,10,7,3,5,3,2,0,0.0,0.0
1016,1659,2020-03-19 21:47:00,0,1666.0,1209.0,0.726,7.902,0,0,0,0,0,0,0,0,0.0,0.0
1016,1660,2020-03-19 21:50:00,0,1662.0,1226.0,0.737,7.905,4,0,0,0,4,0,4,0,0.0,0.0
1016,1661,2020-03-19 21:53:00,0,1663.0,1223.0,0.735,7.909,0,0,0,0,0,0,0,0,0.0,0.0
1016,1662,2020-03-19 21:56:00,0,1514.0,1154.0,0.762,7.243,2,0,0,0,2,0,2,0,0.0,0.0
1016,1663,2020-03-19 21:59:00,0,1657.0,1184.0,0.715,7.841,1,0,0,0,1,0,1,0,0.0,0.0
1016,1664,2020-03-19 22:02:00,0,1656.0,1208.0,0.729,7.863,7,6,1,5,1,0,1,0,0.0,0.0
1016,1665,2020-03-19 22:05:00,0,1663.0,1215.0,0.73,7.897,1,1,0,1,0,0,0,0,0.0,0.0
1016,1666,2020-03-19 22:08:00,0,1670.0,1186.0,0.71,7.894,0,0,0,0,0,0,0,0,0.0,0.0
1016,1667,2020-03-19 22:11:00,0,1651.0,1179.0,0.714,7.812,50,38,22,16,12,0,12,3,0.0,0.0
1016,1668,2020-03-19 22:14:00,0,1647.0,1242.0,0.754,7.864,395,242,173,69,153,86,67,3,0.0,0.0
1016,1669,2020-03-19 22:17:00,0,1854.0,1378.0,0.743,8.83,448,270,212,58,178,130,48,86,0.0,0.0
1016,1670,2020-03-19 22:20:00,0,1994.0,1510.0,0.757,9.528,280,172,118,54,108,78,30,180,0.0,0.0
1016,1671,2020-03-19 22:23:00,0,2226.0,1613.0,0.725,10.555,274,107,58,49,167,115,52,18,0.0,0.0
1016,1672,2020-03-19 22:26:00,0,2218.0,1648.0,0.743,10.565,116,57,24,33,59,26,33,3,0.0,0.0
1016,1673,2020-03-19 22:29:00,0,2158.0,1541.0,0.714,10.208,548,193,148,45,355,269,86,54,0.18,0.0
1016,1674,2020-03-19 22:32:00,0,2354.0,1717.0,0.73,11.176,1204,734,595,139,470,355,115,37,0.0,0.0
1016,1675,2020-03-19 22:35:00,0,2562.0,1884.0,0.735,12.181,1478,828,653,175,650,509,141,37,0.0,0.0
1016,1676,2020-03-19 22:38:00,0,2559.0,1955.0,0.764,12.245,1357,820,672,148,537,408,129,30,0.0,0.0
1016,1677,2020-03-19 22:41:00,0,2396.0,1864.0,0.778,11.503,733,458,369,89,275,195,80,30,0.0,0.0
1016,1678,2020-03-19 22:44:00,0,2320.0,1834.0,0.791,11.17,249,159,122,37,90,62,28,110,0.0,0.0
1016,1679,2020-03-19 22:47:00,0,2483.0,1877.0,0.756,11.86,126,110,68,42,16,4,12,2,0.0,0.0
1016,1680,2020-03-19 22:50:00,0,2408.0,1853.0,0.769,11.538,135,67,33,34,68,29,39,3,0.0,0.0
1016,1681,2020-03-19 22:53:00,0,2340.0,1747.0,0.747,11.153,779,456,335,121,323,219,104,12,0.0,0.0
1016,1682,2020-03-19 22:56:00,0,2340.0,1775.0,0.758,11.187,1470,882,705,177,588,452,136,29,0.0,0.0
1016,1683,2020-03-19 22:59:00,0,2349.0,1750.0,0.745,11.192,853,444,356,88,409,296,113,23,0.01,0.0
1016,1684,2020-03-19 23:02:00,0,2349.0,1753.0,0.746,11.197,597,300,230,70,297,204,93,25,0.08,0.0
1016,1685,2020-03-19 23:05:00,0,2179.0,1678.0,0.77,10.444,167,98,41,57,69,42,27,1,0.0,0.0
1016,1686,2020-03-19 23:08:00,0,2191.0,1680.0,0.767,10.495,299,179,140,39,120,86,34,1,0.0,0.0
1016,1687,2020-03-19 23:11:00,0,2213.0,1634.0,0.738,10.53,39,16,4,12,23,8,15,0,0.0,0.0
1016,1688,2020-03-19 23:14:00,0,2152.0,1596.0,0.741,10.246,22,9,4,5,13,5,8,2,0.0,0.0
1016,1689,2020-03-19 23:17:00,0,1985.0,1537.0,0.775,9.522,24,8,1,7,16,1,15,0,0.0,0.0
1016,1690,2020-03-19 23:20:00,0,2009.0,1486.0,0.74,9.561,26,12,0,12,14,1,13,0,0.0,0.0
1016,1691,2020-03-19 23:23:00,0,2054.0,1563.0,0.761,9.826,99,82,40,42,17,10,7,0,0.0,0.0
1016,1692,2020-03-19 23:26:00,0,2220.0,1645.0,0.741,10.568,76,67,35,32,9,2,7,0,0.0,0.0
1016,1693,2020-03-19 23:29:00,0,2230.0,1582.0,0.709,10.54,12,12,4,8,0,0,0,0,0.0,0.0
1016,1694,2020-03-19 23:32:00,0,1992.0,1464.0,0.735,9.47,10,10,4,6,0,0,0,0,0.0,0.0
1016,1695,2020-03-19 23:35:00,0,1861.0,1378.0,0.741,8.859,10,7,4,3,3,3,0,0,0.0,0.0
1016,1696,2020-03-19 23:38:00,0,1730.0,1292.0,0.747,8.248,47,35,23,12,12,7,5,2,0.0,0.0
1016,1697,2020-03-19 23:41:00,0,1651.0,1228.0,0.743,7.866,10,9,0,9,1,0,1,0,0.0,0.0
1016,1698,2020-03-19 23:44:00,0,1503.0,1167.0,0.776,7.215,8,8,1,7,0,0,0,0,0.0,0.0
1016,1699,2020-03-19 23:47:00,0,1529.0,1105.0,0.723,7.249,3,3,0,3,0,0,0,0,0.0,0.0
1016,1700,2020-03-19 23:50:00,0,1526.0,1097.0,0.719,7.228,13,13,0,13,0,0,0,0,0.0,0.0
1016,1701,2020-03-19 23:53:00,0,1517.0,1134.0,0.747,7.233,8,6,1,5,2,1,1,0,0.0,0.0
1016,1702,2020-03-19 23:56:00,0,1516.0,1138.0,0.751,7.234,0,0,0,0,0,0,0,0,0.0,0.0
1016,1703,2020-03-19 23:59:00,0,1526.0,1102.0,0.722,7.234,26,14,9,5,12,0,12,0,0.0,0.0
1016,1704,2020-03-20 00:02:00,0,1527.0,1107.0,0.725,7.241,10,1,1,0,9,0,9,0,0.0,0.0
1016,1705,2020-03-20 00:05:00,0,1517.0,1129.0,0.744,7.225,11,0,0,0,11,0,11,0,0.0,0.0
1016,1706,2020-03-20 00:08:00,0,1523.0,1123.0,0.738,7.245,54,31,14,17,23,9,14,0,0.0,0.0
1016,1707,2020-03-20 00:11:00,0,1516.0,1139.0,0.751,7.236,0,0,0,0,0,0,0,0,0.0,0.0
1016,1708,2020-03-20 00:14:00,0,1536.0,1076.0,0.701,7.243,1,1,1,0,0,0,0,0,0.0,0.0
1016,1709,2020-03-20 00:17:00,0,1516.0,1137.0,0.75,7.233,1,0,0,0,1,0,1,0,0.0,0.0
1016,1710,2020-03-20 00:20:00,0,1525.0,1106.0,0.725,7.235,3,3,1,2,0,0,0,0,0.0,0.0
1016,1711,2020-03-20 00:23:00,0,1535.0,1096.0,0.714,7.262,1,1,0,1,0,0,0,0,0.0,0.0
1016,1712,2020-03-20 00:26:00,0,1451.0,1061.0,0.732,6.891,0,0,0,0,0,0,0,0,0.0,0.0
1016,1713,2020-03-20 00:29:00,0,1362.0,1026.0,0.753,6.502,0,0,0,0,0,0,0,0,0.0,0.0
1016,1714,2020-03-20 00:32:00,0,1391.0,1012.0,0.728,6.601,11,7,5,2,4,3,1,0,0.0,0.0
1016,1715,2020-03-20 00:35:00,0,1390.0,1003.0,0.722,6.59,0,0,0,0,0,0,0,0,0.0,0.0
1016,1716,2020-03-20 00:38:00,0,1376.0,1012.0,0.735,6.542,38,24,11,13,14,2,12,4,0.0,0.0
1016,1717,2020-03-20 00:41:00,0,1578.0,1187.0,0.752,7.532,127,55,18,37,72,43,29,6,0.0,0.0
1016,1718,2020-03-20 00:44:00,0,2007.0,1498.0,0.747,9.568,382,206,175,31,176,125,51,150,0.0,0.0
1016,1719,2020-03-20 00:47:00,0,2140.0,1614.0,0.754,10.217,411,215,157,58,196,140,56,97,0.0,0.0
1016,1720,2020-03-20 00:50:00,0,2258.0,1693.0,0.75,10.77,298,169,122,47,129,82,47,118,0.0,0.0
1016,1721,2020-03-20 00:53:00,0,2603.0,1942.0,0.746,12.406,516,275,214,61,241,185,56,152,0.23,0.0
1016,1722,2020-03-20 00:56:00,0,2565.0,1863.0,0.726,12.171,64,27,8,19,37,7,30,41,0.0,0.0
1016,1723,2020-03-20 00:59:00,0,2411.0,1824.0,0.757,11.521,49,25,11,14,24,5,19,1,0.0,0.0
1016,1724,2020-03-20 01:02:00,0,2204.0,1664.0,0.755,10.527,0,0,0,0,0,0,0,0,0.0,0.0
1016,1725,2020-03-20 01:05:00,0,2001.0,1507.0,0.753,9.553,15,13,1,12,2,1,1,0,0.0,0.0
1016,1726,2020-03-20 01:08:00,0,1868.0,1381.0,0.739,8.888,8,7,0,7,1,0,1,0,0.0,0.0
1016,1727,2020-03-20 01:11:00,0,1646.0,1287.0,0.782,7.91,3,1,0,1,2,0,2,0,0.0,0.0
1016,1728,2020-03-20 01:14:00,0,1649.0,1224.0,0.742,7.851,7,3,0,3,4,0,4,0,0.0,0.0
1016,1729,2020-03-20 01:17:00,0,1512.0,1146.0,0.758,7.224,8,7,0,7,1,0,1,0,0.0,0.0
1016,1730,2020-03-20 01:20:00,0,1524.0,1109.0,0.727,7.234,0,0,0,0,0,0,0,0,0.0,0.0
1016,1731,2020-03-20 01:23:00,0,1456.0,1057.0,0.726,6.908,26,13,6,7,13,4,9,0,0.0,0.0
1016,1732,2020-03-20 01:26:00,0,1520.0,1109.0,0.729,7.219,1,1,0,1,0,0,0,0,0.0,0.0
1016,1733,2020-03-20 01:29:00,0,1528.0,1078.0,0.706,7.212,8,5,0,5,3,0,3,0,0.0,0.0
1016,1734,2020-03-20 01:32:00,0,1531.0,1091.0,0.712,7.242,14,13,0,13,1,0,1,0,0.0,0.0
1016,1735,2020-03-20 01:35:00,0,1379.0,1050.0,0.761,6.596,11,7,0,7,4,0,4,0,0.0,0.0
1016,1736,2020-03-20 01:38:00,0,1384.0,1026.0,0.741,6.589,15,4,0,4,11,0,11,0,0.0,0.0
1016,1737,2020-03-20 01:41:00,0,1453.0,1059.0,0.729,6.896,3,0,0,0,3,0,3,0,0.0,0.0
1016,1738,2020-03-20 01:44:00,0,1520.0,1069.0,0.703,7.172,4,4,0,4,0,0,0,0,0.0,0.0
1016,1739,2020-03-20 01:47:00,0,1454.0,1069.0,0.735,6.915,5,3,0,3,2,0,2,0,0.0,0.0
1016,1740,2020-03-20 01:50:00,0,1533.0,1074.0,0.701,7.23,52,35,11,24,17,2,15,0,0.0,0.0
1016,1741,2020-03-20 01:53:00,0,1507.0,1180.0,0.783,7.244,23,9,4,5,14,4,10,0,0.0,0.0
1016,1742,2020-03-20 01:56:00,0,1518.0,1139.0,0.75,7.244,0,0,0,0,0,0,0,0,0.0,0.0
1016,1743,2020-03-20 01:59:00,0,1520.0,1148.0,0.755,7.261,0,0,0,0,0,0,0,0,0.0,0.0
1016,1744,2020-03-20 02:02:00,0,1512.0,1140.0,0.754,7.219,6,6,4,2,0,0,0,0,0.0,0.0
1016,1745,2020-03-20 02:05:00,0,1663.0,1190.0,0.716,7.872,0,0,0,0,0,0,0,0,0.0,0.0
1016,1746,2020-03-20 02:08:00,0,1513.0,1153.0,0.762,7.238,8,3,1,2,5,2,3,0,0.0,0.0
1016,1747,2020-03-20 02:11:00,0,1515.0,1169.0,0.772,7.262,11,0,0,0,11,0,11,0,0.0,0.0
1016,1748,2020-03-20 02:14:00,0,1497.0,1170.0,0.781,7.195,3,2,1,1,1,0,1,0,0.0,0.0
1016,1749,2020-03-20 02:17:00,0,1584.0,1176.0,0.743,7.544,1,0,0,0,1,0,1,0,0.0,0.0
1016,1750,2020-03-20 02:20:00,0,1664.0,1186.0,0.713,7.872,1,0,0,0,1,0,1,0,0.0,0.0
1016,1751,2020-03-20 02:23:00,0,1668.0,1213.0,0.727,7.917,3,3,1,2,0,0,0,0,0.0,0.0
1016,1752,2020-03-20 02:26:00,0,1585.0,1190.0,0.751,7.562,1,1,0,1,0,0,0,0,0.0,0.0
1016,1753,2020-03-20 02:29:00,0,1504.0,1174.0,0.78,7.227,0,0,0,0,0,0,0,0,0.0,0.0
1016,1754,2020-03-20 02:32:00,0,1514.0,1167.0,0.771,7.258,0,0,0,0,0,0,0,0,0.0,0.0
1016,1755,2020-03-20 02:35:00,0,1543.5,1174.0,0.761,7.381,5,5,0,5,0,0,0,0,0.0,0.0
1016,1756,2020-03-20 02:38:00,0,1573.0,1181.0,0.751,7.504,3,3,0,3,0,0,0,0,0.0,0.0
1016,1757,2020-03-20 02:41:00,0,1506.0,1173.0,0.779,7.231,2,0,0,0,2,0,2,0,0.0,0.0
1016,1758,2020-03-20 02:44:00,0,1520.0,1137.0,0.748,7.248,1,1,0,1,0,0,0,0,0.0,0.0
1016,1759,2020-03-20 02:47:00,0,1518.0,1172.0,0.772,7.277,120,83,41,42,37,21,16,3,0.0,0.0
1016,1760,2020-03-20 02:50:00,0,1866.0,1392.0,0.746,8.892,359,193,151,42,166,127,39,104,0.0,0.0
1016,1761,2020-03-20 02:53:00,0,2150.0,1577.0,0.734,10.217,539,311,230,81,228,171,57,94,0.0,0.0
1016,1762,2020-03-20 02:56:00,0,2216.0,1631.0,0.736,10.536,73,37,13,24,36,4,32,8,0.0,0.0
1016,1763,2020-03-20 02:59:00,0,2191.0,1674.0,0.764,10.488,146,63,28,35,83,53,30,2,0.0,0.0
1016,1764,2020-03-20 03:02:00,0,2049.0,1580.0,0.771,9.825,532,249,187,62,283,205,78,72,0.0,0.0
1016,1765,2020-03-20 03:05:00,0,2255.0,1712.0,0.759,10.779,525,332,261,71,193,130,63,39,0.0,0.0
1016,1766,2020-03-20 03:08:00,0,2191.0,1637.0,0.747,10.445,324,196,153,43,128,90,38,5,0.0,0.0
1016,1767,2020-03-20 03:11:00,0,2143.0,1592.0,0.743,10.204,290,130,103,27,160,102,58,31,0.0,0.0
1016,1768,2020-03-20 03:14:00,0,2209.0,1596.0,0.723,10.471,399,212,161,51,187,127,60,7,0.0,0.0
1016,1769,2020-03-20 03:17:00,0,1984.0,1548.0,0.78,9.531,106,63,34,29,43,18,25,22,0.0,0.0
1016,1770,2020-03-20 03:20:00,0,2225.0,1603.0,0.721,10.541,79,57,25,32,22,6,16,0,0.0,0.0
1016,1771,2020-03-20 03:23:00,0,1991.0,1540.0,0.773,9.55,35,27,13,14,8,1,7,3,0.0,0.0
1016,1772,2020-03-20 03:26:00,0,2001.0,1506.0,0.753,9.55,136,130,84,46,6,2,4,11,0.0,0.0
1016,1773,2020-03-20 03:29:00,0,1931.0,1454.0,0.753,9.22,6,6,0,6,0,0,0,0,0.0,0.0
1016,1774,2020-03-20 03:32:00,0,1715.0,1321.0,0.77,8.218,0,0,0,0,0,0,0,0,0.0,0.0
1016,1775,2020-03-20 03:35:00,0,1656.0,1240.0,0.749,7.897,0,0,0,0,0,0,0,0,0.0,0.0
1016,1776,2020-03-20 03:38:00,0,1508.0,1158.0,0.768,7.224,6,6,2,4,0,0,0,0,0.0,0.0
1016,1777,2020-03-20 03:41:00,0,1513.0,1152.0,0.762,7.235,0,0,0,0,0,0,0,0,0.0,0.0
1016,1778,2020-03-20 03:44:00,0,1519.0,1120.0,0.738,7.223,2,0,0,0,2,0,2,0,0.0,0.0
1016,1779,2020-03-20 03:47:00,0,1513.0,1105.0,0.73,7.187,11,2,0,2,9,0,9,0,0.0,0.0
1016,1780,2020-03-20 03:50:00,0,1517.0,1128.0,0.744,7.226,0,0,0,0,0,0,0,0,0.0,0.0
1016,1781,2020-03-20 03:53:00,0,1448.0,1073.0,0.741,6.892,11,11,0,11,0,0,0,0,0.0,0.0
1016,1782,2020-03-20 03:56:00,0,1376.0,1027.0,0.747,6.557,0,0,0,0,0,0,0,0,0.0,0.0
1016,1783,2020-03-20 03:59:00,0,1390.0,1002.0,0.721,6.587,21,15,8,7,6,5,1,0,0.0,0.0
1016,1784,2020-03-20 04:02:00,0,1380.0,1054.0,0.764,6.604,13,9,7,2,4,1,3,0,0.0,0.0
1016,1785,2020-03-20 04:05:00,0,1369.0,1031.0,0.753,6.536,7,3,1,2,4,0,4,0,0.0,0.0
1016,1786,2020-03-20 04:08:00,0,1378.0,1036.0,0.752,6.576,5,1,1,0,4,0,4,0,0.0,0.0
1016,1787,2020-03-20 04:11:00,0,1373.0,1051.0,0.766,6.573,10,8,1,7,2,0,2,0,0.0,0.0
1016,1788,2020-03-20 04:14:00,0,1381.0,1050.0,0.76,6.603,31,27,17,10,4,0,4,0,0.0,0.0
1016,1789,2020-03-20 04:17:00,0,1382.0,1042.0,0.753,6.6,0,0,0,0,0,0,0,0,0.0,0.0
1016,1790,2020-03-20 04:20:00,0,1381.0,997.0,0.722,6.544,4,3,0,3,1,0,1,0,0.0,0.0
1016,1791,2020-03-20 04:23:00,0,1385.0,986.0,0.712,6.55,9,0,0,0,9,0,9,0,0.0,0.0
1016,1792,2020-03-20 04:26:00,0,1390.0,997.0,0.717,6.58,5,1,0,1,4,0,4,0,0.0,0.0
1016,1793,2020-03-20 04:29:00,0,1533.0,1089.0,0.71,7.247,3,2,2,0,1,0,1,0,0.0,0.0
1016,1794,2020-03-20 04:32:00,0,1527.0,1095.0,0.717,7.228,0,0,0,0,0,0,0,0,0.0,0.0
1016,1795,2020-03-20 04:35:00,0,1527.0,1097.0,0.719,7.23,1,1,0,1,0,0,0,0,0.0,0.0
1016,1796,2020-03-20 04:38:00,0,1521.0,1122.0,0.738,7.235,0,0,0,0,0,0,0,0,0.0,0.0
1016,1797,2020-03-20 04:41:00,0,1515.0,1168.0,0.771,7.264,111,83,31,52,28,8,20,8,0.0,0.0
1016,1798,2020-03-20 04:44:00,0,1640.0,1291.0,0.787,7.891,247,167,121,46,80,53,27,57,0.0,0.0
1016,1799,2020-03-20 04:47:00,0,1866.0,1385.0,0.742,8.886,99,72,47,25,27,12,15,6,0.0,0.0
1016,1800,2020-03-20 04:50:00,0,1927.0,1466.0,0.761,9.216,145,108,61,47,37,18,19,8,0.0,0.0
1016,1801,2020-03-20 04:53:00,0,1931.0,1465.0,0.758,9.231,84,30,14,16,54,5,49,10,0.0,0.0
1016,1802,2020-03-20 04:56:00,0,1841.0,1435.0,0.78,8.841,64,38,10,28,26,2,24,7,0.0,0.0
1016,1803,2020-03-20 04:59:00,0,1845.0,1431.0,0.775,8.853,28,12,7,5,16,3,13,0,0.0,0.0
1016,1804,2020-03-20 05:02:00,0,1866.0,1389.0,0.744,8.891,16,0,0,0,16,0,16,0,0.0,0.0
1016,1805,2020-03-20 05:05:00,0,1721.0,1307.0,0.76,8.228,4,0,0,0,4,2,2,0,0.0,0.0
1016,1806,2020-03-20 05:08:00,0,1654.0,1250.0,0.756,7.9,0,0,0,0,0,0,0,0,0.0,0.0
1016,1807,2020-03-20 05:11:00,0,1643.0,1245.0,0.758,7.854,8,8,0,8,0,0,0,0,0.0,0.0
1016,1808,2020-03-20 05:14:00,0,1707.0,1296.0,0.759,8.162,22,17,6,11,5,5,0,0,0.0,0.0
1016,1809,2020-03-20 05:17:00,0,1655.0,1223.0,0.739,7.874,0,0,0,0,0,0,0,0,0.0,0.0
1016,1810,2020-03-20 05:20:00,0,1514.0,1157.0,0.764,7.248,0,0,0,0,0,0,0,0,0.0,0.0
1016,1811,2020-03-20 05:23:00,0,1525.0,1133.0,0.743,7.264,0,0,0,0,0,0,0,0,0.0,0.0
1016,1812,2020-03-20 05:26:00,0,1509.0,1148.0,0.761,7.215,0,0,0,0,0,0,0,0,0.0,0.0
1016,1813,2020-03-20 05:29:00,0,1511.0,1123.0,0.744,7.196,2,2,0,2,0,0,0,0,0.0,0.0
1016,1814,2020-03-20 05:32:00,0,1522.0,1101.0,0.723,7.214,8,2,1,1,6,0,6,0,0.0,0.0
1016,1815,2020-03-20 05:35:00,0,1568.5,1099.0,0.7015,7.3955,4,0,0,0,4,0,4,0,0.0,0.0
1016,1816,2020-03-20 05:38:00,0,1615.0,1097.0,0.68,7.577,42,22,15,7,20,17,3,2,0.0,0.0
1016,1817,2020-03-20 05:41:00,0,1598.0,1146.0,0.717,7.563,0,0,0,0,0,0,0,0,0.0,0.0
1016,1818,2020-03-20 05:44:00,0,1605.0,1105.0,0.689,7.548,0,0,0,0,0,0,0,0,0.0,0.0
1016,1819,2020-03-20 05:47:00,0,1604.0,1105.0,0.689,7.544,0,0,0,0,0,0,0,0,0.0,0.0
1016,1820,2020-03-20 05:50:00,0,1605.0,1104.0,0.688,7.547,2,2,0,2,0,0,0,0,0.0,0.0
1016,1821,2020-03-20 05:53:00,0,1609.0,1119.0,0.696,7.578,2,2,2,0,0,0,0,0,0.0,0.0
1016,1822,2020-03-20 05:56:00,0,1605.0,1115.0,0.694,7.56,28,20,11,9,8,4,4,0,0.0,0.0
1016,1823,2020-03-20 05:59:00,0,1605.0,1123.0,0.7,7.567,24,22,15,7,2,0,2,0,0.0,0.0
1016,1824,2020-03-20 06:02:00,1,1446.0,1080.0,0.747,6.895,136,77,55,22,59,30,29,33,0.0,0.0
1016,1825,2020-03-20 06:05:00,1,2150.0,1573.0,0.732,10.213,75,41,18,23,34,8,26,71,0.0,0.0
1016,1826,2020-03-20 06:08:00,1,2423.0,1785.0,0.737,11.523,118,36,5,31,82,39,43,87,0.0,0.1
1016,1827,2020-03-20 06:11:00,1,2611.0,1967.0,0.754,12.465,230,138,108,30,92,67,25,106,0.0,0.18
1016,1828,2020-03-20 06:14:00,1,2238.0,1754.0,0.784,10.762,311,154,116,38,157,121,36,137,0.0,0.0
1016,1829,2020-03-20 06:17:00,1,1854.0,1437.0,0.775,8.898,132,58,45,13,74,53,21,67,0.37,0.0
1016,1830,2020-03-20 06:20:00,1,2262.0,1777.0,0.786,10.88,214,135,90,45,79,48,31,49,0.0,0.0
1016,1831,2020-03-20 06:23:00,1,2577.0,2127.0,0.826,12.507,228,106,80,26,122,82,40,120,0.06,0.0
1016,1832,2020-03-20 06:26:00,1,1992.0,1757.0,0.882,9.794,73,58,49,9,15,8,7,81,0.0,0.04
1016,1833,2020-03-20 06:29:00,1,2247.0,1836.0,0.817,10.885,199,109,83,26,90,64,26,102,0.05,0.0
1016,1834,2020-03-20 06:32:00,1,2196.0,1979.0,0.901,10.843,137,91,76,15,46,36,10,126,0.06,0.0
1016,1835,2020-03-20 06:35:00,1,2349.0,2076.0,0.884,11.554,162,83,52,31,79,45,34,25,0.0,0.0
1016,1836,2020-03-20 06:38:00,1,2361.0,2071.0,0.877,11.595,208,67,35,32,141,83,58,43,0.0,0.12
1016,1837,2020-03-20 06:41:00,1,2530.0,2322.0,0.918,12.537,128,90,69,21,38,20,18,87,0.15,0.05
1016,1838,2020-03-20 06:44:00,1,1814.0,1576.0,0.869,8.891,136,100,64,36,36,8,28,15,0.0,0.0
1016,1839,2020-03-20 06:47:00,1,2191.0,1983.0,0.905,10.83,0,0,0,0,0,0,0,0,0.0,0.0
1016,1840,2020-03-20 06:50:00,1,1864.0,1716.0,0.921,9.244,48,35,21,14,13,4,9,0,0.0,0.0
1016,1841,2020-03-20 06:53:00,1,1862.0,1693.0,0.909,9.212,17,4,2,2,13,1,12,0,0.0,0.0
1016,1842,2020-03-20 06:56:00,1,1664.0,1503.0,0.903,8.22,16,0,0,0,16,0,16,0,0.0,0.0
1016,1843,2020-03-20 06:59:00,1,1663.0,1517.0,0.912,8.232,7,4,1,3,3,0,3,1,0.0,0.0
1016,1844,2020-03-20 07:02:00,1,1800.0,1597.0,0.887,8.858,239,163,122,41,76,42,34,94,0.14,0.0
1016,1845,2020-03-20 07:05:00,1,2221.0,1923.0,0.866,10.879,89,62,26,36,27,5,22,69,0.0,0.13
1016,1846,2020-03-20 07:08:00,1,1876.0,1659.0,0.884,9.227,125,75,50,25,50,29,21,2,0.0,0.0
1016,1847,2020-03-20 07:11:00,1,1935.0,1736.0,0.897,9.545,154,135,83,52,19,2,17,6,0.0,0.0
1016,1848,2020-03-20 07:14:00,1,1990.0,1815.0,0.912,9.85,95,94,56,38,1,0,1,3,0.0,0.0
1016,1849,2020-03-20 07:17:00,1,1995.0,1810.0,0.907,9.867,13,13,7,6,0,0,0,0,0.0,0.0
1016,1850,2020-03-20 07:20:00,1,1798.0,1631.0,0.907,8.889,4,2,0,2,2,1,1,0,0.0,0.0
1016,1851,2020-03-20 07:23:00,1,1655.0,1560.0,0.942,8.249,0,0,0,0,0,0,0,0,0.0,0.0
1016,1852,2020-03-20 07:26:00,1,1664.0,1514.0,0.91,8.231,57,43,30,13,14,9,5,0,0.0,0.0
1016,1853,2020-03-20 07:29:00,1,1511.0,1427.0,0.945,7.532,1,1,0,1,0,0,0,0,0.0,0.0
1016,1854,2020-03-20 07:32:00,1,1384.0,1309.0,0.946,6.902,1,1,0,1,0,0,0,0,0.0,0.0
1016,1855,2020-03-20 07:35:00,1,1395.0,1259.0,0.903,6.891,3,2,0,2,1,0,1,0,0.0,0.0
1016,1856,2020-03-20 07:38:00,1,1599.0,1471.0,0.92,7.929,123,75,60,15,48,26,22,7,0.04,0.0
1016,1857,2020-03-20 07:41:00,1,1887.0,1652.0,0.875,9.265,4,0,0,0,4,0,4,0,0.0,0.0
1016,1858,2020-03-20 07:44:00,1,1667.0,1529.0,0.917,8.262,2,2,1,1,0,0,0,0,0.0,0.0
1016,1859,2020-03-20 07:47:00,1,1590.0,1454.0,0.915,7.875,0,0,0,0,0,0,0,0,0.0,0.0
1016,1860,2020-03-20 07:50:00,1,1682.0,1463.0,0.87,8.246,8,4,2,2,4,0,4,0,0.0,0.0
1016,1861,2020-03-20 07:53:00,1,1649.0,1539.0,0.933,8.202,43,32,8,24,11,1,10,0,0.0,0.0
1016,1862,2020-03-20 07:56:00,1,1645.0,1543.0,0.938,8.191,11,11,2,9,0,0,0,0,0.0,0.0
1016,1863,2020-03-20 07:59:00,1,1592.0,1492.0,0.937,7.923,0,0,0,0,0,0,0,0,0.0,0.0
1016,1864,2020-03-20 08:02:00,1,1673.0,1509.0,0.902,8.261,0,0,0,0,0,0,0,0,0.0,0.0
1016,1865,2020-03-20 08:05:00,1,1667.0,1449.0,0.869,8.173,135,97,58,39,38,19,19,22,0.0,0.0
1016,1866,2020-03-20 08:08:00,1,1995.0,1818.0,0.911,9.874,194,88,58,30,106,67,39,74,0.1,0.12
1016,1867,2020-03-20 08:11:00,1,1865.0,1715.0,0.919,9.247,338,179,144,35,159,120,39,122,0.08,0.0
1016,1868,2020-03-20 08:14:00,1,1865.0,1710.0,0.917,9.242,148,80,54,26,68,44,24,25,0.0,0.0
1016,1869,2020-03-20 08:17:00,1,1983.0,1859.0,0.937,9.873,515,232,175,57,283,223,60,41,0.0,0.0
1016,1870,2020-03-20 08:20:00,1,1862.0,1707.0,0.917,9.228,338,186,138,48,152,105,47,44,0.07,0.0
1016,1871,2020-03-20 08:23:00,1,2200.0,1992.0,0.906,10.872,51,36,17,19,15,4,11,59,0.0,0.0
1016,1872,2020-03-20 08:26:00,1,2196.0,1998.0,0.91,10.863,21,18,7,11,3,0,3,57,0.0,0.0
1016,1873,2020-03-20 08:29:00,1,2143.0,1922.0,0.897,10.569,15,0,0,0,15,0,15,0,0.0,0.0
1016,1874,2020-03-20 08:32:00,1,1920.0,1716.0,0.894,9.466,4,0,0,0,4,0,4,0,0.0,0.0
1016,1875,2020-03-20 08:35:00,1,1683.5,1567.0,0.937,8.3685,10,10,1,9,0,0,0,0,0.0,0.0
1016,1876,2020-03-20 08:38:00,1,1447.0,1418.0,0.98,7.271,7,7,3,4,0,0,0,0,0.0,0.0
1016,1877,2020-03-20 08:41:00,1,1317.0,1260.0,0.957,6.585,17,15,11,4,2,0,2,0,0.0,0.0
1016,1878,2020-03-20 08:44:00,1,1457.0,1349.0,0.926,7.233,2,2,1,1,0,0,0,0,0.0,0.0
1016,1879,2020-03-20 08:47:00,1,1467.0,1337.0,0.911,7.261,9,9,5,4,0,0,0,0,0.0,0.0
1016,1880,2020-03-20 08:50:00,1,1455.0,1351.0,0.928,7.229,2,2,0,2,0,0,0,0,0.0,0.0
1016,1881,2020-03-20 08:53:00,1,1441.0,1407.0,0.976,7.235,3,3,1,2,0,0,0,0,0.0,0.0
1016,1882,2020-03-20 08:56:00,1,1455.0,1347.0,0.926,7.223,10,6,2,4,4,0,4,0,0.0,0.0
1016,1883,2020-03-20 08:59:00,1,1607.0,1438.0,0.895,7.925,21,6,1,5,15,0,15,0,0.0,0.0
1016,1884,2020-03-20 09:02:00,1,1512.0,1412.0,0.934,7.523,11,8,1,7,3,0,3,0,0.0,0.0
1016,1885,2020-03-20 09:05:00,1,1443.0,1384.0,0.959,7.216,3,2,0,2,1,0,1,0,0.0,0.0
1016,1886,2020-03-20 09:08:00,1,1448.0,1405.0,0.97,7.263,17,11,1,10,6,0,6,0,0.0,0.0
1016,1887,2020-03-20 09:11:00,1,1452.0,1401.0,0.965,7.273,1,1,0,1,0,0,0,0,0.0,0.0
1016,1888,2020-03-20 09:14:00,1,1449.0,1403.0,0.969,7.262,6,6,2,4,0,0,0,0,0.0,0.0
1016,1889,2020-03-20 09:17:00,1,1387.0,1314.0,0.947,6.921,3,1,1,0,2,0,2,0,0.0,0.0
1016,1890,2020-03-20 09:20:00,1,1307.0,1286.0,0.984,6.575,16,6,2,4,10,2,8,0,0.0,0.0
1016,1891,2020-03-20 09:23:00,1,1443.0,1382.0,0.958,7.215,3,2,1,1,1,0,1,0,0.0,0.0
1016,1892,2020-03-20 09:26:00,1,1456.0,1357.0,0.932,7.241,5,1,0,1,4,0,4,0,0.0,0.0
1016,1893,2020-03-20 09:29:00,1,1464.0,1305.0,0.892,7.211,21,8,0,8,13,0,13,0,0.0,0.0
1016,1894,2020-03-20 09:32:00,1,1463.0,1319.0,0.902,7.224,86,60,32,28,26,0,26,20,0.0,0.0
1016,1895,2020-03-20 09:35:00,1,1561.0,1503.0,0.963,7.814,155,102,52,50,53,10,43,82,0.0,0.12
1016,1896,2020-03-20 09:38:00,1,1979.0,1863.0,0.942,9.86,150,46,25,21,104,66,38,56,0.03,0.19
1016,1897,2020-03-20 09:41:00,1,1647.0,1608.0,0.976,8.271,71,45,17,28,26,14,12,36,0.0,0.0
1016,1898,2020-03-20 09:44:00,1,1803.0,1658.0,0.92,8.94,24,24,4,20,0,0,0,0,0.0,0.01
1016,1899,2020-03-20 09:47:00,1,1776.0,1659.0,0.935,8.833,21,21,12,9,0,0,0,0,0.0,0.0
1016,1900,2020-03-20 09:50:00,1,1574.0,1544.0,0.981,7.912,9,9,6,3,0,0,0,0,0.0,0.0
1016,1901,2020-03-20 09:53:00,1,1465.0,1314.0,0.897,7.228,26,21,10,11,5,0,5,0,0.0,0.0
1016,1902,2020-03-20 09:56:00,1,1390.0,1319.0,0.949,6.936,103,101,55,46,2,0,2,9,0.0,0.0
1016,1903,2020-03-20 09:59:00,1,1797.0,1664.0,0.926,8.923,72,42,6,36,30,0,30,2,0.0,0.0
1016,1904,2020-03-20 10:02:00,1,1709.0,1624.0,0.95,8.533,11,9,4,5,2,0,2,0,0.0,0.0
1016,1905,2020-03-20 10:05:00,1,1575.0,1490.0,0.946,7.854,12,12,6,6,0,0,0,0,0.0,0.0
1016,1906,2020-03-20 10:08:00,1,1499.0,1481.0,0.988,7.544,194,157,113,44,37,15,22,18,0.0,0.11
1016,1907,2020-03-20 10:11:00,1,1785.0,1670.0,0.936,8.883,12,10,3,7,2,1,1,0,0.0,0.01
1016,1908,2020-03-20 10:14:00,1,1557.0,1587.0,1.019,7.893,0,0,0,0,0,0,0,0,0.0,0.0
1016,1909,2020-03-20 10:17:00,1,1577.0,1564.0,0.992,7.944,2,0,0,0,2,0,2,0,0.0,0.0
1016,1910,2020-03-20 10:20:00,1,1578.0,1556.0,0.986,7.938,19,17,2,15,2,0,2,0,0.0,0.0
1016,1911,2020-03-20 10:23:00,1,1572.0,1513.0,0.963,7.87,13,12,3,9,1,0,1,0,0.0,0.0
1016,1912,2020-03-20 10:26:00,1,1582.0,1505.0,0.951,7.9,3,3,1,2,0,0,0,0,0.0,0.0
1016,1913,2020-03-20 10:29:00,1,1423.0,1479.0,1.04,7.243,7,7,1,6,0,0,0,0,0.0,0.0
1016,1914,2020-03-20 10:32:00,1,1582.0,1548.0,0.979,7.945,77,52,28,24,25,0,25,1,0.0,0.0
1016,1915,2020-03-20 10:35:00,1,1711.0,1645.0,0.961,8.562,49,20,5,15,29,0,29,10,0.0,0.0
1016,1916,2020-03-20 10:38:00,1,1785.0,1685.0,0.944,8.896,34,23,8,15,11,0,11,10,0.0,0.0
1016,1917,2020-03-20 10:41:00,1,1711.0,1656.0,0.967,8.576,0,0,0,0,0,0,0,0,0.0,0.0
1016,1918,2020-03-20 10:44:00,1,1423.0,1459.0,1.026,7.22,0,0,0,0,0,0,0,0,0.0,0.0
1016,1919,2020-03-20 10:47:00,1,1429.0,1472.0,1.031,7.258,0,0,0,0,0,0,0,0,0.0,0.0
1016,1920,2020-03-20 10:50:00,1,1440.0,1472.0,1.022,7.303,102,65,49,16,37,22,15,7,0.12,0.0
1016,1921,2020-03-20 10:53:00,1,1587.0,1531.0,0.965,7.947,4,2,1,1,2,0,2,0,0.0,0.0
1016,1922,2020-03-20 10:56:00,1,1585.0,1515.0,0.956,7.924,2,2,1,1,0,0,0,0,0.0,0.0
1016,1923,2020-03-20 10:59:00,1,1441.0,1422.0,0.987,7.251,13,13,4,9,0,0,0,0,0.0,0.0
1016,1924,2020-03-20 11:02:00,1,1440.0,1420.0,0.986,7.244,27,26,9,17,1,0,1,0,0.0,0.0
1016,1925,2020-03-20 11:05:00,1,1450.0,1376.0,0.949,7.238,22,22,4,18,0,0,0,0,0.0,0.0
1016,1926,2020-03-20 11:08:00,1,1462.0,1332.0,0.911,7.236,12,12,7,5,0,0,0,0,0.0,0.0
1016,1927,2020-03-20 11:11:00,1,1450.0,1411.0,0.974,7.275,36,36,14,22,0,0,0,0,0.0,0.01
1016,1928,2020-03-20 11:14:00,1,1451.0,1396.0,0.962,7.263,7,7,5,2,0,0,0,0,0.0,0.0
1016,1929,2020-03-20 11:17:00,1,1446.0,1381.0,0.955,7.225,4,2,1,1,2,0,2,0,0.0,0.0
1016,1930,2020-03-20 11:20:00,1,1580.0,1520.0,0.962,7.908,5,2,1,1,3,0,3,0,0.0,0.0
1016,1931,2020-03-20 11:23:00,1,1639.0,1603.0,0.978,8.232,9,5,1,4,4,0,4,0,0.0,0.0
1016,1932,2020-03-20 11:26:00,1,1638.0,1615.0,0.986,8.244,85,52,14,38,33,2,31,4,0.0,0.0
1016,1933,2020-03-20 11:29:00,1,1796.0,1669.0,0.929,8.926,94,69,43,26,25,10,15,23,0.0,0.0
1016,1934,2020-03-20 11:32:00,1,1918.0,1811.0,0.944,9.563,53,23,19,4,30,17,13,22,0.0,0.34
1016,1935,2020-03-20 11:35:00,1,1872.5,1806.0,0.9645,9.378,21,12,5,7,9,4,5,0,0.0,0.0
1016,1936,2020-03-20 11:38:00,1,1827.0,1801.0,0.985,9.193,425,212,156,56,213,155,58,49,0.0,0.0
1016,1937,2020-03-20 11:41:00,1,1901.0,1871.0,0.984,9.562,631,363,288,75,268,204,64,18,0.0,0.0
1016,1938,2020-03-20 11:44:00,1,1886.0,1841.0,0.976,9.467,416,201,148,53,215,147,68,31,0.08,0.03
1016,1939,2020-03-20 11:47:00,1,1964.0,1923.0,0.979,9.866,481,335,249,86,146,97,49,73,0.0,0.0
1016,1940,2020-03-20 11:50:00,1,1891.0,1897.0,1.004,9.549,343,190,136,54,153,96,57,23,0.0,0.0
1016,1941,2020-03-20 11:53:00,1,1904.0,1892.0,0.994,9.599,506,304,240,64,202,136,66,11,0.02,0.0
1016,1942,2020-03-20 11:56:00,1,1921.0,1830.0,0.953,9.596,320,171,122,49,149,93,56,42,0.0,0.07
1016,1943,2020-03-20 11:59:00,1,1778.0,1734.0,0.976,8.923,231,156,96,60,75,58,17,8,0.0,0.0
1016,1944,2020-03-20 12:02:00,1,1906.0,1884.0,0.989,9.596,18,16,7,9,2,1,1,2,0.0,0.02
1016,1945,2020-03-20 12:05:00,1,1753.0,1751.0,0.999,8.845,4,4,1,3,0,0,0,0,0.0,0.0
1016,1946,2020-03-20 12:08:00,1,1786.0,1673.0,0.937,8.888,3,2,0,2,1,0,1,0,0.0,0.0
